userID,trajID,poiID,startTime,endTime,#photo,trajLen,poiDuration
1,1,1,1,18,0,38,17
1,1,1,18,29,0,38,11
1,1,2,29,35,0,38,6
1,1,2,35,41,0,38,6
1,1,2,41,51,0,38,10
1,1,2,51,54,0,38,3
1,1,2,54,74,0,38,20
1,1,3,74,92,0,38,18
1,1,3,92,109,0,38,17
1,1,3,109,121,0,38,12
1,1,3,121,128,0,38,7
1,1,3,128,137,0,38,9
1,1,4,137,146,0,38,9
1,1,3,146,166,0,38,20
1,1,3,166,175,0,38,9
1,1,3,175,186,0,38,11
1,1,3,186,205,0,38,19
1,1,3,205,222,0,38,17
1,1,5,222,227,0,38,5
1,1,5,227,243,0,38,16
1,1,5,243,249,0,38,6
1,1,5,249,260,0,38,11
1,1,5,260,276,0,38,16
1,1,5,276,278,0,38,2
1,1,5,278,298,0,38,20
1,1,5,298,315,0,38,17
1,1,5,315,317,0,38,2
1,1,6,317,321,0,38,4
1,1,6,321,339,0,38,18
1,1,6,339,340,0,38,1
1,1,6,340,345,0,38,5
1,1,6,345,349,0,38,4
1,1,7,349,361,0,38,12
1,1,7,361,370,0,38,9
1,1,7,370,389,0,38,19
1,1,7,389,403,0,38,14
1,1,7,403,408,0,38,5
1,11,24,408,422,0,118,14
1,11,24,422,435,0,118,13
1,11,24,435,436,0,118,1
1,11,7,436,439,0,118,3
1,11,7,439,450,0,118,11
1,11,7,450,456,0,118,6
1,11,7,456,460,0,118,4
1,11,7,460,475,0,118,15
1,11,27,475,494,0,118,19
1,11,27,494,498,0,118,4
1,11,27,498,509,0,118,11
1,11,27,509,526,0,118,17
1,11,27,526,532,0,118,6
1,11,27,532,552,0,118,20
1,11,27,552,563,0,118,11
1,11,27,563,565,0,118,2
1,11,27,565,566,0,118,1
1,11,27,566,576,0,118,10
1,11,27,576,585,0,118,9
1,11,28,585,604,0,118,19
1,11,28,604,624,0,118,20
1,11,28,624,634,0,118,10
1,11,25,634,645,0,118,11
1,11,26,645,664,0,118,19
1,11,25,664,683,0,118,19
1,11,25,683,694,0,118,11
1,11,25,694,695,0,118,1
1,11,25,695,705,0,118,10
1,11,25,705,719,0,118,14
1,11,25,719,721,0,118,2
1,11,25,721,729,0,118,8
1,11,25,729,741,0,118,12
1,11,25,741,757,0,118,16
1,11,25,757,766,0,118,9
1,11,25,766,770,0,118,4
1,11,25,770,772,0,118,2
1,11,25,772,782,0,118,10
1,11,25,782,790,0,118,8
1,11,25,790,809,0,118,19
1,11,25,809,829,0,118,20
1,11,25,829,832,0,118,3
1,11,25,832,845,0,118,13
1,11,25,845,857,0,118,12
1,11,25,857,865,0,118,8
1,11,25,865,879,0,118,14
1,11,25,879,891,0,118,12
1,11,25,891,901,0,118,10
1,11,25,901,921,0,118,20
1,11,25,921,936,0,118,15
1,11,25,936,949,0,118,13
1,11,25,949,963,0,118,14
1,11,25,963,974,0,118,11
1,11,25,974,994,0,118,20
1,11,25,994,1012,0,118,18
1,11,25,1012,1016,0,118,4
1,11,25,1016,1029,0,118,13
1,11,25,1029,1033,0,118,4
1,11,25,1033,1038,0,118,5
1,11,25,1038,1056,0,118,18
1,11,25,1056,1075,0,118,19
1,11,25,1075,1090,0,118,15
1,11,25,1090,1094,0,118,4
1,11,25,1094,1097,0,118,3
1,11,25,1097,1115,0,118,18
1,11,25,1115,1131,0,118,16
1,11,25,1131,1132,0,118,1
1,11,25,1132,1136,0,118,4
1,11,25,1136,1143,0,118,7
1,11,25,1143,1157,0,118,14
1,11,25,1157,1164,0,118,7
1,11,25,1164,1171,0,118,7
1,11,25,1171,1179,0,118,8
1,11,25,1179,1184,0,118,5
1,11,25,1184,1195,0,118,11
1,11,25,1195,1204,0,118,9
1,11,25,1204,1214,0,118,10
1,11,25,1214,1229,0,118,15
1,11,25,1229,1245,0,118,16
1,11,25,1245,1263,0,118,18
1,11,25,1263,1280,0,118,17
1,11,25,1280,1299,0,118,19
1,11,25,1299,1302,0,118,3
1,11,25,1302,1318,0,118,16
1,11,25,1318,1323,0,118,5
1,11,25,1323,1327,0,118,4
1,11,25,1327,1334,0,118,7
1,11,25,1334,1349,0,118,15
1,11,25,1349,1360,0,118,11
1,11,25,1360,1373,0,118,13
1,11,25,1373,1375,0,118,2
1,11,25,1375,1392,0,118,17
1,11,25,1392,1412,0,118,20
1,11,25,1412,1423,0,118,11
1,11,25,1423,1437,0,118,14
1,11,25,1437,1442,0,118,5
1,11,25,1442,1455,0,118,13
1,11,25,1455,1460,0,118,5
1,11,25,1460,1464,0,118,4
1,11,25,1464,1473,0,118,9
1,11,25,1473,1487,0,118,14
1,11,25,1487,1503,0,118,16
1,11,25,1503,1510,0,118,7
1,11,25,1510,1516,0,118,6
1,11,25,1516,1530,0,118,14
1,11,25,1530,1548,0,118,18
1,11,25,1548,1566,0,118,18
1,11,25,1566,1572,0,118,6
1,11,25,1572,1588,0,118,16
1,11,25,1588,1607,0,118,19
1,11,25,1607,1608,0,118,1
1,11,25,1608,1622,0,118,14
1,11,25,1622,1637,0,118,15
1,11,25,1637,1657,0,118,20
1,11,25,1657,1673,0,118,16
1,11,25,1673,1676,0,118,3
1,11,25,1676,1688,0,118,12
1,11,25,1688,1697,0,118,9
1,21,8,1697,1712,0,25,15
1,21,8,1712,1723,0,25,11
1,21,8,1723,1734,0,25,11
1,21,7,1734,1750,0,25,16
1,21,7,1750,1756,0,25,6
1,21,7,1756,1772,0,25,16
1,21,7,1772,1782,0,25,10
1,21,7,1782,1790,0,25,8
1,21,24,1790,1808,0,25,18
1,21,7,1808,1810,0,25,2
1,21,7,1810,1824,0,25,14
1,21,7,1824,1829,0,25,5
1,21,8,1829,1835,0,25,6
1,21,8,1835,1847,0,25,12
1,21,8,1847,1849,0,25,2
1,21,8,1849,1852,0,25,3
1,21,8,1852,1866,0,25,14
1,21,8,1866,1885,0,25,19
1,21,8,1885,1886,0,25,1
1,21,8,1886,1889,0,25,3
1,21,8,1889,1903,0,25,14
1,21,8,1903,1913,0,25,10
1,21,8,1913,1920,0,25,7
1,21,8,1920,1934,0,25,14
1,31,8,1934,1937,0,23,3
1,31,8,1937,1938,0,23,1
1,31,8,1938,1954,0,23,16
1,31,8,1954,1955,0,23,1
1,31,8,1955,1975,0,23,20
1,31,7,1975,1988,0,23,13
1,31,7,1988,1991,0,23,3
1,31,7,1991,2010,0,23,19
1,31,7,2010,2020,0,23,10
1,31,7,2020,2039,0,23,19
1,31,24,2039,2043,0,23,4
1,31,24,2043,2054,0,23,11
1,31,24,2054,2071,0,23,17
1,31,24,2071,2086,0,23,15
1,31,23,2086,2089,0,23,3
1,31,23,2089,2095,0,23,6
1,31,23,2095,2098,0,23,3
1,31,23,2098,2117,0,23,19
1,31,23,2117,2135,0,23,18
1,31,23,2135,2139,0,23,4
1,31,23,2139,2149,0,23,10
1,31,23,2149,2167,0,23,18
1,41,7,2167,2178,0,16,11
1,41,7,2178,2198,0,16,20
1,41,7,2198,2214,0,16,16
1,41,7,2214,2218,0,16,4
1,41,8,2218,2233,0,16,15
1,41,8,2233,2235,0,16,2
1,41,8,2235,2247,0,16,12
1,41,8,2247,2251,0,16,4
1,41,8,2251,2254,0,16,3
1,41,8,2254,2256,0,16,2
1,41,8,2256,2264,0,16,8
1,41,8,2264,2280,0,16,16
1,41,8,2280,2289,0,16,9
1,41,8,2289,2296,0,16,7
1,41,8,2296,2311,0,16,15
1,51,8,2311,2326,0,2,15
1,61,24,2326,2336,0,23,10
1,61,24,2336,2348,0,23,12
1,61,24,2348,2351,0,23,3
1,61,24,2351,2367,0,23,16
1,61,7,2367,2380,0,23,13
1,61,8,2380,2382,0,23,2
1,61,8,2382,2399,0,23,17
1,61,8,2399,2400,0,23,1
1,61,8,2400,2417,0,23,17
1,61,8,2417,2432,0,23,15
1,61,8,2432,2451,0,23,19
1,61,8,2451,2465,0,23,14
1,61,8,2465,2474,0,23,9
1,61,8,2474,2492,0,23,18
1,61,8,2492,2507,0,23,15
1,61,8,2507,2526,0,23,19
1,61,7,2526,2536,0,23,10
1,61,7,2536,2547,0,23,11
1,61,24,2547,2564,0,23,17
1,61,24,2564,2576,0,23,12
1,61,24,2576,2593,0,23,17
1,61,24,2593,2594,0,23,1
1,71,45,2594,2595,0,139,1
1,71,46,2595,2596,0,139,1
1,71,47,2596,2616,0,139,20
1,71,48,2616,2629,0,139,13
1,71,48,2629,2648,0,139,19
1,71,48,2648,2651,0,139,3
1,71,48,2651,2655,0,139,4
1,71,49,2655,2661,0,139,6
1,71,49,2661,2671,0,139,10
1,71,49,2671,2685,0,139,14
1,71,50,2685,2703,0,139,18
1,71,51,2703,2714,0,139,11
1,71,52,2714,2726,0,139,12
1,71,53,2726,2741,0,139,15
1,71,53,2741,2759,0,139,18
1,71,54,2759,2765,0,139,6
1,71,54,2765,2768,0,139,3
1,71,54,2768,2773,0,139,5
1,71,55,2773,2775,0,139,2
1,71,56,2775,2777,0,139,2
1,71,57,2777,2784,0,139,7
1,71,58,2784,2788,0,139,4
1,71,59,2788,2806,0,139,18
1,71,60,2806,2814,0,139,8
1,71,61,2814,2828,0,139,14
1,71,62,2828,2835,0,139,7
1,71,63,2835,2843,0,139,8
1,71,64,2843,2847,0,139,4
1,71,65,2847,2854,0,139,7
1,71,66,2854,2861,0,139,7
1,71,67,2861,2869,0,139,8
1,71,68,2869,2884,0,139,15
1,71,69,2884,2903,0,139,19
1,71,69,2903,2918,0,139,15
1,71,69,2918,2922,0,139,4
1,71,69,2922,2929,0,139,7
1,71,70,2929,2932,0,139,3
1,71,70,2932,2944,0,139,12
1,71,71,2944,2957,0,139,13
1,71,72,2957,2963,0,139,6
1,71,73,2963,2980,0,139,17
1,71,74,2980,2986,0,139,6
1,71,74,2986,3002,0,139,16
1,71,74,3002,3011,0,139,9
1,71,74,3011,3027,0,139,16
1,71,74,3027,3036,0,139,9
1,71,75,3036,3052,0,139,16
1,71,75,3052,3067,0,139,15
1,71,73,3067,3073,0,139,6
1,71,72,3073,3092,0,139,19
1,71,76,3092,3099,0,139,7
1,71,76,3099,3114,0,139,15
1,71,76,3114,3133,0,139,19
1,71,77,3133,3144,0,139,11
1,71,62,3144,3159,0,139,15
1,71,78,3159,3177,0,139,18
1,71,60,3177,3196,0,139,19
1,71,59,3196,3212,0,139,16
1,71,58,3212,3225,0,139,13
1,71,57,3225,3236,0,139,11
1,71,56,3236,3242,0,139,6
1,71,55,3242,3258,0,139,16
1,71,54,3258,3260,0,139,2
1,71,79,3260,3279,0,139,19
1,71,53,3279,3281,0,139,2
1,71,80,3281,3283,0,139,2
1,71,51,3283,3302,0,139,19
1,71,47,3302,3316,0,139,14
1,71,47,3316,3335,0,139,19
1,71,47,3335,3345,0,139,10
1,71,46,3345,3359,0,139,14
1,71,46,3359,3370,0,139,11
1,71,46,3370,3380,0,139,10
1,71,45,3380,3381,0,139,1
1,71,44,3381,3392,0,139,11
1,71,44,3392,3409,0,139,17
1,71,42,3409,3423,0,139,14
1,71,41,3423,3426,0,139,3
1,71,40,3426,3428,0,139,2
1,71,40,3428,3438,0,139,10
1,71,23,3438,3444,0,139,6
1,71,23,3444,3460,0,139,16
1,71,6,3460,3480,0,139,20
1,71,1,3480,3484,0,139,4
1,71,6,3484,3499,0,139,15
1,71,6,3499,3500,0,139,1
1,71,6,3500,3520,0,139,20
1,71,6,3520,3526,0,139,6
1,71,6,3526,3541,0,139,15
1,71,6,3541,3554,0,139,13
1,71,6,3554,3571,0,139,17
1,71,6,3571,3587,0,139,16
1,71,6,3587,3599,0,139,12
1,71,6,3599,3618,0,139,19
1,71,6,3618,3621,0,139,3
1,71,6,3621,3636,0,139,15
1,71,7,3636,3648,0,139,12
1,71,7,3648,3651,0,139,3
1,71,7,3651,3654,0,139,3
1,71,7,3654,3664,0,139,10
1,71,7,3664,3678,0,139,14
1,71,7,3678,3693,0,139,15
1,71,7,3693,3695,0,139,2
1,71,7,3695,3698,0,139,3
1,71,7,3698,3703,0,139,5
1,71,7,3703,3713,0,139,10
1,71,7,3713,3722,0,139,9
1,71,7,3722,3739,0,139,17
1,71,8,3739,3757,0,139,18
1,71,8,3757,3771,0,139,14
1,71,8,3771,3786,0,139,15
1,71,8,3786,3787,0,139,1
1,71,8,3787,3796,0,139,9
1,71,8,3796,3816,0,139,20
1,71,28,3816,3821,0,139,5
1,71,28,3821,3826,0,139,5
1,71,28,3826,3827,0,139,1
1,71,28,3827,3842,0,139,15
1,71,28,3842,3862,0,139,20
1,71,8,3862,3864,0,139,2
1,71,8,3864,3872,0,139,8
1,71,8,3872,3882,0,139,10
1,71,8,3882,3902,0,139,20
1,71,8,3902,3910,0,139,8
1,71,8,3910,3920,0,139,10
1,71,8,3920,3922,0,139,2
1,71,8,3922,3927,0,139,5
1,71,8,3927,3944,0,139,17
1,71,8,3944,3950,0,139,6
1,71,8,3950,3970,0,139,20
1,71,8,3970,3986,0,139,16
1,71,8,3986,4004,0,139,18
1,71,8,4004,4006,0,139,2
1,71,8,4006,4012,0,139,6
1,71,7,4012,4014,0,139,2
1,71,24,4014,4017,0,139,3
1,71,28,4017,4028,0,139,11
1,71,8,4028,4034,0,139,6
1,81,8,4034,4049,0,104,15
1,81,28,4049,4056,0,104,7
1,81,8,4056,4075,0,104,19
1,81,8,4075,4092,0,104,17
1,81,8,4092,4094,0,104,2
1,81,8,4094,4106,0,104,12
1,81,8,4106,4109,0,104,3
1,81,8,4109,4129,0,104,20
1,81,8,4129,4144,0,104,15
1,81,8,4144,4161,0,104,17
1,81,8,4161,4169,0,104,8
1,81,8,4169,4184,0,104,15
1,81,8,4184,4203,0,104,19
1,81,7,4203,4210,0,104,7
1,81,7,4210,4230,0,104,20
1,81,7,4230,4236,0,104,6
1,81,24,4236,4239,0,104,3
1,81,24,4239,4256,0,104,17
1,81,24,4256,4269,0,104,13
1,81,7,4269,4271,0,104,2
1,81,24,4271,4281,0,104,10
1,81,24,4281,4286,0,104,5
1,81,24,4286,4296,0,104,10
1,81,24,4296,4304,0,104,8
1,81,24,4304,4305,0,104,1
1,81,24,4305,4312,0,104,7
1,81,24,4312,4313,0,104,1
1,81,24,4313,4324,0,104,11
1,81,7,4324,4325,0,104,1
1,81,24,4325,4342,0,104,17
1,81,24,4342,4361,0,104,19
1,81,24,4361,4362,0,104,1
1,81,24,4362,4364,0,104,2
1,81,24,4364,4380,0,104,16
1,81,24,4380,4389,0,104,9
1,81,24,4389,4392,0,104,3
1,81,24,4392,4403,0,104,11
1,81,24,4403,4417,0,104,14
1,81,24,4417,4426,0,104,9
1,81,24,4426,4445,0,104,19
1,81,24,4445,4451,0,104,6
1,81,23,4451,4463,0,104,12
1,81,23,4463,4472,0,104,9
1,81,23,4472,4488,0,104,16
1,81,23,4488,4503,0,104,15
1,81,23,4503,4507,0,104,4
1,81,23,4507,4518,0,104,11
1,81,23,4518,4531,0,104,13
1,81,23,4531,4549,0,104,18
1,81,23,4549,4567,0,104,18
1,81,23,4567,4580,0,104,13
1,81,23,4580,4593,0,104,13
1,81,23,4593,4612,0,104,19
1,81,101,4612,4623,0,104,11
1,81,102,4623,4636,0,104,13
1,81,103,4636,4648,0,104,12
1,81,104,4648,4668,0,104,20
1,81,104,4668,4680,0,104,12
1,81,104,4680,4687,0,104,7
1,81,104,4687,4704,0,104,17
1,81,104,4704,4721,0,104,17
1,81,104,4721,4731,0,104,10
1,81,105,4731,4751,0,104,20
1,81,105,4751,4762,0,104,11
1,81,105,4762,4770,0,104,8
1,81,105,4770,4788,0,104,18
1,81,105,4788,4805,0,104,17
1,81,105,4805,4806,0,104,1
1,81,105,4806,4826,0,104,20
1,81,105,4826,4836,0,104,10
1,81,106,4836,4853,0,104,17
1,81,106,4853,4869,0,104,16
1,81,106,4869,4878,0,104,9
1,81,106,4878,4894,0,104,16
1,81,106,4894,4911,0,104,17
1,81,106,4911,4922,0,104,11
1,81,106,4922,4926,0,104,4
1,81,106,4926,4934,0,104,8
1,81,106,4934,4940,0,104,6
1,81,106,4940,4958,0,104,18
1,81,106,4958,4974,0,104,16
1,81,107,4974,4991,0,104,17
1,81,107,4991,5002,0,104,11
1,81,107,5002,5015,0,104,13
1,81,107,5015,5029,0,104,14
1,81,107,5029,5031,0,104,2
1,81,107,5031,5047,0,104,16
1,81,107,5047,5051,0,104,4
1,81,107,5051,5070,0,104,19
1,81,107,5070,5085,0,104,15
1,81,107,5085,5094,0,104,9
1,81,107,5094,5101,0,104,7
1,81,107,5101,5103,0,104,2
1,81,107,5103,5123,0,104,20
1,81,107,5123,5130,0,104,7
1,81,107,5130,5139,0,104,9
1,81,107,5139,5147,0,104,8
1,81,107,5147,5162,0,104,15
1,81,107,5162,5179,0,104,17
1,81,107,5179,5197,0,104,18
1,81,108,5197,5210,0,104,13
1,81,108,5210,5226,0,104,16
1,81,108,5226,5236,0,104,10
1,91,24,5236,5256,0,10,20
1,91,24,5256,5261,0,10,5
1,91,7,5261,5273,0,10,12
1,91,7,5273,5274,0,10,1
1,91,7,5274,5283,0,10,9
1,91,8,5283,5292,0,10,9
1,91,8,5292,5293,0,10,1
1,91,8,5293,5294,0,10,1
1,91,8,5294,5299,0,10,5
1,101,122,5299,5311,0,34,12
1,101,123,5311,5323,0,34,12
1,101,124,5323,5329,0,34,6
1,101,124,5329,5331,0,34,2
1,101,124,5331,5342,0,34,11
1,101,124,5342,5353,0,34,11
1,101,125,5353,5364,0,34,11
1,101,125,5364,5376,0,34,12
1,101,126,5376,5395,0,34,19
1,101,163,5395,5409,0,34,14
1,101,128,5409,5426,0,34,17
1,101,129,5426,5437,0,34,11
1,101,130,5437,5450,0,34,13
1,101,166,5450,5462,0,34,12
1,101,131,5462,5472,0,34,10
1,101,134,5472,5475,0,34,3
1,101,167,5475,5481,0,34,6
1,101,168,5481,5499,0,34,18
1,101,179,5499,5515,0,34,16
1,101,138,5515,5534,0,34,19
1,101,139,5534,5546,0,34,12
1,101,140,5546,5549,0,34,3
1,101,141,5549,5552,0,34,3
1,101,178,5552,5561,0,34,9
1,101,143,5561,5573,0,34,12
1,101,180,5573,5583,0,34,10
1,101,181,5583,5595,0,34,12
1,101,147,5595,5602,0,34,7
1,101,169,5602,5607,0,34,5
1,101,148,5607,5627,0,34,20
1,101,148,5627,5633,0,34,6
1,101,149,5633,5641,0,34,8
1,101,149,5641,5645,0,34,4
1,111,24,5645,5653,0,5,8
1,111,24,5653,5660,0,5,7
1,111,24,5660,5665,0,5,5
1,111,24,5665,5677,0,5,12
1,121,214,5677,5679,0,46,2
1,121,214,5679,5686,0,46,7
1,121,214,5686,5693,0,46,7
1,121,214,5693,5695,0,46,2
1,121,214,5695,5710,0,46,15
1,121,214,5710,5721,0,46,11
1,121,216,5721,5736,0,46,15
1,121,216,5736,5749,0,46,13
1,121,216,5749,5764,0,46,15
1,121,216,5764,5781,0,46,17
1,121,216,5781,5784,0,46,3
1,121,216,5784,5798,0,46,14
1,121,216,5798,5807,0,46,9
1,121,216,5807,5813,0,46,6
1,121,216,5813,5830,0,46,17
1,121,216,5830,5838,0,46,8
1,121,216,5838,5844,0,46,6
1,121,216,5844,5863,0,46,19
1,121,216,5863,5873,0,46,10
1,121,216,5873,5878,0,46,5
1,121,216,5878,5893,0,46,15
1,121,216,5893,5895,0,46,2
1,121,216,5895,5914,0,46,19
1,121,216,5914,5922,0,46,8
1,121,216,5922,5942,0,46,20
1,121,216,5942,5954,0,46,12
1,121,216,5954,5958,0,46,4
1,121,216,5958,5971,0,46,13
1,121,216,5971,5984,0,46,13
1,121,216,5984,5985,0,46,1
1,121,216,5985,5995,0,46,10
1,121,216,5995,6000,0,46,5
1,121,217,6000,6008,0,46,8
1,121,217,6008,6020,0,46,12
1,121,216,6020,6038,0,46,18
1,121,216,6038,6054,0,46,16
1,121,216,6054,6065,0,46,11
1,121,218,6065,6067,0,46,2
1,121,218,6067,6084,0,46,17
1,121,218,6084,6089,0,46,5
1,121,218,6089,6094,0,46,5
1,121,218,6094,6104,0,46,10
1,121,218,6104,6113,0,46,9
1,121,218,6113,6130,0,46,17
1,121,218,6130,6143,0,46,13
1,131,8,6143,6159,0,72,16
1,131,8,6159,6170,0,72,11
1,131,8,6170,6186,0,72,16
1,131,8,6186,6190,0,72,4
1,131,7,6190,6205,0,72,15
1,131,7,6205,6225,0,72,20
1,131,24,6225,6245,0,72,20
1,131,24,6245,6253,0,72,8
1,131,24,6253,6255,0,72,2
1,131,24,6255,6265,0,72,10
1,131,24,6265,6278,0,72,13
1,131,23,6278,6287,0,72,9
1,131,23,6287,6292,0,72,5
1,131,23,6292,6308,0,72,16
1,131,23,6308,6326,0,72,18
1,131,23,6326,6344,0,72,18
1,131,29,6344,6363,0,72,19
1,131,29,6363,6367,0,72,4
1,131,29,6367,6383,0,72,16
1,131,29,6383,6400,0,72,17
1,131,29,6400,6413,0,72,13
1,131,29,6413,6415,0,72,2
1,131,30,6415,6417,0,72,2
1,131,30,6417,6429,0,72,12
1,131,30,6429,6432,0,72,3
1,131,30,6432,6449,0,72,17
1,131,30,6449,6459,0,72,10
1,131,30,6459,6475,0,72,16
1,131,30,6475,6478,0,72,3
1,131,29,6478,6493,0,72,15
1,131,29,6493,6498,0,72,5
1,131,29,6498,6503,0,72,5
1,131,29,6503,6514,0,72,11
1,131,29,6514,6521,0,72,7
1,131,29,6521,6532,0,72,11
1,131,29,6532,6543,0,72,11
1,131,23,6543,6545,0,72,2
1,131,23,6545,6546,0,72,1
1,131,23,6546,6550,0,72,4
1,131,23,6550,6570,0,72,20
1,131,23,6570,6582,0,72,12
1,131,24,6582,6597,0,72,15
1,131,24,6597,6605,0,72,8
1,131,24,6605,6622,0,72,17
1,131,24,6622,6636,0,72,14
1,131,36,6636,6645,0,72,9
1,131,24,6645,6656,0,72,11
1,131,24,6656,6667,0,72,11
1,131,7,6667,6683,0,72,16
1,131,7,6683,6691,0,72,8
1,131,7,6691,6695,0,72,4
1,131,7,6695,6696,0,72,1
1,131,7,6696,6715,0,72,19
1,131,8,6715,6720,0,72,5
1,131,8,6720,6724,0,72,4
1,131,8,6724,6743,0,72,19
1,131,7,6743,6755,0,72,12
1,131,8,6755,6763,0,72,8
1,131,8,6763,6776,0,72,13
1,131,8,6776,6779,0,72,3
1,131,8,6779,6785,0,72,6
1,131,8,6785,6801,0,72,16
1,131,7,6801,6810,0,72,9
1,131,8,6810,6811,0,72,1
1,131,8,6811,6828,0,72,17
1,131,7,6828,6837,0,72,9
1,131,7,6837,6844,0,72,7
1,131,7,6844,6857,0,72,13
1,131,7,6857,6863,0,72,6
1,131,7,6863,6880,0,72,17
1,131,24,6880,6896,0,72,16
1,141,8,6896,6906,0,89,10
1,141,8,6906,6911,0,89,5
1,141,8,6911,6913,0,89,2
1,141,7,6913,6924,0,89,11
1,141,7,6924,6929,0,89,5
1,141,7,6929,6944,0,89,15
1,141,24,6944,6963,0,89,19
1,141,24,6963,6968,0,89,5
1,141,23,6968,6969,0,89,1
1,141,23,6969,6972,0,89,3
1,141,23,6972,6985,0,89,13
1,141,23,6985,6990,0,89,5
1,141,23,6990,6994,0,89,4
1,141,23,6994,7008,0,89,14
1,141,23,7008,7021,0,89,13
1,141,23,7021,7036,0,89,15
1,141,23,7036,7052,0,89,16
1,141,23,7052,7062,0,89,10
1,141,23,7062,7067,0,89,5
1,141,29,7067,7074,0,89,7
1,141,30,7074,7082,0,89,8
1,141,30,7082,7089,0,89,7
1,141,101,7089,7103,0,89,14
1,141,102,7103,7122,0,89,19
1,141,102,7122,7124,0,89,2
1,141,103,7124,7131,0,89,7
1,141,104,7131,7135,0,89,4
1,141,104,7135,7146,0,89,11
1,141,104,7146,7150,0,89,4
1,141,104,7150,7153,0,89,3
1,141,88,7153,7165,0,89,12
1,141,88,7165,7181,0,89,16
1,141,88,7181,7183,0,89,2
1,141,239,7183,7186,0,89,3
1,141,239,7186,7199,0,89,13
1,141,239,7199,7210,0,89,11
1,141,88,7210,7229,0,89,19
1,141,88,7229,7249,0,89,20
1,141,88,7249,7253,0,89,4
1,141,88,7253,7265,0,89,12
1,141,88,7265,7277,0,89,12
1,141,88,7277,7281,0,89,4
1,141,240,7281,7282,0,89,1
1,141,240,7282,7302,0,89,20
1,141,240,7302,7312,0,89,10
1,141,240,7312,7319,0,89,7
1,141,240,7319,7336,0,89,17
1,141,240,7336,7342,0,89,6
1,141,240,7342,7361,0,89,19
1,141,240,7361,7370,0,89,9
1,141,240,7370,7390,0,89,20
1,141,240,7390,7408,0,89,18
1,141,240,7408,7421,0,89,13
1,141,240,7421,7438,0,89,17
1,141,240,7438,7439,0,89,1
1,141,240,7439,7454,0,89,15
1,141,240,7454,7472,0,89,18
1,141,240,7472,7490,0,89,18
1,141,240,7490,7501,0,89,11
1,141,240,7501,7502,0,89,1
1,141,240,7502,7503,0,89,1
1,141,240,7503,7515,0,89,12
1,141,240,7515,7522,0,89,7
1,141,240,7522,7524,0,89,2
1,141,240,7524,7540,0,89,16
1,141,240,7540,7553,0,89,13
1,141,240,7553,7572,0,89,19
1,141,240,7572,7589,0,89,17
1,141,240,7589,7604,0,89,15
1,141,240,7604,7620,0,89,16
1,141,240,7620,7637,0,89,17
1,141,240,7637,7654,0,89,17
1,141,240,7654,7673,0,89,19
1,141,240,7673,7679,0,89,6
1,141,240,7679,7695,0,89,16
1,141,240,7695,7706,0,89,11
1,141,240,7706,7711,0,89,5
1,141,240,7711,7713,0,89,2
1,141,240,7713,7718,0,89,5
1,141,240,7718,7729,0,89,11
1,141,240,7729,7730,0,89,1
1,141,240,7730,7740,0,89,10
1,141,240,7740,7759,0,89,19
1,141,240,7759,7768,0,89,9
1,141,240,7768,7778,0,89,10
1,141,240,7778,7782,0,89,4
1,141,240,7782,7783,0,89,1
1,141,240,7783,7794,0,89,11
1,151,36,7794,7805,0,23,11
1,151,8,7805,7821,0,23,16
1,151,8,7821,7831,0,23,10
1,151,8,7831,7849,0,23,18
1,151,8,7849,7869,0,23,20
1,151,8,7869,7879,0,23,10
1,151,8,7879,7897,0,23,18
1,151,28,7897,7916,0,23,19
1,151,28,7916,7932,0,23,16
1,151,8,7932,7940,0,23,8
1,151,8,7940,7952,0,23,12
1,151,8,7952,7955,0,23,3
1,151,8,7955,7971,0,23,16
1,151,8,7971,7986,0,23,15
1,151,7,7986,7997,0,23,11
1,151,7,7997,8009,0,23,12
1,151,7,8009,8021,0,23,12
1,151,7,8021,8029,0,23,8
1,151,7,8029,8046,0,23,17
1,151,7,8046,8054,0,23,8
1,151,24,8054,8066,0,23,12
1,151,24,8066,8080,0,23,14
1,161,24,8080,8100,0,53,20
1,161,24,8100,8115,0,53,15
1,161,24,8115,8129,0,53,14
1,161,7,8129,8132,0,53,3
1,161,8,8132,8149,0,53,17
1,161,8,8149,8161,0,53,12
1,161,8,8161,8180,0,53,19
1,161,8,8180,8188,0,53,8
1,161,8,8188,8202,0,53,14
1,161,8,8202,8206,0,53,4
1,161,8,8206,8213,0,53,7
1,161,8,8213,8231,0,53,18
1,161,8,8231,8235,0,53,4
1,161,8,8235,8252,0,53,17
1,161,8,8252,8263,0,53,11
1,161,8,8263,8283,0,53,20
1,161,8,8283,8294,0,53,11
1,161,8,8294,8311,0,53,17
1,161,8,8311,8314,0,53,3
1,161,8,8314,8325,0,53,11
1,161,8,8325,8335,0,53,10
1,161,8,8335,8339,0,53,4
1,161,28,8339,8348,0,53,9
1,161,28,8348,8351,0,53,3
1,161,28,8351,8363,0,53,12
1,161,8,8363,8364,0,53,1
1,161,8,8364,8371,0,53,7
1,161,28,8371,8385,0,53,14
1,161,8,8385,8402,0,53,17
1,161,8,8402,8416,0,53,14
1,161,8,8416,8434,0,53,18
1,161,7,8434,8450,0,53,16
1,161,7,8450,8469,0,53,19
1,161,7,8469,8485,0,53,16
1,161,7,8485,8490,0,53,5
1,161,24,8490,8506,0,53,16
1,161,24,8506,8515,0,53,9
1,161,24,8515,8519,0,53,4
1,161,24,8519,8536,0,53,17
1,161,24,8536,8543,0,53,7
1,161,23,8543,8552,0,53,9
1,161,23,8552,8572,0,53,20
1,161,23,8572,8583,0,53,11
1,161,23,8583,8591,0,53,8
1,161,1,8591,8595,0,53,4
1,161,1,8595,8602,0,53,7
1,161,1,8602,8606,0,53,4
1,161,1,8606,8614,0,53,8
1,161,1,8614,8623,0,53,9
1,161,29,8623,8635,0,53,12
1,161,29,8635,8654,0,53,19
1,161,29,8654,8666,0,53,12
1,171,8,8666,8686,0,21,20
1,171,8,8686,8695,0,21,9
1,171,8,8695,8702,0,21,7
1,171,8,8702,8722,0,21,20
1,171,8,8722,8741,0,21,19
1,171,8,8741,8759,0,21,18
1,171,8,8759,8764,0,21,5
1,171,8,8764,8779,0,21,15
1,171,8,8779,8794,0,21,15
1,171,8,8794,8804,0,21,10
1,171,28,8804,8808,0,21,4
1,171,8,8808,8825,0,21,17
1,171,8,8825,8837,0,21,12
1,171,8,8837,8850,0,21,13
1,171,8,8850,8870,0,21,20
1,171,8,8870,8884,0,21,14
1,171,28,8884,8901,0,21,17
1,171,8,8901,8912,0,21,11
1,171,8,8912,8922,0,21,10
1,171,8,8922,8939,0,21,17
1,181,8,8939,8954,0,8,15
1,181,8,8954,8971,0,8,17
1,181,7,8971,8984,0,8,13
1,181,7,8984,8989,0,8,5
1,181,7,8989,8991,0,8,2
1,181,24,8991,9007,0,8,16
1,181,24,9007,9019,0,8,12
1,191,24,9019,9027,0,14,8
1,191,24,9027,9047,0,14,20
1,191,7,9047,9067,0,14,20
1,191,7,9067,9079,0,14,12
1,191,7,9079,9085,0,14,6
1,191,8,9085,9091,0,14,6
1,191,7,9091,9101,0,14,10
1,191,7,9101,9121,0,14,20
1,191,8,9121,9135,0,14,14
1,191,8,9135,9141,0,14,6
1,191,8,9141,9150,0,14,9
1,191,28,9150,9156,0,14,6
1,191,28,9156,9159,0,14,3
1,201,24,9159,9162,0,9,3
1,201,24,9162,9180,0,9,18
1,201,7,9180,9196,0,9,16
1,201,7,9196,9203,0,9,7
1,201,8,9203,9213,0,9,10
1,201,8,9213,9232,0,9,19
1,201,8,9232,9247,0,9,15
1,201,8,9247,9258,0,9,11
1,211,24,9258,9274,0,29,16
1,211,24,9274,9286,0,29,12
1,211,7,9286,9301,0,29,15
1,211,7,9301,9312,0,29,11
1,211,8,9312,9329,0,29,17
1,211,8,9329,9337,0,29,8
1,211,8,9337,9349,0,29,12
1,211,8,9349,9361,0,29,12
1,211,8,9361,9369,0,29,8
1,211,8,9369,9373,0,29,4
1,211,8,9373,9376,0,29,3
1,211,8,9376,9378,0,29,2
1,211,36,9378,9398,0,29,20
1,211,36,9398,9404,0,29,6
1,211,36,9404,9412,0,29,8
1,211,8,9412,9414,0,29,2
1,211,8,9414,9416,0,29,2
1,211,8,9416,9426,0,29,10
1,211,8,9426,9441,0,29,15
1,211,8,9441,9453,0,29,12
1,211,8,9453,9461,0,29,8
1,211,8,9461,9473,0,29,12
1,211,7,9473,9493,0,29,20
1,211,7,9493,9509,0,29,16
1,211,7,9509,9522,0,29,13
1,211,24,9522,9524,0,29,2
1,211,24,9524,9535,0,29,11
1,211,24,9535,9549,0,29,14
1,221,8,9549,9559,0,9,10
1,221,8,9559,9567,0,9,8
1,221,7,9567,9579,0,9,12
1,221,7,9579,9584,0,9,5
1,221,7,9584,9597,0,9,13
1,221,24,9597,9608,0,9,11
1,221,24,9608,9621,0,9,13
1,221,24,9621,9640,0,9,19
1,231,7,9640,9647,0,67,7
1,231,7,9647,9666,0,67,19
1,231,8,9666,9684,0,67,18
1,231,8,9684,9696,0,67,12
1,231,8,9696,9715,0,67,19
1,231,8,9715,9726,0,67,11
1,231,8,9726,9736,0,67,10
1,231,8,9736,9738,0,67,2
1,231,8,9738,9746,0,67,8
1,231,8,9746,9766,0,67,20
1,231,8,9766,9774,0,67,8
1,231,8,9774,9776,0,67,2
1,231,8,9776,9782,0,67,6
1,231,8,9782,9797,0,67,15
1,231,8,9797,9809,0,67,12
1,231,8,9809,9819,0,67,10
1,231,8,9819,9839,0,67,20
1,231,8,9839,9843,0,67,4
1,231,8,9843,9858,0,67,15
1,231,8,9858,9860,0,67,2
1,231,8,9860,9869,0,67,9
1,231,8,9869,9884,0,67,15
1,231,8,9884,9891,0,67,7
1,231,8,9891,9909,0,67,18
1,231,8,9909,9915,0,67,6
1,231,8,9915,9926,0,67,11
1,231,8,9926,9944,0,67,18
1,231,8,9944,9946,0,67,2
1,231,8,9946,9953,0,67,7
1,231,8,9953,9959,0,67,6
1,231,8,9959,9969,0,67,10
1,231,8,9969,9986,0,67,17
1,231,8,9986,9993,0,67,7
1,231,8,9993,10012,0,67,19
1,231,8,10012,10018,0,67,6
1,231,8,10018,10019,0,67,1
1,231,8,10019,10023,0,67,4
1,231,8,10023,10028,0,67,5
1,231,8,10028,10042,0,67,14
1,231,8,10042,10045,0,67,3
1,231,8,10045,10063,0,67,18
1,231,8,10063,10068,0,67,5
1,231,8,10068,10080,0,67,12
1,231,8,10080,10088,0,67,8
1,231,8,10088,10101,0,67,13
1,231,8,10101,10117,0,67,16
1,231,8,10117,10128,0,67,11
1,231,8,10128,10133,0,67,5
1,231,8,10133,10139,0,67,6
1,231,8,10139,10157,0,67,18
1,231,8,10157,10162,0,67,5
1,231,8,10162,10168,0,67,6
1,231,8,10168,10185,0,67,17
1,231,8,10185,10202,0,67,17
1,231,8,10202,10210,0,67,8
1,231,8,10210,10227,0,67,17
1,231,8,10227,10230,0,67,3
1,231,8,10230,10235,0,67,5
1,231,8,10235,10242,0,67,7
1,231,8,10242,10252,0,67,10
1,231,8,10252,10268,0,67,16
1,231,8,10268,10274,0,67,6
1,231,7,10274,10281,0,67,7
1,231,24,10281,10286,0,67,5
1,231,24,10286,10291,0,67,5
1,231,24,10291,10299,0,67,8
1,241,114,10299,10318,0,107,19
1,241,114,10318,10319,0,107,1
1,241,114,10319,10336,0,107,17
1,241,114,10336,10338,0,107,2
1,241,114,10338,10341,0,107,3
1,241,114,10341,10353,0,107,12
1,241,113,10353,10364,0,107,11
1,241,113,10364,10366,0,107,2
1,241,34,10366,10377,0,107,11
1,241,34,10377,10389,0,107,12
1,241,34,10389,10409,0,107,20
1,241,34,10409,10415,0,107,6
1,241,100,10415,10429,0,107,14
1,241,100,10429,10431,0,107,2
1,241,100,10431,10438,0,107,7
1,241,100,10438,10445,0,107,7
1,241,100,10445,10455,0,107,10
1,241,100,10455,10459,0,107,4
1,241,99,10459,10479,0,107,20
1,241,99,10479,10491,0,107,12
1,241,99,10491,10494,0,107,3
1,241,99,10494,10500,0,107,6
1,241,99,10500,10512,0,107,12
1,241,99,10512,10530,0,107,18
1,241,99,10530,10539,0,107,9
1,241,99,10539,10559,0,107,20
1,241,99,10559,10564,0,107,5
1,241,99,10564,10569,0,107,5
1,241,99,10569,10577,0,107,8
1,241,99,10577,10596,0,107,19
1,241,99,10596,10602,0,107,6
1,241,99,10602,10616,0,107,14
1,241,99,10616,10629,0,107,13
1,241,99,10629,10640,0,107,11
1,241,99,10640,10643,0,107,3
1,241,99,10643,10661,0,107,18
1,241,99,10661,10668,0,107,7
1,241,99,10668,10672,0,107,4
1,241,99,10672,10680,0,107,8
1,241,99,10680,10696,0,107,16
1,241,98,10696,10711,0,107,15
1,241,98,10711,10721,0,107,10
1,241,98,10721,10738,0,107,17
1,241,98,10738,10742,0,107,4
1,241,98,10742,10761,0,107,19
1,241,98,10761,10779,0,107,18
1,241,98,10779,10799,0,107,20
1,241,99,10799,10811,0,107,12
1,241,99,10811,10828,0,107,17
1,241,99,10828,10844,0,107,16
1,241,99,10844,10852,0,107,8
1,241,99,10852,10856,0,107,4
1,241,99,10856,10868,0,107,12
1,241,99,10868,10877,0,107,9
1,241,99,10877,10886,0,107,9
1,241,99,10886,10905,0,107,19
1,241,99,10905,10906,0,107,1
1,241,99,10906,10922,0,107,16
1,241,99,10922,10925,0,107,3
1,241,99,10925,10926,0,107,1
1,241,99,10926,10937,0,107,11
1,241,99,10937,10954,0,107,17
1,241,99,10954,10959,0,107,5
1,241,99,10959,10972,0,107,13
1,241,99,10972,10990,0,107,18
1,241,99,10990,11003,0,107,13
1,241,99,11003,11006,0,107,3
1,241,99,11006,11021,0,107,15
1,241,99,11021,11041,0,107,20
1,241,99,11041,11048,0,107,7
1,241,99,11048,11057,0,107,9
1,241,99,11057,11071,0,107,14
1,241,99,11071,11086,0,107,15
1,241,99,11086,11105,0,107,19
1,241,99,11105,11121,0,107,16
1,241,99,11121,11125,0,107,4
1,241,99,11125,11139,0,107,14
1,241,99,11139,11149,0,107,10
1,241,99,11149,11155,0,107,6
1,241,99,11155,11170,0,107,15
1,241,99,11170,11181,0,107,11
1,241,99,11181,11198,0,107,17
1,241,99,11198,11203,0,107,5
1,241,99,11203,11204,0,107,1
1,241,99,11204,11212,0,107,8
1,241,99,11212,11228,0,107,16
1,241,99,11228,11243,0,107,15
1,241,99,11243,11244,0,107,1
1,241,99,11244,11254,0,107,10
1,241,100,11254,11259,0,107,5
1,241,100,11259,11271,0,107,12
1,241,100,11271,11278,0,107,7
1,241,100,11278,11291,0,107,13
1,241,99,11291,11293,0,107,2
1,241,100,11293,11298,0,107,5
1,241,100,11298,11318,0,107,20
1,241,100,11318,11326,0,107,8
1,241,34,11326,11338,0,107,12
1,241,34,11338,11348,0,107,10
1,241,33,11348,11350,0,107,2
1,241,33,11350,11362,0,107,12
1,241,87,11362,11364,0,107,2
1,241,87,11364,11377,0,107,13
1,241,30,11377,11393,0,107,16
1,241,30,11393,11394,0,107,1
1,241,30,11394,11410,0,107,16
1,251,8,11410,11415,0,24,5
1,251,8,11415,11432,0,24,17
1,251,8,11432,11440,0,24,8
1,251,8,11440,11450,0,24,10
1,251,8,11450,11468,0,24,18
1,251,8,11468,11482,0,24,14
1,251,8,11482,11485,0,24,3
1,251,8,11485,11503,0,24,18
1,251,7,11503,11523,0,24,20
1,251,7,11523,11536,0,24,13
1,251,24,11536,11549,0,24,13
1,251,24,11549,11559,0,24,10
1,251,24,11559,11570,0,24,11
1,251,24,11570,11575,0,24,5
1,251,24,11575,11588,0,24,13
1,251,24,11588,11606,0,24,18
1,251,24,11606,11626,0,24,20
1,251,7,11626,11636,0,24,10
1,251,8,11636,11655,0,24,19
1,251,8,11655,11660,0,24,5
1,251,8,11660,11670,0,24,10
1,251,8,11670,11672,0,24,2
1,251,8,11672,11678,0,24,6
1,261,288,11678,11688,0,56,10
1,261,288,11688,11689,0,56,1
1,261,288,11689,11706,0,56,17
1,261,288,11706,11718,0,56,12
1,261,288,11718,11734,0,56,16
1,261,288,11734,11751,0,56,17
1,261,287,11751,11753,0,56,2
1,261,287,11753,11756,0,56,3
1,261,285,11756,11776,0,56,20
1,261,285,11776,11779,0,56,3
1,261,271,11779,11791,0,56,12
1,261,284,11791,11808,0,56,17
1,261,284,11808,11811,0,56,3
1,261,270,11811,11824,0,56,13
1,261,269,11824,11840,0,56,16
1,261,289,11840,11845,0,56,5
1,261,266,11845,11864,0,56,19
1,261,266,11864,11878,0,56,14
1,261,265,11878,11893,0,56,15
1,261,260,11893,11912,0,56,19
1,261,259,11912,11931,0,56,19
1,261,80,11931,11935,0,56,4
1,261,51,11935,11952,0,56,17
1,261,50,11952,11969,0,56,17
1,261,47,11969,11980,0,56,11
1,261,46,11980,11981,0,56,1
1,261,45,11981,11998,0,56,17
1,261,44,11998,12004,0,56,6
1,261,44,12004,12014,0,56,10
1,261,42,12014,12032,0,56,18
1,261,41,12032,12036,0,56,4
1,261,41,12036,12049,0,56,13
1,261,40,12049,12064,0,56,15
1,261,23,12064,12078,0,56,14
1,261,23,12078,12084,0,56,6
1,261,23,12084,12093,0,56,9
1,261,23,12093,12095,0,56,2
1,261,23,12095,12105,0,56,10
1,261,6,12105,12106,0,56,1
1,261,7,12106,12119,0,56,13
1,261,7,12119,12124,0,56,5
1,261,24,12124,12132,0,56,8
1,261,24,12132,12134,0,56,2
1,261,24,12134,12153,0,56,19
1,261,7,12153,12154,0,56,1
1,261,8,12154,12172,0,56,18
1,261,8,12172,12181,0,56,9
1,261,8,12181,12200,0,56,19
1,261,8,12200,12216,0,56,16
1,261,8,12216,12227,0,56,11
1,261,8,12227,12235,0,56,8
1,261,8,12235,12243,0,56,8
1,261,8,12243,12260,0,56,17
1,261,8,12260,12279,0,56,19
1,261,8,12279,12284,0,56,5
1,271,8,12284,12285,0,16,1
1,271,8,12285,12302,0,16,17
1,271,8,12302,12309,0,16,7
1,271,7,12309,12311,0,16,2
1,271,7,12311,12321,0,16,10
1,271,7,12321,12329,0,16,8
1,271,7,12329,12347,0,16,18
1,271,7,12347,12360,0,16,13
1,271,7,12360,12370,0,16,10
1,271,7,12370,12383,0,16,13
1,271,7,12383,12397,0,16,14
1,271,24,12397,12401,0,16,4
1,271,24,12401,12411,0,16,10
1,271,24,12411,12413,0,16,2
1,271,24,12413,12417,0,16,4
1,281,24,12417,12433,0,14,16
1,281,24,12433,12452,0,14,19
1,281,7,12452,12460,0,14,8
1,281,7,12460,12467,0,14,7
1,281,8,12467,12480,0,14,13
1,281,8,12480,12485,0,14,5
1,281,8,12485,12501,0,14,16
1,281,8,12501,12515,0,14,14
1,281,8,12515,12516,0,14,1
1,281,7,12516,12518,0,14,2
1,281,7,12518,12530,0,14,12
1,281,7,12530,12542,0,14,12
1,281,24,12542,12557,0,14,15
1,291,337,12557,12561,0,104,4
1,291,337,12561,12577,0,104,16
1,291,337,12577,12590,0,104,13
1,291,337,12590,12610,0,104,20
1,291,337,12610,12621,0,104,11
1,291,337,12621,12625,0,104,4
1,291,337,12625,12645,0,104,20
1,291,337,12645,12657,0,104,12
1,291,337,12657,12664,0,104,7
1,291,337,12664,12673,0,104,9
1,291,337,12673,12683,0,104,10
1,291,337,12683,12701,0,104,18
1,291,337,12701,12713,0,104,12
1,291,337,12713,12727,0,104,14
1,291,337,12727,12730,0,104,3
1,291,337,12730,12750,0,104,20
1,291,337,12750,12752,0,104,2
1,291,337,12752,12772,0,104,20
1,291,337,12772,12774,0,104,2
1,291,337,12774,12776,0,104,2
1,291,337,12776,12782,0,104,6
1,291,337,12782,12798,0,104,16
1,291,337,12798,12812,0,104,14
1,291,337,12812,12818,0,104,6
1,291,337,12818,12830,0,104,12
1,291,337,12830,12835,0,104,5
1,291,337,12835,12843,0,104,8
1,291,337,12843,12850,0,104,7
1,291,337,12850,12865,0,104,15
1,291,337,12865,12873,0,104,8
1,291,337,12873,12884,0,104,11
1,291,337,12884,12890,0,104,6
1,291,337,12890,12908,0,104,18
1,291,337,12908,12924,0,104,16
1,291,337,12924,12934,0,104,10
1,291,337,12934,12941,0,104,7
1,291,337,12941,12949,0,104,8
1,291,337,12949,12963,0,104,14
1,291,337,12963,12967,0,104,4
1,291,337,12967,12983,0,104,16
1,291,337,12983,12984,0,104,1
1,291,337,12984,13003,0,104,19
1,291,337,13003,13010,0,104,7
1,291,337,13010,13027,0,104,17
1,291,337,13027,13032,0,104,5
1,291,337,13032,13035,0,104,3
1,291,337,13035,13049,0,104,14
1,291,337,13049,13059,0,104,10
1,291,337,13059,13069,0,104,10
1,291,337,13069,13074,0,104,5
1,291,337,13074,13089,0,104,15
1,291,337,13089,13103,0,104,14
1,291,337,13103,13107,0,104,4
1,291,337,13107,13114,0,104,7
1,291,337,13114,13128,0,104,14
1,291,337,13128,13140,0,104,12
1,291,337,13140,13146,0,104,6
1,291,337,13146,13152,0,104,6
1,291,337,13152,13159,0,104,7
1,291,338,13159,13172,0,104,13
1,291,338,13172,13177,0,104,5
1,291,338,13177,13183,0,104,6
1,291,338,13183,13192,0,104,9
1,291,338,13192,13197,0,104,5
1,291,339,13197,13216,0,104,19
1,291,339,13216,13220,0,104,4
1,291,339,13220,13237,0,104,17
1,291,339,13237,13257,0,104,20
1,291,339,13257,13264,0,104,7
1,291,339,13264,13269,0,104,5
1,291,339,13269,13283,0,104,14
1,291,339,13283,13290,0,104,7
1,291,339,13290,13300,0,104,10
1,291,339,13300,13317,0,104,17
1,291,339,13317,13331,0,104,14
1,291,339,13331,13343,0,104,12
1,291,339,13343,13346,0,104,3
1,291,339,13346,13355,0,104,9
1,291,339,13355,13368,0,104,13
1,291,339,13368,13378,0,104,10
1,291,339,13378,13379,0,104,1
1,291,339,13379,13387,0,104,8
1,291,339,13387,13404,0,104,17
1,291,339,13404,13423,0,104,19
1,291,339,13423,13440,0,104,17
1,291,339,13440,13442,0,104,2
1,291,339,13442,13453,0,104,11
1,291,339,13453,13472,0,104,19
1,291,339,13472,13475,0,104,3
1,291,339,13475,13490,0,104,15
1,291,339,13490,13491,0,104,1
1,291,338,13491,13499,0,104,8
1,291,338,13499,13514,0,104,15
1,291,338,13514,13521,0,104,7
1,291,338,13521,13531,0,104,10
1,291,338,13531,13546,0,104,15
1,291,338,13546,13556,0,104,10
1,291,338,13556,13563,0,104,7
1,291,338,13563,13578,0,104,15
1,291,338,13578,13589,0,104,11
1,291,338,13589,13591,0,104,2
1,291,338,13591,13594,0,104,3
1,291,338,13594,13600,0,104,6
1,301,24,13600,13614,0,24,14
1,301,24,13614,13615,0,24,1
1,301,7,13615,13632,0,24,17
1,301,7,13632,13638,0,24,6
1,301,7,13638,13652,0,24,14
1,301,8,13652,13657,0,24,5
1,301,8,13657,13665,0,24,8
1,301,8,13665,13673,0,24,8
1,301,8,13673,13678,0,24,5
1,301,8,13678,13682,0,24,4
1,301,8,13682,13698,0,24,16
1,301,8,13698,13705,0,24,7
1,301,8,13705,13716,0,24,11
1,301,8,13716,13726,0,24,10
1,301,7,13726,13742,0,24,16
1,301,24,13742,13753,0,24,11
1,301,24,13753,13771,0,24,18
1,301,24,13771,13774,0,24,3
1,301,24,13774,13785,0,24,11
1,301,24,13785,13791,0,24,6
1,301,24,13791,13803,0,24,12
1,301,24,13803,13814,0,24,11
1,301,24,13814,13828,0,24,14
1,311,24,13828,13837,0,22,9
1,311,24,13837,13855,0,22,18
1,311,8,13855,13871,0,22,16
1,311,8,13871,13877,0,22,6
1,311,8,13877,13881,0,22,4
1,311,8,13881,13883,0,22,2
1,311,8,13883,13884,0,22,1
1,311,8,13884,13891,0,22,7
1,311,8,13891,13898,0,22,7
1,311,7,13898,13900,0,22,2
1,311,7,13900,13904,0,22,4
1,311,24,13904,13911,0,22,7
1,311,24,13911,13915,0,22,4
1,311,24,13915,13930,0,22,15
1,311,24,13930,13932,0,22,2
1,311,24,13932,13941,0,22,9
1,311,24,13941,13957,0,22,16
1,311,23,13957,13971,0,22,14
1,311,23,13971,13991,0,22,20
1,311,24,13991,13999,0,22,8
1,311,24,13999,14010,0,22,11
1,321,24,14010,14028,0,45,18
1,321,24,14028,14034,0,45,6
1,321,7,14034,14052,0,45,18
1,321,7,14052,14057,0,45,5
1,321,7,14057,14069,0,45,12
1,321,8,14069,14089,0,45,20
1,321,8,14089,14093,0,45,4
1,321,8,14093,14106,0,45,13
1,321,8,14106,14107,0,45,1
1,321,8,14107,14110,0,45,3
1,321,8,14110,14113,0,45,3
1,321,8,14113,14121,0,45,8
1,321,8,14121,14126,0,45,5
1,321,8,14126,14133,0,45,7
1,321,8,14133,14138,0,45,5
1,321,8,14138,14149,0,45,11
1,321,8,14149,14162,0,45,13
1,321,8,14162,14180,0,45,18
1,321,8,14180,14191,0,45,11
1,321,8,14191,14195,0,45,4
1,321,8,14195,14211,0,45,16
1,321,8,14211,14221,0,45,10
1,321,8,14221,14222,0,45,1
1,321,8,14222,14231,0,45,9
1,321,8,14231,14246,0,45,15
1,321,8,14246,14249,0,45,3
1,321,8,14249,14262,0,45,13
1,321,8,14262,14278,0,45,16
1,321,8,14278,14287,0,45,9
1,321,8,14287,14298,0,45,11
1,321,8,14298,14307,0,45,9
1,321,8,14307,14327,0,45,20
1,321,8,14327,14344,0,45,17
1,321,8,14344,14363,0,45,19
1,321,8,14363,14383,0,45,20
1,321,8,14383,14395,0,45,12
1,321,8,14395,14410,0,45,15
1,321,7,14410,14417,0,45,7
1,321,7,14417,14429,0,45,12
1,321,7,14429,14444,0,45,15
1,321,7,14444,14454,0,45,10
1,321,24,14454,14460,0,45,6
1,321,24,14460,14476,0,45,16
1,321,24,14476,14492,0,45,16
1,331,363,14492,14509,0,60,17
1,331,363,14509,14518,0,60,9
1,331,363,14518,14521,0,60,3
1,331,363,14521,14528,0,60,7
1,331,363,14528,14535,0,60,7
1,331,74,14535,14542,0,60,7
1,331,74,14542,14557,0,60,15
1,331,74,14557,14577,0,60,20
1,331,74,14577,14579,0,60,2
1,331,74,14579,14586,0,60,7
1,331,74,14586,14593,0,60,7
1,331,74,14593,14612,0,60,19
1,331,74,14612,14620,0,60,8
1,331,74,14620,14637,0,60,17
1,331,75,14637,14656,0,60,19
1,331,75,14656,14673,0,60,17
1,331,75,14673,14680,0,60,7
1,331,72,14680,14690,0,60,10
1,331,76,14690,14694,0,60,4
1,331,76,14694,14708,0,60,14
1,331,77,14708,14726,0,60,18
1,331,62,14726,14734,0,60,8
1,331,78,14734,14749,0,60,15
1,331,60,14749,14755,0,60,6
1,331,59,14755,14757,0,60,2
1,331,58,14757,14768,0,60,11
1,331,57,14768,14779,0,60,11
1,331,56,14779,14791,0,60,12
1,331,55,14791,14805,0,60,14
1,331,79,14805,14817,0,60,12
1,331,53,14817,14830,0,60,13
1,331,51,14830,14841,0,60,11
1,331,50,14841,14855,0,60,14
1,331,47,14855,14875,0,60,20
1,331,47,14875,14880,0,60,5
1,331,46,14880,14899,0,60,19
1,331,46,14899,14910,0,60,11
1,331,45,14910,14911,0,60,1
1,331,44,14911,14931,0,60,20
1,331,42,14931,14950,0,60,19
1,331,41,14950,14951,0,60,1
1,331,40,14951,14963,0,60,12
1,331,23,14963,14968,0,60,5
1,331,23,14968,14979,0,60,11
1,331,1,14979,14994,0,60,15
1,331,1,14994,15004,0,60,10
1,331,1,15004,15012,0,60,8
1,331,1,15012,15014,0,60,2
1,331,23,15014,15027,0,60,13
1,331,23,15027,15028,0,60,1
1,331,23,15028,15045,0,60,17
1,331,6,15045,15054,0,60,9
1,331,6,15054,15063,0,60,9
1,331,7,15063,15078,0,60,15
1,331,7,15078,15090,0,60,12
1,331,7,15090,15108,0,60,18
1,331,7,15108,15113,0,60,5
1,331,8,15113,15130,0,60,17
1,331,8,15130,15143,0,60,13
1,341,366,15143,15152,0,125,9
1,341,366,15152,15170,0,125,18
1,341,366,15170,15187,0,125,17
1,341,366,15187,15198,0,125,11
1,341,366,15198,15214,0,125,16
1,341,366,15214,15216,0,125,2
1,341,366,15216,15229,0,125,13
1,341,366,15229,15247,0,125,18
1,341,366,15247,15261,0,125,14
1,341,366,15261,15262,0,125,1
1,341,366,15262,15280,0,125,18
1,341,366,15280,15300,0,125,20
1,341,366,15300,15310,0,125,10
1,341,366,15310,15321,0,125,11
1,341,366,15321,15341,0,125,20
1,341,366,15341,15360,0,125,19
1,341,366,15360,15369,0,125,9
1,341,366,15369,15373,0,125,4
1,341,367,15373,15378,0,125,5
1,341,366,15378,15381,0,125,3
1,341,366,15381,15391,0,125,10
1,341,366,15391,15396,0,125,5
1,341,366,15396,15413,0,125,17
1,341,366,15413,15429,0,125,16
1,341,366,15429,15435,0,125,6
1,341,366,15435,15447,0,125,12
1,341,366,15447,15455,0,125,8
1,341,366,15455,15459,0,125,4
1,341,366,15459,15478,0,125,19
1,341,366,15478,15479,0,125,1
1,341,365,15479,15487,0,125,8
1,341,365,15487,15502,0,125,15
1,341,365,15502,15521,0,125,19
1,341,365,15521,15524,0,125,3
1,341,365,15524,15531,0,125,7
1,341,365,15531,15538,0,125,7
1,341,364,15538,15545,0,125,7
1,341,364,15545,15565,0,125,20
1,341,364,15565,15574,0,125,9
1,341,364,15574,15582,0,125,8
1,341,296,15582,15589,0,125,7
1,341,296,15589,15601,0,125,12
1,341,296,15601,15613,0,125,12
1,341,296,15613,15632,0,125,19
1,341,296,15632,15636,0,125,4
1,341,41,15636,15647,0,125,11
1,341,41,15647,15660,0,125,13
1,341,41,15660,15663,0,125,3
1,341,40,15663,15680,0,125,17
1,341,40,15680,15690,0,125,10
1,341,23,15690,15698,0,125,8
1,341,23,15698,15703,0,125,5
1,341,23,15703,15720,0,125,17
1,341,23,15720,15737,0,125,17
1,341,6,15737,15749,0,125,12
1,341,6,15749,15769,0,125,20
1,341,6,15769,15770,0,125,1
1,341,5,15770,15790,0,125,20
1,341,5,15790,15800,0,125,10
1,341,5,15800,15816,0,125,16
1,341,27,15816,15820,0,125,4
1,341,27,15820,15830,0,125,10
1,341,27,15830,15835,0,125,5
1,341,27,15835,15850,0,125,15
1,341,27,15850,15864,0,125,14
1,341,27,15864,15884,0,125,20
1,341,27,15884,15902,0,125,18
1,341,27,15902,15906,0,125,4
1,341,27,15906,15924,0,125,18
1,341,27,15924,15942,0,125,18
1,341,27,15942,15945,0,125,3
1,341,27,15945,15960,0,125,15
1,341,27,15960,15968,0,125,8
1,341,27,15968,15969,0,125,1
1,341,27,15969,15975,0,125,6
1,341,27,15975,15981,0,125,6
1,341,27,15981,15986,0,125,5
1,341,27,15986,15988,0,125,2
1,341,27,15988,16001,0,125,13
1,341,27,16001,16013,0,125,12
1,341,27,16013,16019,0,125,6
1,341,27,16019,16039,0,125,20
1,341,27,16039,16044,0,125,5
1,341,27,16044,16064,0,125,20
1,341,5,16064,16081,0,125,17
1,341,27,16081,16099,0,125,18
1,341,27,16099,16100,0,125,1
1,341,5,16100,16119,0,125,19
1,341,27,16119,16122,0,125,3
1,341,27,16122,16130,0,125,8
1,341,27,16130,16135,0,125,5
1,341,27,16135,16143,0,125,8
1,341,27,16143,16154,0,125,11
1,341,27,16154,16163,0,125,9
1,341,27,16163,16167,0,125,4
1,341,27,16167,16178,0,125,11
1,341,27,16178,16191,0,125,13
1,341,27,16191,16210,0,125,19
1,341,27,16210,16219,0,125,9
1,341,27,16219,16238,0,125,19
1,341,27,16238,16256,0,125,18
1,341,5,16256,16264,0,125,8
1,341,27,16264,16272,0,125,8
1,341,27,16272,16287,0,125,15
1,341,27,16287,16299,0,125,12
1,341,27,16299,16304,0,125,5
1,341,5,16304,16320,0,125,16
1,341,27,16320,16338,0,125,18
1,341,27,16338,16344,0,125,6
1,341,27,16344,16353,0,125,9
1,341,27,16353,16360,0,125,7
1,341,27,16360,16365,0,125,5
1,341,27,16365,16379,0,125,14
1,341,27,16379,16395,0,125,16
1,341,27,16395,16397,0,125,2
1,341,5,16397,16415,0,125,18
1,341,27,16415,16416,0,125,1
1,341,27,16416,16433,0,125,17
1,341,27,16433,16451,0,125,18
1,341,27,16451,16454,0,125,3
1,341,27,16454,16471,0,125,17
1,341,27,16471,16491,0,125,20
1,341,27,16491,16499,0,125,8
1,341,27,16499,16516,0,125,17
11,2881,632,16516,16530,0,26,14
11,2881,633,16530,16544,0,26,14
11,2881,630,16544,16556,0,26,12
11,2881,629,16556,16576,0,26,20
11,2881,628,16576,16590,0,26,14
11,2881,627,16590,16592,0,26,2
11,2881,802,16592,16596,0,26,4
11,2881,625,16596,16613,0,26,17
11,2881,146,16613,16630,0,26,17
11,2881,624,16630,16650,0,26,20
11,2881,623,16650,16655,0,26,5
11,2881,622,16655,16660,0,26,5
11,2881,156,16660,16664,0,26,4
11,2881,620,16664,16670,0,26,6
11,2881,619,16670,16688,0,26,18
11,2881,618,16688,16702,0,26,14
11,2881,563,16702,16713,0,26,11
11,2881,562,16713,16728,0,26,15
11,2881,616,16728,16732,0,26,4
11,2881,589,16732,16750,0,26,18
11,2881,252,16750,16765,0,26,15
11,2881,593,16765,16782,0,26,17
11,2881,614,16782,16798,0,26,16
11,2881,614,16798,16816,0,26,18
11,2881,257,16816,16827,0,26,11
11,2891,537,16827,16847,0,8,20
11,2891,537,16847,16856,0,8,9
11,2891,537,16856,16865,0,8,9
11,2891,537,16865,16871,0,8,6
11,2891,537,16871,16885,0,8,14
11,2891,537,16885,16889,0,8,4
11,2891,537,16889,16895,0,8,6
11,2901,562,16895,16904,0,48,9
11,2901,561,16904,16908,0,48,4
11,2901,561,16908,16913,0,48,5
11,2901,638,16913,16927,0,48,14
11,2901,638,16927,16934,0,48,7
11,2901,638,16934,16938,0,48,4
11,2901,638,16938,16940,0,48,2
11,2901,638,16940,16944,0,48,4
11,2901,638,16944,16948,0,48,4
11,2901,638,16948,16960,0,48,12
11,2901,638,16960,16966,0,48,6
11,2901,638,16966,16982,0,48,16
11,2901,638,16982,16983,0,48,1
11,2901,617,16983,16996,0,48,13
11,2901,638,16996,16998,0,48,2
11,2901,616,16998,17010,0,48,12
11,2901,616,17010,17026,0,48,16
11,2901,616,17026,17042,0,48,16
11,2901,584,17042,17054,0,48,12
11,2901,584,17054,17067,0,48,13
11,2901,584,17067,17069,0,48,2
11,2901,584,17069,17084,0,48,15
11,2901,584,17084,17096,0,48,12
11,2901,13,17096,17104,0,48,8
11,2901,13,17104,17116,0,48,12
11,2901,13,17116,17127,0,48,11
11,2901,13,17127,17141,0,48,14
11,2901,13,17141,17158,0,48,17
11,2901,12,17158,17161,0,48,3
11,2901,12,17161,17162,0,48,1
11,2901,12,17162,17174,0,48,12
11,2901,12,17174,17194,0,48,20
11,2901,12,17194,17200,0,48,6
11,2901,104,17200,17203,0,48,3
11,2901,104,17203,17217,0,48,14
11,2901,104,17217,17227,0,48,10
11,2901,104,17227,17229,0,48,2
11,2901,241,17229,17233,0,48,4
11,2901,102,17233,17242,0,48,9
11,2901,101,17242,17258,0,48,16
11,2901,101,17258,17272,0,48,14
11,2901,29,17272,17286,0,48,14
11,2901,23,17286,17290,0,48,4
11,2901,23,17290,17297,0,48,7
11,2901,23,17297,17310,0,48,13
11,2901,23,17310,17322,0,48,12
11,2901,23,17322,17333,0,48,11
11,2911,724,17333,17343,0,42,10
11,2911,250,17343,17344,0,42,1
11,2911,589,17344,17345,0,42,1
11,2911,616,17345,17359,0,42,14
11,2911,638,17359,17367,0,42,8
11,2911,562,17367,17384,0,42,17
11,2911,562,17384,17391,0,42,7
11,2911,562,17391,17394,0,42,3
11,2911,617,17394,17400,0,42,6
11,2911,617,17400,17404,0,42,4
11,2911,617,17404,17423,0,42,19
11,2911,617,17423,17426,0,42,3
11,2911,617,17426,17436,0,42,10
11,2911,617,17436,17452,0,42,16
11,2911,617,17452,17462,0,42,10
11,2911,617,17462,17472,0,42,10
11,2911,617,17472,17475,0,42,3
11,2911,723,17475,17488,0,42,13
11,2911,723,17488,17503,0,42,15
11,2911,723,17503,17510,0,42,7
11,2911,518,17510,17517,0,42,7
11,2911,518,17517,17524,0,42,7
11,2911,518,17524,17537,0,42,13
11,2911,518,17537,17557,0,42,20
11,2911,518,17557,17559,0,42,2
11,2911,518,17559,17577,0,42,18
11,2911,518,17577,17593,0,42,16
11,2911,91,17593,17611,0,42,18
11,2911,91,17611,17620,0,42,9
11,2911,104,17620,17638,0,42,18
11,2911,104,17638,17650,0,42,12
11,2911,103,17650,17652,0,42,2
11,2911,102,17652,17659,0,42,7
11,2911,101,17659,17663,0,42,4
11,2911,101,17663,17672,0,42,9
11,2911,29,17672,17681,0,42,9
11,2911,23,17681,17691,0,42,10
11,2911,23,17691,17705,0,42,14
11,2911,23,17705,17722,0,42,17
11,2911,23,17722,17742,0,42,20
11,2911,23,17742,17743,0,42,1
11,2921,724,17743,17746,0,33,3
11,2921,250,17746,17759,0,33,13
11,2921,589,17759,17764,0,33,5
11,2921,616,17764,17784,0,33,20
11,2921,638,17784,17794,0,33,10
11,2921,562,17794,17813,0,33,19
11,2921,562,17813,17818,0,33,5
11,2921,617,17818,17838,0,33,20
11,2921,617,17838,17856,0,33,18
11,2921,617,17856,17866,0,33,10
11,2921,617,17866,17875,0,33,9
11,2921,617,17875,17880,0,33,5
11,2921,723,17880,17896,0,33,16
11,2921,723,17896,17904,0,33,8
11,2921,723,17904,17923,0,33,19
11,2921,723,17923,17924,0,33,1
11,2921,518,17924,17940,0,33,16
11,2921,518,17940,17949,0,33,9
11,2921,518,17949,17969,0,33,20
11,2921,518,17969,17984,0,33,15
11,2921,518,17984,17991,0,33,7
11,2921,103,17991,18009,0,33,18
11,2921,102,18009,18015,0,33,6
11,2921,102,18015,18027,0,33,12
11,2921,101,18027,18032,0,33,5
11,2921,30,18032,18050,0,33,18
11,2921,29,18050,18064,0,33,14
11,2921,23,18064,18075,0,33,11
11,2921,23,18075,18079,0,33,4
11,2921,23,18079,18096,0,33,17
11,2921,23,18096,18110,0,33,14
11,2921,23,18110,18127,0,33,17
11,2931,933,18127,18133,0,32,6
11,2931,228,18133,18144,0,32,11
11,2931,590,18144,18146,0,32,2
11,2931,615,18146,18147,0,32,1
11,2931,638,18147,18152,0,32,5
11,2931,562,18152,18162,0,32,10
11,2931,562,18162,18173,0,32,11
11,2931,617,18173,18192,0,32,19
11,2931,617,18192,18204,0,32,12
11,2931,617,18204,18211,0,32,7
11,2931,723,18211,18221,0,32,10
11,2931,723,18221,18241,0,32,20
11,2931,723,18241,18258,0,32,17
11,2931,723,18258,18266,0,32,8
11,2931,723,18266,18283,0,32,17
11,2931,518,18283,18293,0,32,10
11,2931,518,18293,18304,0,32,11
11,2931,518,18304,18319,0,32,15
11,2931,91,18319,18333,0,32,14
11,2931,104,18333,18335,0,32,2
11,2931,103,18335,18338,0,32,3
11,2931,241,18338,18348,0,32,10
11,2931,102,18348,18366,0,32,18
11,2931,101,18366,18386,0,32,20
11,2931,29,18386,18403,0,32,17
11,2931,23,18403,18423,0,32,20
11,2931,23,18423,18436,0,32,13
11,2931,23,18436,18452,0,32,16
11,2931,23,18452,18469,0,32,17
11,2931,23,18469,18480,0,32,11
11,2931,23,18480,18487,0,32,7
11,2941,406,18487,18505,0,20,18
11,2941,948,18505,18525,0,20,20
11,2941,948,18525,18529,0,20,4
11,2941,355,18529,18546,0,20,17
11,2941,38,18546,18558,0,20,12
11,2941,38,18558,18576,0,20,18
11,2941,38,18576,18580,0,20,4
11,2941,38,18580,18583,0,20,3
11,2941,38,18583,18597,0,20,14
11,2941,38,18597,18611,0,20,14
11,2941,28,18611,18631,0,20,20
11,2941,28,18631,18647,0,20,16
11,2941,8,18647,18662,0,20,15
11,2941,36,18662,18665,0,20,3
11,2941,24,18665,18682,0,20,17
11,2941,24,18682,18683,0,20,1
11,2941,24,18683,18689,0,20,6
11,2941,23,18689,18695,0,20,6
11,2941,23,18695,18702,0,20,7
11,2951,933,18702,18707,0,36,5
11,2951,228,18707,18718,0,36,11
11,2951,590,18718,18722,0,36,4
11,2951,615,18722,18724,0,36,2
11,2951,616,18724,18744,0,36,20
11,2951,638,18744,18751,0,36,7
11,2951,562,18751,18758,0,36,7
11,2951,562,18758,18768,0,36,10
11,2951,617,18768,18774,0,36,6
11,2951,617,18774,18782,0,36,8
11,2951,617,18782,18783,0,36,1
11,2951,514,18783,18792,0,36,9
11,2951,498,18792,18806,0,36,14
11,2951,497,18806,18814,0,36,8
11,2951,16,18814,18826,0,36,12
11,2951,17,18826,18836,0,36,10
11,2951,93,18836,18846,0,36,10
11,2951,93,18846,18852,0,36,6
11,2951,93,18852,18856,0,36,4
11,2951,94,18856,18862,0,36,6
11,2951,94,18862,18875,0,36,13
11,2951,95,18875,18894,0,36,19
11,2951,95,18894,18895,0,36,1
11,2951,96,18895,18897,0,36,2
11,2951,96,18897,18911,0,36,14
11,2951,104,18911,18914,0,36,3
11,2951,103,18914,18928,0,36,14
11,2951,295,18928,18937,0,36,9
11,2951,405,18937,18941,0,36,4
11,2951,296,18941,18960,0,36,19
11,2951,296,18960,18969,0,36,9
11,2951,41,18969,18989,0,36,20
11,2951,41,18989,18996,0,36,7
11,2951,40,18996,19003,0,36,7
11,2951,23,19003,19013,0,36,10
11,2961,562,19013,19015,0,6,2
11,2961,638,19015,19018,0,6,3
11,2961,615,19018,19020,0,6,2
11,2961,251,19020,19024,0,6,4
11,2961,229,19024,19033,0,6,9
11,2971,23,19033,19048,0,149,15
11,2971,23,19048,19065,0,149,17
11,2971,23,19065,19066,0,149,1
11,2971,39,19066,19080,0,149,14
11,2971,30,19080,19082,0,149,2
11,2971,101,19082,19096,0,149,14
11,2971,101,19096,19116,0,149,20
11,2971,102,19116,19117,0,149,1
11,2971,241,19117,19120,0,149,3
11,2971,103,19120,19124,0,149,4
11,2971,104,19124,19134,0,149,10
11,2971,104,19134,19148,0,149,14
11,2971,104,19148,19152,0,149,4
11,2971,104,19152,19166,0,149,14
11,2971,104,19166,19174,0,149,8
11,2971,104,19174,19185,0,149,11
11,2971,104,19185,19198,0,149,13
11,2971,104,19198,19212,0,149,14
11,2971,104,19212,19231,0,149,19
11,2971,104,19231,19244,0,149,13
11,2971,104,19244,19259,0,149,15
11,2971,104,19259,19267,0,149,8
11,2971,104,19267,19276,0,149,9
11,2971,104,19276,19279,0,149,3
11,2971,104,19279,19297,0,149,18
11,2971,103,19297,19307,0,149,10
11,2971,103,19307,19312,0,149,5
11,2971,104,19312,19320,0,149,8
11,2971,104,19320,19321,0,149,1
11,2971,104,19321,19324,0,149,3
11,2971,103,19324,19331,0,149,7
11,2971,241,19331,19343,0,149,12
11,2971,102,19343,19344,0,149,1
11,2971,101,19344,19354,0,149,10
11,2971,30,19354,19356,0,149,2
11,2971,29,19356,19366,0,149,10
11,2971,29,19366,19377,0,149,11
11,2971,29,19377,19387,0,149,10
11,2971,23,19387,19398,0,149,11
11,2971,24,19398,19407,0,149,9
11,2971,8,19407,19408,0,149,1
11,2971,403,19408,19418,0,149,10
11,2971,354,19418,19435,0,149,17
11,2971,353,19435,19437,0,149,2
11,2971,725,19437,19441,0,149,4
11,2971,726,19441,19457,0,149,16
11,2971,727,19457,19462,0,149,5
11,2971,314,19462,19468,0,149,6
11,2971,597,19468,19473,0,149,5
11,2971,599,19473,19479,0,149,6
11,2971,1057,19479,19484,0,149,5
11,2971,731,19484,19495,0,149,11
11,2971,732,19495,19499,0,149,4
11,2971,747,19499,19513,0,149,14
11,2971,1058,19513,19533,0,149,20
11,2971,1059,19533,19534,0,149,1
11,2971,1060,19534,19541,0,149,7
11,2971,751,19541,19549,0,149,8
11,2971,753,19549,19562,0,149,13
11,2971,753,19562,19581,0,149,19
11,2971,753,19581,19597,0,149,16
11,2971,754,19597,19598,0,149,1
11,2971,755,19598,19612,0,149,14
11,2971,794,19612,19623,0,149,11
11,2971,756,19623,19640,0,149,17
11,2971,757,19640,19641,0,149,1
11,2971,758,19641,19661,0,149,20
11,2971,758,19661,19675,0,149,14
11,2971,793,19675,19684,0,149,9
11,2971,760,19684,19691,0,149,7
11,2971,761,19691,19699,0,149,8
11,2971,762,19699,19701,0,149,2
11,2971,762,19701,19716,0,149,15
11,2971,763,19716,19728,0,149,12
11,2971,763,19728,19737,0,149,9
11,2971,764,19737,19742,0,149,5
11,2971,764,19742,19754,0,149,12
11,2971,766,19754,19764,0,149,10
11,2971,766,19764,19776,0,149,12
11,2971,791,19776,19781,0,149,5
11,2971,767,19781,19792,0,149,11
11,2971,768,19792,19807,0,149,15
11,2971,769,19807,19809,0,149,2
11,2971,769,19809,19818,0,149,9
11,2971,770,19818,19820,0,149,2
11,2971,771,19820,19829,0,149,9
11,2971,771,19829,19845,0,149,16
11,2971,770,19845,19846,0,149,1
11,2971,772,19846,19853,0,149,7
11,2971,773,19853,19859,0,149,6
11,2971,773,19859,19863,0,149,4
11,2971,773,19863,19873,0,149,10
11,2971,774,19873,19888,0,149,15
11,2971,775,19888,19906,0,149,18
11,2971,776,19906,19918,0,149,12
11,2971,1061,19918,19932,0,149,14
11,2971,778,19932,19952,0,149,20
11,2971,779,19952,19960,0,149,8
11,2971,780,19960,19978,0,149,18
11,2971,788,19978,19997,0,149,19
11,2971,787,19997,20004,0,149,7
11,2971,783,20004,20015,0,149,11
11,2971,784,20015,20019,0,149,4
11,2971,784,20019,20023,0,149,4
11,2971,785,20023,20029,0,149,6
11,2971,785,20029,20034,0,149,5
11,2971,785,20034,20053,0,149,19
11,2971,785,20053,20071,0,149,18
11,2971,785,20071,20088,0,149,17
11,2971,785,20088,20098,0,149,10
11,2971,785,20098,20102,0,149,4
11,2971,785,20102,20109,0,149,7
11,2971,785,20109,20121,0,149,12
11,2971,785,20121,20122,0,149,1
11,2971,785,20122,20131,0,149,9
11,2971,785,20131,20141,0,149,10
11,2971,784,20141,20157,0,149,16
11,2971,783,20157,20177,0,149,20
11,2971,1062,20177,20195,0,149,18
11,2971,782,20195,20206,0,149,11
11,2971,781,20206,20217,0,149,11
11,2971,780,20217,20228,0,149,11
11,2971,779,20228,20234,0,149,6
11,2971,1061,20234,20249,0,149,15
11,2971,776,20249,20259,0,149,10
11,2971,775,20259,20262,0,149,3
11,2971,774,20262,20271,0,149,9
11,2971,773,20271,20289,0,149,18
11,2971,773,20289,20299,0,149,10
11,2971,773,20299,20312,0,149,13
11,2971,772,20312,20315,0,149,3
11,2971,770,20315,20324,0,149,9
11,2971,790,20324,20330,0,149,6
11,2971,790,20330,20349,0,149,19
11,2971,790,20349,20366,0,149,17
11,2971,790,20366,20376,0,149,10
11,2971,769,20376,20389,0,149,13
11,2971,769,20389,20399,0,149,10
11,2971,768,20399,20419,0,149,20
11,2971,768,20419,20438,0,149,19
11,2971,791,20438,20439,0,149,1
11,2971,766,20439,20447,0,149,8
11,2971,766,20447,20460,0,149,13
11,2971,765,20460,20466,0,149,6
11,2971,764,20466,20469,0,149,3
11,2971,764,20469,20481,0,149,12
11,2971,763,20481,20492,0,149,11
11,2971,763,20492,20501,0,149,9
11,2981,23,20501,20504,0,56,3
11,2981,23,20504,20520,0,56,16
11,2981,23,20520,20527,0,56,7
11,2981,23,20527,20538,0,56,11
11,2981,23,20538,20540,0,56,2
11,2981,23,20540,20559,0,56,19
11,2981,23,20559,20564,0,56,5
11,2981,23,20564,20578,0,56,14
11,2981,29,20578,20595,0,56,17
11,2981,40,20595,20608,0,56,13
11,2981,41,20608,20617,0,56,9
11,2981,42,20617,20620,0,56,3
11,2981,43,20620,20625,0,56,5
11,2981,43,20625,20635,0,56,10
11,2981,465,20635,20650,0,56,15
11,2981,613,20650,20667,0,56,17
11,2981,613,20667,20686,0,56,19
11,2981,299,20686,20696,0,56,10
11,2981,300,20696,20715,0,56,19
11,2981,301,20715,20721,0,56,6
11,2981,303,20721,20731,0,56,10
11,2981,305,20731,20737,0,56,6
11,2981,306,20737,20753,0,56,16
11,2981,307,20753,20761,0,56,8
11,2981,308,20761,20780,0,56,19
11,2981,310,20780,20783,0,56,3
11,2981,349,20783,20787,0,56,4
11,2981,313,20787,20798,0,56,11
11,2981,597,20798,20804,0,56,6
11,2981,599,20804,20816,0,56,12
11,2981,600,20816,20824,0,56,8
11,2981,602,20824,20837,0,56,13
11,2981,603,20837,20840,0,56,3
11,2981,604,20840,20849,0,56,9
11,2981,649,20849,20857,0,56,8
11,2981,605,20857,20876,0,56,19
11,2981,649,20876,20877,0,56,1
11,2981,649,20877,20887,0,56,10
11,2981,1079,20887,20904,0,56,17
11,2981,1080,20904,20920,0,56,16
11,2981,612,20920,20926,0,56,6
11,2981,612,20926,20940,0,56,14
11,2981,609,20940,20946,0,56,6
11,2981,609,20946,20961,0,56,15
11,2981,609,20961,20980,0,56,19
11,2981,610,20980,20984,0,56,4
11,2981,611,20984,21001,0,56,17
11,2981,611,21001,21017,0,56,16
11,2981,1081,21017,21033,0,56,16
11,2981,1082,21033,21043,0,56,10
11,2981,1082,21043,21054,0,56,11
11,2981,1083,21054,21069,0,56,15
11,2981,1084,21069,21085,0,56,16
11,2981,1085,21085,21092,0,56,7
11,2981,1085,21092,21108,0,56,16
11,2991,724,21108,21127,0,35,19
11,2991,250,21127,21144,0,35,17
11,2991,589,21144,21150,0,35,6
11,2991,616,21150,21162,0,35,12
11,2991,638,21162,21177,0,35,15
11,2991,562,21177,21194,0,35,17
11,2991,562,21194,21195,0,35,1
11,2991,617,21195,21207,0,35,12
11,2991,617,21207,21223,0,35,16
11,2991,723,21223,21240,0,35,17
11,2991,723,21240,21260,0,35,20
11,2991,723,21260,21261,0,35,1
11,2991,91,21261,21276,0,35,15
11,2991,91,21276,21295,0,35,19
11,2991,104,21295,21312,0,35,17
11,2991,104,21312,21330,0,35,18
11,2991,104,21330,21348,0,35,18
11,2991,104,21348,21363,0,35,15
11,2991,104,21363,21380,0,35,17
11,2991,104,21380,21383,0,35,3
11,2991,104,21383,21394,0,35,11
11,2991,104,21394,21412,0,35,18
11,2991,103,21412,21424,0,35,12
11,2991,102,21424,21433,0,35,9
11,2991,101,21433,21439,0,35,6
11,2991,101,21439,21448,0,35,9
11,2991,30,21448,21452,0,35,4
11,2991,29,21452,21467,0,35,15
11,2991,29,21467,21487,0,35,20
11,2991,23,21487,21501,0,35,14
11,2991,23,21501,21518,0,35,17
11,2991,23,21518,21522,0,35,4
11,2991,23,21522,21541,0,35,19
11,2991,23,21541,21545,0,35,4
21,4981,3,21545,21558,0,4,13
21,4981,3,21558,21569,0,4,11
21,4981,3,21569,21571,0,4,2
21,4991,29,21571,21578,0,31,7
21,4991,29,21578,21588,0,31,10
21,4991,29,21588,21603,0,31,15
21,4991,29,21603,21623,0,31,20
21,4991,29,21623,21628,0,31,5
21,4991,29,21628,21634,0,31,6
21,4991,29,21634,21647,0,31,13
21,4991,1,21647,21649,0,31,2
21,4991,87,21649,21651,0,31,2
21,4991,32,21651,21652,0,31,1
21,4991,32,21652,21671,0,31,19
21,4991,32,21671,21673,0,31,2
21,4991,32,21673,21685,0,31,12
21,4991,32,21685,21703,0,31,18
21,4991,32,21703,21704,0,31,1
21,4991,32,21704,21722,0,31,18
21,4991,32,21722,21731,0,31,9
21,4991,32,21731,21745,0,31,14
21,4991,32,21745,21760,0,31,15
21,4991,32,21760,21761,0,31,1
21,4991,419,21761,21774,0,31,13
21,4991,419,21774,21788,0,31,14
21,4991,419,21788,21800,0,31,12
21,4991,32,21800,21803,0,31,3
21,4991,3,21803,21811,0,31,8
21,4991,3,21811,21812,0,31,1
21,4991,3,21812,21827,0,31,15
21,4991,3,21827,21832,0,31,5
21,4991,3,21832,21845,0,31,13
21,4991,3,21845,21853,0,31,8
21,5001,32,21853,21864,0,26,11
21,5001,32,21864,21876,0,26,12
21,5001,2,21876,21889,0,26,13
21,5001,2,21889,21892,0,26,3
21,5001,1,21892,21911,0,26,19
21,5001,87,21911,21930,0,26,19
21,5001,1,21930,21950,0,26,20
21,5001,1,21950,21968,0,26,18
21,5001,1,21968,21974,0,26,6
21,5001,1,21974,21988,0,26,14
21,5001,1,21988,21991,0,26,3
21,5001,1,21991,21993,0,26,2
21,5001,1,21993,21998,0,26,5
21,5001,1,21998,22013,0,26,15
21,5001,29,22013,22024,0,26,11
21,5001,29,22024,22036,0,26,12
21,5001,29,22036,22051,0,26,15
21,5001,29,22051,22071,0,26,20
21,5001,29,22071,22090,0,26,19
21,5001,29,22090,22101,0,26,11
21,5001,29,22101,22102,0,26,1
21,5001,29,22102,22120,0,26,18
21,5001,29,22120,22134,0,26,14
21,5001,29,22134,22138,0,26,4
21,5001,29,22138,22147,0,26,9
21,5011,3,22147,22165,0,14,18
21,5011,3,22165,22174,0,14,9
21,5011,3,22174,22182,0,14,8
21,5011,3,22182,22186,0,14,4
21,5011,3,22186,22200,0,14,14
21,5011,3,22200,22202,0,14,2
21,5011,3,22202,22204,0,14,2
21,5011,3,22204,22211,0,14,7
21,5011,3,22211,22217,0,14,6
21,5011,3,22217,22221,0,14,4
21,5011,3,22221,22232,0,14,11
21,5011,3,22232,22251,0,14,19
21,5011,2,22251,22261,0,14,10
21,5021,37,22261,22264,0,2,3
21,5031,1,22264,22269,0,11,5
21,5031,1,22269,22272,0,11,3
21,5031,1,22272,22280,0,11,8
21,5031,2,22280,22288,0,11,8
21,5031,2,22288,22291,0,11,3
21,5031,2,22291,22292,0,11,1
21,5031,2,22292,22306,0,11,14
21,5031,2,22306,22311,0,11,5
21,5031,3,22311,22318,0,11,7
21,5031,3,22318,22324,0,11,6
21,5041,30,22324,22328,0,4,4
21,5041,29,22328,22331,0,4,3
21,5041,29,22331,22346,0,4,15
21,5051,2,22346,22360,0,15,14
21,5051,32,22360,22374,0,15,14
21,5051,32,22374,22384,0,15,10
21,5051,32,22384,22397,0,15,13
21,5051,2,22397,22414,0,15,17
21,5051,2,22414,22434,0,15,20
21,5051,2,22434,22443,0,15,9
21,5051,2,22443,22454,0,15,11
21,5051,2,22454,22470,0,15,16
21,5051,2,22470,22471,0,15,1
21,5051,2,22471,22472,0,15,1
21,5051,2,22472,22488,0,15,16
21,5051,3,22488,22501,0,15,13
21,5051,3,22501,22503,0,15,2
21,5061,29,22503,22519,0,33,16
21,5061,29,22519,22534,0,33,15
21,5061,29,22534,22541,0,33,7
21,5061,29,22541,22551,0,33,10
21,5061,29,22551,22557,0,33,6
21,5061,29,22557,22570,0,33,13
21,5061,29,22570,22581,0,33,11
21,5061,29,22581,22599,0,33,18
21,5061,29,22599,22613,0,33,14
21,5061,29,22613,22629,0,33,16
21,5061,30,22629,22634,0,33,5
21,5061,30,22634,22643,0,33,9
21,5061,30,22643,22652,0,33,9
21,5061,30,22652,22659,0,33,7
21,5061,29,22659,22665,0,33,6
21,5061,30,22665,22679,0,33,14
21,5061,29,22679,22699,0,33,20
21,5061,29,22699,22713,0,33,14
21,5061,1,22713,22720,0,33,7
21,5061,1,22720,22735,0,33,15
21,5061,1,22735,22753,0,33,18
21,5061,87,22753,22771,0,33,18
21,5061,87,22771,22774,0,33,3
21,5061,32,22774,22786,0,33,12
21,5061,32,22786,22798,0,33,12
21,5061,32,22798,22815,0,33,17
21,5061,32,22815,22829,0,33,14
21,5061,32,22829,22838,0,33,9
21,5061,32,22838,22841,0,33,3
21,5061,2,22841,22844,0,33,3
21,5061,2,22844,22851,0,33,7
21,5061,3,22851,22855,0,33,4
21,5071,2,22855,22859,0,2,4
21,5081,1,22859,22862,0,9,3
21,5081,1,22862,22867,0,9,5
21,5081,1,22867,22874,0,9,7
21,5081,29,22874,22885,0,9,11
21,5081,29,22885,22894,0,9,9
21,5081,29,22894,22906,0,9,12
21,5081,29,22906,22908,0,9,2
21,5081,29,22908,22923,0,9,15
21,5091,7,22923,22938,0,38,15
21,5091,7,22938,22957,0,38,19
21,5091,7,22957,22962,0,38,5
21,5091,27,22962,22974,0,38,12
21,5091,27,22974,22993,0,38,19
21,5091,27,22993,22994,0,38,1
21,5091,27,22994,23009,0,38,15
21,5091,7,23009,23018,0,38,9
21,5091,7,23018,23038,0,38,20
21,5091,7,23038,23053,0,38,15
21,5091,7,23053,23062,0,38,9
21,5091,7,23062,23081,0,38,19
21,5091,7,23081,23099,0,38,18
21,5091,7,23099,23110,0,38,11
21,5091,7,23110,23121,0,38,11
21,5091,24,23121,23131,0,38,10
21,5091,24,23131,23139,0,38,8
21,5091,24,23139,23149,0,38,10
21,5091,24,23149,23165,0,38,16
21,5091,23,23165,23181,0,38,16
21,5091,23,23181,23183,0,38,2
21,5091,23,23183,23190,0,38,7
21,5091,23,23190,23199,0,38,9
21,5091,23,23199,23212,0,38,13
21,5091,6,23212,23226,0,38,14
21,5091,29,23226,23241,0,38,15
21,5091,29,23241,23256,0,38,15
21,5091,1,23256,23257,0,38,1
21,5091,1,23257,23258,0,38,1
21,5091,1,23258,23267,0,38,9
21,5091,1,23267,23286,0,38,19
21,5091,2,23286,23306,0,38,20
21,5091,2,23306,23311,0,38,5
21,5091,2,23311,23317,0,38,6
21,5091,2,23317,23327,0,38,10
21,5091,2,23327,23336,0,38,9
21,5091,3,23336,23339,0,38,3
21,5101,29,23339,23350,0,15,11
21,5101,29,23350,23354,0,15,4
21,5101,29,23354,23374,0,15,20
21,5101,1,23374,23375,0,15,1
21,5101,1,23375,23387,0,15,12
21,5101,1,23387,23406,0,15,19
21,5101,1,23406,23424,0,15,18
21,5101,2,23424,23431,0,15,7
21,5101,2,23431,23439,0,15,8
21,5101,2,23439,23444,0,15,5
21,5101,2,23444,23457,0,15,13
21,5101,2,23457,23464,0,15,7
21,5101,2,23464,23479,0,15,15
21,5101,3,23479,23497,0,15,18
21,5111,29,23497,23513,0,13,16
21,5111,29,23513,23527,0,13,14
21,5111,1,23527,23540,0,13,13
21,5111,1,23540,23552,0,13,12
21,5111,1,23552,23559,0,13,7
21,5111,1,23559,23570,0,13,11
21,5111,2,23570,23577,0,13,7
21,5111,2,23577,23585,0,13,8
21,5111,2,23585,23599,0,13,14
21,5111,2,23599,23608,0,13,9
21,5111,2,23608,23628,0,13,20
21,5111,2,23628,23644,0,13,16
21,5121,3,23644,23657,0,20,13
21,5121,2,23657,23659,0,20,2
21,5121,2,23659,23677,0,20,18
21,5121,2,23677,23682,0,20,5
21,5121,2,23682,23697,0,20,15
21,5121,32,23697,23698,0,20,1
21,5121,87,23698,23717,0,20,19
21,5121,87,23717,23726,0,20,9
21,5121,87,23726,23741,0,20,15
21,5121,1,23741,23743,0,20,2
21,5121,1,23743,23746,0,20,3
21,5121,1,23746,23753,0,20,7
21,5121,1,23753,23772,0,20,19
21,5121,29,23772,23787,0,20,15
21,5121,29,23787,23789,0,20,2
21,5121,29,23789,23807,0,20,18
21,5121,29,23807,23825,0,20,18
21,5121,29,23825,23827,0,20,2
21,5121,29,23827,23838,0,20,11
21,5131,32,23838,23845,0,12,7
21,5131,32,23845,23857,0,12,12
21,5131,87,23857,23859,0,12,2
21,5131,87,23859,23868,0,12,9
21,5131,87,23868,23883,0,12,15
21,5131,87,23883,23903,0,12,20
21,5131,30,23903,23921,0,12,18
21,5131,29,23921,23934,0,12,13
21,5131,29,23934,23948,0,12,14
21,5131,29,23948,23965,0,12,17
21,5131,29,23965,23983,0,12,18
31,6641,24,23983,23995,0,35,12
31,6641,7,23995,24004,0,35,9
31,6641,7,24004,24020,0,35,16
31,6641,7,24020,24026,0,35,6
31,6641,7,24026,24033,0,35,7
31,6641,7,24033,24040,0,35,7
31,6641,7,24040,24041,0,35,1
31,6641,7,24041,24053,0,35,12
31,6641,7,24053,24063,0,35,10
31,6641,7,24063,24065,0,35,2
31,6641,7,24065,24071,0,35,6
31,6641,7,24071,24088,0,35,17
31,6641,24,24088,24108,0,35,20
31,6641,24,24108,24118,0,35,10
31,6641,24,24118,24124,0,35,6
31,6641,24,24124,24142,0,35,18
31,6641,24,24142,24143,0,35,1
31,6641,24,24143,24150,0,35,7
31,6641,7,24150,24157,0,35,7
31,6641,7,24157,24165,0,35,8
31,6641,7,24165,24182,0,35,17
31,6641,7,24182,24202,0,35,20
31,6641,8,24202,24209,0,35,7
31,6641,8,24209,24220,0,35,11
31,6641,8,24220,24225,0,35,5
31,6641,8,24225,24238,0,35,13
31,6641,8,24238,24250,0,35,12
31,6641,8,24250,24258,0,35,8
31,6641,8,24258,24275,0,35,17
31,6641,8,24275,24293,0,35,18
31,6641,7,24293,24295,0,35,2
31,6641,7,24295,24296,0,35,1
31,6641,7,24296,24313,0,35,17
31,6641,24,24313,24330,0,35,17
31,6651,24,24330,24337,0,10,7
31,6651,24,24337,24351,0,10,14
31,6651,24,24351,24367,0,10,16
31,6651,7,24367,24382,0,10,15
31,6651,7,24382,24395,0,10,13
31,6651,8,24395,24402,0,10,7
31,6651,8,24402,24414,0,10,12
31,6651,8,24414,24421,0,10,7
31,6651,8,24421,24422,0,10,1
31,6661,8,24422,24427,0,2,5
31,6671,8,24427,24439,0,106,12
31,6671,8,24439,24444,0,106,5
31,6671,8,24444,24457,0,106,13
31,6671,8,24457,24464,0,106,7
31,6671,8,24464,24467,0,106,3
31,6671,8,24467,24481,0,106,14
31,6671,8,24481,24494,0,106,13
31,6671,8,24494,24496,0,106,2
31,6671,28,24496,24506,0,106,10
31,6671,8,24506,24515,0,106,9
31,6671,28,24515,24535,0,106,20
31,6671,8,24535,24549,0,106,14
31,6671,28,24549,24560,0,106,11
31,6671,8,24560,24574,0,106,14
31,6671,8,24574,24587,0,106,13
31,6671,8,24587,24604,0,106,17
31,6671,8,24604,24607,0,106,3
31,6671,8,24607,24620,0,106,13
31,6671,8,24620,24630,0,106,10
31,6671,8,24630,24648,0,106,18
31,6671,8,24648,24653,0,106,5
31,6671,8,24653,24664,0,106,11
31,6671,8,24664,24683,0,106,19
31,6671,8,24683,24693,0,106,10
31,6671,8,24693,24707,0,106,14
31,6671,7,24707,24712,0,106,5
31,6671,24,24712,24721,0,106,9
31,6671,24,24721,24722,0,106,1
31,6671,24,24722,24735,0,106,13
31,6671,24,24735,24736,0,106,1
31,6671,24,24736,24750,0,106,14
31,6671,24,24750,24760,0,106,10
31,6671,7,24760,24774,0,106,14
31,6671,7,24774,24775,0,106,1
31,6671,7,24775,24778,0,106,3
31,6671,8,24778,24786,0,106,8
31,6671,8,24786,24789,0,106,3
31,6671,8,24789,24792,0,106,3
31,6671,8,24792,24804,0,106,12
31,6671,8,24804,24816,0,106,12
31,6671,8,24816,24833,0,106,17
31,6671,8,24833,24849,0,106,16
31,6671,8,24849,24855,0,106,6
31,6671,8,24855,24866,0,106,11
31,6671,8,24866,24875,0,106,9
31,6671,8,24875,24892,0,106,17
31,6671,8,24892,24906,0,106,14
31,6671,8,24906,24925,0,106,19
31,6671,28,24925,24935,0,106,10
31,6671,28,24935,24942,0,106,7
31,6671,28,24942,24958,0,106,16
31,6671,8,24958,24960,0,106,2
31,6671,8,24960,24968,0,106,8
31,6671,8,24968,24988,0,106,20
31,6671,8,24988,25000,0,106,12
31,6671,8,25000,25013,0,106,13
31,6671,8,25013,25022,0,106,9
31,6671,8,25022,25029,0,106,7
31,6671,8,25029,25043,0,106,14
31,6671,8,25043,25056,0,106,13
31,6671,8,25056,25068,0,106,12
31,6671,8,25068,25078,0,106,10
31,6671,8,25078,25079,0,106,1
31,6671,8,25079,25095,0,106,16
31,6671,8,25095,25115,0,106,20
31,6671,8,25115,25135,0,106,20
31,6671,8,25135,25146,0,106,11
31,6671,8,25146,25161,0,106,15
31,6671,8,25161,25180,0,106,19
31,6671,8,25180,25193,0,106,13
31,6671,8,25193,25195,0,106,2
31,6671,8,25195,25213,0,106,18
31,6671,8,25213,25228,0,106,15
31,6671,8,25228,25248,0,106,20
31,6671,28,25248,25249,0,106,1
31,6671,28,25249,25250,0,106,1
31,6671,8,25250,25266,0,106,16
31,6671,8,25266,25280,0,106,14
31,6671,8,25280,25291,0,106,11
31,6671,8,25291,25304,0,106,13
31,6671,8,25304,25306,0,106,2
31,6671,8,25306,25310,0,106,4
31,6671,8,25310,25320,0,106,10
31,6671,8,25320,25329,0,106,9
31,6671,8,25329,25337,0,106,8
31,6671,8,25337,25346,0,106,9
31,6671,8,25346,25347,0,106,1
31,6671,8,25347,25349,0,106,2
31,6671,8,25349,25355,0,106,6
31,6671,8,25355,25366,0,106,11
31,6671,8,25366,25382,0,106,16
31,6671,8,25382,25399,0,106,17
31,6671,8,25399,25414,0,106,15
31,6671,8,25414,25433,0,106,19
31,6671,8,25433,25446,0,106,13
31,6671,8,25446,25458,0,106,12
31,6671,8,25458,25473,0,106,15
31,6671,8,25473,25481,0,106,8
31,6671,8,25481,25485,0,106,4
31,6671,7,25485,25498,0,106,13
31,6671,7,25498,25500,0,106,2
31,6671,7,25500,25511,0,106,11
31,6671,7,25511,25529,0,106,18
31,6671,24,25529,25548,0,106,19
31,6671,24,25548,25563,0,106,15
31,6681,192,25563,25580,0,49,17
31,6681,225,25580,25587,0,49,7
31,6681,193,25587,25597,0,49,10
31,6681,194,25597,25604,0,49,7
31,6681,235,25604,25616,0,49,12
31,6681,196,25616,25631,0,49,15
31,6681,197,25631,25644,0,49,13
31,6681,236,25644,25648,0,49,4
31,6681,199,25648,25656,0,49,8
31,6681,200,25656,25657,0,49,1
31,6681,201,25657,25660,0,49,3
31,6681,201,25660,25679,0,49,19
31,6681,237,25679,25688,0,49,9
31,6681,204,25688,25690,0,49,2
31,6681,238,25690,25696,0,49,6
31,6681,206,25696,25713,0,49,17
31,6681,223,25713,25717,0,49,4
31,6681,207,25717,25725,0,49,8
31,6681,222,25725,25736,0,49,11
31,6681,221,25736,25753,0,49,17
31,6681,210,25753,25756,0,49,3
31,6681,212,25756,25760,0,49,4
31,6681,220,25760,25762,0,49,2
31,6681,219,25762,25778,0,49,16
31,6681,214,25778,25792,0,49,14
31,6681,214,25792,25800,0,49,8
31,6681,215,25800,25816,0,49,16
31,6681,215,25816,25829,0,49,13
31,6681,216,25829,25849,0,49,20
31,6681,217,25849,25855,0,49,6
31,6681,217,25855,25867,0,49,12
31,6681,217,25867,25868,0,49,1
31,6681,217,25868,25871,0,49,3
31,6681,217,25871,25887,0,49,16
31,6681,2354,25887,25901,0,49,14
31,6681,217,25901,25914,0,49,13
31,6681,217,25914,25931,0,49,17
31,6681,217,25931,25950,0,49,19
31,6681,217,25950,25968,0,49,18
31,6681,217,25968,25983,0,49,15
31,6681,217,25983,25986,0,49,3
31,6681,217,25986,26000,0,49,14
31,6681,217,26000,26011,0,49,11
31,6681,217,26011,26020,0,49,9
31,6681,217,26020,26032,0,49,12
31,6681,217,26032,26036,0,49,4
31,6681,217,26036,26042,0,49,6
31,6681,217,26042,26061,0,49,19
31,6691,8,26061,26071,0,21,10
31,6691,8,26071,26073,0,21,2
31,6691,8,26073,26088,0,21,15
31,6691,8,26088,26097,0,21,9
31,6691,8,26097,26117,0,21,20
31,6691,8,26117,26121,0,21,4
31,6691,28,26121,26132,0,21,11
31,6691,8,26132,26146,0,21,14
31,6691,8,26146,26149,0,21,3
31,6691,8,26149,26169,0,21,20
31,6691,8,26169,26177,0,21,8
31,6691,7,26177,26178,0,21,1
31,6691,7,26178,26179,0,21,1
31,6691,7,26179,26199,0,21,20
31,6691,7,26199,26207,0,21,8
31,6691,7,26207,26221,0,21,14
31,6691,24,26221,26227,0,21,6
31,6691,24,26227,26230,0,21,3
31,6691,24,26230,26234,0,21,4
31,6691,24,26234,26239,0,21,5
31,6701,217,26239,26247,0,11,8
31,6701,217,26247,26258,0,11,11
31,6701,217,26258,26261,0,11,3
31,6701,217,26261,26281,0,11,20
31,6701,217,26281,26295,0,11,14
31,6701,217,26295,26315,0,11,20
31,6701,217,26315,26321,0,11,6
31,6701,217,26321,26341,0,11,20
31,6701,217,26341,26352,0,11,11
31,6701,217,26352,26372,0,11,20
31,6711,7,26372,26389,0,49,17
31,6711,7,26389,26401,0,49,12
31,6711,7,26401,26413,0,49,12
31,6711,8,26413,26430,0,49,17
31,6711,8,26430,26444,0,49,14
31,6711,8,26444,26452,0,49,8
31,6711,8,26452,26470,0,49,18
31,6711,8,26470,26489,0,49,19
31,6711,8,26489,26500,0,49,11
31,6711,8,26500,26514,0,49,14
31,6711,8,26514,26528,0,49,14
31,6711,8,26528,26538,0,49,10
31,6711,8,26538,26545,0,49,7
31,6711,8,26545,26551,0,49,6
31,6711,8,26551,26561,0,49,10
31,6711,8,26561,26569,0,49,8
31,6711,8,26569,26578,0,49,9
31,6711,8,26578,26589,0,49,11
31,6711,8,26589,26596,0,49,7
31,6711,8,26596,26600,0,49,4
31,6711,8,26600,26610,0,49,10
31,6711,8,26610,26619,0,49,9
31,6711,8,26619,26626,0,49,7
31,6711,8,26626,26627,0,49,1
31,6711,8,26627,26629,0,49,2
31,6711,8,26629,26648,0,49,19
31,6711,8,26648,26659,0,49,11
31,6711,28,26659,26676,0,49,17
31,6711,8,26676,26681,0,49,5
31,6711,28,26681,26695,0,49,14
31,6711,8,26695,26711,0,49,16
31,6711,8,26711,26713,0,49,2
31,6711,8,26713,26720,0,49,7
31,6711,8,26720,26729,0,49,9
31,6711,7,26729,26746,0,49,17
31,6711,7,26746,26755,0,49,9
31,6711,7,26755,26763,0,49,8
31,6711,7,26763,26766,0,49,3
31,6711,7,26766,26784,0,49,18
31,6711,7,26784,26799,0,49,15
31,6711,7,26799,26805,0,49,6
31,6711,7,26805,26818,0,49,13
31,6711,7,26818,26819,0,49,1
31,6711,7,26819,26836,0,49,17
31,6711,7,26836,26852,0,49,16
31,6711,24,26852,26871,0,49,19
31,6711,24,26871,26874,0,49,3
31,6711,24,26874,26883,0,49,9
31,6721,24,26883,26885,0,14,2
31,6721,24,26885,26888,0,14,3
31,6721,7,26888,26906,0,14,18
31,6721,7,26906,26920,0,14,14
31,6721,8,26920,26928,0,14,8
31,6721,8,26928,26940,0,14,12
31,6721,8,26940,26943,0,14,3
31,6721,8,26943,26947,0,14,4
31,6721,8,26947,26964,0,14,17
31,6721,28,26964,26970,0,14,6
31,6721,28,26970,26986,0,14,16
31,6721,28,26986,27002,0,14,16
31,6721,8,27002,27007,0,14,5
31,6731,8,27007,27021,0,29,14
31,6731,8,27021,27031,0,29,10
31,6731,8,27031,27041,0,29,10
31,6731,8,27041,27052,0,29,11
31,6731,8,27052,27063,0,29,11
31,6731,8,27063,27076,0,29,13
31,6731,8,27076,27085,0,29,9
31,6731,8,27085,27095,0,29,10
31,6731,8,27095,27104,0,29,9
31,6731,8,27104,27123,0,29,19
31,6731,8,27123,27130,0,29,7
31,6731,8,27130,27144,0,29,14
31,6731,8,27144,27151,0,29,7
31,6731,8,27151,27162,0,29,11
31,6731,8,27162,27180,0,29,18
31,6731,8,27180,27199,0,29,19
31,6731,8,27199,27213,0,29,14
31,6731,7,27213,27220,0,29,7
31,6731,7,27220,27228,0,29,8
31,6731,7,27228,27238,0,29,10
31,6731,7,27238,27258,0,29,20
31,6731,24,27258,27278,0,29,20
31,6731,24,27278,27284,0,29,6
31,6731,24,27284,27296,0,29,12
31,6731,24,27296,27300,0,29,4
31,6731,24,27300,27320,0,29,20
31,6731,24,27320,27332,0,29,12
31,6731,7,27332,27350,0,29,18
31,6741,23,27350,27353,0,38,3
31,6741,23,27353,27362,0,38,9
31,6741,23,27362,27363,0,38,1
31,6741,23,27363,27372,0,38,9
31,6741,23,27372,27381,0,38,9
31,6741,24,27381,27399,0,38,18
31,6741,24,27399,27406,0,38,7
31,6741,24,27406,27423,0,38,17
31,6741,24,27423,27436,0,38,13
31,6741,24,27436,27453,0,38,17
31,6741,24,27453,27468,0,38,15
31,6741,24,27468,27480,0,38,12
31,6741,24,27480,27492,0,38,12
31,6741,7,27492,27501,0,38,9
31,6741,7,27501,27512,0,38,11
31,6741,7,27512,27518,0,38,6
31,6741,7,27518,27524,0,38,6
31,6741,7,27524,27532,0,38,8
31,6741,7,27532,27546,0,38,14
31,6741,7,27546,27548,0,38,2
31,6741,7,27548,27557,0,38,9
31,6741,8,27557,27571,0,38,14
31,6741,8,27571,27577,0,38,6
31,6741,8,27577,27588,0,38,11
31,6741,8,27588,27607,0,38,19
31,6741,8,27607,27619,0,38,12
31,6741,28,27619,27639,0,38,20
31,6741,8,27639,27656,0,38,17
31,6741,8,27656,27673,0,38,17
31,6741,8,27673,27687,0,38,14
31,6741,28,27687,27706,0,38,19
31,6741,28,27706,27725,0,38,19
31,6741,28,27725,27738,0,38,13
31,6741,28,27738,27747,0,38,9
31,6741,28,27747,27756,0,38,9
31,6741,8,27756,27763,0,38,7
31,6741,8,27763,27781,0,38,18
31,6751,28,27781,27799,0,15,18
31,6751,28,27799,27800,0,15,1
31,6751,8,27800,27807,0,15,7
31,6751,8,27807,27809,0,15,2
31,6751,8,27809,27817,0,15,8
31,6751,8,27817,27830,0,15,13
31,6751,7,27830,27848,0,15,18
31,6751,7,27848,27866,0,15,18
31,6751,7,27866,27876,0,15,10
31,6751,7,27876,27877,0,15,1
31,6751,24,27877,27879,0,15,2
31,6751,24,27879,27897,0,15,18
31,6751,24,27897,27902,0,15,5
31,6751,8,27902,27922,0,15,20
31,6761,7,27922,27928,0,22,6
31,6761,24,27928,27941,0,22,13
31,6761,24,27941,27948,0,22,7
31,6761,24,27948,27968,0,22,20
31,6761,24,27968,27975,0,22,7
31,6761,24,27975,27978,0,22,3
31,6761,24,27978,27987,0,22,9
31,6761,23,27987,28004,0,22,17
31,6761,23,28004,28017,0,22,13
31,6761,23,28017,28021,0,22,4
31,6761,23,28021,28039,0,22,18
31,6761,23,28039,28058,0,22,19
31,6761,23,28058,28071,0,22,13
31,6761,23,28071,28086,0,22,15
31,6761,23,28086,28097,0,22,11
31,6761,23,28097,28103,0,22,6
31,6761,24,28103,28113,0,22,10
31,6761,24,28113,28118,0,22,5
31,6761,24,28118,28129,0,22,11
31,6761,24,28129,28138,0,22,9
31,6761,24,28138,28148,0,22,10
31,6771,8,28148,28157,0,7,9
31,6771,8,28157,28158,0,7,1
31,6771,28,28158,28176,0,7,18
31,6771,28,28176,28183,0,7,7
31,6771,28,28183,28197,0,7,14
31,6771,28,28197,28201,0,7,4
31,6781,8,28201,28205,0,18,4
31,6781,28,28205,28215,0,18,10
31,6781,8,28215,28225,0,18,10
31,6781,8,28225,28232,0,18,7
31,6781,8,28232,28243,0,18,11
31,6781,8,28243,28259,0,18,16
31,6781,8,28259,28272,0,18,13
31,6781,8,28272,28289,0,18,17
31,6781,8,28289,28305,0,18,16
31,6781,8,28305,28325,0,18,20
31,6781,7,28325,28342,0,18,17
31,6781,7,28342,28350,0,18,8
31,6781,7,28350,28366,0,18,16
31,6781,7,28366,28367,0,18,1
31,6781,24,28367,28378,0,18,11
31,6781,24,28378,28386,0,18,8
31,6781,24,28386,28402,0,18,16
31,6791,1,28402,28412,0,62,10
31,6791,1,28412,28422,0,62,10
31,6791,1,28422,28437,0,62,15
31,6791,1,28437,28447,0,62,10
31,6791,1,28447,28452,0,62,5
31,6791,1,28452,28457,0,62,5
31,6791,1,28457,28460,0,62,3
31,6791,1,28460,28475,0,62,15
31,6791,1,28475,28480,0,62,5
31,6791,1,28480,28482,0,62,2
31,6791,6,28482,28491,0,62,9
31,6791,6,28491,28502,0,62,11
31,6791,6,28502,28505,0,62,3
31,6791,6,28505,28516,0,62,11
31,6791,6,28516,28523,0,62,7
31,6791,6,28523,28527,0,62,4
31,6791,23,28527,28543,0,62,16
31,6791,23,28543,28545,0,62,2
31,6791,23,28545,28547,0,62,2
31,6791,23,28547,28563,0,62,16
31,6791,24,28563,28577,0,62,14
31,6791,24,28577,28584,0,62,7
31,6791,24,28584,28595,0,62,11
31,6791,24,28595,28612,0,62,17
31,6791,24,28612,28621,0,62,9
31,6791,24,28621,28637,0,62,16
31,6791,24,28637,28641,0,62,4
31,6791,24,28641,28661,0,62,20
31,6791,7,28661,28672,0,62,11
31,6791,7,28672,28682,0,62,10
31,6791,7,28682,28687,0,62,5
31,6791,7,28687,28705,0,62,18
31,6791,8,28705,28709,0,62,4
31,6791,8,28709,28722,0,62,13
31,6791,8,28722,28728,0,62,6
31,6791,8,28728,28740,0,62,12
31,6791,8,28740,28750,0,62,10
31,6791,8,28750,28758,0,62,8
31,6791,8,28758,28768,0,62,10
31,6791,8,28768,28783,0,62,15
31,6791,8,28783,28801,0,62,18
31,6791,8,28801,28815,0,62,14
31,6791,8,28815,28819,0,62,4
31,6791,8,28819,28827,0,62,8
31,6791,8,28827,28831,0,62,4
31,6791,8,28831,28833,0,62,2
31,6791,8,28833,28840,0,62,7
31,6791,8,28840,28860,0,62,20
31,6791,8,28860,28870,0,62,10
31,6791,8,28870,28886,0,62,16
31,6791,8,28886,28892,0,62,6
31,6791,8,28892,28912,0,62,20
31,6791,8,28912,28921,0,62,9
31,6791,8,28921,28924,0,62,3
31,6791,8,28924,28925,0,62,1
31,6791,7,28925,28933,0,62,8
31,6791,7,28933,28952,0,62,19
31,6791,24,28952,28968,0,62,16
31,6791,24,28968,28980,0,62,12
31,6791,24,28980,28998,0,62,18
31,6791,24,28998,29011,0,62,13
31,6801,218,29011,29020,0,88,9
31,6801,218,29020,29023,0,88,3
31,6801,218,29023,29030,0,88,7
31,6801,218,29030,29031,0,88,1
31,6801,218,29031,29046,0,88,15
31,6801,218,29046,29050,0,88,4
31,6801,216,29050,29069,0,88,19
31,6801,216,29069,29074,0,88,5
31,6801,216,29074,29079,0,88,5
31,6801,218,29079,29091,0,88,12
31,6801,218,29091,29094,0,88,3
31,6801,218,29094,29098,0,88,4
31,6801,218,29098,29115,0,88,17
31,6801,218,29115,29128,0,88,13
31,6801,218,29128,29147,0,88,19
31,6801,218,29147,29160,0,88,13
31,6801,218,29160,29171,0,88,11
31,6801,218,29171,29179,0,88,8
31,6801,216,29179,29180,0,88,1
31,6801,216,29180,29195,0,88,15
31,6801,216,29195,29213,0,88,18
31,6801,218,29213,29232,0,88,19
31,6801,218,29232,29241,0,88,9
31,6801,218,29241,29259,0,88,18
31,6801,218,29259,29275,0,88,16
31,6801,218,29275,29278,0,88,3
31,6801,218,29278,29295,0,88,17
31,6801,218,29295,29297,0,88,2
31,6801,218,29297,29311,0,88,14
31,6801,218,29311,29322,0,88,11
31,6801,218,29322,29332,0,88,10
31,6801,218,29332,29338,0,88,6
31,6801,218,29338,29357,0,88,19
31,6801,218,29357,29376,0,88,19
31,6801,214,29376,29391,0,88,15
31,6801,218,29391,29401,0,88,10
31,6801,218,29401,29412,0,88,11
31,6801,218,29412,29431,0,88,19
31,6801,218,29431,29441,0,88,10
31,6801,218,29441,29445,0,88,4
31,6801,218,29445,29464,0,88,19
31,6801,218,29464,29481,0,88,17
31,6801,218,29481,29488,0,88,7
31,6801,218,29488,29500,0,88,12
31,6801,218,29500,29516,0,88,16
31,6801,218,29516,29525,0,88,9
31,6801,219,29525,29538,0,88,13
31,6801,218,29538,29552,0,88,14
31,6801,218,29552,29572,0,88,20
31,6801,218,29572,29577,0,88,5
31,6801,216,29577,29583,0,88,6
31,6801,216,29583,29593,0,88,10
31,6801,216,29593,29610,0,88,17
31,6801,216,29610,29614,0,88,4
31,6801,217,29614,29625,0,88,11
31,6801,217,29625,29630,0,88,5
31,6801,216,29630,29641,0,88,11
31,6801,216,29641,29644,0,88,3
31,6801,217,29644,29645,0,88,1
31,6801,216,29645,29654,0,88,9
31,6801,216,29654,29672,0,88,18
31,6801,216,29672,29686,0,88,14
31,6801,217,29686,29696,0,88,10
31,6801,217,29696,29701,0,88,5
31,6801,217,29701,29721,0,88,20
31,6801,217,29721,29740,0,88,19
31,6801,217,29740,29754,0,88,14
31,6801,216,29754,29760,0,88,6
31,6801,216,29760,29765,0,88,5
31,6801,216,29765,29785,0,88,20
31,6801,216,29785,29789,0,88,4
31,6801,218,29789,29802,0,88,13
31,6801,214,29802,29809,0,88,7
31,6801,218,29809,29820,0,88,11
31,6801,218,29820,29826,0,88,6
31,6801,216,29826,29837,0,88,11
31,6801,216,29837,29845,0,88,8
31,6801,216,29845,29860,0,88,15
31,6801,216,29860,29865,0,88,5
31,6801,216,29865,29878,0,88,13
31,6801,218,29878,29893,0,88,15
31,6801,218,29893,29901,0,88,8
31,6801,218,29901,29910,0,88,9
31,6801,218,29910,29929,0,88,19
31,6801,216,29929,29945,0,88,16
31,6801,216,29945,29952,0,88,7
31,6801,216,29952,29967,0,88,15
31,6811,24,29967,29975,0,15,8
31,6811,24,29975,29982,0,15,7
31,6811,7,29982,29999,0,15,17
31,6811,7,29999,30012,0,15,13
31,6811,7,30012,30026,0,15,14
31,6811,7,30026,30037,0,15,11
31,6811,7,30037,30046,0,15,9
31,6811,8,30046,30059,0,15,13
31,6811,8,30059,30065,0,15,6
31,6811,8,30065,30084,0,15,19
31,6811,28,30084,30100,0,15,16
31,6811,28,30100,30101,0,15,1
31,6811,28,30101,30107,0,15,6
31,6811,28,30107,30117,0,15,10
31,6821,28,30117,30119,0,22,2
31,6821,28,30119,30123,0,22,4
31,6821,8,30123,30130,0,22,7
31,6821,8,30130,30134,0,22,4
31,6821,8,30134,30142,0,22,8
31,6821,8,30142,30162,0,22,20
31,6821,8,30162,30173,0,22,11
31,6821,8,30173,30188,0,22,15
31,6821,8,30188,30193,0,22,5
31,6821,8,30193,30202,0,22,9
31,6821,8,30202,30208,0,22,6
31,6821,8,30208,30216,0,22,8
31,6821,8,30216,30225,0,22,9
31,6821,8,30225,30239,0,22,14
31,6821,7,30239,30259,0,22,20
31,6821,7,30259,30263,0,22,4
31,6821,7,30263,30266,0,22,3
31,6821,7,30266,30270,0,22,4
31,6821,24,30270,30284,0,22,14
31,6821,24,30284,30288,0,22,4
31,6821,24,30288,30295,0,22,7
31,6831,32,30295,30315,0,118,20
31,6831,33,30315,30316,0,118,1
31,6831,33,30316,30334,0,118,18
31,6831,33,30334,30351,0,118,17
31,6831,33,30351,30361,0,118,10
31,6831,33,30361,30375,0,118,14
31,6831,33,30375,30387,0,118,12
31,6831,33,30387,30389,0,118,2
31,6831,33,30389,30408,0,118,19
31,6831,33,30408,30417,0,118,9
31,6831,33,30417,30430,0,118,13
31,6831,33,30430,30434,0,118,4
31,6831,114,30434,30438,0,118,4
31,6831,114,30438,30456,0,118,18
31,6831,114,30456,30464,0,118,8
31,6831,102,30464,30467,0,118,3
31,6831,102,30467,30483,0,118,16
31,6831,241,30483,30490,0,118,7
31,6831,241,30490,30498,0,118,8
31,6831,241,30498,30499,0,118,1
31,6831,241,30499,30501,0,118,2
31,6831,98,30501,30507,0,118,6
31,6831,98,30507,30525,0,118,18
31,6831,104,30525,30528,0,118,3
31,6831,104,30528,30544,0,118,16
31,6831,104,30544,30557,0,118,13
31,6831,104,30557,30569,0,118,12
31,6831,104,30569,30580,0,118,11
31,6831,104,30580,30586,0,118,6
31,6831,188,30586,30588,0,118,2
31,6831,188,30588,30590,0,118,2
31,6831,188,30590,30610,0,118,20
31,6831,188,30610,30615,0,118,5
31,6831,188,30615,30629,0,118,14
31,6831,188,30629,30636,0,118,7
31,6831,188,30636,30653,0,118,17
31,6831,188,30653,30669,0,118,16
31,6831,188,30669,30675,0,118,6
31,6831,189,30675,30692,0,118,17
31,6831,190,30692,30698,0,118,6
31,6831,192,30698,30718,0,118,20
31,6831,225,30718,30730,0,118,12
31,6831,193,30730,30735,0,118,5
31,6831,194,30735,30751,0,118,16
31,6831,235,30751,30769,0,118,18
31,6831,196,30769,30776,0,118,7
31,6831,197,30776,30780,0,118,4
31,6831,236,30780,30796,0,118,16
31,6831,198,30796,30804,0,118,8
31,6831,200,30804,30805,0,118,1
31,6831,875,30805,30817,0,118,12
31,6831,201,30817,30831,0,118,14
31,6831,201,30831,30849,0,118,18
31,6831,201,30849,30859,0,118,10
31,6831,201,30859,30865,0,118,6
31,6831,224,30865,30870,0,118,5
31,6831,202,30870,30885,0,118,15
31,6831,202,30885,30893,0,118,8
31,6831,203,30893,30903,0,118,10
31,6831,204,30903,30921,0,118,18
31,6831,204,30921,30937,0,118,16
31,6831,204,30937,30945,0,118,8
31,6831,204,30945,30955,0,118,10
31,6831,238,30955,30968,0,118,13
31,6831,206,30968,30969,0,118,1
31,6831,223,30969,30988,0,118,19
31,6831,207,30988,31001,0,118,13
31,6831,208,31001,31017,0,118,16
31,6831,209,31017,31032,0,118,15
31,6831,210,31032,31044,0,118,12
31,6831,211,31044,31055,0,118,11
31,6831,212,31055,31066,0,118,11
31,6831,213,31066,31081,0,118,15
31,6831,219,31081,31084,0,118,3
31,6831,214,31084,31098,0,118,14
31,6831,214,31098,31104,0,118,6
31,6831,214,31104,31106,0,118,2
31,6831,214,31106,31107,0,118,1
31,6831,214,31107,31116,0,118,9
31,6831,214,31116,31131,0,118,15
31,6831,214,31131,31145,0,118,14
31,6831,216,31145,31154,0,118,9
31,6831,216,31154,31159,0,118,5
31,6831,216,31159,31166,0,118,7
31,6831,216,31166,31186,0,118,20
31,6831,216,31186,31199,0,118,13
31,6831,216,31199,31200,0,118,1
31,6831,218,31200,31209,0,118,9
31,6831,218,31209,31221,0,118,12
31,6831,218,31221,31233,0,118,12
31,6831,218,31233,31251,0,118,18
31,6831,218,31251,31269,0,118,18
31,6831,218,31269,31276,0,118,7
31,6831,218,31276,31278,0,118,2
31,6831,218,31278,31282,0,118,4
31,6831,218,31282,31293,0,118,11
31,6831,218,31293,31294,0,118,1
31,6831,218,31294,31313,0,118,19
31,6831,218,31313,31320,0,118,7
31,6831,216,31320,31324,0,118,4
31,6831,216,31324,31331,0,118,7
31,6831,216,31331,31348,0,118,17
31,6831,216,31348,31350,0,118,2
31,6831,216,31350,31370,0,118,20
31,6831,216,31370,31373,0,118,3
31,6831,216,31373,31375,0,118,2
31,6831,216,31375,31389,0,118,14
31,6831,216,31389,31392,0,118,3
31,6831,217,31392,31411,0,118,19
31,6831,217,31411,31414,0,118,3
31,6831,217,31414,31423,0,118,9
31,6831,217,31423,31430,0,118,7
31,6831,217,31430,31450,0,118,20
31,6831,217,31450,31468,0,118,18
31,6831,217,31468,31479,0,118,11
31,6831,217,31479,31481,0,118,2
31,6831,217,31481,31488,0,118,7
31,6841,36,31488,31499,0,13,11
31,6841,24,31499,31509,0,13,10
31,6841,23,31509,31518,0,13,9
31,6841,23,31518,31535,0,13,17
31,6841,23,31535,31551,0,13,16
31,6841,23,31551,31568,0,13,17
31,6841,23,31568,31572,0,13,4
31,6841,23,31572,31573,0,13,1
31,6841,24,31573,31591,0,13,18
31,6841,24,31591,31597,0,13,6
31,6841,24,31597,31598,0,13,1
31,6841,24,31598,31613,0,13,15
31,6851,8,31613,31619,0,20,6
31,6851,8,31619,31623,0,20,4
31,6851,8,31623,31629,0,20,6
31,6851,8,31629,31637,0,20,8
31,6851,8,31637,31651,0,20,14
31,6851,7,31651,31658,0,20,7
31,6851,7,31658,31678,0,20,20
31,6851,7,31678,31688,0,20,10
31,6851,24,31688,31694,0,20,6
31,6851,24,31694,31707,0,20,13
31,6851,7,31707,31718,0,20,11
31,6851,7,31718,31729,0,20,11
31,6851,7,31729,31730,0,20,1
31,6851,7,31730,31731,0,20,1
31,6851,7,31731,31744,0,20,13
31,6851,7,31744,31756,0,20,12
31,6851,7,31756,31773,0,20,17
31,6851,8,31773,31787,0,20,14
31,6851,36,31787,31799,0,20,12
31,6861,24,31799,31808,0,23,9
31,6861,24,31808,31822,0,23,14
31,6861,24,31822,31841,0,23,19
31,6861,24,31841,31856,0,23,15
31,6861,24,31856,31863,0,23,7
31,6861,7,31863,31875,0,23,12
31,6861,7,31875,31876,0,23,1
31,6861,8,31876,31886,0,23,10
31,6861,8,31886,31891,0,23,5
31,6861,8,31891,31892,0,23,1
31,6861,8,31892,31912,0,23,20
31,6861,8,31912,31917,0,23,5
31,6861,8,31917,31920,0,23,3
31,6861,8,31920,31932,0,23,12
31,6861,8,31932,31948,0,23,16
31,6861,8,31948,31958,0,23,10
31,6861,7,31958,31972,0,23,14
31,6861,7,31972,31982,0,23,10
31,6861,24,31982,31983,0,23,1
31,6861,24,31983,31988,0,23,5
31,6861,24,31988,31992,0,23,4
31,6861,24,31992,32011,0,23,19
31,6871,8,32011,32030,0,53,19
31,6871,8,32030,32036,0,53,6
31,6871,8,32036,32038,0,53,2
31,6871,8,32038,32058,0,53,20
31,6871,8,32058,32072,0,53,14
31,6871,8,32072,32090,0,53,18
31,6871,8,32090,32106,0,53,16
31,6871,8,32106,32125,0,53,19
31,6871,8,32125,32143,0,53,18
31,6871,8,32143,32151,0,53,8
31,6871,8,32151,32159,0,53,8
31,6871,8,32159,32170,0,53,11
31,6871,8,32170,32180,0,53,10
31,6871,8,32180,32196,0,53,16
31,6871,8,32196,32211,0,53,15
31,6871,8,32211,32216,0,53,5
31,6871,8,32216,32227,0,53,11
31,6871,8,32227,32234,0,53,7
31,6871,8,32234,32242,0,53,8
31,6871,8,32242,32250,0,53,8
31,6871,8,32250,32253,0,53,3
31,6871,8,32253,32258,0,53,5
31,6871,8,32258,32273,0,53,15
31,6871,8,32273,32293,0,53,20
31,6871,8,32293,32304,0,53,11
31,6871,8,32304,32323,0,53,19
31,6871,8,32323,32336,0,53,13
31,6871,8,32336,32355,0,53,19
31,6871,8,32355,32356,0,53,1
31,6871,8,32356,32373,0,53,17
31,6871,8,32373,32392,0,53,19
31,6871,8,32392,32404,0,53,12
31,6871,8,32404,32411,0,53,7
31,6871,8,32411,32427,0,53,16
31,6871,8,32427,32443,0,53,16
31,6871,8,32443,32461,0,53,18
31,6871,8,32461,32476,0,53,15
31,6871,8,32476,32488,0,53,12
31,6871,8,32488,32501,0,53,13
31,6871,8,32501,32504,0,53,3
31,6871,8,32504,32522,0,53,18
31,6871,8,32522,32534,0,53,12
31,6871,8,32534,32552,0,53,18
31,6871,7,32552,32565,0,53,13
31,6871,7,32565,32579,0,53,14
31,6871,7,32579,32585,0,53,6
31,6871,7,32585,32601,0,53,16
31,6871,24,32601,32603,0,53,2
31,6871,24,32603,32622,0,53,19
31,6871,24,32622,32638,0,53,16
31,6871,24,32638,32656,0,53,18
31,6871,24,32656,32675,0,53,19
31,6881,8,32675,32676,0,37,1
31,6881,8,32676,32695,0,37,19
31,6881,8,32695,32705,0,37,10
31,6881,8,32705,32718,0,37,13
31,6881,8,32718,32722,0,37,4
31,6881,8,32722,32735,0,37,13
31,6881,28,32735,32753,0,37,18
31,6881,8,32753,32769,0,37,16
31,6881,8,32769,32784,0,37,15
31,6881,8,32784,32787,0,37,3
31,6881,28,32787,32806,0,37,19
31,6881,8,32806,32807,0,37,1
31,6881,8,32807,32821,0,37,14
31,6881,8,32821,32824,0,37,3
31,6881,7,32824,32837,0,37,13
31,6881,7,32837,32850,0,37,13
31,6881,7,32850,32860,0,37,10
31,6881,7,32860,32876,0,37,16
31,6881,7,32876,32893,0,37,17
31,6881,24,32893,32895,0,37,2
31,6881,24,32895,32902,0,37,7
31,6881,24,32902,32904,0,37,2
31,6881,24,32904,32924,0,37,20
31,6881,24,32924,32940,0,37,16
31,6881,24,32940,32948,0,37,8
31,6881,7,32948,32956,0,37,8
31,6881,7,32956,32960,0,37,4
31,6881,7,32960,32979,0,37,19
31,6881,8,32979,32999,0,37,20
31,6881,8,32999,33013,0,37,14
31,6881,7,33013,33026,0,37,13
31,6881,8,33026,33036,0,37,10
31,6881,8,33036,33050,0,37,14
31,6881,8,33050,33051,0,37,1
31,6881,28,33051,33060,0,37,9
31,6881,28,33060,33077,0,37,17
31,6891,217,33077,33095,0,3,18
31,6891,217,33095,33109,0,3,14
31,6901,24,33109,33111,0,16,2
31,6901,24,33111,33113,0,16,2
31,6901,7,33113,33132,0,16,19
31,6901,7,33132,33146,0,16,14
31,6901,7,33146,33164,0,16,18
31,6901,7,33164,33184,0,16,20
31,6901,7,33184,33204,0,16,20
31,6901,7,33204,33218,0,16,14
31,6901,7,33218,33230,0,16,12
31,6901,8,33230,33235,0,16,5
31,6901,8,33235,33239,0,16,4
31,6901,8,33239,33251,0,16,12
31,6901,8,33251,33268,0,16,17
31,6901,8,33268,33282,0,16,14
31,6901,8,33282,33296,0,16,14
31,6911,8,33296,33311,0,14,15
31,6911,8,33311,33312,0,14,1
31,6911,8,33312,33314,0,14,2
31,6911,8,33314,33330,0,14,16
31,6911,8,33330,33340,0,14,10
31,6911,8,33340,33353,0,14,13
31,6911,7,33353,33365,0,14,12
31,6911,7,33365,33378,0,14,13
31,6911,7,33378,33396,0,14,18
31,6911,24,33396,33416,0,14,20
31,6911,24,33416,33432,0,14,16
31,6911,24,33432,33448,0,14,16
31,6911,24,33448,33463,0,14,15
31,6921,149,33463,33466,0,67,3
31,6921,149,33466,33469,0,67,3
31,6921,149,33469,33473,0,67,4
31,6921,148,33473,33486,0,67,13
31,6921,148,33486,33505,0,67,19
31,6921,169,33505,33512,0,67,7
31,6921,147,33512,33523,0,67,11
31,6921,147,33523,33543,0,67,20
31,6921,147,33543,33561,0,67,18
31,6921,147,33561,33580,0,67,19
31,6921,170,33580,33595,0,67,15
31,6921,150,33595,33610,0,67,15
31,6921,150,33610,33629,0,67,19
31,6921,150,33629,33649,0,67,20
31,6921,151,33649,33652,0,67,3
31,6921,151,33652,33671,0,67,19
31,6921,151,33671,33685,0,67,14
31,6921,153,33685,33702,0,67,17
31,6921,152,33702,33704,0,67,2
31,6921,153,33704,33720,0,67,16
31,6921,154,33720,33732,0,67,12
31,6921,154,33732,33739,0,67,7
31,6921,155,33739,33752,0,67,13
31,6921,155,33752,33771,0,67,19
31,6921,155,33771,33785,0,67,14
31,6921,157,33785,33793,0,67,8
31,6921,158,33793,33798,0,67,5
31,6921,182,33798,33799,0,67,1
31,6921,159,33799,33814,0,67,15
31,6921,160,33814,33816,0,67,2
31,6921,161,33816,33833,0,67,17
31,6921,162,33833,33844,0,67,11
31,6921,163,33844,33855,0,67,11
31,6921,126,33855,33872,0,67,17
31,6921,125,33872,33890,0,67,18
31,6921,125,33890,33903,0,67,13
31,6921,124,33903,33918,0,67,15
31,6921,124,33918,33927,0,67,9
31,6921,124,33927,33946,0,67,19
31,6921,124,33946,33966,0,67,20
31,6921,123,33966,33971,0,67,5
31,6921,122,33971,33989,0,67,18
31,6921,121,33989,33991,0,67,2
31,6921,86,33991,34001,0,67,10
31,6921,3,34001,34002,0,67,1
31,6921,3,34002,34019,0,67,17
31,6921,37,34019,34024,0,67,5
31,6921,37,34024,34037,0,67,13
31,6921,37,34037,34047,0,67,10
31,6921,37,34047,34059,0,67,12
31,6921,26,34059,34062,0,67,3
31,6921,27,34062,34073,0,67,11
31,6921,27,34073,34093,0,67,20
31,6921,5,34093,34095,0,67,2
31,6921,5,34095,34110,0,67,15
31,6921,6,34110,34111,0,67,1
31,6921,6,34111,34125,0,67,14
31,6921,23,34125,34128,0,67,3
31,6921,23,34128,34140,0,67,12
31,6921,23,34140,34160,0,67,20
31,6921,23,34160,34161,0,67,1
31,6921,23,34161,34168,0,67,7
31,6921,24,34168,34171,0,67,3
31,6921,24,34171,34180,0,67,9
31,6921,24,34180,34193,0,67,13
31,6921,24,34193,34212,0,67,19
31,6931,217,34212,34232,0,15,20
31,6931,217,34232,34242,0,15,10
31,6931,217,34242,34258,0,15,16
31,6931,217,34258,34274,0,15,16
31,6931,217,34274,34285,0,15,11
31,6931,217,34285,34287,0,15,2
31,6931,217,34287,34299,0,15,12
31,6931,217,34299,34303,0,15,4
31,6931,216,34303,34315,0,15,12
31,6931,216,34315,34320,0,15,5
31,6931,216,34320,34326,0,15,6
31,6931,218,34326,34345,0,15,19
31,6931,219,34345,34364,0,15,19
31,6931,216,34364,34381,0,15,17
31,6941,7,34381,34387,0,28,6
31,6941,24,34387,34395,0,28,8
31,6941,24,34395,34411,0,28,16
31,6941,24,34411,34431,0,28,20
31,6941,24,34431,34432,0,28,1
31,6941,7,34432,34440,0,28,8
31,6941,7,34440,34456,0,28,16
31,6941,7,34456,34466,0,28,10
31,6941,8,34466,34486,0,28,20
31,6941,8,34486,34505,0,28,19
31,6941,8,34505,34521,0,28,16
31,6941,8,34521,34533,0,28,12
31,6941,8,34533,34542,0,28,9
31,6941,8,34542,34560,0,28,18
31,6941,28,34560,34577,0,28,17
31,6941,8,34577,34584,0,28,7
31,6941,8,34584,34587,0,28,3
31,6941,8,34587,34600,0,28,13
31,6941,8,34600,34615,0,28,15
31,6941,8,34615,34620,0,28,5
31,6941,8,34620,34623,0,28,3
31,6941,8,34623,34643,0,28,20
31,6941,7,34643,34659,0,28,16
31,6941,24,34659,34679,0,28,20
31,6941,24,34679,34689,0,28,10
31,6941,24,34689,34695,0,28,6
31,6941,24,34695,34703,0,28,8
31,6951,217,34703,34704,0,66,1
31,6951,217,34704,34718,0,66,14
31,6951,217,34718,34733,0,66,15
31,6951,217,34733,34740,0,66,7
31,6951,216,34740,34745,0,66,5
31,6951,216,34745,34748,0,66,3
31,6951,216,34748,34757,0,66,9
31,6951,215,34757,34758,0,66,1
31,6951,215,34758,34772,0,66,14
31,6951,214,34772,34774,0,66,2
31,6951,214,34774,34778,0,66,4
31,6951,219,34778,34793,0,66,15
31,6951,213,34793,34810,0,66,17
31,6951,220,34810,34817,0,66,7
31,6951,220,34817,34819,0,66,2
31,6951,211,34819,34823,0,66,4
31,6951,210,34823,34825,0,66,2
31,6951,221,34825,34830,0,66,5
31,6951,208,34830,34841,0,66,11
31,6951,207,34841,34857,0,66,16
31,6951,223,34857,34859,0,66,2
31,6951,205,34859,34872,0,66,13
31,6951,238,34872,34888,0,66,16
31,6951,204,34888,34890,0,66,2
31,6951,204,34890,34901,0,66,11
31,6951,203,34901,34907,0,66,6
31,6951,202,34907,34909,0,66,2
31,6951,202,34909,34916,0,66,7
31,6951,201,34916,34932,0,66,16
31,6951,201,34932,34933,0,66,1
31,6951,201,34933,34953,0,66,20
31,6951,201,34953,34969,0,66,16
31,6951,200,34969,34981,0,66,12
31,6951,198,34981,34982,0,66,1
31,6951,236,34982,34995,0,66,13
31,6951,197,34995,34998,0,66,3
31,6951,195,34998,35010,0,66,12
31,6951,235,35010,35017,0,66,7
31,6951,194,35017,35019,0,66,2
31,6951,225,35019,35024,0,66,5
31,6951,192,35024,35039,0,66,15
31,6951,191,35039,35044,0,66,5
31,6951,189,35044,35049,0,66,5
31,6951,188,35049,35062,0,66,13
31,6951,188,35062,35070,0,66,8
31,6951,188,35070,35079,0,66,9
31,6951,188,35079,35092,0,66,13
31,6951,29,35092,35109,0,66,17
31,6951,29,35109,35111,0,66,2
31,6951,23,35111,35131,0,66,20
31,6951,23,35131,35146,0,66,15
31,6951,23,35146,35157,0,66,11
31,6951,23,35157,35162,0,66,5
31,6951,23,35162,35176,0,66,14
31,6951,23,35176,35180,0,66,4
31,6951,23,35180,35198,0,66,18
31,6951,23,35198,35207,0,66,9
31,6951,23,35207,35218,0,66,11
31,6951,24,35218,35238,0,66,20
31,6951,24,35238,35249,0,66,11
31,6951,24,35249,35264,0,66,15
31,6951,24,35264,35266,0,66,2
31,6951,24,35266,35271,0,66,5
31,6951,24,35271,35291,0,66,20
31,6951,24,35291,35307,0,66,16
31,6961,24,35307,35310,0,24,3
31,6961,24,35310,35322,0,24,12
31,6961,7,35322,35335,0,24,13
31,6961,7,35335,35341,0,24,6
31,6961,7,35341,35345,0,24,4
31,6961,8,35345,35351,0,24,6
31,6961,8,35351,35366,0,24,15
31,6961,8,35366,35384,0,24,18
31,6961,8,35384,35394,0,24,10
31,6961,8,35394,35404,0,24,10
31,6961,8,35404,35406,0,24,2
31,6961,8,35406,35423,0,24,17
31,6961,8,35423,35432,0,24,9
31,6961,8,35432,35437,0,24,5
31,6961,7,35437,35439,0,24,2
31,6961,7,35439,35454,0,24,15
31,6961,7,35454,35458,0,24,4
31,6961,7,35458,35465,0,24,7
31,6961,7,35465,35472,0,24,7
31,6961,7,35472,35480,0,24,8
31,6961,24,35480,35491,0,24,11
31,6961,24,35491,35500,0,24,9
31,6961,24,35500,35510,0,24,10
31,6971,8,35510,35521,0,86,11
31,6971,8,35521,35522,0,86,1
31,6971,8,35522,35528,0,86,6
31,6971,8,35528,35531,0,86,3
31,6971,7,35531,35546,0,86,15
31,6971,24,35546,35548,0,86,2
31,6971,24,35548,35565,0,86,17
31,6971,24,35565,35567,0,86,2
31,6971,23,35567,35584,0,86,17
31,6971,23,35584,35585,0,86,1
31,6971,23,35585,35600,0,86,15
31,6971,23,35600,35601,0,86,1
31,6971,23,35601,35604,0,86,3
31,6971,23,35604,35615,0,86,11
31,6971,23,35615,35633,0,86,18
31,6971,23,35633,35638,0,86,5
31,6971,29,35638,35642,0,86,4
31,6971,30,35642,35650,0,86,8
31,6971,101,35650,35654,0,86,4
31,6971,102,35654,35663,0,86,9
31,6971,102,35663,35675,0,86,12
31,6971,241,35675,35693,0,86,18
31,6971,104,35693,35711,0,86,18
31,6971,104,35711,35718,0,86,7
31,6971,104,35718,35729,0,86,11
31,6971,104,35729,35748,0,86,19
31,6971,104,35748,35767,0,86,19
31,6971,88,35767,35780,0,86,13
31,6971,88,35780,35783,0,86,3
31,6971,88,35783,35784,0,86,1
31,6971,239,35784,35792,0,86,8
31,6971,239,35792,35805,0,86,13
31,6971,88,35805,35824,0,86,19
31,6971,88,35824,35844,0,86,20
31,6971,88,35844,35846,0,86,2
31,6971,88,35846,35865,0,86,19
31,6971,88,35865,35873,0,86,8
31,6971,88,35873,35885,0,86,12
31,6971,240,35885,35896,0,86,11
31,6971,240,35896,35907,0,86,11
31,6971,240,35907,35923,0,86,16
31,6971,240,35923,35928,0,86,5
31,6971,240,35928,35948,0,86,20
31,6971,240,35948,35962,0,86,14
31,6971,240,35962,35979,0,86,17
31,6971,240,35979,35989,0,86,10
31,6971,240,35989,35994,0,86,5
31,6971,240,35994,35995,0,86,1
31,6971,240,35995,36006,0,86,11
31,6971,240,36006,36011,0,86,5
31,6971,240,36011,36012,0,86,1
31,6971,240,36012,36024,0,86,12
31,6971,240,36024,36039,0,86,15
31,6971,240,36039,36041,0,86,2
31,6971,240,36041,36058,0,86,17
31,6971,240,36058,36061,0,86,3
31,6971,240,36061,36079,0,86,18
31,6971,240,36079,36095,0,86,16
31,6971,240,36095,36115,0,86,20
31,6971,240,36115,36125,0,86,10
31,6971,240,36125,36134,0,86,9
31,6971,240,36134,36147,0,86,13
31,6971,240,36147,36161,0,86,14
31,6971,240,36161,36173,0,86,12
31,6971,240,36173,36177,0,86,4
31,6971,240,36177,36195,0,86,18
31,6971,240,36195,36207,0,86,12
31,6971,240,36207,36210,0,86,3
31,6971,240,36210,36220,0,86,10
31,6971,240,36220,36228,0,86,8
31,6971,240,36228,36248,0,86,20
31,6971,240,36248,36266,0,86,18
31,6971,240,36266,36275,0,86,9
31,6971,240,36275,36283,0,86,8
31,6971,240,36283,36303,0,86,20
31,6971,240,36303,36310,0,86,7
31,6971,240,36310,36330,0,86,20
31,6971,240,36330,36347,0,86,17
31,6971,240,36347,36362,0,86,15
31,6971,240,36362,36381,0,86,19
31,6971,240,36381,36394,0,86,13
31,6971,240,36394,36410,0,86,16
31,6971,240,36410,36423,0,86,13
31,6971,240,36423,36442,0,86,19
31,6971,240,36442,36456,0,86,14
31,6981,149,36456,36472,0,58,16
31,6981,149,36472,36473,0,58,1
31,6981,149,36473,36475,0,58,2
31,6981,148,36475,36483,0,58,8
31,6981,148,36483,36503,0,58,20
31,6981,169,36503,36521,0,58,18
31,6981,147,36521,36529,0,58,8
31,6981,169,36529,36537,0,58,8
31,6981,181,36537,36548,0,58,11
31,6981,180,36548,36551,0,58,3
31,6981,143,36551,36562,0,58,11
31,6981,178,36562,36578,0,58,16
31,6981,141,36578,36590,0,58,12
31,6981,177,36590,36594,0,58,4
31,6981,140,36594,36612,0,58,18
31,6981,139,36612,36628,0,58,16
31,6981,184,36628,36647,0,58,19
31,6981,697,36647,36659,0,58,12
31,6981,186,36659,36671,0,58,12
31,6981,187,36671,36679,0,58,8
31,6981,171,36679,36689,0,58,10
31,6981,159,36689,36708,0,58,19
31,6981,160,36708,36717,0,58,9
31,6981,161,36717,36730,0,58,13
31,6981,162,36730,36733,0,58,3
31,6981,163,36733,36742,0,58,9
31,6981,126,36742,36750,0,58,8
31,6981,125,36750,36764,0,58,14
31,6981,125,36764,36770,0,58,6
31,6981,125,36770,36784,0,58,14
31,6981,124,36784,36792,0,58,8
31,6981,124,36792,36796,0,58,4
31,6981,123,36796,36808,0,58,12
31,6981,122,36808,36816,0,58,8
31,6981,121,36816,36817,0,58,1
31,6981,86,36817,36834,0,58,17
31,6981,3,36834,36837,0,58,3
31,6981,3,36837,36849,0,58,12
31,6981,37,36849,36864,0,58,15
31,6981,37,36864,36868,0,58,4
31,6981,26,36868,36871,0,58,3
31,6981,27,36871,36889,0,58,18
31,6981,27,36889,36909,0,58,20
31,6981,5,36909,36910,0,58,1
31,6981,5,36910,36928,0,58,18
31,6981,6,36928,36932,0,58,4
31,6981,6,36932,36941,0,58,9
31,6981,23,36941,36958,0,58,17
31,6981,23,36958,36959,0,58,1
31,6981,23,36959,36973,0,58,14
31,6981,23,36973,36977,0,58,4
31,6981,23,36977,36979,0,58,2
31,6981,24,36979,36987,0,58,8
31,6981,24,36987,36990,0,58,3
31,6981,24,36990,36992,0,58,2
31,6981,24,36992,37008,0,58,16
31,6981,24,37008,37020,0,58,12
31,6991,7,37020,37037,0,11,17
31,6991,7,37037,37047,0,11,10
31,6991,7,37047,37054,0,11,7
31,6991,7,37054,37074,0,11,20
31,6991,7,37074,37093,0,11,19
31,6991,7,37093,37095,0,11,2
31,6991,27,37095,37096,0,11,1
31,6991,27,37096,37108,0,11,12
31,6991,27,37108,37109,0,11,1
31,6991,27,37109,37110,0,11,1
31,7001,97,37110,37123,0,6,13
31,7001,98,37123,37131,0,6,8
31,7001,357,37131,37151,0,6,20
31,7001,357,37151,37169,0,6,18
31,7001,357,37169,37183,0,6,14
31,7011,8,37183,37188,0,16,5
31,7011,28,37188,37199,0,16,11
31,7011,8,37199,37207,0,16,8
31,7011,8,37207,37217,0,16,10
31,7011,8,37217,37221,0,16,4
31,7011,7,37221,37228,0,16,7
31,7011,7,37228,37247,0,16,19
31,7011,7,37247,37262,0,16,15
31,7011,7,37262,37270,0,16,8
31,7011,7,37270,37284,0,16,14
31,7011,24,37284,37293,0,16,9
31,7011,24,37293,37295,0,16,2
31,7011,24,37295,37310,0,16,15
31,7011,24,37310,37317,0,16,7
31,7011,24,37317,37334,0,16,17
31,7021,24,37334,37351,0,27,17
31,7021,24,37351,37357,0,27,6
31,7021,24,37357,37377,0,27,20
31,7021,24,37377,37382,0,27,5
31,7021,7,37382,37387,0,27,5
31,7021,7,37387,37390,0,27,3
31,7021,8,37390,37398,0,27,8
31,7021,8,37398,37416,0,27,18
31,7021,8,37416,37429,0,27,13
31,7021,8,37429,37434,0,27,5
31,7021,8,37434,37448,0,27,14
31,7021,8,37448,37464,0,27,16
31,7021,8,37464,37471,0,27,7
31,7021,8,37471,37487,0,27,16
31,7021,8,37487,37494,0,27,7
31,7021,8,37494,37495,0,27,1
31,7021,8,37495,37501,0,27,6
31,7021,8,37501,37516,0,27,15
31,7021,8,37516,37534,0,27,18
31,7021,7,37534,37547,0,27,13
31,7021,24,37547,37566,0,27,19
31,7021,24,37566,37585,0,27,19
31,7021,24,37585,37586,0,27,1
31,7021,24,37586,37601,0,27,15
31,7021,24,37601,37603,0,27,2
31,7021,24,37603,37606,0,27,3
31,7031,24,37606,37611,0,35,5
31,7031,24,37611,37619,0,35,8
31,7031,24,37619,37624,0,35,5
31,7031,24,37624,37643,0,35,19
31,7031,24,37643,37653,0,35,10
31,7031,24,37653,37666,0,35,13
31,7031,24,37666,37676,0,35,10
31,7031,24,37676,37686,0,35,10
31,7031,24,37686,37696,0,35,10
31,7031,24,37696,37706,0,35,10
31,7031,24,37706,37717,0,35,11
31,7031,24,37717,37721,0,35,4
31,7031,24,37721,37726,0,35,5
31,7031,24,37726,37735,0,35,9
31,7031,24,37735,37742,0,35,7
31,7031,24,37742,37747,0,35,5
31,7031,24,37747,37756,0,35,9
31,7031,24,37756,37772,0,35,16
31,7031,24,37772,37792,0,35,20
31,7031,24,37792,37798,0,35,6
31,7031,5,37798,37818,0,35,20
31,7031,24,37818,37823,0,35,5
31,7031,24,37823,37827,0,35,4
31,7031,24,37827,37834,0,35,7
31,7031,24,37834,37839,0,35,5
31,7031,24,37839,37859,0,35,20
31,7031,24,37859,37879,0,35,20
31,7031,24,37879,37896,0,35,17
31,7031,24,37896,37897,0,35,1
31,7031,24,37897,37903,0,35,6
31,7031,24,37903,37917,0,35,14
31,7031,24,37917,37930,0,35,13
31,7031,24,37930,37934,0,35,4
31,7031,24,37934,37952,0,35,18
31,7041,24,37952,37963,0,16,11
31,7041,24,37963,37972,0,16,9
31,7041,24,37972,37992,0,16,20
31,7041,24,37992,37998,0,16,6
31,7041,7,37998,38003,0,16,5
31,7041,8,38003,38009,0,16,6
31,7041,8,38009,38025,0,16,16
31,7041,7,38025,38045,0,16,20
31,7041,8,38045,38065,0,16,20
31,7041,8,38065,38070,0,16,5
31,7041,8,38070,38076,0,16,6
31,7041,28,38076,38091,0,16,15
31,7041,8,38091,38108,0,16,17
31,7041,28,38108,38112,0,16,4
31,7041,8,38112,38114,0,16,2
31,7051,24,38114,38119,0,25,5
31,7051,24,38119,38132,0,25,13
31,7051,24,38132,38134,0,25,2
31,7051,7,38134,38136,0,25,2
31,7051,7,38136,38147,0,25,11
31,7051,8,38147,38158,0,25,11
31,7051,8,38158,38163,0,25,5
31,7051,8,38163,38179,0,25,16
31,7051,8,38179,38196,0,25,17
31,7051,8,38196,38215,0,25,19
31,7051,8,38215,38223,0,25,8
31,7051,8,38223,38231,0,25,8
31,7051,8,38231,38235,0,25,4
31,7051,8,38235,38248,0,25,13
31,7051,8,38248,38260,0,25,12
31,7051,8,38260,38278,0,25,18
31,7051,7,38278,38283,0,25,5
31,7051,7,38283,38297,0,25,14
31,7051,7,38297,38317,0,25,20
31,7051,24,38317,38334,0,25,17
31,7051,24,38334,38336,0,25,2
31,7051,24,38336,38350,0,25,14
31,7051,24,38350,38362,0,25,12
31,7051,24,38362,38363,0,25,1
31,7061,24,38363,38373,0,13,10
31,7061,7,38373,38383,0,13,10
31,7061,7,38383,38386,0,13,3
31,7061,7,38386,38391,0,13,5
31,7061,7,38391,38395,0,13,4
31,7061,7,38395,38413,0,13,18
31,7061,8,38413,38427,0,13,14
31,7061,8,38427,38429,0,13,2
31,7061,8,38429,38441,0,13,12
31,7061,8,38441,38453,0,13,12
31,7061,8,38453,38462,0,13,9
31,7061,8,38462,38477,0,13,15
31,7071,24,38477,38493,0,47,16
31,7071,24,38493,38510,0,47,17
31,7071,24,38510,38517,0,47,7
31,7071,24,38517,38525,0,47,8
31,7071,7,38525,38528,0,47,3
31,7071,7,38528,38536,0,47,8
31,7071,7,38536,38542,0,47,6
31,7071,7,38542,38562,0,47,20
31,7071,7,38562,38572,0,47,10
31,7071,7,38572,38576,0,47,4
31,7071,8,38576,38589,0,47,13
31,7071,8,38589,38609,0,47,20
31,7071,8,38609,38629,0,47,20
31,7071,8,38629,38635,0,47,6
31,7071,8,38635,38639,0,47,4
31,7071,8,38639,38647,0,47,8
31,7071,8,38647,38657,0,47,10
31,7071,8,38657,38659,0,47,2
31,7071,8,38659,38668,0,47,9
31,7071,8,38668,38687,0,47,19
31,7071,8,38687,38690,0,47,3
31,7071,8,38690,38694,0,47,4
31,7071,8,38694,38701,0,47,7
31,7071,8,38701,38709,0,47,8
31,7071,8,38709,38728,0,47,19
31,7071,8,38728,38745,0,47,17
31,7071,7,38745,38748,0,47,3
31,7071,7,38748,38762,0,47,14
31,7071,7,38762,38767,0,47,5
31,7071,7,38767,38771,0,47,4
31,7071,7,38771,38780,0,47,9
31,7071,7,38780,38782,0,47,2
31,7071,7,38782,38790,0,47,8
31,7071,7,38790,38808,0,47,18
31,7071,7,38808,38814,0,47,6
31,7071,7,38814,38824,0,47,10
31,7071,7,38824,38837,0,47,13
31,7071,7,38837,38848,0,47,11
31,7071,7,38848,38857,0,47,9
31,7071,24,38857,38861,0,47,4
31,7071,24,38861,38864,0,47,3
31,7071,24,38864,38872,0,47,8
31,7071,24,38872,38889,0,47,17
31,7071,24,38889,38901,0,47,12
31,7071,24,38901,38914,0,47,13
31,7071,24,38914,38919,0,47,5
31,7081,217,38919,38938,0,33,19
31,7081,217,38938,38940,0,33,2
31,7081,217,38940,38955,0,33,15
31,7081,217,38955,38966,0,33,11
31,7081,217,38966,38980,0,33,14
31,7081,217,38980,38991,0,33,11
31,7081,217,38991,39007,0,33,16
31,7081,217,39007,39015,0,33,8
31,7081,217,39015,39025,0,33,10
31,7081,217,39025,39038,0,33,13
31,7081,217,39038,39039,0,33,1
31,7081,217,39039,39047,0,33,8
31,7081,217,39047,39052,0,33,5
31,7081,217,39052,39056,0,33,4
31,7081,217,39056,39076,0,33,20
31,7081,217,39076,39096,0,33,20
31,7081,217,39096,39100,0,33,4
31,7081,217,39100,39114,0,33,14
31,7081,216,39114,39132,0,33,18
31,7081,216,39132,39150,0,33,18
31,7081,216,39150,39169,0,33,19
31,7081,216,39169,39180,0,33,11
31,7081,216,39180,39188,0,33,8
31,7081,218,39188,39195,0,33,7
31,7081,218,39195,39215,0,33,20
31,7081,218,39215,39230,0,33,15
31,7081,218,39230,39241,0,33,11
31,7081,218,39241,39244,0,33,3
31,7081,218,39244,39246,0,33,2
31,7081,218,39246,39259,0,33,13
31,7081,218,39259,39264,0,33,5
31,7081,219,39264,39283,0,33,19
31,7091,28,39283,39286,0,58,3
31,7091,28,39286,39300,0,58,14
31,7091,8,39300,39313,0,58,13
31,7091,8,39313,39326,0,58,13
31,7091,8,39326,39344,0,58,18
31,7091,7,39344,39362,0,58,18
31,7091,7,39362,39376,0,58,14
31,7091,7,39376,39384,0,58,8
31,7091,7,39384,39388,0,58,4
31,7091,7,39388,39400,0,58,12
31,7091,7,39400,39409,0,58,9
31,7091,7,39409,39417,0,58,8
31,7091,7,39417,39429,0,58,12
31,7091,7,39429,39435,0,58,6
31,7091,7,39435,39449,0,58,14
31,7091,7,39449,39457,0,58,8
31,7091,7,39457,39466,0,58,9
31,7091,7,39466,39481,0,58,15
31,7091,7,39481,39483,0,58,2
31,7091,7,39483,39501,0,58,18
31,7091,7,39501,39510,0,58,9
31,7091,7,39510,39520,0,58,10
31,7091,7,39520,39533,0,58,13
31,7091,7,39533,39542,0,58,9
31,7091,7,39542,39554,0,58,12
31,7091,7,39554,39571,0,58,17
31,7091,7,39571,39587,0,58,16
31,7091,7,39587,39603,0,58,16
31,7091,7,39603,39604,0,58,1
31,7091,7,39604,39607,0,58,3
31,7091,7,39607,39625,0,58,18
31,7091,7,39625,39634,0,58,9
31,7091,7,39634,39640,0,58,6
31,7091,24,39640,39645,0,58,5
31,7091,24,39645,39657,0,58,12
31,7091,24,39657,39674,0,58,17
31,7091,24,39674,39688,0,58,14
31,7091,24,39688,39692,0,58,4
31,7091,24,39692,39703,0,58,11
31,7091,24,39703,39706,0,58,3
31,7091,24,39706,39720,0,58,14
31,7091,24,39720,39735,0,58,15
31,7091,24,39735,39746,0,58,11
31,7091,24,39746,39760,0,58,14
31,7091,24,39760,39767,0,58,7
31,7091,24,39767,39769,0,58,2
31,7091,24,39769,39788,0,58,19
31,7091,24,39788,39805,0,58,17
31,7091,24,39805,39817,0,58,12
31,7091,24,39817,39837,0,58,20
31,7091,7,39837,39853,0,58,16
31,7091,7,39853,39868,0,58,15
31,7091,7,39868,39870,0,58,2
31,7091,8,39870,39872,0,58,2
31,7091,8,39872,39878,0,58,6
31,7091,8,39878,39890,0,58,12
31,7091,8,39890,39905,0,58,15
31,7101,8,39905,39915,0,33,10
31,7101,28,39915,39916,0,33,1
31,7101,8,39916,39935,0,33,19
31,7101,8,39935,39938,0,33,3
31,7101,8,39938,39947,0,33,9
31,7101,8,39947,39965,0,33,18
31,7101,8,39965,39976,0,33,11
31,7101,8,39976,39981,0,33,5
31,7101,8,39981,39983,0,33,2
31,7101,8,39983,40000,0,33,17
31,7101,28,40000,40001,0,33,1
31,7101,8,40001,40017,0,33,16
31,7101,8,40017,40028,0,33,11
31,7101,8,40028,40045,0,33,17
31,7101,8,40045,40050,0,33,5
31,7101,8,40050,40068,0,33,18
31,7101,8,40068,40075,0,33,7
31,7101,8,40075,40081,0,33,6
31,7101,8,40081,40083,0,33,2
31,7101,28,40083,40101,0,33,18
31,7101,28,40101,40115,0,33,14
31,7101,8,40115,40121,0,33,6
31,7101,8,40121,40135,0,33,14
31,7101,8,40135,40148,0,33,13
31,7101,7,40148,40152,0,33,4
31,7101,7,40152,40169,0,33,17
31,7101,7,40169,40185,0,33,16
31,7101,7,40185,40203,0,33,18
31,7101,7,40203,40221,0,33,18
31,7101,24,40221,40224,0,33,3
31,7101,24,40224,40229,0,33,5
31,7101,24,40229,40232,0,33,3
31,7111,8,40232,40240,0,57,8
31,7111,8,40240,40254,0,57,14
31,7111,8,40254,40266,0,57,12
31,7111,8,40266,40275,0,57,9
31,7111,8,40275,40292,0,57,17
31,7111,8,40292,40302,0,57,10
31,7111,8,40302,40306,0,57,4
31,7111,8,40306,40312,0,57,6
31,7111,8,40312,40324,0,57,12
31,7111,8,40324,40333,0,57,9
31,7111,7,40333,40353,0,57,20
31,7111,7,40353,40367,0,57,14
31,7111,7,40367,40383,0,57,16
31,7111,7,40383,40397,0,57,14
31,7111,7,40397,40416,0,57,19
31,7111,7,40416,40427,0,57,11
31,7111,7,40427,40428,0,57,1
31,7111,7,40428,40432,0,57,4
31,7111,7,40432,40435,0,57,3
31,7111,7,40435,40454,0,57,19
31,7111,24,40454,40465,0,57,11
31,7111,24,40465,40472,0,57,7
31,7111,24,40472,40481,0,57,9
31,7111,24,40481,40491,0,57,10
31,7111,24,40491,40501,0,57,10
31,7111,24,40501,40517,0,57,16
31,7111,24,40517,40536,0,57,19
31,7111,24,40536,40554,0,57,18
31,7111,24,40554,40571,0,57,17
31,7111,24,40571,40582,0,57,11
31,7111,23,40582,40592,0,57,10
31,7111,23,40592,40593,0,57,1
31,7111,23,40593,40601,0,57,8
31,7111,23,40601,40609,0,57,8
31,7111,23,40609,40627,0,57,18
31,7111,23,40627,40645,0,57,18
31,7111,23,40645,40658,0,57,13
31,7111,23,40658,40661,0,57,3
31,7111,29,40661,40666,0,57,5
31,7111,29,40666,40677,0,57,11
31,7111,30,40677,40694,0,57,17
31,7111,87,40694,40702,0,57,8
31,7111,87,40702,40713,0,57,11
31,7111,87,40713,40722,0,57,9
31,7111,87,40722,40742,0,57,20
31,7111,87,40742,40744,0,57,2
31,7111,32,40744,40754,0,57,10
31,7111,33,40754,40771,0,57,17
31,7111,33,40771,40773,0,57,2
31,7111,34,40773,40778,0,57,5
31,7111,34,40778,40786,0,57,8
31,7111,100,40786,40791,0,57,5
31,7111,100,40791,40795,0,57,4
31,7111,100,40795,40813,0,57,18
31,7111,100,40813,40814,0,57,1
31,7111,100,40814,40833,0,57,19
31,7121,46,40833,40837,0,61,4
31,7121,46,40837,40846,0,61,9
31,7121,47,40846,40850,0,61,4
31,7121,47,40850,40853,0,61,3
31,7121,47,40853,40864,0,61,11
31,7121,47,40864,40872,0,61,8
31,7121,46,40872,40880,0,61,8
31,7121,47,40880,40900,0,61,20
31,7121,47,40900,40904,0,61,4
31,7121,47,40904,40910,0,61,6
31,7121,47,40910,40921,0,61,11
31,7121,46,40921,40938,0,61,17
31,7121,46,40938,40958,0,61,20
31,7121,46,40958,40962,0,61,4
31,7121,46,40962,40968,0,61,6
31,7121,46,40968,40973,0,61,5
31,7121,46,40973,40984,0,61,11
31,7121,46,40984,40986,0,61,2
31,7121,46,40986,41000,0,61,14
31,7121,46,41000,41010,0,61,10
31,7121,46,41010,41023,0,61,13
31,7121,46,41023,41025,0,61,2
31,7121,46,41025,41037,0,61,12
31,7121,46,41037,41040,0,61,3
31,7121,46,41040,41055,0,61,15
31,7121,46,41055,41073,0,61,18
31,7121,46,41073,41091,0,61,18
31,7121,46,41091,41110,0,61,19
31,7121,521,41110,41118,0,61,8
31,7121,521,41118,41132,0,61,14
31,7121,521,41132,41138,0,61,6
31,7121,521,41138,41144,0,61,6
31,7121,521,41144,41160,0,61,16
31,7121,532,41160,41173,0,61,13
31,7121,464,41173,41182,0,61,9
31,7121,464,41182,41196,0,61,14
31,7121,465,41196,41204,0,61,8
31,7121,465,41204,41221,0,61,17
31,7121,465,41221,41225,0,61,4
31,7121,465,41225,41237,0,61,12
31,7121,594,41237,41242,0,61,5
31,7121,594,41242,41249,0,61,7
31,7121,594,41249,41250,0,61,1
31,7121,258,41250,41266,0,61,16
31,7121,258,41266,41276,0,61,10
31,7121,24,41276,41277,0,61,1
31,7121,24,41277,41285,0,61,8
31,7121,24,41285,41299,0,61,14
31,7121,24,41299,41313,0,61,14
31,7121,24,41313,41322,0,61,9
31,7121,24,41322,41333,0,61,11
31,7121,24,41333,41341,0,61,8
31,7121,24,41341,41348,0,61,7
31,7121,24,41348,41366,0,61,18
31,7121,24,41366,41376,0,61,10
31,7121,24,41376,41386,0,61,10
31,7121,24,41386,41399,0,61,13
31,7121,24,41399,41408,0,61,9
31,7121,24,41408,41428,0,61,20
31,7121,24,41428,41443,0,61,15
31,7131,8,41443,41461,0,49,18
31,7131,8,41461,41476,0,49,15
31,7131,8,41476,41491,0,49,15
31,7131,8,41491,41505,0,49,14
31,7131,8,41505,41508,0,49,3
31,7131,7,41508,41523,0,49,15
31,7131,24,41523,41527,0,49,4
31,7131,24,41527,41529,0,49,2
31,7131,7,41529,41543,0,49,14
31,7131,24,41543,41551,0,49,8
31,7131,24,41551,41565,0,49,14
31,7131,24,41565,41579,0,49,14
31,7131,24,41579,41592,0,49,13
31,7131,7,41592,41596,0,49,4
31,7131,8,41596,41616,0,49,20
31,7131,8,41616,41624,0,49,8
31,7131,8,41624,41644,0,49,20
31,7131,8,41644,41654,0,49,10
31,7131,8,41654,41663,0,49,9
31,7131,8,41663,41670,0,49,7
31,7131,8,41670,41683,0,49,13
31,7131,8,41683,41699,0,49,16
31,7131,8,41699,41716,0,49,17
31,7131,8,41716,41734,0,49,18
31,7131,8,41734,41742,0,49,8
31,7131,28,41742,41748,0,49,6
31,7131,8,41748,41760,0,49,12
31,7131,8,41760,41776,0,49,16
31,7131,8,41776,41796,0,49,20
31,7131,8,41796,41804,0,49,8
31,7131,8,41804,41820,0,49,16
31,7131,8,41820,41834,0,49,14
31,7131,28,41834,41853,0,49,19
31,7131,8,41853,41870,0,49,17
31,7131,8,41870,41882,0,49,12
31,7131,8,41882,41894,0,49,12
31,7131,8,41894,41904,0,49,10
31,7131,8,41904,41923,0,49,19
31,7131,7,41923,41942,0,49,19
31,7131,8,41942,41950,0,49,8
31,7131,8,41950,41958,0,49,8
31,7131,8,41958,41966,0,49,8
31,7131,7,41966,41985,0,49,19
31,7131,24,41985,42001,0,49,16
31,7131,24,42001,42020,0,49,19
31,7131,24,42020,42033,0,49,13
31,7131,24,42033,42046,0,49,13
31,7131,24,42046,42062,0,49,16
31,7141,218,42062,42082,0,33,20
31,7141,218,42082,42090,0,33,8
31,7141,218,42090,42106,0,33,16
31,7141,218,42106,42123,0,33,17
31,7141,216,42123,42126,0,33,3
31,7141,216,42126,42131,0,33,5
31,7141,216,42131,42140,0,33,9
31,7141,216,42140,42141,0,33,1
31,7141,216,42141,42144,0,33,3
31,7141,216,42144,42159,0,33,15
31,7141,216,42159,42173,0,33,14
31,7141,216,42173,42179,0,33,6
31,7141,217,42179,42184,0,33,5
31,7141,217,42184,42204,0,33,20
31,7141,217,42204,42208,0,33,4
31,7141,217,42208,42219,0,33,11
31,7141,217,42219,42227,0,33,8
31,7141,217,42227,42233,0,33,6
31,7141,217,42233,42238,0,33,5
31,7141,217,42238,42254,0,33,16
31,7141,217,42254,42263,0,33,9
31,7141,217,42263,42269,0,33,6
31,7141,217,42269,42287,0,33,18
31,7141,217,42287,42305,0,33,18
31,7141,217,42305,42325,0,33,20
31,7141,217,42325,42335,0,33,10
31,7141,217,42335,42347,0,33,12
31,7141,217,42347,42352,0,33,5
31,7141,217,42352,42369,0,33,17
31,7141,217,42369,42382,0,33,13
31,7141,217,42382,42401,0,33,19
31,7141,217,42401,42419,0,33,18
31,7151,24,42419,42426,0,15,7
31,7151,24,42426,42429,0,15,3
31,7151,7,42429,42449,0,15,20
31,7151,7,42449,42450,0,15,1
31,7151,7,42450,42461,0,15,11
31,7151,7,42461,42472,0,15,11
31,7151,7,42472,42474,0,15,2
31,7151,7,42474,42487,0,15,13
31,7151,8,42487,42495,0,15,8
31,7151,8,42495,42514,0,15,19
31,7151,8,42514,42528,0,15,14
31,7151,8,42528,42536,0,15,8
31,7151,28,42536,42553,0,15,17
31,7151,28,42553,42570,0,15,17
31,7161,103,42570,42574,0,21,4
31,7161,103,42574,42590,0,21,16
31,7161,295,42590,42601,0,21,11
31,7161,405,42601,42616,0,21,15
31,7161,296,42616,42634,0,21,18
31,7161,41,42634,42635,0,21,1
31,7161,41,42635,42654,0,21,19
31,7161,40,42654,42659,0,21,5
31,7161,23,42659,42676,0,21,17
31,7161,23,42676,42682,0,21,6
31,7161,23,42682,42700,0,21,18
31,7161,23,42700,42702,0,21,2
31,7161,24,42702,42714,0,21,12
31,7161,24,42714,42716,0,21,2
31,7161,7,42716,42721,0,21,5
31,7161,7,42721,42728,0,21,7
31,7161,7,42728,42734,0,21,6
31,7161,8,42734,42736,0,21,2
31,7161,8,42736,42754,0,21,18
31,7161,8,42754,42769,0,21,15
31,7171,24,42769,42785,0,22,16
31,7171,24,42785,42803,0,22,18
31,7171,7,42803,42817,0,22,14
31,7171,7,42817,42824,0,22,7
31,7171,7,42824,42825,0,22,1
31,7171,7,42825,42837,0,22,12
31,7171,7,42837,42848,0,22,11
31,7171,7,42848,42854,0,22,6
31,7171,8,42854,42871,0,22,17
31,7171,8,42871,42881,0,22,10
31,7171,8,42881,42894,0,22,13
31,7171,8,42894,42902,0,22,8
31,7171,8,42902,42904,0,22,2
31,7171,28,42904,42907,0,22,3
31,7171,28,42907,42922,0,22,15
31,7171,28,42922,42925,0,22,3
31,7171,28,42925,42940,0,22,15
31,7171,8,42940,42951,0,22,11
31,7171,8,42951,42968,0,22,17
31,7171,8,42968,42973,0,22,5
31,7171,8,42973,42979,0,22,6
31,7181,8,42979,42984,0,14,5
31,7181,8,42984,43001,0,14,17
31,7181,8,43001,43021,0,14,20
31,7181,8,43021,43038,0,14,17
31,7181,7,43038,43051,0,14,13
31,7181,7,43051,43062,0,14,11
31,7181,7,43062,43065,0,14,3
31,7181,7,43065,43067,0,14,2
31,7181,7,43067,43083,0,14,16
31,7181,24,43083,43096,0,14,13
31,7181,24,43096,43100,0,14,4
31,7181,24,43100,43102,0,14,2
31,7181,24,43102,43121,0,14,19
31,7191,216,43121,43140,0,63,19
31,7191,216,43140,43154,0,63,14
31,7191,216,43154,43169,0,63,15
31,7191,216,43169,43188,0,63,19
31,7191,216,43188,43198,0,63,10
31,7191,216,43198,43210,0,63,12
31,7191,217,43210,43221,0,63,11
31,7191,217,43221,43222,0,63,1
31,7191,217,43222,43235,0,63,13
31,7191,217,43235,43246,0,63,11
31,7191,217,43246,43254,0,63,8
31,7191,217,43254,43268,0,63,14
31,7191,217,43268,43280,0,63,12
31,7191,217,43280,43289,0,63,9
31,7191,217,43289,43291,0,63,2
31,7191,217,43291,43305,0,63,14
31,7191,217,43305,43308,0,63,3
31,7191,217,43308,43325,0,63,17
31,7191,217,43325,43337,0,63,12
31,7191,217,43337,43354,0,63,17
31,7191,217,43354,43360,0,63,6
31,7191,217,43360,43369,0,63,9
31,7191,217,43369,43377,0,63,8
31,7191,217,43377,43397,0,63,20
31,7191,217,43397,43405,0,63,8
31,7191,217,43405,43422,0,63,17
31,7191,217,43422,43424,0,63,2
31,7191,217,43424,43432,0,63,8
31,7191,217,43432,43445,0,63,13
31,7191,217,43445,43448,0,63,3
31,7191,2356,43448,43456,0,63,8
31,7191,2356,43456,43472,0,63,16
31,7191,2356,43472,43489,0,63,17
31,7191,217,43489,43492,0,63,3
31,7191,217,43492,43512,0,63,20
31,7191,217,43512,43522,0,63,10
31,7191,217,43522,43539,0,63,17
31,7191,217,43539,43549,0,63,10
31,7191,217,43549,43567,0,63,18
31,7191,217,43567,43577,0,63,10
31,7191,217,43577,43587,0,63,10
31,7191,217,43587,43593,0,63,6
31,7191,217,43593,43596,0,63,3
31,7191,217,43596,43600,0,63,4
31,7191,217,43600,43612,0,63,12
31,7191,217,43612,43630,0,63,18
31,7191,217,43630,43637,0,63,7
31,7191,217,43637,43652,0,63,15
31,7191,217,43652,43670,0,63,18
31,7191,217,43670,43678,0,63,8
31,7191,217,43678,43689,0,63,11
31,7191,217,43689,43704,0,63,15
31,7191,217,43704,43717,0,63,13
31,7191,217,43717,43719,0,63,2
31,7191,217,43719,43726,0,63,7
31,7191,217,43726,43737,0,63,11
31,7191,217,43737,43740,0,63,3
31,7191,217,43740,43755,0,63,15
31,7191,217,43755,43771,0,63,16
31,7191,217,43771,43774,0,63,3
31,7191,217,43774,43785,0,63,11
31,7191,217,43785,43796,0,63,11
31,7201,24,43796,43810,0,14,14
31,7201,24,43810,43828,0,14,18
31,7201,24,43828,43842,0,14,14
31,7201,24,43842,43853,0,14,11
31,7201,24,43853,43863,0,14,10
31,7201,24,43863,43879,0,14,16
31,7201,24,43879,43881,0,14,2
31,7201,24,43881,43901,0,14,20
31,7201,24,43901,43908,0,14,7
31,7201,24,43908,43923,0,14,15
31,7201,24,43923,43939,0,14,16
31,7201,24,43939,43955,0,14,16
31,7201,24,43955,43973,0,14,18
31,7211,24,43973,43983,0,10,10
31,7211,24,43983,43990,0,10,7
31,7211,23,43990,44004,0,10,14
31,7211,24,44004,44012,0,10,8
31,7211,24,44012,44025,0,10,13
31,7211,24,44025,44042,0,10,17
31,7211,24,44042,44052,0,10,10
31,7211,24,44052,44058,0,10,6
31,7211,24,44058,44070,0,10,12
31,7221,8,44070,44082,0,24,12
31,7221,8,44082,44095,0,24,13
31,7221,8,44095,44102,0,24,7
31,7221,8,44102,44113,0,24,11
31,7221,8,44113,44114,0,24,1
31,7221,8,44114,44121,0,24,7
31,7221,7,44121,44126,0,24,5
31,7221,7,44126,44135,0,24,9
31,7221,7,44135,44149,0,24,14
31,7221,7,44149,44162,0,24,13
31,7221,24,44162,44175,0,24,13
31,7221,24,44175,44182,0,24,7
31,7221,24,44182,44200,0,24,18
31,7221,24,44200,44214,0,24,14
31,7221,24,44214,44226,0,24,12
31,7221,24,44226,44237,0,24,11
31,7221,24,44237,44238,0,24,1
31,7221,24,44238,44255,0,24,17
31,7221,24,44255,44261,0,24,6
31,7221,24,44261,44262,0,24,1
31,7221,7,44262,44276,0,24,14
31,7221,7,44276,44291,0,24,15
31,7221,7,44291,44298,0,24,7
31,7231,24,44298,44304,0,28,6
31,7231,24,44304,44317,0,28,13
31,7231,24,44317,44321,0,28,4
31,7231,24,44321,44330,0,28,9
31,7231,24,44330,44340,0,28,10
31,7231,24,44340,44348,0,28,8
31,7231,24,44348,44366,0,28,18
31,7231,24,44366,44377,0,28,11
31,7231,24,44377,44388,0,28,11
31,7231,24,44388,44400,0,28,12
31,7231,24,44400,44409,0,28,9
31,7231,24,44409,44421,0,28,12
31,7231,24,44421,44434,0,28,13
31,7231,24,44434,44450,0,28,16
31,7231,24,44450,44459,0,28,9
31,7231,24,44459,44460,0,28,1
31,7231,24,44460,44478,0,28,18
31,7231,24,44478,44490,0,28,12
31,7231,7,44490,44502,0,28,12
31,7231,7,44502,44519,0,28,17
31,7231,24,44519,44522,0,28,3
31,7231,24,44522,44530,0,28,8
31,7231,24,44530,44532,0,28,2
31,7231,24,44532,44537,0,28,5
31,7231,24,44537,44547,0,28,10
31,7231,24,44547,44559,0,28,12
31,7231,24,44559,44562,0,28,3
31,7241,98,44562,44571,0,96,9
31,7241,97,44571,44575,0,96,4
31,7241,97,44575,44576,0,96,1
31,7241,97,44576,44593,0,96,17
31,7241,97,44593,44609,0,96,16
31,7241,97,44609,44616,0,96,7
31,7241,97,44616,44627,0,96,11
31,7241,97,44627,44646,0,96,19
31,7241,97,44646,44666,0,96,20
31,7241,97,44666,44669,0,96,3
31,7241,97,44669,44677,0,96,8
31,7241,97,44677,44686,0,96,9
31,7241,98,44686,44702,0,96,16
31,7241,98,44702,44717,0,96,15
31,7241,98,44717,44736,0,96,19
31,7241,98,44736,44756,0,96,20
31,7241,98,44756,44761,0,96,5
31,7241,98,44761,44774,0,96,13
31,7241,99,44774,44777,0,96,3
31,7241,99,44777,44795,0,96,18
31,7241,100,44795,44801,0,96,6
31,7241,100,44801,44811,0,96,10
31,7241,100,44811,44822,0,96,11
31,7241,34,44822,44823,0,96,1
31,7241,34,44823,44836,0,96,13
31,7241,34,44836,44852,0,96,16
31,7241,34,44852,44870,0,96,18
31,7241,34,44870,44875,0,96,5
31,7241,33,44875,44894,0,96,19
31,7241,33,44894,44901,0,96,7
31,7241,87,44901,44911,0,96,10
31,7241,87,44911,44927,0,96,16
31,7241,32,44927,44929,0,96,2
31,7241,32,44929,44931,0,96,2
31,7241,32,44931,44950,0,96,19
31,7241,32,44950,44954,0,96,4
31,7241,32,44954,44969,0,96,15
31,7241,32,44969,44984,0,96,15
31,7241,2,44984,44999,0,96,15
31,7241,2,44999,45019,0,96,20
31,7241,2,45019,45023,0,96,4
31,7241,2,45023,45035,0,96,12
31,7241,2,45035,45040,0,96,5
31,7241,2,45040,45045,0,96,5
31,7241,2,45045,45065,0,96,20
31,7241,5,45065,45077,0,96,12
31,7241,5,45077,45086,0,96,9
31,7241,27,45086,45100,0,96,14
31,7241,27,45100,45112,0,96,12
31,7241,27,45112,45129,0,96,17
31,7241,27,45129,45149,0,96,20
31,7241,27,45149,45167,0,96,18
31,7241,27,45167,45174,0,96,7
31,7241,27,45174,45180,0,96,6
31,7241,27,45180,45197,0,96,17
31,7241,7,45197,45203,0,96,6
31,7241,7,45203,45214,0,96,11
31,7241,7,45214,45222,0,96,8
31,7241,7,45222,45224,0,96,2
31,7241,7,45224,45231,0,96,7
31,7241,7,45231,45244,0,96,13
31,7241,7,45244,45247,0,96,3
31,7241,7,45247,45249,0,96,2
31,7241,7,45249,45251,0,96,2
31,7241,7,45251,45255,0,96,4
31,7241,7,45255,45274,0,96,19
31,7241,7,45274,45286,0,96,12
31,7241,7,45286,45288,0,96,2
31,7241,7,45288,45308,0,96,20
31,7241,7,45308,45323,0,96,15
31,7241,7,45323,45335,0,96,12
31,7241,7,45335,45340,0,96,5
31,7241,7,45340,45358,0,96,18
31,7241,8,45358,45360,0,96,2
31,7241,8,45360,45361,0,96,1
31,7241,8,45361,45366,0,96,5
31,7241,8,45366,45371,0,96,5
31,7241,28,45371,45378,0,96,7
31,7241,28,45378,45388,0,96,10
31,7241,8,45388,45390,0,96,2
31,7241,8,45390,45400,0,96,10
31,7241,8,45400,45410,0,96,10
31,7241,28,45410,45412,0,96,2
31,7241,8,45412,45414,0,96,2
31,7241,8,45414,45420,0,96,6
31,7241,8,45420,45434,0,96,14
31,7241,7,45434,45443,0,96,9
31,7241,7,45443,45452,0,96,9
31,7241,7,45452,45469,0,96,17
31,7241,8,45469,45472,0,96,3
31,7241,8,45472,45489,0,96,17
31,7241,7,45489,45493,0,96,4
31,7241,7,45493,45494,0,96,1
31,7241,7,45494,45501,0,96,7
31,7241,7,45501,45503,0,96,2
31,7251,24,45503,45518,0,15,15
31,7251,24,45518,45526,0,15,8
31,7251,7,45526,45530,0,15,4
31,7251,7,45530,45534,0,15,4
31,7251,7,45534,45540,0,15,6
31,7251,7,45540,45545,0,15,5
31,7251,7,45545,45556,0,15,11
31,7251,7,45556,45569,0,15,13
31,7251,8,45569,45575,0,15,6
31,7251,8,45575,45584,0,15,9
31,7251,8,45584,45586,0,15,2
31,7251,8,45586,45605,0,15,19
31,7251,8,45605,45614,0,15,9
31,7251,8,45614,45616,0,15,2
31,7261,24,45616,45623,0,13,7
31,7261,24,45623,45625,0,13,2
31,7261,7,45625,45630,0,13,5
31,7261,7,45630,45649,0,13,19
31,7261,7,45649,45651,0,13,2
31,7261,8,45651,45660,0,13,9
31,7261,7,45660,45663,0,13,3
31,7261,7,45663,45681,0,13,18
31,7261,8,45681,45687,0,13,6
31,7261,8,45687,45700,0,13,13
31,7261,8,45700,45712,0,13,12
31,7261,28,45712,45721,0,13,9
31,7271,218,45721,45729,0,69,8
31,7271,218,45729,45739,0,69,10
31,7271,216,45739,45744,0,69,5
31,7271,216,45744,45763,0,69,19
31,7271,216,45763,45768,0,69,5
31,7271,216,45768,45783,0,69,15
31,7271,216,45783,45787,0,69,4
31,7271,218,45787,45788,0,69,1
31,7271,218,45788,45801,0,69,13
31,7271,218,45801,45819,0,69,18
31,7271,218,45819,45825,0,69,6
31,7271,218,45825,45826,0,69,1
31,7271,216,45826,45827,0,69,1
31,7271,216,45827,45846,0,69,19
31,7271,216,45846,45848,0,69,2
31,7271,214,45848,45863,0,69,15
31,7271,214,45863,45865,0,69,2
31,7271,214,45865,45872,0,69,7
31,7271,214,45872,45880,0,69,8
31,7271,214,45880,45891,0,69,11
31,7271,216,45891,45904,0,69,13
31,7271,216,45904,45909,0,69,5
31,7271,216,45909,45917,0,69,8
31,7271,217,45917,45921,0,69,4
31,7271,215,45921,45932,0,69,11
31,7271,214,45932,45936,0,69,4
31,7271,214,45936,45938,0,69,2
31,7271,219,45938,45951,0,69,13
31,7271,213,45951,45960,0,69,9
31,7271,220,45960,45968,0,69,8
31,7271,212,45968,45988,0,69,20
31,7271,211,45988,46002,0,69,14
31,7271,210,46002,46022,0,69,20
31,7271,209,46022,46039,0,69,17
31,7271,208,46039,46058,0,69,19
31,7271,207,46058,46074,0,69,16
31,7271,206,46074,46075,0,69,1
31,7271,205,46075,46092,0,69,17
31,7271,238,46092,46110,0,69,18
31,7271,238,46110,46112,0,69,2
31,7271,238,46112,46118,0,69,6
31,7271,204,46118,46130,0,69,12
31,7271,204,46130,46138,0,69,8
31,7271,204,46138,46152,0,69,14
31,7271,237,46152,46160,0,69,8
31,7271,237,46160,46167,0,69,7
31,7271,237,46167,46174,0,69,7
31,7271,237,46174,46179,0,69,5
31,7271,2370,46179,46187,0,69,8
31,7271,2370,46187,46190,0,69,3
31,7271,2370,46190,46205,0,69,15
31,7271,2370,46205,46214,0,69,9
31,7271,875,46214,46231,0,69,17
31,7271,875,46231,46239,0,69,8
31,7271,496,46239,46242,0,69,3
31,7271,875,46242,46256,0,69,14
31,7271,200,46256,46260,0,69,4
31,7271,199,46260,46270,0,69,10
31,7271,198,46270,46277,0,69,7
31,7271,197,46277,46286,0,69,9
31,7271,196,46286,46301,0,69,15
31,7271,195,46301,46316,0,69,15
31,7271,194,46316,46333,0,69,17
31,7271,193,46333,46350,0,69,17
31,7271,225,46350,46370,0,69,20
31,7271,191,46370,46376,0,69,6
31,7271,190,46376,46386,0,69,10
31,7271,189,46386,46396,0,69,10
31,7281,24,46396,46397,0,18,1
31,7281,7,46397,46409,0,18,12
31,7281,7,46409,46414,0,18,5
31,7281,7,46414,46430,0,18,16
31,7281,7,46430,46449,0,18,19
31,7281,7,46449,46459,0,18,10
31,7281,7,46459,46466,0,18,7
31,7281,7,46466,46486,0,18,20
31,7281,24,46486,46487,0,18,1
31,7281,24,46487,46502,0,18,15
31,7281,24,46502,46522,0,18,20
31,7281,24,46522,46531,0,18,9
31,7281,24,46531,46540,0,18,9
31,7281,24,46540,46544,0,18,4
31,7281,30,46544,46548,0,18,4
31,7281,24,46548,46565,0,18,17
31,7281,24,46565,46570,0,18,5
31,7291,23,46570,46583,0,14,13
31,7291,23,46583,46591,0,14,8
31,7291,23,46591,46609,0,14,18
31,7291,23,46609,46624,0,14,15
31,7291,23,46624,46641,0,14,17
31,7291,23,46641,46654,0,14,13
31,7291,23,46654,46656,0,14,2
31,7291,23,46656,46674,0,14,18
31,7291,23,46674,46681,0,14,7
31,7291,24,46681,46697,0,14,16
31,7291,24,46697,46701,0,14,4
31,7291,24,46701,46716,0,14,15
31,7291,24,46716,46717,0,14,1
31,7301,8,46717,46728,0,19,11
31,7301,8,46728,46747,0,19,19
31,7301,8,46747,46760,0,19,13
31,7301,8,46760,46776,0,19,16
31,7301,8,46776,46777,0,19,1
31,7301,8,46777,46780,0,19,3
31,7301,8,46780,46789,0,19,9
31,7301,8,46789,46798,0,19,9
31,7301,8,46798,46813,0,19,15
31,7301,8,46813,46833,0,19,20
31,7301,7,46833,46853,0,19,20
31,7301,7,46853,46854,0,19,1
31,7301,7,46854,46861,0,19,7
31,7301,24,46861,46870,0,19,9
31,7301,24,46870,46874,0,19,4
31,7301,24,46874,46885,0,19,11
31,7301,24,46885,46894,0,19,9
31,7301,24,46894,46907,0,19,13
31,7311,24,46907,46916,0,34,9
31,7311,24,46916,46930,0,34,14
31,7311,24,46930,46936,0,34,6
31,7311,24,46936,46946,0,34,10
31,7311,23,46946,46952,0,34,6
31,7311,24,46952,46962,0,34,10
31,7311,23,46962,46971,0,34,9
31,7311,24,46971,46981,0,34,10
31,7311,24,46981,47001,0,34,20
31,7311,23,47001,47012,0,34,11
31,7311,23,47012,47032,0,34,20
31,7311,23,47032,47041,0,34,9
31,7311,23,47041,47058,0,34,17
31,7311,24,47058,47076,0,34,18
31,7311,24,47076,47087,0,34,11
31,7311,24,47087,47102,0,34,15
31,7311,24,47102,47111,0,34,9
31,7311,24,47111,47131,0,34,20
31,7311,24,47131,47135,0,34,4
31,7311,24,47135,47139,0,34,4
31,7311,24,47139,47156,0,34,17
31,7311,24,47156,47172,0,34,16
31,7311,24,47172,47179,0,34,7
31,7311,24,47179,47182,0,34,3
31,7311,24,47182,47189,0,34,7
31,7311,24,47189,47201,0,34,12
31,7311,24,47201,47206,0,34,5
31,7311,24,47206,47213,0,34,7
31,7311,24,47213,47230,0,34,17
31,7311,24,47230,47232,0,34,2
31,7311,24,47232,47249,0,34,17
31,7311,24,47249,47266,0,34,17
31,7311,24,47266,47269,0,34,3
31,7321,100,47269,47272,0,70,3
31,7321,100,47272,47274,0,70,2
31,7321,100,47274,47293,0,70,19
31,7321,100,47293,47296,0,70,3
31,7321,100,47296,47301,0,70,5
31,7321,100,47301,47302,0,70,1
31,7321,100,47302,47313,0,70,11
31,7321,34,47313,47330,0,70,17
31,7321,34,47330,47349,0,70,19
31,7321,34,47349,47365,0,70,16
31,7321,34,47365,47367,0,70,2
31,7321,33,47367,47376,0,70,9
31,7321,33,47376,47380,0,70,4
31,7321,33,47380,47398,0,70,18
31,7321,33,47398,47399,0,70,1
31,7321,33,47399,47409,0,70,10
31,7321,33,47409,47418,0,70,9
31,7321,33,47418,47425,0,70,7
31,7321,33,47425,47436,0,70,11
31,7321,33,47436,47441,0,70,5
31,7321,33,47441,47459,0,70,18
31,7321,33,47459,47470,0,70,11
31,7321,87,47470,47472,0,70,2
31,7321,32,47472,47477,0,70,5
31,7321,32,47477,47478,0,70,1
31,7321,32,47478,47493,0,70,15
31,7321,32,47493,47509,0,70,16
31,7321,2,47509,47526,0,70,17
31,7321,2,47526,47535,0,70,9
31,7321,2,47535,47537,0,70,2
31,7321,2,47537,47542,0,70,5
31,7321,2,47542,47554,0,70,12
31,7321,2,47554,47562,0,70,8
31,7321,2,47562,47571,0,70,9
31,7321,5,47571,47579,0,70,8
31,7321,5,47579,47585,0,70,6
31,7321,5,47585,47605,0,70,20
31,7321,5,47605,47625,0,70,20
31,7321,5,47625,47629,0,70,4
31,7321,27,47629,47640,0,70,11
31,7321,27,47640,47643,0,70,3
31,7321,27,47643,47662,0,70,19
31,7321,27,47662,47673,0,70,11
31,7321,28,47673,47674,0,70,1
31,7321,28,47674,47676,0,70,2
31,7321,28,47676,47692,0,70,16
31,7321,28,47692,47696,0,70,4
31,7321,28,47696,47702,0,70,6
31,7321,8,47702,47703,0,70,1
31,7321,8,47703,47719,0,70,16
31,7321,28,47719,47739,0,70,20
31,7321,28,47739,47743,0,70,4
31,7321,8,47743,47761,0,70,18
31,7321,8,47761,47764,0,70,3
31,7321,8,47764,47765,0,70,1
31,7321,8,47765,47777,0,70,12
31,7321,8,47777,47785,0,70,8
31,7321,8,47785,47789,0,70,4
31,7321,8,47789,47808,0,70,19
31,7321,8,47808,47818,0,70,10
31,7321,7,47818,47838,0,70,20
31,7321,7,47838,47858,0,70,20
31,7321,7,47858,47870,0,70,12
31,7321,7,47870,47884,0,70,14
31,7321,7,47884,47885,0,70,1
31,7321,24,47885,47900,0,70,15
31,7321,24,47900,47920,0,70,20
31,7321,24,47920,47934,0,70,14
31,7321,24,47934,47939,0,70,5
31,7331,9,47939,47949,0,39,10
31,7331,9,47949,47962,0,39,13
31,7331,9,47962,47969,0,39,7
31,7331,9,47969,47982,0,39,13
31,7331,104,47982,47989,0,39,7
31,7331,104,47989,47990,0,39,1
31,7331,104,47990,48000,0,39,10
31,7331,104,48000,48002,0,39,2
31,7331,104,48002,48008,0,39,6
31,7331,104,48008,48020,0,39,12
31,7331,103,48020,48021,0,39,1
31,7331,102,48021,48022,0,39,1
31,7331,101,48022,48023,0,39,1
31,7331,101,48023,48025,0,39,2
31,7331,30,48025,48041,0,39,16
31,7331,29,48041,48055,0,39,14
31,7331,23,48055,48068,0,39,13
31,7331,23,48068,48076,0,39,8
31,7331,23,48076,48090,0,39,14
31,7331,23,48090,48103,0,39,13
31,7331,23,48103,48120,0,39,17
31,7331,23,48120,48123,0,39,3
31,7331,23,48123,48134,0,39,11
31,7331,23,48134,48148,0,39,14
31,7331,23,48148,48158,0,39,10
31,7331,23,48158,48176,0,39,18
31,7331,23,48176,48187,0,39,11
31,7331,23,48187,48200,0,39,13
31,7331,23,48200,48203,0,39,3
31,7331,24,48203,48218,0,39,15
31,7331,24,48218,48229,0,39,11
31,7331,24,48229,48245,0,39,16
31,7331,24,48245,48254,0,39,9
31,7331,24,48254,48269,0,39,15
31,7331,24,48269,48272,0,39,3
31,7331,24,48272,48279,0,39,7
31,7331,24,48279,48291,0,39,12
31,7331,24,48291,48298,0,39,7
31,7341,24,48298,48303,0,6,5
31,7341,24,48303,48323,0,6,20
31,7341,24,48323,48325,0,6,2
31,7341,24,48325,48340,0,6,15
31,7341,24,48340,48353,0,6,13
41,8971,365,48353,48355,0,85,2
41,8971,365,48355,48357,0,85,2
41,8971,365,48357,48364,0,85,7
41,8971,365,48364,48373,0,85,9
41,8971,365,48373,48380,0,85,7
41,8971,365,48380,48383,0,85,3
41,8971,365,48383,48398,0,85,15
41,8971,405,48398,48402,0,85,4
41,8971,101,48402,48412,0,85,10
41,8971,30,48412,48427,0,85,15
41,8971,87,48427,48447,0,85,20
41,8971,87,48447,48448,0,85,1
41,8971,87,48448,48454,0,85,6
41,8971,32,48454,48465,0,85,11
41,8971,32,48465,48473,0,85,8
41,8971,32,48473,48477,0,85,4
41,8971,32,48477,48490,0,85,13
41,8971,32,48490,48494,0,85,4
41,8971,32,48494,48495,0,85,1
41,8971,32,48495,48496,0,85,1
41,8971,32,48496,48499,0,85,3
41,8971,32,48499,48514,0,85,15
41,8971,32,48514,48515,0,85,1
41,8971,32,48515,48528,0,85,13
41,8971,32,48528,48539,0,85,11
41,8971,32,48539,48556,0,85,17
41,8971,32,48556,48570,0,85,14
41,8971,419,48570,48590,0,85,20
41,8971,419,48590,48593,0,85,3
41,8971,419,48593,48606,0,85,13
41,8971,419,48606,48617,0,85,11
41,8971,419,48617,48619,0,85,2
41,8971,419,48619,48637,0,85,18
41,8971,419,48637,48648,0,85,11
41,8971,419,48648,48660,0,85,12
41,8971,419,48660,48676,0,85,16
41,8971,419,48676,48677,0,85,1
41,8971,419,48677,48680,0,85,3
41,8971,419,48680,48686,0,85,6
41,8971,419,48686,48704,0,85,18
41,8971,3,48704,48722,0,85,18
41,8971,3,48722,48736,0,85,14
41,8971,419,48736,48755,0,85,19
41,8971,3,48755,48770,0,85,15
41,8971,419,48770,48778,0,85,8
41,8971,419,48778,48779,0,85,1
41,8971,419,48779,48784,0,85,5
41,8971,419,48784,48792,0,85,8
41,8971,3,48792,48798,0,85,6
41,8971,3,48798,48799,0,85,1
41,8971,419,48799,48815,0,85,16
41,8971,419,48815,48821,0,85,6
41,8971,419,48821,48837,0,85,16
41,8971,419,48837,48842,0,85,5
41,8971,32,48842,48843,0,85,1
41,8971,32,48843,48863,0,85,20
41,8971,32,48863,48868,0,85,5
41,8971,32,48868,48878,0,85,10
41,8971,32,48878,48893,0,85,15
41,8971,32,48893,48895,0,85,2
41,8971,32,48895,48903,0,85,8
41,8971,32,48903,48909,0,85,6
41,8971,32,48909,48912,0,85,3
41,8971,32,48912,48928,0,85,16
41,8971,32,48928,48942,0,85,14
41,8971,32,48942,48951,0,85,9
41,8971,32,48951,48957,0,85,6
41,8971,32,48957,48962,0,85,5
41,8971,32,48962,48980,0,85,18
41,8971,32,48980,48990,0,85,10
41,8971,32,48990,49005,0,85,15
41,8971,32,49005,49012,0,85,7
41,8971,32,49012,49014,0,85,2
41,8971,32,49014,49018,0,85,4
41,8971,32,49018,49027,0,85,9
41,8971,32,49027,49029,0,85,2
41,8971,32,49029,49030,0,85,1
41,8971,32,49030,49044,0,85,14
41,8971,32,49044,49051,0,85,7
41,8971,32,49051,49068,0,85,17
41,8971,32,49068,49081,0,85,13
41,8971,32,49081,49098,0,85,17
41,8971,32,49098,49105,0,85,7
41,8971,32,49105,49115,0,85,10
41,8981,419,49115,49118,0,34,3
41,8981,419,49118,49120,0,34,2
41,8981,419,49120,49130,0,34,10
41,8981,419,49130,49138,0,34,8
41,8981,419,49138,49147,0,34,9
41,8981,419,49147,49157,0,34,10
41,8981,419,49157,49175,0,34,18
41,8981,419,49175,49183,0,34,8
41,8981,419,49183,49190,0,34,7
41,8981,419,49190,49195,0,34,5
41,8981,419,49195,49200,0,34,5
41,8981,419,49200,49213,0,34,13
41,8981,419,49213,49215,0,34,2
41,8981,419,49215,49231,0,34,16
41,8981,419,49231,49247,0,34,16
41,8981,419,49247,49253,0,34,6
41,8981,419,49253,49269,0,34,16
41,8981,419,49269,49282,0,34,13
41,8981,419,49282,49284,0,34,2
41,8981,419,49284,49297,0,34,13
41,8981,419,49297,49300,0,34,3
41,8981,419,49300,49304,0,34,4
41,8981,419,49304,49320,0,34,16
41,8981,419,49320,49336,0,34,16
41,8981,419,49336,49337,0,34,1
41,8981,419,49337,49353,0,34,16
41,8981,419,49353,49357,0,34,4
41,8981,419,49357,49358,0,34,1
41,8981,32,49358,49375,0,34,17
41,8981,32,49375,49393,0,34,18
41,8981,32,49393,49401,0,34,8
41,8981,32,49401,49418,0,34,17
41,8981,32,49418,49425,0,34,7
41,8991,29,49425,49427,0,11,2
41,8991,40,49427,49439,0,11,12
41,8991,42,49439,49457,0,11,18
41,8991,44,49457,49471,0,11,14
41,8991,404,49471,49481,0,11,10
41,8991,404,49481,49501,0,11,20
41,8991,404,49501,49521,0,11,20
41,8991,404,49521,49523,0,11,2
41,8991,409,49523,49524,0,11,1
41,8991,409,49524,49529,0,11,5
41,9001,30,49529,49542,0,28,13
41,9001,30,49542,49554,0,28,12
41,9001,30,49554,49558,0,28,4
41,9001,30,49558,49566,0,28,8
41,9001,30,49566,49568,0,28,2
41,9001,30,49568,49569,0,28,1
41,9001,30,49569,49580,0,28,11
41,9001,30,49580,49591,0,28,11
41,9001,30,49591,49609,0,28,18
41,9001,30,49609,49629,0,28,20
41,9001,30,49629,49635,0,28,6
41,9001,30,49635,49647,0,28,12
41,9001,30,49647,49661,0,28,14
41,9001,30,49661,49669,0,28,8
41,9001,30,49669,49682,0,28,13
41,9001,30,49682,49690,0,28,8
41,9001,30,49690,49705,0,28,15
41,9001,29,49705,49723,0,28,18
41,9001,29,49723,49743,0,28,20
41,9001,29,49743,49746,0,28,3
41,9001,30,49746,49765,0,28,19
41,9001,30,49765,49784,0,28,19
41,9001,30,49784,49791,0,28,7
41,9001,30,49791,49801,0,28,10
41,9001,30,49801,49806,0,28,5
41,9001,30,49806,49823,0,28,17
41,9001,30,49823,49831,0,28,8
41,9011,366,49831,49842,0,24,11
41,9011,366,49842,49851,0,24,9
41,9011,366,49851,49867,0,24,16
41,9011,365,49867,49871,0,24,4
41,9011,366,49871,49879,0,24,8
41,9011,365,49879,49887,0,24,8
41,9011,365,49887,49894,0,24,7
41,9011,365,49894,49905,0,24,11
41,9011,365,49905,49906,0,24,1
41,9011,365,49906,49923,0,24,17
41,9011,365,49923,49938,0,24,15
41,9011,405,49938,49939,0,24,1
41,9011,405,49939,49945,0,24,6
41,9011,405,49945,49957,0,24,12
41,9011,296,49957,49964,0,24,7
41,9011,39,49964,49968,0,24,4
41,9011,39,49968,49985,0,24,17
41,9011,29,49985,49994,0,24,9
41,9011,29,49994,49997,0,24,3
41,9011,30,49997,50013,0,24,16
41,9011,30,50013,50028,0,24,15
41,9011,30,50028,50047,0,24,19
41,9011,30,50047,50051,0,24,4
41,9021,91,50051,50063,0,16,12
41,9021,9,50063,50074,0,16,11
41,9021,9,50074,50083,0,16,9
41,9021,9,50083,50103,0,16,20
41,9021,9,50103,50108,0,16,5
41,9021,474,50108,50111,0,16,3
41,9021,474,50111,50112,0,16,1
41,9021,111,50112,50113,0,16,1
41,9021,111,50113,50123,0,16,10
41,9021,106,50123,50139,0,16,16
41,9021,106,50139,50155,0,16,16
41,9021,105,50155,50164,0,16,9
41,9021,105,50164,50172,0,16,8
41,9021,520,50172,50173,0,16,1
41,9021,520,50173,50178,0,16,5
51,10111,407,50178,50190,0,2,12
51,10121,1631,50190,50194,0,93,4
51,10121,688,50194,50197,0,93,3
51,10121,688,50197,50214,0,93,17
51,10121,688,50214,50225,0,93,11
51,10121,688,50225,50227,0,93,2
51,10121,688,50227,50242,0,93,15
51,10121,688,50242,50261,0,93,19
51,10121,688,50261,50277,0,93,16
51,10121,688,50277,50282,0,93,5
51,10121,688,50282,50293,0,93,11
51,10121,688,50293,50296,0,93,3
51,10121,688,50296,50311,0,93,15
51,10121,688,50311,50328,0,93,17
51,10121,688,50328,50334,0,93,6
51,10121,688,50334,50339,0,93,5
51,10121,688,50339,50343,0,93,4
51,10121,688,50343,50346,0,93,3
51,10121,688,50346,50347,0,93,1
51,10121,688,50347,50355,0,93,8
51,10121,688,50355,50365,0,93,10
51,10121,688,50365,50380,0,93,15
51,10121,688,50380,50388,0,93,8
51,10121,688,50388,50401,0,93,13
51,10121,688,50401,50405,0,93,4
51,10121,688,50405,50413,0,93,8
51,10121,688,50413,50425,0,93,12
51,10121,688,50425,50428,0,93,3
51,10121,688,50428,50445,0,93,17
51,10121,688,50445,50463,0,93,18
51,10121,688,50463,50482,0,93,19
51,10121,688,50482,50491,0,93,9
51,10121,688,50491,50504,0,93,13
51,10121,688,50504,50513,0,93,9
51,10121,123,50513,50529,0,93,16
51,10121,123,50529,50540,0,93,11
51,10121,123,50540,50550,0,93,10
51,10121,123,50550,50559,0,93,9
51,10121,123,50559,50574,0,93,15
51,10121,122,50574,50577,0,93,3
51,10121,122,50577,50578,0,93,1
51,10121,1388,50578,50586,0,93,8
51,10121,1388,50586,50606,0,93,20
51,10121,1387,50606,50614,0,93,8
51,10121,1387,50614,50622,0,93,8
51,10121,1386,50622,50624,0,93,2
51,10121,1385,50624,50634,0,93,10
51,10121,1385,50634,50640,0,93,6
51,10121,2608,50640,50645,0,93,5
51,10121,2608,50645,50656,0,93,11
51,10121,1678,50656,50660,0,93,4
51,10121,2607,50660,50676,0,93,16
51,10121,2607,50676,50678,0,93,2
51,10121,2604,50678,50692,0,93,14
51,10121,2604,50692,50707,0,93,15
51,10121,387,50707,50709,0,93,2
51,10121,387,50709,50729,0,93,20
51,10121,387,50729,50740,0,93,11
51,10121,387,50740,50741,0,93,1
51,10121,387,50741,50746,0,93,5
51,10121,387,50746,50761,0,93,15
51,10121,387,50761,50770,0,93,9
51,10121,387,50770,50784,0,93,14
51,10121,387,50784,50794,0,93,10
51,10121,387,50794,50796,0,93,2
51,10121,387,50796,50808,0,93,12
51,10121,387,50808,50815,0,93,7
51,10121,387,50815,50820,0,93,5
51,10121,387,50820,50829,0,93,9
51,10121,387,50829,50845,0,93,16
51,10121,387,50845,50856,0,93,11
51,10121,388,50856,50874,0,93,18
51,10121,387,50874,50882,0,93,8
51,10121,387,50882,50883,0,93,1
51,10121,387,50883,50886,0,93,3
51,10121,387,50886,50893,0,93,7
51,10121,387,50893,50894,0,93,1
51,10121,387,50894,50907,0,93,13
51,10121,387,50907,50918,0,93,11
51,10121,387,50918,50922,0,93,4
51,10121,387,50922,50923,0,93,1
51,10121,387,50923,50928,0,93,5
51,10121,387,50928,50936,0,93,8
51,10121,387,50936,50941,0,93,5
51,10121,387,50941,50955,0,93,14
51,10121,387,50955,50974,0,93,19
51,10121,387,50974,50984,0,93,10
51,10121,387,50984,50986,0,93,2
51,10121,387,50986,50988,0,93,2
51,10121,387,50988,50992,0,93,4
51,10121,387,50992,50999,0,93,7
51,10121,387,50999,51014,0,93,15
51,10121,388,51014,51019,0,93,5
51,10131,163,51019,51028,0,71,9
51,10131,694,51028,51044,0,71,16
51,10131,694,51044,51060,0,71,16
51,10131,694,51060,51066,0,71,6
51,10131,639,51066,51068,0,71,2
51,10131,20,51068,51074,0,71,6
51,10131,21,51074,51090,0,71,16
51,10131,21,51090,51103,0,71,13
51,10131,21,51103,51123,0,71,20
51,10131,22,51123,51138,0,71,15
51,10131,356,51138,51142,0,71,4
51,10131,356,51142,51157,0,71,15
51,10131,356,51157,51159,0,71,2
51,10131,357,51159,51162,0,71,3
51,10131,97,51162,51178,0,71,16
51,10131,97,51178,51198,0,71,20
51,10131,97,51198,51209,0,71,11
51,10131,246,51209,51217,0,71,8
51,10131,97,51217,51229,0,71,12
51,10131,97,51229,51230,0,71,1
51,10131,97,51230,51237,0,71,7
51,10131,97,51237,51257,0,71,20
51,10131,97,51257,51265,0,71,8
51,10131,97,51265,51278,0,71,13
51,10131,97,51278,51291,0,71,13
51,10131,97,51291,51311,0,71,20
51,10131,97,51311,51327,0,71,16
51,10131,97,51327,51341,0,71,14
51,10131,97,51341,51355,0,71,14
51,10131,97,51355,51365,0,71,10
51,10131,97,51365,51375,0,71,10
51,10131,96,51375,51391,0,71,16
51,10131,96,51391,51394,0,71,3
51,10131,96,51394,51402,0,71,8
51,10131,96,51402,51411,0,71,9
51,10131,96,51411,51418,0,71,7
51,10131,96,51418,51434,0,71,16
51,10131,96,51434,51444,0,71,10
51,10131,96,51444,51452,0,71,8
51,10131,96,51452,51467,0,71,15
51,10131,96,51467,51474,0,71,7
51,10131,96,51474,51488,0,71,14
51,10131,97,51488,51489,0,71,1
51,10131,97,51489,51491,0,71,2
51,10131,97,51491,51500,0,71,9
51,10131,98,51500,51505,0,71,5
51,10131,98,51505,51518,0,71,13
51,10131,99,51518,51538,0,71,20
51,10131,99,51538,51546,0,71,8
51,10131,357,51546,51548,0,71,2
51,10131,357,51548,51564,0,71,16
51,10131,357,51564,51566,0,71,2
51,10131,97,51566,51568,0,71,2
51,10131,97,51568,51586,0,71,18
51,10131,97,51586,51601,0,71,15
51,10131,96,51601,51608,0,71,7
51,10131,96,51608,51615,0,71,7
51,10131,96,51615,51626,0,71,11
51,10131,96,51626,51633,0,71,7
51,10131,96,51633,51639,0,71,6
51,10131,96,51639,51646,0,71,7
51,10131,96,51646,51648,0,71,2
51,10131,96,51648,51666,0,71,18
51,10131,96,51666,51686,0,71,20
51,10131,96,51686,51704,0,71,18
51,10131,104,51704,51717,0,71,13
51,10131,104,51717,51722,0,71,5
51,10131,104,51722,51735,0,71,13
51,10131,104,51735,51741,0,71,6
51,10131,104,51741,51744,0,71,3
51,10141,3,51744,51755,0,71,11
51,10141,3,51755,51772,0,71,17
51,10141,3,51772,51774,0,71,2
51,10141,3,51774,51780,0,71,6
51,10141,3,51780,51784,0,71,4
51,10141,3,51784,51794,0,71,10
51,10141,3,51794,51797,0,71,3
51,10141,3,51797,51811,0,71,14
51,10141,2,51811,51825,0,71,14
51,10141,2,51825,51827,0,71,2
51,10141,2,51827,51837,0,71,10
51,10141,2,51837,51853,0,71,16
51,10141,2,51853,51868,0,71,15
51,10141,2,51868,51883,0,71,15
51,10141,2,51883,51892,0,71,9
51,10141,2,51892,51893,0,71,1
51,10141,2,51893,51897,0,71,4
51,10141,2,51897,51912,0,71,15
51,10141,2,51912,51923,0,71,11
51,10141,2,51923,51929,0,71,6
51,10141,2,51929,51938,0,71,9
51,10141,2,51938,51953,0,71,15
51,10141,2,51953,51962,0,71,9
51,10141,2,51962,51966,0,71,4
51,10141,2,51966,51984,0,71,18
51,10141,2,51984,51992,0,71,8
51,10141,2,51992,52007,0,71,15
51,10141,2,52007,52021,0,71,14
51,10141,2,52021,52033,0,71,12
51,10141,2,52033,52045,0,71,12
51,10141,2,52045,52063,0,71,18
51,10141,2,52063,52071,0,71,8
51,10141,2,52071,52075,0,71,4
51,10141,2,52075,52081,0,71,6
51,10141,2,52081,52093,0,71,12
51,10141,2,52093,52096,0,71,3
51,10141,2,52096,52101,0,71,5
51,10141,2,52101,52108,0,71,7
51,10141,2,52108,52126,0,71,18
51,10141,2,52126,52133,0,71,7
51,10141,2,52133,52148,0,71,15
51,10141,2,52148,52150,0,71,2
51,10141,2,52150,52154,0,71,4
51,10141,2,52154,52163,0,71,9
51,10141,2,52163,52167,0,71,4
51,10141,2,52167,52185,0,71,18
51,10141,2,52185,52186,0,71,1
51,10141,2,52186,52188,0,71,2
51,10141,2,52188,52195,0,71,7
51,10141,2,52195,52213,0,71,18
51,10141,32,52213,52232,0,71,19
51,10141,32,52232,52247,0,71,15
51,10141,32,52247,52262,0,71,15
51,10141,32,52262,52263,0,71,1
51,10141,417,52263,52281,0,71,18
51,10141,417,52281,52295,0,71,14
51,10141,418,52295,52307,0,71,12
51,10141,418,52307,52324,0,71,17
51,10141,418,52324,52341,0,71,17
51,10141,418,52341,52351,0,71,10
51,10141,418,52351,52369,0,71,18
51,10141,642,52369,52380,0,71,11
51,10141,642,52380,52395,0,71,15
51,10141,688,52395,52411,0,71,16
51,10141,688,52411,52428,0,71,17
51,10141,688,52428,52448,0,71,20
51,10141,688,52448,52457,0,71,9
51,10141,688,52457,52466,0,71,9
51,10141,688,52466,52486,0,71,20
51,10141,688,52486,52502,0,71,16
51,10151,741,52502,52520,0,149,18
51,10151,741,52520,52527,0,149,7
51,10151,741,52527,52537,0,149,10
51,10151,741,52537,52542,0,149,5
51,10151,741,52542,52545,0,149,3
51,10151,741,52545,52551,0,149,6
51,10151,741,52551,52556,0,149,5
51,10151,741,52556,52573,0,149,17
51,10151,741,52573,52585,0,149,12
51,10151,491,52585,52603,0,149,18
51,10151,491,52603,52608,0,149,5
51,10151,741,52608,52615,0,149,7
51,10151,741,52615,52618,0,149,3
51,10151,491,52618,52629,0,149,11
51,10151,491,52629,52640,0,149,11
51,10151,491,52640,52659,0,149,19
51,10151,803,52659,52678,0,149,19
51,10151,491,52678,52695,0,149,17
51,10151,803,52695,52697,0,149,2
51,10151,491,52697,52717,0,149,20
51,10151,491,52717,52725,0,149,8
51,10151,741,52725,52726,0,149,1
51,10151,718,52726,52730,0,149,4
51,10151,718,52730,52748,0,149,18
51,10151,718,52748,52768,0,149,20
51,10151,741,52768,52778,0,149,10
51,10151,741,52778,52794,0,149,16
51,10151,741,52794,52813,0,149,19
51,10151,741,52813,52833,0,149,20
51,10151,741,52833,52850,0,149,17
51,10151,741,52850,52870,0,149,20
51,10151,741,52870,52890,0,149,20
51,10151,741,52890,52908,0,149,18
51,10151,741,52908,52912,0,149,4
51,10151,1907,52912,52931,0,149,19
51,10151,1907,52931,52949,0,149,18
51,10151,1907,52949,52963,0,149,14
51,10151,1907,52963,52971,0,149,8
51,10151,1907,52971,52976,0,149,5
51,10151,1907,52976,52991,0,149,15
51,10151,1907,52991,53001,0,149,10
51,10151,1907,53001,53021,0,149,20
51,10151,1907,53021,53027,0,149,6
51,10151,1907,53027,53034,0,149,7
51,10151,1907,53034,53051,0,149,17
51,10151,1907,53051,53056,0,149,5
51,10151,1907,53056,53058,0,149,2
51,10151,1907,53058,53074,0,149,16
51,10151,1907,53074,53089,0,149,15
51,10151,1907,53089,53103,0,149,14
51,10151,1907,53103,53117,0,149,14
51,10151,1907,53117,53131,0,149,14
51,10151,1907,53131,53141,0,149,10
51,10151,1907,53141,53158,0,149,17
51,10151,1907,53158,53166,0,149,8
51,10151,1907,53166,53173,0,149,7
51,10151,1907,53173,53184,0,149,11
51,10151,1907,53184,53204,0,149,20
51,10151,1907,53204,53219,0,149,15
51,10151,1907,53219,53231,0,149,12
51,10151,1907,53231,53240,0,149,9
51,10151,1907,53240,53256,0,149,16
51,10151,836,53256,53259,0,149,3
51,10151,836,53259,53261,0,149,2
51,10151,836,53261,53280,0,149,19
51,10151,836,53280,53288,0,149,8
51,10151,836,53288,53289,0,149,1
51,10151,836,53289,53303,0,149,14
51,10151,836,53303,53308,0,149,5
51,10151,836,53308,53309,0,149,1
51,10151,836,53309,53312,0,149,3
51,10151,836,53312,53314,0,149,2
51,10151,836,53314,53334,0,149,20
51,10151,1907,53334,53340,0,149,6
51,10151,1907,53340,53355,0,149,15
51,10151,1907,53355,53373,0,149,18
51,10151,1907,53373,53384,0,149,11
51,10151,1907,53384,53387,0,149,3
51,10151,1907,53387,53389,0,149,2
51,10151,1907,53389,53396,0,149,7
51,10151,741,53396,53413,0,149,17
51,10151,1907,53413,53416,0,149,3
51,10151,1907,53416,53419,0,149,3
51,10151,1907,53419,53420,0,149,1
51,10151,1907,53420,53426,0,149,6
51,10151,1907,53426,53441,0,149,15
51,10151,1907,53441,53442,0,149,1
51,10151,836,53442,53450,0,149,8
51,10151,836,53450,53456,0,149,6
51,10151,836,53456,53464,0,149,8
51,10151,836,53464,53482,0,149,18
51,10151,836,53482,53499,0,149,17
51,10151,836,53499,53503,0,149,4
51,10151,1907,53503,53509,0,149,6
51,10151,1907,53509,53520,0,149,11
51,10151,182,53520,53534,0,149,14
51,10151,182,53534,53536,0,149,2
51,10151,182,53536,53553,0,149,17
51,10151,835,53553,53563,0,149,10
51,10151,835,53563,53578,0,149,15
51,10151,835,53578,53583,0,149,5
51,10151,835,53583,53589,0,149,6
51,10151,835,53589,53596,0,149,7
51,10151,835,53596,53600,0,149,4
51,10151,835,53600,53617,0,149,17
51,10151,835,53617,53620,0,149,3
51,10151,835,53620,53629,0,149,9
51,10151,836,53629,53642,0,149,13
51,10151,836,53642,53654,0,149,12
51,10151,836,53654,53659,0,149,5
51,10151,836,53659,53667,0,149,8
51,10151,836,53667,53679,0,149,12
51,10151,836,53679,53686,0,149,7
51,10151,836,53686,53690,0,149,4
51,10151,836,53690,53709,0,149,19
51,10151,836,53709,53712,0,149,3
51,10151,836,53712,53722,0,149,10
51,10151,836,53722,53730,0,149,8
51,10151,836,53730,53731,0,149,1
51,10151,836,53731,53733,0,149,2
51,10151,491,53733,53742,0,149,9
51,10151,491,53742,53759,0,149,17
51,10151,491,53759,53767,0,149,8
51,10151,491,53767,53774,0,149,7
51,10151,491,53774,53781,0,149,7
51,10151,491,53781,53785,0,149,4
51,10151,491,53785,53802,0,149,17
51,10151,491,53802,53812,0,149,10
51,10151,491,53812,53828,0,149,16
51,10151,491,53828,53840,0,149,12
51,10151,491,53840,53853,0,149,13
51,10151,491,53853,53856,0,149,3
51,10151,491,53856,53865,0,149,9
51,10151,491,53865,53873,0,149,8
51,10151,491,53873,53889,0,149,16
51,10151,803,53889,53900,0,149,11
51,10151,717,53900,53913,0,149,13
51,10151,837,53913,53928,0,149,15
51,10151,717,53928,53929,0,149,1
51,10151,717,53929,53935,0,149,6
51,10151,837,53935,53944,0,149,9
51,10151,837,53944,53955,0,149,11
51,10151,717,53955,53965,0,149,10
51,10151,717,53965,53970,0,149,5
51,10151,717,53970,53981,0,149,11
51,10151,717,53981,53995,0,149,14
51,10151,717,53995,54007,0,149,12
51,10151,432,54007,54022,0,149,15
51,10161,723,54022,54026,0,129,4
51,10161,723,54026,54035,0,129,9
51,10161,723,54035,54054,0,129,19
51,10161,723,54054,54062,0,129,8
51,10161,723,54062,54077,0,129,15
51,10161,723,54077,54083,0,129,6
51,10161,666,54083,54090,0,129,7
51,10161,666,54090,54107,0,129,17
51,10161,665,54107,54116,0,129,9
51,10161,665,54116,54134,0,129,18
51,10161,665,54134,54135,0,129,1
51,10161,665,54135,54149,0,129,14
51,10161,15,54149,54161,0,129,12
51,10161,15,54161,54163,0,129,2
51,10161,15,54163,54169,0,129,6
51,10161,15,54169,54180,0,129,11
51,10161,16,54180,54200,0,129,20
51,10161,17,54200,54219,0,129,19
51,10161,17,54219,54228,0,129,9
51,10161,17,54228,54233,0,129,5
51,10161,17,54233,54243,0,129,10
51,10161,18,54243,54255,0,129,12
51,10161,18,54255,54273,0,129,18
51,10161,18,54273,54276,0,129,3
51,10161,360,54276,54279,0,129,3
51,10161,360,54279,54293,0,129,14
51,10161,360,54293,54304,0,129,11
51,10161,360,54304,54306,0,129,2
51,10161,360,54306,54323,0,129,17
51,10161,360,54323,54343,0,129,20
51,10161,360,54343,54352,0,129,9
51,10161,360,54352,54360,0,129,8
51,10161,360,54360,54378,0,129,18
51,10161,360,54378,54391,0,129,13
51,10161,360,54391,54404,0,129,13
51,10161,991,54404,54413,0,129,9
51,10161,991,54413,54431,0,129,18
51,10161,360,54431,54451,0,129,20
51,10161,360,54451,54453,0,129,2
51,10161,360,54453,54466,0,129,13
51,10161,360,54466,54469,0,129,3
51,10161,360,54469,54471,0,129,2
51,10161,360,54471,54482,0,129,11
51,10161,361,54482,54491,0,129,9
51,10161,361,54491,54510,0,129,19
51,10161,359,54510,54517,0,129,7
51,10161,359,54517,54533,0,129,16
51,10161,359,54533,54538,0,129,5
51,10161,358,54538,54549,0,129,11
51,10161,358,54549,54562,0,129,13
51,10161,357,54562,54576,0,129,14
51,10161,357,54576,54592,0,129,16
51,10161,357,54592,54605,0,129,13
51,10161,356,54605,54617,0,129,12
51,10161,356,54617,54632,0,129,15
51,10161,356,54632,54637,0,129,5
51,10161,100,54637,54647,0,129,10
51,10161,100,54647,54652,0,129,5
51,10161,100,54652,54665,0,129,13
51,10161,34,54665,54683,0,129,18
51,10161,34,54683,54684,0,129,1
51,10161,34,54684,54703,0,129,19
51,10161,34,54703,54712,0,129,9
51,10161,33,54712,54723,0,129,11
51,10161,87,54723,54734,0,129,11
51,10161,32,54734,54746,0,129,12
51,10161,32,54746,54753,0,129,7
51,10161,32,54753,54761,0,129,8
51,10161,32,54761,54767,0,129,6
51,10161,32,54767,54770,0,129,3
51,10161,32,54770,54787,0,129,17
51,10161,32,54787,54806,0,129,19
51,10161,32,54806,54807,0,129,1
51,10161,32,54807,54824,0,129,17
51,10161,32,54824,54835,0,129,11
51,10161,32,54835,54840,0,129,5
51,10161,32,54840,54845,0,129,5
51,10161,32,54845,54846,0,129,1
51,10161,32,54846,54856,0,129,10
51,10161,32,54856,54868,0,129,12
51,10161,32,54868,54873,0,129,5
51,10161,32,54873,54885,0,129,12
51,10161,32,54885,54894,0,129,9
51,10161,32,54894,54912,0,129,18
51,10161,32,54912,54917,0,129,5
51,10161,32,54917,54932,0,129,15
51,10161,32,54932,54939,0,129,7
51,10161,32,54939,54941,0,129,2
51,10161,32,54941,54946,0,129,5
51,10161,32,54946,54963,0,129,17
51,10161,32,54963,54981,0,129,18
51,10161,32,54981,55000,0,129,19
51,10161,32,55000,55009,0,129,9
51,10161,32,55009,55015,0,129,6
51,10161,32,55015,55017,0,129,2
51,10161,32,55017,55030,0,129,13
51,10161,32,55030,55047,0,129,17
51,10161,32,55047,55066,0,129,19
51,10161,32,55066,55077,0,129,11
51,10161,32,55077,55083,0,129,6
51,10161,32,55083,55088,0,129,5
51,10161,32,55088,55089,0,129,1
51,10161,417,55089,55101,0,129,12
51,10161,417,55101,55104,0,129,3
51,10161,418,55104,55118,0,129,14
51,10161,418,55118,55129,0,129,11
51,10161,418,55129,55149,0,129,20
51,10161,642,55149,55156,0,129,7
51,10161,642,55156,55175,0,129,19
51,10161,688,55175,55184,0,129,9
51,10161,688,55184,55196,0,129,12
51,10161,688,55196,55198,0,129,2
51,10161,123,55198,55200,0,129,2
51,10161,123,55200,55220,0,129,20
51,10161,123,55220,55223,0,129,3
51,10161,123,55223,55226,0,129,3
51,10161,122,55226,55242,0,129,16
51,10161,122,55242,55260,0,129,18
51,10161,1388,55260,55271,0,129,11
51,10161,1388,55271,55277,0,129,6
51,10161,1388,55277,55295,0,129,18
51,10161,1387,55295,55303,0,129,8
51,10161,1387,55303,55318,0,129,15
51,10161,1387,55318,55327,0,129,9
51,10161,1386,55327,55335,0,129,8
51,10161,1386,55335,55352,0,129,17
51,10161,1385,55352,55371,0,129,19
51,10161,2608,55371,55379,0,129,8
51,10171,2,55379,55395,0,99,16
51,10171,2,55395,55411,0,99,16
51,10171,2,55411,55417,0,99,6
51,10171,2,55417,55435,0,99,18
51,10171,2,55435,55453,0,99,18
51,10171,2,55453,55467,0,99,14
51,10171,2,55467,55482,0,99,15
51,10171,2,55482,55498,0,99,16
51,10171,2,55498,55505,0,99,7
51,10171,2,55505,55518,0,99,13
51,10171,2,55518,55529,0,99,11
51,10171,2,55529,55548,0,99,19
51,10171,2,55548,55559,0,99,11
51,10171,2,55559,55577,0,99,18
51,10171,2,55577,55582,0,99,5
51,10171,2,55582,55596,0,99,14
51,10171,2,55596,55598,0,99,2
51,10171,32,55598,55611,0,99,13
51,10171,32,55611,55628,0,99,17
51,10171,32,55628,55643,0,99,15
51,10171,32,55643,55661,0,99,18
51,10171,32,55661,55675,0,99,14
51,10171,32,55675,55677,0,99,2
51,10171,32,55677,55687,0,99,10
51,10171,32,55687,55706,0,99,19
51,10171,32,55706,55715,0,99,9
51,10171,32,55715,55718,0,99,3
51,10171,32,55718,55738,0,99,20
51,10171,32,55738,55746,0,99,8
51,10171,32,55746,55759,0,99,13
51,10171,32,55759,55760,0,99,1
51,10171,32,55760,55768,0,99,8
51,10171,32,55768,55771,0,99,3
51,10171,32,55771,55785,0,99,14
51,10171,32,55785,55787,0,99,2
51,10171,32,55787,55797,0,99,10
51,10171,32,55797,55801,0,99,4
51,10171,32,55801,55803,0,99,2
51,10171,419,55803,55805,0,99,2
51,10171,419,55805,55824,0,99,19
51,10171,419,55824,55832,0,99,8
51,10171,419,55832,55842,0,99,10
51,10171,419,55842,55858,0,99,16
51,10171,419,55858,55864,0,99,6
51,10171,419,55864,55883,0,99,19
51,10171,419,55883,55900,0,99,17
51,10171,419,55900,55912,0,99,12
51,10171,419,55912,55930,0,99,18
51,10171,419,55930,55939,0,99,9
51,10171,419,55939,55956,0,99,17
51,10171,419,55956,55962,0,99,6
51,10171,419,55962,55971,0,99,9
51,10171,419,55971,55973,0,99,2
51,10171,419,55973,55977,0,99,4
51,10171,419,55977,55994,0,99,17
51,10171,3,55994,55998,0,99,4
51,10171,86,55998,56018,0,99,20
51,10171,85,56018,56028,0,99,10
51,10171,85,56028,56033,0,99,5
51,10171,85,56033,56035,0,99,2
51,10171,4,56035,56045,0,99,10
51,10171,4,56045,56064,0,99,19
51,10171,81,56064,56080,0,99,16
51,10171,81,56080,56093,0,99,13
51,10171,81,56093,56108,0,99,15
51,10171,81,56108,56124,0,99,16
51,10171,81,56124,56140,0,99,16
51,10171,82,56140,56149,0,99,9
51,10171,82,56149,56166,0,99,17
51,10171,82,56166,56182,0,99,16
51,10171,82,56182,56191,0,99,9
51,10171,84,56191,56197,0,99,6
51,10171,84,56197,56212,0,99,15
51,10171,84,56212,56230,0,99,18
51,10171,381,56230,56231,0,99,1
51,10171,381,56231,56245,0,99,14
51,10171,381,56245,56253,0,99,8
51,10171,382,56253,56254,0,99,1
51,10171,382,56254,56266,0,99,12
51,10171,383,56266,56267,0,99,1
51,10171,383,56267,56268,0,99,1
51,10171,383,56268,56288,0,99,20
51,10171,384,56288,56295,0,99,7
51,10171,385,56295,56311,0,99,16
51,10171,386,56311,56329,0,99,18
51,10171,386,56329,56341,0,99,12
51,10171,387,56341,56343,0,99,2
51,10171,387,56343,56357,0,99,14
51,10171,387,56357,56365,0,99,8
51,10171,387,56365,56382,0,99,17
51,10171,387,56382,56388,0,99,6
51,10171,387,56388,56403,0,99,15
51,10171,387,56403,56410,0,99,7
51,10171,387,56410,56427,0,99,17
51,10171,387,56427,56447,0,99,20
51,10171,387,56447,56458,0,99,11
51,10171,387,56458,56473,0,99,15
51,10171,387,56473,56484,0,99,11
51,10181,121,56484,56487,0,52,3
51,10181,122,56487,56493,0,52,6
51,10181,1388,56493,56511,0,52,18
51,10181,1388,56511,56519,0,52,8
51,10181,1387,56519,56539,0,52,20
51,10181,1386,56539,56553,0,52,14
51,10181,1386,56553,56573,0,52,20
51,10181,1385,56573,56584,0,52,11
51,10181,1760,56584,56591,0,52,7
51,10181,385,56591,56592,0,52,1
51,10181,385,56592,56600,0,52,8
51,10181,385,56600,56609,0,52,9
51,10181,385,56609,56612,0,52,3
51,10181,385,56612,56630,0,52,18
51,10181,385,56630,56631,0,52,1
51,10181,385,56631,56637,0,52,6
51,10181,385,56637,56648,0,52,11
51,10181,385,56648,56667,0,52,19
51,10181,385,56667,56683,0,52,16
51,10181,385,56683,56688,0,52,5
51,10181,385,56688,56706,0,52,18
51,10181,385,56706,56723,0,52,17
51,10181,385,56723,56726,0,52,3
51,10181,385,56726,56732,0,52,6
51,10181,385,56732,56733,0,52,1
51,10181,385,56733,56737,0,52,4
51,10181,385,56737,56755,0,52,18
51,10181,385,56755,56771,0,52,16
51,10181,385,56771,56789,0,52,18
51,10181,385,56789,56799,0,52,10
51,10181,385,56799,56808,0,52,9
51,10181,385,56808,56818,0,52,10
51,10181,385,56818,56837,0,52,19
51,10181,385,56837,56850,0,52,13
51,10181,385,56850,56854,0,52,4
51,10181,385,56854,56856,0,52,2
51,10181,385,56856,56871,0,52,15
51,10181,385,56871,56878,0,52,7
51,10181,385,56878,56885,0,52,7
51,10181,385,56885,56892,0,52,7
51,10181,385,56892,56896,0,52,4
51,10181,385,56896,56912,0,52,16
51,10181,385,56912,56932,0,52,20
51,10181,385,56932,56933,0,52,1
51,10181,385,56933,56943,0,52,10
51,10181,385,56943,56948,0,52,5
51,10181,386,56948,56952,0,52,4
51,10181,386,56952,56961,0,52,9
51,10181,386,56961,56977,0,52,16
51,10181,387,56977,56993,0,52,16
51,10181,387,56993,56999,0,52,6
51,10191,397,56999,57003,0,108,4
51,10191,397,57003,57014,0,108,11
51,10191,397,57014,57034,0,108,20
51,10191,397,57034,57048,0,108,14
51,10191,397,57048,57066,0,108,18
51,10191,397,57066,57068,0,108,2
51,10191,397,57068,57082,0,108,14
51,10191,397,57082,57092,0,108,10
51,10191,397,57092,57102,0,108,10
51,10191,397,57102,57108,0,108,6
51,10191,397,57108,57123,0,108,15
51,10191,397,57123,57128,0,108,5
51,10191,397,57128,57141,0,108,13
51,10191,397,57141,57155,0,108,14
51,10191,397,57155,57169,0,108,14
51,10191,397,57169,57171,0,108,2
51,10191,397,57171,57173,0,108,2
51,10191,397,57173,57185,0,108,12
51,10191,397,57185,57191,0,108,6
51,10191,397,57191,57204,0,108,13
51,10191,397,57204,57206,0,108,2
51,10191,397,57206,57226,0,108,20
51,10191,397,57226,57241,0,108,15
51,10191,397,57241,57242,0,108,1
51,10191,397,57242,57249,0,108,7
51,10191,397,57249,57265,0,108,16
51,10191,397,57265,57280,0,108,15
51,10191,2486,57280,57284,0,108,4
51,10191,2486,57284,57302,0,108,18
51,10191,2486,57302,57322,0,108,20
51,10191,2486,57322,57325,0,108,3
51,10191,2486,57325,57330,0,108,5
51,10191,2486,57330,57336,0,108,6
51,10191,2486,57336,57344,0,108,8
51,10191,2486,57344,57358,0,108,14
51,10191,2486,57358,57365,0,108,7
51,10191,2486,57365,57374,0,108,9
51,10191,2486,57374,57389,0,108,15
51,10191,2486,57389,57405,0,108,16
51,10191,2486,57405,57422,0,108,17
51,10191,2486,57422,57433,0,108,11
51,10191,2486,57433,57440,0,108,7
51,10191,2486,57440,57457,0,108,17
51,10191,2486,57457,57462,0,108,5
51,10191,2486,57462,57466,0,108,4
51,10191,2486,57466,57482,0,108,16
51,10191,2486,57482,57501,0,108,19
51,10191,2486,57501,57503,0,108,2
51,10191,2486,57503,57523,0,108,20
51,10191,2486,57523,57531,0,108,8
51,10191,2486,57531,57535,0,108,4
51,10191,2486,57535,57538,0,108,3
51,10191,2486,57538,57548,0,108,10
51,10191,2486,57548,57555,0,108,7
51,10191,2486,57555,57560,0,108,5
51,10191,2486,57560,57576,0,108,16
51,10191,2486,57576,57590,0,108,14
51,10191,2486,57590,57609,0,108,19
51,10191,398,57609,57612,0,108,3
51,10191,2486,57612,57618,0,108,6
51,10191,2486,57618,57636,0,108,18
51,10191,398,57636,57642,0,108,6
51,10191,398,57642,57653,0,108,11
51,10191,398,57653,57671,0,108,18
51,10191,398,57671,57679,0,108,8
51,10191,398,57679,57681,0,108,2
51,10191,398,57681,57686,0,108,5
51,10191,398,57686,57705,0,108,19
51,10191,398,57705,57719,0,108,14
51,10191,398,57719,57737,0,108,18
51,10191,398,57737,57742,0,108,5
51,10191,398,57742,57745,0,108,3
51,10191,398,57745,57762,0,108,17
51,10191,398,57762,57777,0,108,15
51,10191,398,57777,57788,0,108,11
51,10191,398,57788,57796,0,108,8
51,10191,398,57796,57808,0,108,12
51,10191,398,57808,57821,0,108,13
51,10191,398,57821,57841,0,108,20
51,10191,398,57841,57849,0,108,8
51,10191,398,57849,57850,0,108,1
51,10191,398,57850,57862,0,108,12
51,10191,398,57862,57873,0,108,11
51,10191,398,57873,57878,0,108,5
51,10191,398,57878,57891,0,108,13
51,10191,398,57891,57898,0,108,7
51,10191,387,57898,57905,0,108,7
51,10191,387,57905,57916,0,108,11
51,10191,387,57916,57923,0,108,7
51,10191,387,57923,57936,0,108,13
51,10191,387,57936,57939,0,108,3
51,10191,387,57939,57947,0,108,8
51,10191,387,57947,57961,0,108,14
51,10191,387,57961,57971,0,108,10
51,10191,387,57971,57984,0,108,13
51,10191,387,57984,57985,0,108,1
51,10191,387,57985,57987,0,108,2
51,10191,387,57987,58003,0,108,16
51,10191,387,58003,58011,0,108,8
51,10191,387,58011,58014,0,108,3
51,10191,387,58014,58017,0,108,3
51,10191,387,58017,58019,0,108,2
51,10191,387,58019,58023,0,108,4
51,10191,387,58023,58041,0,108,18
51,10191,387,58041,58058,0,108,17
51,10191,387,58058,58066,0,108,8
51,10191,387,58066,58082,0,108,16
51,10201,406,58082,58098,0,115,16
51,10201,406,58098,58115,0,115,17
51,10201,406,58115,58127,0,115,12
51,10201,406,58127,58131,0,115,4
51,10201,406,58131,58135,0,115,4
51,10201,406,58135,58147,0,115,12
51,10201,406,58147,58160,0,115,13
51,10201,406,58160,58170,0,115,10
51,10201,406,58170,58190,0,115,20
51,10201,406,58190,58210,0,115,20
51,10201,406,58210,58223,0,115,13
51,10201,948,58223,58237,0,115,14
51,10201,355,58237,58238,0,115,1
51,10201,355,58238,58251,0,115,13
51,10201,355,58251,58256,0,115,5
51,10201,38,58256,58276,0,115,20
51,10201,38,58276,58285,0,115,9
51,10201,38,58285,58290,0,115,5
51,10201,38,58290,58297,0,115,7
51,10201,28,58297,58304,0,115,7
51,10201,28,58304,58305,0,115,1
51,10201,28,58305,58323,0,115,18
51,10201,28,58323,58339,0,115,16
51,10201,27,58339,58340,0,115,1
51,10201,27,58340,58357,0,115,17
51,10201,27,58357,58377,0,115,20
51,10201,27,58377,58392,0,115,15
51,10201,5,58392,58409,0,115,17
51,10201,5,58409,58416,0,115,7
51,10201,5,58416,58430,0,115,14
51,10201,5,58430,58436,0,115,6
51,10201,5,58436,58442,0,115,6
51,10201,5,58442,58452,0,115,10
51,10201,5,58452,58458,0,115,6
51,10201,5,58458,58475,0,115,17
51,10201,2,58475,58483,0,115,8
51,10201,3,58483,58492,0,115,9
51,10201,3,58492,58512,0,115,20
51,10201,3,58512,58513,0,115,1
51,10201,3,58513,58522,0,115,9
51,10201,3,58522,58527,0,115,5
51,10201,86,58527,58547,0,115,20
51,10201,86,58547,58551,0,115,4
51,10201,121,58551,58566,0,115,15
51,10201,164,58566,58581,0,115,15
51,10201,122,58581,58595,0,115,14
51,10201,122,58595,58609,0,115,14
51,10201,122,58609,58623,0,115,14
51,10201,123,58623,58636,0,115,13
51,10201,123,58636,58653,0,115,17
51,10201,124,58653,58655,0,115,2
51,10201,124,58655,58657,0,115,2
51,10201,124,58657,58666,0,115,9
51,10201,125,58666,58686,0,115,20
51,10201,125,58686,58697,0,115,11
51,10201,125,58697,58707,0,115,10
51,10201,126,58707,58720,0,115,13
51,10201,126,58720,58723,0,115,3
51,10201,126,58723,58728,0,115,5
51,10201,163,58728,58732,0,115,4
51,10201,163,58732,58748,0,115,16
51,10201,163,58748,58762,0,115,14
51,10201,162,58762,58769,0,115,7
51,10201,162,58769,58774,0,115,5
51,10201,162,58774,58775,0,115,1
51,10201,162,58775,58793,0,115,18
51,10201,162,58793,58808,0,115,15
51,10201,162,58808,58819,0,115,11
51,10201,162,58819,58824,0,115,5
51,10201,161,58824,58827,0,115,3
51,10201,161,58827,58828,0,115,1
51,10201,161,58828,58834,0,115,6
51,10201,161,58834,58836,0,115,2
51,10201,161,58836,58855,0,115,19
51,10201,161,58855,58871,0,115,16
51,10201,160,58871,58890,0,115,19
51,10201,160,58890,58900,0,115,10
51,10201,159,58900,58915,0,115,15
51,10201,159,58915,58922,0,115,7
51,10201,159,58922,58933,0,115,11
51,10201,159,58933,58942,0,115,9
51,10201,171,58942,58956,0,115,14
51,10201,171,58956,58961,0,115,5
51,10201,182,58961,58975,0,115,14
51,10201,182,58975,58980,0,115,5
51,10201,182,58980,58998,0,115,18
51,10201,835,58998,59015,0,115,17
51,10201,836,59015,59024,0,115,9
51,10201,836,59024,59040,0,115,16
51,10201,836,59040,59060,0,115,20
51,10201,491,59060,59078,0,115,18
51,10201,491,59078,59095,0,115,17
51,10201,491,59095,59096,0,115,1
51,10201,717,59096,59102,0,115,6
51,10201,837,59102,59111,0,115,9
51,10201,837,59111,59129,0,115,18
51,10201,837,59129,59132,0,115,3
51,10201,837,59132,59152,0,115,20
51,10201,837,59152,59171,0,115,19
51,10201,837,59171,59180,0,115,9
51,10201,837,59180,59191,0,115,11
51,10201,837,59191,59197,0,115,6
51,10201,491,59197,59206,0,115,9
51,10201,491,59206,59213,0,115,7
51,10201,491,59213,59228,0,115,15
51,10201,491,59228,59236,0,115,8
51,10201,491,59236,59240,0,115,4
51,10201,491,59240,59255,0,115,15
51,10201,491,59255,59270,0,115,15
51,10201,491,59270,59286,0,115,16
51,10201,491,59286,59303,0,115,17
51,10201,491,59303,59311,0,115,8
51,10201,491,59311,59321,0,115,10
51,10201,491,59321,59330,0,115,9
51,10211,89,59330,59348,0,95,18
51,10211,88,59348,59357,0,95,9
51,10211,88,59357,59364,0,95,7
51,10211,88,59364,59382,0,95,18
51,10211,88,59382,59389,0,95,7
51,10211,88,59389,59408,0,95,19
51,10211,88,59408,59425,0,95,17
51,10211,88,59425,59442,0,95,17
51,10211,89,59442,59448,0,95,6
51,10211,89,59448,59456,0,95,8
51,10211,89,59456,59468,0,95,12
51,10211,89,59468,59469,0,95,1
51,10211,89,59469,59473,0,95,4
51,10211,89,59473,59490,0,95,17
51,10211,89,59490,59509,0,95,19
51,10211,88,59509,59515,0,95,6
51,10211,89,59515,59527,0,95,12
51,10211,89,59527,59529,0,95,2
51,10211,89,59529,59532,0,95,3
51,10211,89,59532,59552,0,95,20
51,10211,89,59552,59561,0,95,9
51,10211,89,59561,59581,0,95,20
51,10211,89,59581,59586,0,95,5
51,10211,89,59586,59588,0,95,2
51,10211,89,59588,59589,0,95,1
51,10211,89,59589,59608,0,95,19
51,10211,89,59608,59612,0,95,4
51,10211,89,59612,59616,0,95,4
51,10211,88,59616,59625,0,95,9
51,10211,88,59625,59643,0,95,18
51,10211,88,59643,59648,0,95,5
51,10211,88,59648,59664,0,95,16
51,10211,88,59664,59672,0,95,8
51,10211,88,59672,59681,0,95,9
51,10211,88,59681,59696,0,95,15
51,10211,88,59696,59710,0,95,14
51,10211,88,59710,59718,0,95,8
51,10211,88,59718,59730,0,95,12
51,10211,88,59730,59735,0,95,5
51,10211,88,59735,59752,0,95,17
51,10211,88,59752,59767,0,95,15
51,10211,88,59767,59771,0,95,4
51,10211,88,59771,59791,0,95,20
51,10211,88,59791,59809,0,95,18
51,10211,89,59809,59821,0,95,12
51,10211,89,59821,59837,0,95,16
51,10211,89,59837,59840,0,95,3
51,10211,11,59840,59849,0,95,9
51,10211,11,59849,59854,0,95,5
51,10211,11,59854,59870,0,95,16
51,10211,11,59870,59874,0,95,4
51,10211,11,59874,59887,0,95,13
51,10211,11,59887,59902,0,95,15
51,10211,11,59902,59922,0,95,20
51,10211,11,59922,59928,0,95,6
51,10211,11,59928,59942,0,95,14
51,10211,11,59942,59950,0,95,8
51,10211,11,59950,59967,0,95,17
51,10211,11,59967,59987,0,95,20
51,10211,11,59987,59998,0,95,11
51,10211,11,59998,60001,0,95,3
51,10211,11,60001,60017,0,95,16
51,10211,11,60017,60022,0,95,5
51,10211,11,60022,60040,0,95,18
51,10211,11,60040,60059,0,95,19
51,10211,11,60059,60060,0,95,1
51,10211,11,60060,60067,0,95,7
51,10211,10,60067,60075,0,95,8
51,10211,10,60075,60084,0,95,9
51,10211,10,60084,60096,0,95,12
51,10211,10,60096,60107,0,95,11
51,10211,10,60107,60121,0,95,14
51,10211,10,60121,60129,0,95,8
51,10211,10,60129,60133,0,95,4
51,10211,10,60133,60142,0,95,9
51,10211,10,60142,60144,0,95,2
51,10211,10,60144,60145,0,95,1
51,10211,10,60145,60160,0,95,15
51,10211,10,60160,60163,0,95,3
51,10211,10,60163,60177,0,95,14
51,10211,9,60177,60185,0,95,8
51,10211,9,60185,60194,0,95,9
51,10211,9,60194,60206,0,95,12
51,10211,9,60206,60217,0,95,11
51,10211,9,60217,60236,0,95,19
51,10211,9,60236,60241,0,95,5
51,10211,9,60241,60258,0,95,17
51,10211,9,60258,60259,0,95,1
51,10211,9,60259,60267,0,95,8
51,10211,9,60267,60273,0,95,6
51,10211,9,60273,60274,0,95,1
51,10211,9,60274,60277,0,95,3
51,10211,9,60277,60284,0,95,7
51,10211,9,60284,60299,0,95,15
51,10221,387,60299,60312,0,72,13
51,10221,388,60312,60330,0,72,18
51,10221,388,60330,60347,0,72,17
51,10221,388,60347,60357,0,72,10
51,10221,388,60357,60362,0,72,5
51,10221,387,60362,60371,0,72,9
51,10221,387,60371,60376,0,72,5
51,10221,387,60376,60385,0,72,9
51,10221,387,60385,60404,0,72,19
51,10221,387,60404,60416,0,72,12
51,10221,387,60416,60427,0,72,11
51,10221,387,60427,60446,0,72,19
51,10221,387,60446,60461,0,72,15
51,10221,388,60461,60471,0,72,10
51,10221,387,60471,60486,0,72,15
51,10221,387,60486,60492,0,72,6
51,10221,387,60492,60497,0,72,5
51,10221,387,60497,60504,0,72,7
51,10221,387,60504,60506,0,72,2
51,10221,387,60506,60514,0,72,8
51,10221,387,60514,60524,0,72,10
51,10221,387,60524,60527,0,72,3
51,10221,387,60527,60541,0,72,14
51,10221,387,60541,60557,0,72,16
51,10221,387,60557,60576,0,72,19
51,10221,387,60576,60581,0,72,5
51,10221,387,60581,60582,0,72,1
51,10221,387,60582,60585,0,72,3
51,10221,387,60585,60604,0,72,19
51,10221,387,60604,60614,0,72,10
51,10221,387,60614,60627,0,72,13
51,10221,387,60627,60638,0,72,11
51,10221,387,60638,60641,0,72,3
51,10221,387,60641,60648,0,72,7
51,10221,387,60648,60656,0,72,8
51,10221,387,60656,60674,0,72,18
51,10221,387,60674,60682,0,72,8
51,10221,387,60682,60702,0,72,20
51,10221,387,60702,60721,0,72,19
51,10221,387,60721,60738,0,72,17
51,10221,387,60738,60741,0,72,3
51,10221,387,60741,60746,0,72,5
51,10221,387,60746,60752,0,72,6
51,10221,387,60752,60753,0,72,1
51,10221,387,60753,60761,0,72,8
51,10221,387,60761,60776,0,72,15
51,10221,387,60776,60784,0,72,8
51,10221,387,60784,60799,0,72,15
51,10221,387,60799,60812,0,72,13
51,10221,387,60812,60823,0,72,11
51,10221,387,60823,60827,0,72,4
51,10221,387,60827,60844,0,72,17
51,10221,387,60844,60846,0,72,2
51,10221,387,60846,60849,0,72,3
51,10221,387,60849,60864,0,72,15
51,10221,387,60864,60867,0,72,3
51,10221,387,60867,60873,0,72,6
51,10221,387,60873,60886,0,72,13
51,10221,387,60886,60906,0,72,20
51,10221,387,60906,60921,0,72,15
51,10221,387,60921,60936,0,72,15
51,10221,387,60936,60941,0,72,5
51,10221,387,60941,60946,0,72,5
51,10221,387,60946,60949,0,72,3
51,10221,387,60949,60960,0,72,11
51,10221,387,60960,60973,0,72,13
51,10221,387,60973,60992,0,72,19
51,10221,387,60992,61012,0,72,20
51,10221,387,61012,61021,0,72,9
51,10221,387,61021,61034,0,72,13
51,10221,387,61034,61037,0,72,3
81,13031,39,61037,61051,0,26,14
81,13031,39,61051,61068,0,26,17
81,13031,39,61068,61070,0,26,2
81,13031,39,61070,61088,0,26,18
81,13031,39,61088,61106,0,26,18
81,13031,39,61106,61117,0,26,11
81,13031,39,61117,61130,0,26,13
81,13031,39,61130,61136,0,26,6
81,13031,39,61136,61149,0,26,13
81,13031,39,61149,61155,0,26,6
81,13031,296,61155,61165,0,26,10
81,13031,296,61165,61174,0,26,9
81,13031,296,61174,61190,0,26,16
81,13031,296,61190,61199,0,26,9
81,13031,296,61199,61204,0,26,5
81,13031,296,61204,61210,0,26,6
81,13031,296,61210,61227,0,26,17
81,13031,42,61227,61247,0,26,20
81,13031,42,61247,61259,0,26,12
81,13031,43,61259,61279,0,26,20
81,13031,44,61279,61292,0,26,13
81,13031,44,61292,61302,0,26,10
81,13031,45,61302,61304,0,26,2
81,13031,46,61304,61317,0,26,13
81,13031,46,61317,61333,0,26,16
91,14311,29,61333,61338,0,19,5
91,14311,29,61338,61358,0,19,20
91,14311,29,61358,61368,0,19,10
91,14311,29,61368,61382,0,19,14
91,14311,29,61382,61392,0,19,10
91,14311,29,61392,61405,0,19,13
91,14311,29,61405,61412,0,19,7
91,14311,29,61412,61418,0,19,6
91,14311,29,61418,61428,0,19,10
91,14311,23,61428,61436,0,19,8
91,14311,23,61436,61454,0,19,18
91,14311,23,61454,61466,0,19,12
91,14311,23,61466,61476,0,19,10
91,14311,23,61476,61477,0,19,1
91,14311,23,61477,61478,0,19,1
91,14311,23,61478,61485,0,19,7
91,14311,40,61485,61487,0,19,2
91,14311,40,61487,61496,0,19,9
101,15011,2,61496,61501,0,9,5
101,15011,419,61501,61515,0,9,14
101,15011,419,61515,61535,0,9,20
101,15011,419,61535,61538,0,9,3
101,15011,3,61538,61556,0,9,18
101,15011,3,61556,61564,0,9,8
101,15011,3,61564,61575,0,9,11
101,15011,3,61575,61584,0,9,9
111,15451,29,61584,61597,0,4,13
111,15451,29,61597,61616,0,4,19
111,15451,29,61616,61629,0,4,13
111,15461,104,61629,61642,0,28,13
111,15461,99,61642,61653,0,28,11
111,15461,99,61653,61665,0,28,12
111,15461,100,61665,61672,0,28,7
111,15461,34,61672,61691,0,28,19
111,15461,33,61691,61700,0,28,9
111,15461,32,61700,61703,0,28,3
111,15461,2,61703,61706,0,28,3
111,15461,2,61706,61719,0,28,13
111,15461,2,61719,61734,0,28,15
111,15461,5,61734,61742,0,28,8
111,15461,5,61742,61749,0,28,7
111,15461,5,61749,61768,0,28,19
111,15461,5,61768,61771,0,28,3
111,15461,5,61771,61783,0,28,12
111,15461,5,61783,61789,0,28,6
111,15461,5,61789,61798,0,28,9
111,15461,5,61798,61803,0,28,5
111,15461,5,61803,61815,0,28,12
111,15461,2,61815,61832,0,28,17
111,15461,2,61832,61839,0,28,7
111,15461,5,61839,61854,0,28,15
111,15461,5,61854,61869,0,28,15
111,15461,2,61869,61877,0,28,8
111,15461,2,61877,61885,0,28,8
111,15461,2,61885,61899,0,28,14
111,15461,2,61899,61900,0,28,1
111,15471,1273,61900,61914,0,59,14
111,15471,1273,61914,61915,0,59,1
111,15471,1770,61915,61929,0,59,14
111,15471,1446,61929,61949,0,59,20
111,15471,1842,61949,61962,0,59,13
111,15471,1841,61962,61968,0,59,6
111,15471,1839,61968,61978,0,59,10
111,15471,1438,61978,61996,0,59,18
111,15471,2163,61996,62013,0,59,17
111,15471,2250,62013,62015,0,59,2
111,15471,2162,62015,62016,0,59,1
111,15471,2255,62016,62030,0,59,14
111,15471,2160,62030,62047,0,59,17
111,15471,1159,62047,62051,0,59,4
111,15471,1159,62051,62056,0,59,5
111,15471,2159,62056,62071,0,59,15
111,15471,1156,62071,62079,0,59,8
111,15471,2158,62079,62098,0,59,19
111,15471,1154,62098,62106,0,59,8
111,15471,2157,62106,62108,0,59,2
111,15471,1491,62108,62120,0,59,12
111,15471,1924,62120,62122,0,59,2
111,15471,2181,62122,62127,0,59,5
111,15471,1925,62127,62145,0,59,18
111,15471,1926,62145,62154,0,59,9
111,15471,1147,62154,62162,0,59,8
111,15471,2155,62162,62182,0,59,20
111,15471,2154,62182,62186,0,59,4
111,15471,2150,62186,62199,0,59,13
111,15471,2149,62199,62212,0,59,13
111,15471,3040,62212,62229,0,59,17
111,15471,2148,62229,62247,0,59,18
111,15471,2609,62247,62250,0,59,3
111,15471,2142,62250,62266,0,59,16
111,15471,2142,62266,62280,0,59,14
111,15471,2141,62280,62288,0,59,8
111,15471,2140,62288,62300,0,59,12
111,15471,1761,62300,62312,0,59,12
111,15471,1467,62312,62322,0,59,10
111,15471,1503,62322,62339,0,59,17
111,15471,1467,62339,62342,0,59,3
111,15471,1468,62342,62347,0,59,5
111,15471,1469,62347,62357,0,59,10
111,15471,1470,62357,62362,0,59,5
111,15471,1471,62362,62382,0,59,20
111,15471,1471,62382,62394,0,59,12
111,15471,1471,62394,62401,0,59,7
111,15471,1471,62401,62404,0,59,3
111,15471,1472,62404,62411,0,59,7
111,15471,1494,62411,62420,0,59,9
111,15471,1494,62420,62425,0,59,5
111,15471,1494,62425,62444,0,59,19
111,15471,1494,62444,62454,0,59,10
111,15471,1494,62454,62455,0,59,1
111,15471,1494,62455,62466,0,59,11
111,15471,1471,62466,62470,0,59,4
111,15471,1471,62470,62473,0,59,3
111,15471,1471,62473,62478,0,59,5
111,15481,37,62478,62492,0,3,14
111,15481,5,62492,62506,0,3,14
131,18721,2788,62506,62519,0,102,13
131,18721,2788,62519,62529,0,102,10
131,18721,2788,62529,62541,0,102,12
131,18721,2788,62541,62554,0,102,13
131,18721,2788,62554,62565,0,102,11
131,18721,2788,62565,62578,0,102,13
131,18721,2788,62578,62597,0,102,19
131,18721,2788,62597,62610,0,102,13
131,18721,2788,62610,62622,0,102,12
131,18721,2788,62622,62623,0,102,1
131,18721,2788,62623,62643,0,102,20
131,18721,2788,62643,62648,0,102,5
131,18721,2788,62648,62652,0,102,4
131,18721,2788,62652,62672,0,102,20
131,18721,2788,62672,62692,0,102,20
131,18721,2788,62692,62695,0,102,3
131,18721,2788,62695,62701,0,102,6
131,18721,2788,62701,62702,0,102,1
131,18721,2788,62702,62707,0,102,5
131,18721,2788,62707,62727,0,102,20
131,18721,2788,62727,62745,0,102,18
131,18721,2788,62745,62753,0,102,8
131,18721,2788,62753,62756,0,102,3
131,18721,2788,62756,62765,0,102,9
131,18721,2788,62765,62774,0,102,9
131,18721,2788,62774,62783,0,102,9
131,18721,2788,62783,62800,0,102,17
131,18721,2788,62800,62813,0,102,13
131,18721,2788,62813,62815,0,102,2
131,18721,2788,62815,62830,0,102,15
131,18721,2788,62830,62848,0,102,18
131,18721,2788,62848,62865,0,102,17
131,18721,2788,62865,62876,0,102,11
131,18721,2788,62876,62883,0,102,7
131,18721,2788,62883,62888,0,102,5
131,18721,2788,62888,62893,0,102,5
131,18721,2788,62893,62906,0,102,13
131,18721,2788,62906,62924,0,102,18
131,18721,2788,62924,62938,0,102,14
131,18721,2788,62938,62943,0,102,5
131,18721,2788,62943,62945,0,102,2
131,18721,2788,62945,62948,0,102,3
131,18721,2788,62948,62953,0,102,5
131,18721,2788,62953,62965,0,102,12
131,18721,2788,62965,62983,0,102,18
131,18721,2788,62983,62987,0,102,4
131,18721,2788,62987,62992,0,102,5
131,18721,2788,62992,62998,0,102,6
131,18721,2788,62998,63009,0,102,11
131,18721,2788,63009,63021,0,102,12
131,18721,2788,63021,63038,0,102,17
131,18721,2788,63038,63039,0,102,1
131,18721,2788,63039,63047,0,102,8
131,18721,2788,63047,63061,0,102,14
131,18721,2788,63061,63070,0,102,9
131,18721,2788,63070,63078,0,102,8
131,18721,2788,63078,63088,0,102,10
131,18721,2788,63088,63104,0,102,16
131,18721,565,63104,63117,0,102,13
131,18721,565,63117,63137,0,102,20
131,18721,565,63137,63141,0,102,4
131,18721,565,63141,63145,0,102,4
131,18721,565,63145,63156,0,102,11
131,18721,565,63156,63161,0,102,5
131,18721,565,63161,63175,0,102,14
131,18721,565,63175,63180,0,102,5
131,18721,565,63180,63195,0,102,15
131,18721,565,63195,63210,0,102,15
131,18721,565,63210,63230,0,102,20
131,18721,565,63230,63231,0,102,1
131,18721,565,63231,63243,0,102,12
131,18721,565,63243,63255,0,102,12
131,18721,566,63255,63274,0,102,19
131,18721,566,63274,63277,0,102,3
131,18721,566,63277,63291,0,102,14
131,18721,566,63291,63297,0,102,6
131,18721,566,63297,63317,0,102,20
131,18721,566,63317,63320,0,102,3
131,18721,566,63320,63340,0,102,20
131,18721,566,63340,63355,0,102,15
131,18721,566,63355,63371,0,102,16
131,18721,566,63371,63372,0,102,1
131,18721,566,63372,63377,0,102,5
131,18721,566,63377,63383,0,102,6
131,18721,566,63383,63401,0,102,18
131,18721,566,63401,63402,0,102,1
131,18721,566,63402,63406,0,102,4
131,18721,566,63406,63418,0,102,12
131,18721,566,63418,63437,0,102,19
131,18721,566,63437,63453,0,102,16
131,18721,566,63453,63460,0,102,7
131,18721,566,63460,63468,0,102,8
131,18721,566,63468,63485,0,102,17
131,18721,566,63485,63505,0,102,20
131,18721,566,63505,63512,0,102,7
131,18721,566,63512,63529,0,102,17
131,18721,566,63529,63547,0,102,18
131,18721,566,63547,63558,0,102,11
131,18721,566,63558,63572,0,102,14
131,18721,566,63572,63586,0,102,14
131,18721,566,63586,63603,0,102,17
131,18731,29,63603,63621,0,14,18
131,18731,29,63621,63622,0,14,1
131,18731,29,63622,63631,0,14,9
131,18731,6,63631,63642,0,14,11
131,18731,1,63642,63644,0,14,2
131,18731,1,63644,63657,0,14,13
131,18731,1,63657,63667,0,14,10
131,18731,1,63667,63686,0,14,19
131,18731,1,63686,63701,0,14,15
131,18731,1,63701,63708,0,14,7
131,18731,1,63708,63723,0,14,15
131,18731,1,63723,63741,0,14,18
131,18731,1,63741,63749,0,14,8
131,18741,297,63749,63758,0,123,9
131,18741,594,63758,63766,0,123,8
131,18741,594,63766,63773,0,123,7
131,18741,41,63773,63787,0,123,14
131,18741,40,63787,63804,0,123,17
131,18741,40,63804,63820,0,123,16
131,18741,23,63820,63832,0,123,12
131,18741,23,63832,63838,0,123,6
131,18741,23,63838,63851,0,123,13
131,18741,23,63851,63865,0,123,14
131,18741,23,63865,63869,0,123,4
131,18741,23,63869,63870,0,123,1
131,18741,23,63870,63877,0,123,7
131,18741,23,63877,63880,0,123,3
131,18741,23,63880,63886,0,123,6
131,18741,23,63886,63899,0,123,13
131,18741,23,63899,63910,0,123,11
131,18741,23,63910,63919,0,123,9
131,18741,23,63919,63927,0,123,8
131,18741,23,63927,63933,0,123,6
131,18741,23,63933,63938,0,123,5
131,18741,23,63938,63945,0,123,7
131,18741,23,63945,63947,0,123,2
131,18741,23,63947,63954,0,123,7
131,18741,23,63954,63969,0,123,15
131,18741,23,63969,63979,0,123,10
131,18741,23,63979,63980,0,123,1
131,18741,23,63980,63991,0,123,11
131,18741,23,63991,63994,0,123,3
131,18741,23,63994,64007,0,123,13
131,18741,23,64007,64009,0,123,2
131,18741,23,64009,64016,0,123,7
131,18741,23,64016,64026,0,123,10
131,18741,23,64026,64029,0,123,3
131,18741,23,64029,64047,0,123,18
131,18741,23,64047,64051,0,123,4
131,18741,23,64051,64052,0,123,1
131,18741,23,64052,64054,0,123,2
131,18741,23,64054,64069,0,123,15
131,18741,23,64069,64089,0,123,20
131,18741,23,64089,64107,0,123,18
131,18741,23,64107,64119,0,123,12
131,18741,23,64119,64120,0,123,1
131,18741,23,64120,64121,0,123,1
131,18741,23,64121,64136,0,123,15
131,18741,23,64136,64143,0,123,7
131,18741,23,64143,64158,0,123,15
131,18741,23,64158,64168,0,123,10
131,18741,39,64168,64170,0,123,2
131,18741,40,64170,64179,0,123,9
131,18741,41,64179,64182,0,123,3
131,18741,41,64182,64201,0,123,19
131,18741,42,64201,64204,0,123,3
131,18741,43,64204,64223,0,123,19
131,18741,290,64223,64243,0,123,20
131,18741,407,64243,64259,0,123,16
131,18741,407,64259,64265,0,123,6
131,18741,292,64265,64281,0,123,16
131,18741,408,64281,64284,0,123,3
131,18741,408,64284,64299,0,123,15
131,18741,409,64299,64302,0,123,3
131,18741,410,64302,64319,0,123,17
131,18741,411,64319,64322,0,123,3
131,18741,411,64322,64324,0,123,2
131,18741,411,64324,64338,0,123,14
131,18741,412,64338,64343,0,123,5
131,18741,412,64343,64362,0,123,19
131,18741,412,64362,64379,0,123,17
131,18741,412,64379,64393,0,123,14
131,18741,412,64393,64396,0,123,3
131,18741,413,64396,64404,0,123,8
131,18741,413,64404,64417,0,123,13
131,18741,553,64417,64436,0,123,19
131,18741,553,64436,64441,0,123,5
131,18741,554,64441,64450,0,123,9
131,18741,293,64450,64451,0,123,1
131,18741,483,64451,64461,0,123,10
131,18741,482,64461,64470,0,123,9
131,18741,481,64470,64488,0,123,18
131,18741,481,64488,64498,0,123,10
131,18741,481,64498,64506,0,123,8
131,18741,481,64506,64523,0,123,17
131,18741,481,64523,64533,0,123,10
131,18741,481,64533,64551,0,123,18
131,18741,481,64551,64558,0,123,7
131,18741,481,64558,64570,0,123,12
131,18741,481,64570,64574,0,123,4
131,18741,481,64574,64580,0,123,6
131,18741,481,64580,64588,0,123,8
131,18741,481,64588,64597,0,123,9
131,18741,481,64597,64606,0,123,9
131,18741,481,64606,64615,0,123,9
131,18741,481,64615,64625,0,123,10
131,18741,481,64625,64633,0,123,8
131,18741,481,64633,64643,0,123,10
131,18741,481,64643,64646,0,123,3
131,18741,481,64646,64660,0,123,14
131,18741,481,64660,64671,0,123,11
131,18741,481,64671,64681,0,123,10
131,18741,481,64681,64698,0,123,17
131,18741,481,64698,64710,0,123,12
131,18741,481,64710,64724,0,123,14
131,18741,481,64724,64737,0,123,13
131,18741,481,64737,64757,0,123,20
131,18741,481,64757,64762,0,123,5
131,18741,481,64762,64765,0,123,3
131,18741,481,64765,64781,0,123,16
131,18741,481,64781,64788,0,123,7
131,18741,481,64788,64808,0,123,20
131,18741,481,64808,64811,0,123,3
131,18741,481,64811,64827,0,123,16
131,18741,481,64827,64840,0,123,13
131,18741,481,64840,64860,0,123,20
131,18741,481,64860,64869,0,123,9
131,18741,481,64869,64871,0,123,2
131,18741,481,64871,64889,0,123,18
131,18741,481,64889,64899,0,123,10
131,18741,481,64899,64903,0,123,4
131,18741,481,64903,64914,0,123,11
131,18741,481,64914,64916,0,123,2
131,18741,481,64916,64936,0,123,20
131,18741,481,64936,64944,0,123,8
131,18751,29,64944,64958,0,10,14
131,18751,29,64958,64968,0,10,10
131,18751,29,64968,64981,0,10,13
131,18751,29,64981,64990,0,10,9
131,18751,29,64990,64996,0,10,6
131,18751,29,64996,65014,0,10,18
131,18751,29,65014,65019,0,10,5
131,18751,23,65019,65031,0,10,12
131,18751,23,65031,65046,0,10,15
141,18981,3677,65046,65057,0,50,11
141,18981,1320,65057,65071,0,50,14
141,18981,1319,65071,65086,0,50,15
141,18981,1318,65086,65101,0,50,15
141,18981,3404,65101,65115,0,50,14
141,18981,3404,65115,65131,0,50,16
141,18981,1311,65131,65137,0,50,6
141,18981,1310,65137,65139,0,50,2
141,18981,1306,65139,65146,0,50,7
141,18981,1302,65146,65148,0,50,2
141,18981,3057,65148,65160,0,50,12
141,18981,1295,65160,65180,0,50,20
141,18981,1293,65180,65199,0,50,19
141,18981,1284,65199,65218,0,50,19
141,18981,1284,65218,65235,0,50,17
141,18981,233,65235,65255,0,50,20
141,18981,255,65255,65265,0,50,10
141,18981,248,65265,65275,0,50,10
141,18981,593,65275,65288,0,50,13
141,18981,593,65288,65294,0,50,6
141,18981,593,65294,65311,0,50,17
141,18981,1733,65311,65321,0,50,10
141,18981,1733,65321,65328,0,50,7
141,18981,257,65328,65343,0,50,15
141,18981,257,65343,65361,0,50,18
141,18981,257,65361,65378,0,50,17
141,18981,257,65378,65394,0,50,16
141,18981,614,65394,65412,0,50,18
141,18981,294,65412,65427,0,50,15
141,18981,671,65427,65439,0,50,12
141,18981,685,65439,65459,0,50,20
141,18981,675,65459,65473,0,50,14
141,18981,675,65473,65482,0,50,9
141,18981,410,65482,65496,0,50,14
141,18981,410,65496,65499,0,50,3
141,18981,410,65499,65517,0,50,18
141,18981,47,65517,65519,0,50,2
141,18981,47,65519,65528,0,50,9
141,18981,47,65528,65541,0,50,13
141,18981,47,65541,65557,0,50,16
141,18981,47,65557,65571,0,50,14
141,18981,47,65571,65585,0,50,14
141,18981,47,65585,65586,0,50,1
141,18981,50,65586,65591,0,50,5
141,18981,50,65591,65610,0,50,19
141,18981,50,65610,65629,0,50,19
141,18981,50,65629,65645,0,50,16
141,18981,50,65645,65665,0,50,20
141,18981,50,65665,65674,0,50,9
141,18991,199,65674,65676,0,33,2
141,18991,199,65676,65696,0,33,20
141,18991,199,65696,65709,0,33,13
141,18991,198,65709,65718,0,33,9
141,18991,236,65718,65734,0,33,16
141,18991,236,65734,65744,0,33,10
141,18991,197,65744,65762,0,33,18
141,18991,195,65762,65772,0,33,10
141,18991,194,65772,65782,0,33,10
141,18991,225,65782,65795,0,33,13
141,18991,191,65795,65812,0,33,17
141,18991,190,65812,65817,0,33,5
141,18991,189,65817,65827,0,33,10
141,18991,490,65827,65845,0,33,18
141,18991,490,65845,65849,0,33,4
141,18991,555,65849,65857,0,33,8
141,18991,482,65857,65858,0,33,1
141,18991,483,65858,65875,0,33,17
141,18991,554,65875,65893,0,33,18
141,18991,413,65893,65902,0,33,9
141,18991,412,65902,65919,0,33,17
141,18991,411,65919,65938,0,33,19
141,18991,409,65938,65940,0,33,2
141,18991,408,65940,65959,0,33,19
141,18991,407,65959,65976,0,33,17
141,18991,365,65976,65980,0,33,4
141,18991,101,65980,65997,0,33,17
141,18991,30,65997,66012,0,33,15
141,18991,30,66012,66016,0,33,4
141,18991,30,66016,66022,0,33,6
141,18991,29,66022,66036,0,33,14
141,18991,29,66036,66044,0,33,8
141,19001,107,66044,66052,0,42,8
141,19001,107,66052,66056,0,42,4
141,19001,105,66056,66068,0,42,12
141,19001,105,66068,66070,0,42,2
141,19001,105,66070,66088,0,42,18
141,19001,105,66088,66089,0,42,1
141,19001,540,66089,66101,0,42,12
141,19001,539,66101,66111,0,42,10
141,19001,538,66111,66121,0,42,10
141,19001,685,66121,66134,0,42,13
141,19001,674,66134,66136,0,42,2
141,19001,686,66136,66155,0,42,19
141,19001,686,66155,66172,0,42,17
141,19001,686,66172,66179,0,42,7
141,19001,671,66179,66184,0,42,5
141,19001,479,66184,66185,0,42,1
141,19001,479,66185,66190,0,42,5
141,19001,1201,66190,66200,0,42,10
141,19001,294,66200,66220,0,42,20
141,19001,294,66220,66231,0,42,11
141,19001,486,66231,66236,0,42,5
141,19001,488,66236,66242,0,42,6
141,19001,487,66242,66247,0,42,5
141,19001,955,66247,66257,0,42,10
141,19001,190,66257,66268,0,42,11
141,19001,191,66268,66277,0,42,9
141,19001,192,66277,66283,0,42,6
141,19001,193,66283,66295,0,42,12
141,19001,194,66295,66304,0,42,9
141,19001,194,66304,66317,0,42,13
141,19001,235,66317,66334,0,42,17
141,19001,195,66334,66352,0,42,18
141,19001,196,66352,66368,0,42,16
141,19001,196,66368,66369,0,42,1
141,19001,196,66369,66370,0,42,1
141,19001,196,66370,66374,0,42,4
141,19001,197,66374,66387,0,42,13
141,19001,236,66387,66404,0,42,17
141,19001,236,66404,66406,0,42,2
141,19001,236,66406,66408,0,42,2
141,19001,236,66408,66427,0,42,19
141,19011,350,66427,66434,0,11,7
141,19011,350,66434,66451,0,11,17
141,19011,350,66451,66456,0,11,5
141,19011,350,66456,66462,0,11,6
141,19011,306,66462,66470,0,11,8
141,19011,306,66470,66482,0,11,12
141,19011,306,66482,66496,0,11,14
141,19011,306,66496,66497,0,11,1
141,19011,29,66497,66510,0,11,13
141,19011,29,66510,66513,0,11,3
141,19021,47,66513,66523,0,8,10
141,19021,47,66523,66528,0,8,5
141,19021,47,66528,66542,0,8,14
141,19021,47,66542,66546,0,8,4
141,19021,47,66546,66551,0,8,5
141,19021,47,66551,66554,0,8,3
141,19021,47,66554,66555,0,8,1
141,19031,23,66555,66562,0,11,7
141,19031,40,66562,66563,0,11,1
141,19031,42,66563,66571,0,11,8
141,19031,43,66571,66588,0,11,17
141,19031,45,66588,66608,0,11,20
141,19031,46,66608,66625,0,11,17
141,19031,47,66625,66629,0,11,4
141,19031,50,66629,66647,0,11,18
141,19031,50,66647,66649,0,11,2
141,19031,47,66649,66662,0,11,13
141,19041,47,66662,66677,0,22,15
141,19041,47,66677,66690,0,22,13
141,19041,47,66690,66692,0,22,2
141,19041,47,66692,66712,0,22,20
141,19041,47,66712,66730,0,22,18
141,19041,46,66730,66746,0,22,16
141,19041,45,66746,66755,0,22,9
141,19041,44,66755,66768,0,22,13
141,19041,43,66768,66784,0,22,16
141,19041,42,66784,66802,0,22,18
141,19041,41,66802,66804,0,22,2
141,19041,41,66804,66812,0,22,8
141,19041,40,66812,66814,0,22,2
141,19041,23,66814,66815,0,22,1
141,19041,29,66815,66823,0,22,8
141,19041,39,66823,66834,0,22,11
141,19041,39,66834,66844,0,22,10
141,19041,29,66844,66863,0,22,19
141,19041,29,66863,66877,0,22,14
141,19041,39,66877,66893,0,22,16
141,19041,1,66893,66910,0,22,17
141,19051,290,66910,66922,0,3,12
141,19051,290,66922,66933,0,3,11
141,19061,51,66933,66940,0,73,7
141,19061,80,66940,66946,0,73,6
141,19061,667,66946,66947,0,73,1
141,19061,668,66947,66948,0,73,1
141,19061,668,66948,66964,0,73,16
141,19061,668,66964,66974,0,73,10
141,19061,668,66974,66981,0,73,7
141,19061,668,66981,66995,0,73,14
141,19061,1648,66995,67008,0,73,13
141,19061,1648,67008,67017,0,73,9
141,19061,261,67017,67030,0,73,13
141,19061,261,67030,67043,0,73,13
141,19061,261,67043,67054,0,73,11
141,19061,262,67054,67062,0,73,8
141,19061,262,67062,67064,0,73,2
141,19061,1912,67064,67073,0,73,9
141,19061,1912,67073,67080,0,73,7
141,19061,1912,67080,67094,0,73,14
141,19061,1275,67094,67113,0,73,19
141,19061,262,67113,67119,0,73,6
141,19061,262,67119,67139,0,73,20
141,19061,262,67139,67142,0,73,3
141,19061,262,67142,67149,0,73,7
141,19061,1275,67149,67160,0,73,11
141,19061,1275,67160,67177,0,73,17
141,19061,1912,67177,67192,0,73,15
141,19061,1912,67192,67206,0,73,14
141,19061,1648,67206,67208,0,73,2
141,19061,261,67208,67211,0,73,3
141,19061,668,67211,67218,0,73,7
141,19061,263,67218,67219,0,73,1
141,19061,263,67219,67238,0,73,19
141,19061,261,67238,67253,0,73,15
141,19061,1648,67253,67271,0,73,18
141,19061,1648,67271,67279,0,73,8
141,19061,1648,67279,67295,0,73,16
141,19061,1648,67295,67309,0,73,14
141,19061,1582,67309,67322,0,73,13
141,19061,1582,67322,67326,0,73,4
141,19061,116,67326,67340,0,73,14
141,19061,116,67340,67354,0,73,14
141,19061,116,67354,67367,0,73,13
141,19061,116,67367,67369,0,73,2
141,19061,116,67369,67381,0,73,12
141,19061,56,67381,67390,0,73,9
141,19061,56,67390,67405,0,73,15
141,19061,56,67405,67420,0,73,15
141,19061,56,67420,67425,0,73,5
141,19061,56,67425,67441,0,73,16
141,19061,115,67441,67460,0,73,19
141,19061,1582,67460,67478,0,73,18
141,19061,1582,67478,67479,0,73,1
141,19061,1582,67479,67487,0,73,8
141,19061,1582,67487,67501,0,73,14
141,19061,116,67501,67510,0,73,9
141,19061,1648,67510,67512,0,73,2
141,19061,1648,67512,67524,0,73,12
141,19061,1582,67524,67535,0,73,11
141,19061,1647,67535,67551,0,73,16
141,19061,1647,67551,67567,0,73,16
141,19061,53,67567,67587,0,73,20
141,19061,53,67587,67592,0,73,5
141,19061,53,67592,67610,0,73,18
141,19061,53,67610,67619,0,73,9
141,19061,52,67619,67633,0,73,14
141,19061,80,67633,67634,0,73,1
141,19061,51,67634,67640,0,73,6
141,19061,50,67640,67653,0,73,13
141,19061,50,67653,67673,0,73,20
141,19061,50,67673,67682,0,73,9
141,19061,50,67682,67695,0,73,13
141,19061,47,67695,67697,0,73,2
141,19071,29,67697,67709,0,14,12
141,19071,29,67709,67728,0,14,19
141,19071,40,67728,67744,0,14,16
141,19071,41,67744,67749,0,14,5
141,19071,43,67749,67751,0,14,2
141,19071,45,67751,67755,0,14,4
141,19071,45,67755,67767,0,14,12
141,19071,46,67767,67773,0,14,6
141,19071,46,67773,67778,0,14,5
141,19071,47,67778,67782,0,14,4
141,19071,47,67782,67793,0,14,11
141,19071,47,67793,67809,0,14,16
141,19071,47,67809,67812,0,14,3
141,19081,50,67812,67822,0,70,10
141,19081,50,67822,67829,0,70,7
141,19081,50,67829,67837,0,70,8
141,19081,50,67837,67841,0,70,4
141,19081,50,67841,67844,0,70,3
141,19081,50,67844,67851,0,70,7
141,19081,51,67851,67870,0,70,19
141,19081,51,67870,67873,0,70,3
141,19081,667,67873,67875,0,70,2
141,19081,80,67875,67893,0,70,18
141,19081,667,67893,67909,0,70,16
141,19081,260,67909,67925,0,70,16
141,19081,265,67925,67939,0,70,14
141,19081,266,67939,67941,0,70,2
141,19081,267,67941,67954,0,70,13
141,19081,267,67954,67974,0,70,20
141,19081,267,67974,67992,0,70,18
141,19081,268,67992,67996,0,70,4
141,19081,711,67996,68016,0,70,20
141,19081,270,68016,68033,0,70,17
141,19081,283,68033,68044,0,70,11
141,19081,272,68044,68051,0,70,7
141,19081,1339,68051,68065,0,70,14
141,19081,282,68065,68075,0,70,10
141,19081,276,68075,68086,0,70,11
141,19081,281,68086,68088,0,70,2
141,19081,280,68088,68089,0,70,1
141,19081,1848,68089,68103,0,70,14
141,19081,1505,68103,68118,0,70,15
141,19081,1521,68118,68138,0,70,20
141,19081,1488,68138,68147,0,70,9
141,19081,1455,68147,68157,0,70,10
141,19081,1152,68157,68176,0,70,19
141,19081,1491,68176,68178,0,70,2
141,19081,1924,68178,68182,0,70,4
141,19081,2181,68182,68197,0,70,15
141,19081,1925,68197,68214,0,70,17
141,19081,1925,68214,68216,0,70,2
141,19081,1926,68216,68224,0,70,8
141,19081,1932,68224,68241,0,70,17
141,19081,1147,68241,68247,0,70,6
141,19081,1147,68247,68258,0,70,11
141,19081,2156,68258,68260,0,70,2
141,19081,2154,68260,68262,0,70,2
141,19081,2153,68262,68281,0,70,19
141,19081,2152,68281,68287,0,70,6
141,19081,3039,68287,68299,0,70,12
141,19081,2151,68299,68309,0,70,10
141,19081,2150,68309,68316,0,70,7
141,19081,2149,68316,68327,0,70,11
141,19081,3040,68327,68329,0,70,2
141,19081,2148,68329,68330,0,70,1
141,19081,2609,68330,68349,0,70,19
141,19081,2146,68349,68367,0,70,18
141,19081,3041,68367,68371,0,70,4
141,19081,3041,68371,68372,0,70,1
141,19081,4480,68372,68382,0,70,10
141,19081,4480,68382,68399,0,70,17
141,19081,4480,68399,68405,0,70,6
141,19081,4480,68405,68412,0,70,7
141,19081,4480,68412,68421,0,70,9
141,19081,4480,68421,68427,0,70,6
141,19081,3041,68427,68434,0,70,7
141,19081,3041,68434,68446,0,70,12
141,19081,3041,68446,68465,0,70,19
141,19081,2143,68465,68467,0,70,2
141,19081,2142,68467,68482,0,70,15
141,19081,2142,68482,68502,0,70,20
141,19081,2142,68502,68516,0,70,14
141,19091,54,68516,68526,0,16,10
141,19091,115,68526,68530,0,16,4
141,19091,116,68530,68544,0,16,14
141,19091,117,68544,68548,0,16,4
141,19091,59,68548,68562,0,16,14
141,19091,60,68562,68563,0,16,1
141,19091,118,68563,68573,0,16,10
141,19091,63,68573,68589,0,16,16
141,19091,119,68589,68606,0,16,17
141,19091,65,68606,68608,0,16,2
141,19091,66,68608,68613,0,16,5
141,19091,67,68613,68622,0,16,9
141,19091,68,68622,68630,0,16,8
141,19091,69,68630,68642,0,16,12
141,19091,69,68642,68643,0,16,1
141,19101,50,68643,68651,0,77,8
141,19101,50,68651,68665,0,77,14
141,19101,49,68665,68679,0,77,14
141,19101,49,68679,68684,0,77,5
141,19101,411,68684,68702,0,77,18
141,19101,411,68702,68721,0,77,19
141,19101,411,68721,68730,0,77,9
141,19101,411,68730,68734,0,77,4
141,19101,411,68734,68746,0,77,12
141,19101,412,68746,68762,0,77,16
141,19101,413,68762,68766,0,77,4
141,19101,553,68766,68775,0,77,9
141,19101,554,68775,68780,0,77,5
141,19101,554,68780,68791,0,77,11
141,19101,1362,68791,68798,0,77,7
141,19101,1362,68798,68817,0,77,19
141,19101,293,68817,68823,0,77,6
141,19101,293,68823,68826,0,77,3
141,19101,1362,68826,68827,0,77,1
141,19101,293,68827,68845,0,77,18
141,19101,293,68845,68850,0,77,5
141,19101,293,68850,68867,0,77,17
141,19101,293,68867,68869,0,77,2
141,19101,293,68869,68885,0,77,16
141,19101,293,68885,68892,0,77,7
141,19101,293,68892,68893,0,77,1
141,19101,293,68893,68904,0,77,11
141,19101,293,68904,68910,0,77,6
141,19101,293,68910,68926,0,77,16
141,19101,293,68926,68936,0,77,10
141,19101,293,68936,68955,0,77,19
141,19101,293,68955,68973,0,77,18
141,19101,293,68973,68984,0,77,11
141,19101,293,68984,68995,0,77,11
141,19101,293,68995,69003,0,77,8
141,19101,293,69003,69020,0,77,17
141,19101,293,69020,69036,0,77,16
141,19101,293,69036,69038,0,77,2
141,19101,293,69038,69052,0,77,14
141,19101,293,69052,69059,0,77,7
141,19101,293,69059,69072,0,77,13
141,19101,293,69072,69075,0,77,3
141,19101,293,69075,69083,0,77,8
141,19101,293,69083,69093,0,77,10
141,19101,1362,69093,69099,0,77,6
141,19101,1362,69099,69117,0,77,18
141,19101,1362,69117,69133,0,77,16
141,19101,1362,69133,69149,0,77,16
141,19101,1362,69149,69154,0,77,5
141,19101,1362,69154,69156,0,77,2
141,19101,1362,69156,69159,0,77,3
141,19101,1362,69159,69173,0,77,14
141,19101,1362,69173,69187,0,77,14
141,19101,1362,69187,69205,0,77,18
141,19101,1362,69205,69212,0,77,7
141,19101,1362,69212,69227,0,77,15
141,19101,1362,69227,69244,0,77,17
141,19101,1362,69244,69255,0,77,11
141,19101,293,69255,69267,0,77,12
141,19101,293,69267,69277,0,77,10
141,19101,293,69277,69284,0,77,7
141,19101,293,69284,69288,0,77,4
141,19101,293,69288,69302,0,77,14
141,19101,293,69302,69317,0,77,15
141,19101,293,69317,69328,0,77,11
141,19101,293,69328,69342,0,77,14
141,19101,293,69342,69354,0,77,12
141,19101,293,69354,69359,0,77,5
141,19101,293,69359,69378,0,77,19
141,19101,293,69378,69389,0,77,11
141,19101,293,69389,69398,0,77,9
141,19101,293,69398,69407,0,77,9
141,19101,293,69407,69410,0,77,3
141,19101,293,69410,69418,0,77,8
141,19101,293,69418,69428,0,77,10
141,19101,293,69428,69447,0,77,19
141,19111,42,69447,69456,0,4,9
141,19111,296,69456,69467,0,4,11
141,19111,296,69467,69468,0,4,1
141,19121,657,69468,69473,0,90,5
141,19121,656,69473,69480,0,90,7
141,19121,656,69480,69487,0,90,7
141,19121,656,69487,69489,0,90,2
141,19121,655,69489,69494,0,90,5
141,19121,655,69494,69508,0,90,14
141,19121,654,69508,69510,0,90,2
141,19121,654,69510,69519,0,90,9
141,19121,3942,69519,69535,0,90,16
141,19121,3942,69535,69549,0,90,14
141,19121,2177,69549,69565,0,90,16
141,19121,2177,69565,69584,0,90,19
141,19121,2177,69584,69586,0,90,2
141,19121,2177,69586,69589,0,90,3
141,19121,2177,69589,69594,0,90,5
141,19121,2177,69594,69606,0,90,12
141,19121,2177,69606,69609,0,90,3
141,19121,2177,69609,69619,0,90,10
141,19121,2177,69619,69632,0,90,13
141,19121,550,69632,69641,0,90,9
141,19121,550,69641,69645,0,90,4
141,19121,550,69645,69647,0,90,2
141,19121,550,69647,69663,0,90,16
141,19121,550,69663,69672,0,90,9
141,19121,550,69672,69677,0,90,5
141,19121,550,69677,69693,0,90,16
141,19121,550,69693,69709,0,90,16
141,19121,550,69709,69726,0,90,17
141,19121,550,69726,69736,0,90,10
141,19121,550,69736,69749,0,90,13
141,19121,550,69749,69764,0,90,15
141,19121,550,69764,69784,0,90,20
141,19121,550,69784,69787,0,90,3
141,19121,550,69787,69795,0,90,8
141,19121,550,69795,69813,0,90,18
141,19121,550,69813,69825,0,90,12
141,19121,550,69825,69835,0,90,10
141,19121,550,69835,69848,0,90,13
141,19121,550,69848,69850,0,90,2
141,19121,550,69850,69865,0,90,15
141,19121,550,69865,69882,0,90,17
141,19121,550,69882,69891,0,90,9
141,19121,550,69891,69906,0,90,15
141,19121,550,69906,69920,0,90,14
141,19121,550,69920,69925,0,90,5
141,19121,550,69925,69931,0,90,6
141,19121,550,69931,69946,0,90,15
141,19121,550,69946,69947,0,90,1
141,19121,550,69947,69954,0,90,7
141,19121,2177,69954,69964,0,90,10
141,19121,2177,69964,69972,0,90,8
141,19121,2177,69972,69985,0,90,13
141,19121,550,69985,69988,0,90,3
141,19121,2177,69988,69989,0,90,1
141,19121,2177,69989,69996,0,90,7
141,19121,550,69996,70008,0,90,12
141,19121,2177,70008,70009,0,90,1
141,19121,550,70009,70029,0,90,20
141,19121,550,70029,70040,0,90,11
141,19121,550,70040,70060,0,90,20
141,19121,550,70060,70068,0,90,8
141,19121,2177,70068,70086,0,90,18
141,19121,2177,70086,70093,0,90,7
141,19121,2177,70093,70113,0,90,20
141,19121,2177,70113,70130,0,90,17
141,19121,2177,70130,70148,0,90,18
141,19121,3942,70148,70167,0,90,19
141,19121,1736,70167,70172,0,90,5
141,19121,654,70172,70189,0,90,17
141,19121,654,70189,70203,0,90,14
141,19121,654,70203,70216,0,90,13
141,19121,654,70216,70220,0,90,4
141,19121,654,70220,70233,0,90,13
141,19121,655,70233,70236,0,90,3
141,19121,655,70236,70246,0,90,10
141,19121,656,70246,70262,0,90,16
141,19121,656,70262,70264,0,90,2
141,19121,657,70264,70282,0,90,18
141,19121,657,70282,70292,0,90,10
141,19121,50,70292,70296,0,90,4
141,19121,50,70296,70301,0,90,5
141,19121,50,70301,70309,0,90,8
141,19121,51,70309,70323,0,90,14
141,19121,51,70323,70338,0,90,15
141,19121,50,70338,70343,0,90,5
141,19121,50,70343,70359,0,90,16
141,19121,47,70359,70369,0,90,10
141,19121,47,70369,70371,0,90,2
141,19121,47,70371,70390,0,90,19
141,19131,29,70390,70402,0,16,12
141,19131,23,70402,70419,0,16,17
141,19131,23,70419,70430,0,16,11
141,19131,23,70430,70443,0,16,13
141,19131,23,70443,70446,0,16,3
141,19131,23,70446,70466,0,16,20
141,19131,23,70466,70482,0,16,16
141,19131,23,70482,70484,0,16,2
141,19131,23,70484,70486,0,16,2
141,19131,23,70486,70502,0,16,16
141,19131,23,70502,70508,0,16,6
141,19131,29,70508,70524,0,16,16
141,19131,29,70524,70525,0,16,1
141,19131,29,70525,70537,0,16,12
141,19131,29,70537,70554,0,16,17
141,19141,47,70554,70571,0,67,17
141,19141,46,70571,70584,0,67,13
141,19141,45,70584,70585,0,67,1
141,19141,44,70585,70597,0,67,12
141,19141,43,70597,70611,0,67,14
141,19141,41,70611,70615,0,67,4
141,19141,41,70615,70634,0,67,19
141,19141,41,70634,70652,0,67,18
141,19141,296,70652,70668,0,67,16
141,19141,296,70668,70677,0,67,9
141,19141,296,70677,70690,0,67,13
141,19141,39,70690,70709,0,67,19
141,19141,39,70709,70711,0,67,2
141,19141,39,70711,70725,0,67,14
141,19141,39,70725,70729,0,67,4
141,19141,39,70729,70749,0,67,20
141,19141,29,70749,70758,0,67,9
141,19141,39,70758,70774,0,67,16
141,19141,40,70774,70779,0,67,5
141,19141,40,70779,70780,0,67,1
141,19141,296,70780,70781,0,67,1
141,19141,296,70781,70792,0,67,11
141,19141,39,70792,70797,0,67,5
141,19141,39,70797,70807,0,67,10
141,19141,39,70807,70821,0,67,14
141,19141,39,70821,70838,0,67,17
141,19141,39,70838,70851,0,67,13
141,19141,39,70851,70864,0,67,13
141,19141,39,70864,70883,0,67,19
141,19141,39,70883,70892,0,67,9
141,19141,39,70892,70898,0,67,6
141,19141,39,70898,70917,0,67,19
141,19141,39,70917,70935,0,67,18
141,19141,39,70935,70943,0,67,8
141,19141,39,70943,70951,0,67,8
141,19141,39,70951,70956,0,67,5
141,19141,40,70956,70959,0,67,3
141,19141,41,70959,70975,0,67,16
141,19141,42,70975,70991,0,67,16
141,19141,43,70991,71004,0,67,13
141,19141,43,71004,71016,0,67,12
141,19141,44,71016,71025,0,67,9
141,19141,44,71025,71042,0,67,17
141,19141,45,71042,71051,0,67,9
141,19141,46,71051,71052,0,67,1
141,19141,47,71052,71058,0,67,6
141,19141,50,71058,71061,0,67,3
141,19141,50,71061,71069,0,67,8
141,19141,50,71069,71079,0,67,10
141,19141,50,71079,71095,0,67,16
141,19141,51,71095,71104,0,67,9
141,19141,51,71104,71118,0,67,14
141,19141,51,71118,71120,0,67,2
141,19141,51,71120,71126,0,67,6
141,19141,51,71126,71135,0,67,9
141,19141,51,71135,71137,0,67,2
141,19141,51,71137,71143,0,67,6
141,19141,51,71143,71157,0,67,14
141,19141,51,71157,71159,0,67,2
141,19141,50,71159,71166,0,67,7
141,19141,50,71166,71179,0,67,13
141,19141,50,71179,71196,0,67,17
141,19141,47,71196,71211,0,67,15
141,19141,47,71211,71218,0,67,7
141,19141,47,71218,71230,0,67,12
141,19141,411,71230,71248,0,67,18
141,19151,388,71248,71263,0,134,15
141,19151,388,71263,71283,0,134,20
141,19151,388,71283,71294,0,134,11
141,19151,388,71294,71295,0,134,1
141,19151,388,71295,71314,0,134,19
141,19151,388,71314,71323,0,134,9
141,19151,388,71323,71330,0,134,7
141,19151,388,71330,71344,0,134,14
141,19151,388,71344,71348,0,134,4
141,19151,388,71348,71366,0,134,18
141,19151,388,71366,71368,0,134,2
141,19151,388,71368,71381,0,134,13
141,19151,388,71381,71391,0,134,10
141,19151,388,71391,71394,0,134,3
141,19151,388,71394,71414,0,134,20
141,19151,388,71414,71419,0,134,5
141,19151,388,71419,71437,0,134,18
141,19151,388,71437,71446,0,134,9
141,19151,388,71446,71459,0,134,13
141,19151,388,71459,71474,0,134,15
141,19151,388,71474,71476,0,134,2
141,19151,388,71476,71483,0,134,7
141,19151,388,71483,71491,0,134,8
141,19151,388,71491,71510,0,134,19
141,19151,388,71510,71526,0,134,16
141,19151,388,71526,71531,0,134,5
141,19151,388,71531,71541,0,134,10
141,19151,388,71541,71544,0,134,3
141,19151,388,71544,71563,0,134,19
141,19151,388,71563,71571,0,134,8
141,19151,388,71571,71582,0,134,11
141,19151,388,71582,71593,0,134,11
141,19151,388,71593,71607,0,134,14
141,19151,388,71607,71621,0,134,14
141,19151,388,71621,71633,0,134,12
141,19151,388,71633,71647,0,134,14
141,19151,388,71647,71649,0,134,2
141,19151,388,71649,71668,0,134,19
141,19151,388,71668,71681,0,134,13
141,19151,388,71681,71695,0,134,14
141,19151,388,71695,71705,0,134,10
141,19151,388,71705,71708,0,134,3
141,19151,388,71708,71726,0,134,18
141,19151,388,71726,71734,0,134,8
141,19151,388,71734,71739,0,134,5
141,19151,388,71739,71740,0,134,1
141,19151,388,71740,71751,0,134,11
141,19151,388,71751,71757,0,134,6
141,19151,388,71757,71766,0,134,9
141,19151,388,71766,71768,0,134,2
141,19151,388,71768,71781,0,134,13
141,19151,388,71781,71785,0,134,4
141,19151,388,71785,71795,0,134,10
141,19151,388,71795,71798,0,134,3
141,19151,388,71798,71810,0,134,12
141,19151,388,71810,71811,0,134,1
141,19151,388,71811,71826,0,134,15
141,19151,388,71826,71828,0,134,2
141,19151,388,71828,71844,0,134,16
141,19151,388,71844,71862,0,134,18
141,19151,388,71862,71882,0,134,20
141,19151,388,71882,71898,0,134,16
141,19151,388,71898,71913,0,134,15
141,19151,388,71913,71920,0,134,7
141,19151,388,71920,71923,0,134,3
141,19151,388,71923,71935,0,134,12
141,19151,388,71935,71955,0,134,20
141,19151,388,71955,71970,0,134,15
141,19151,388,71970,71982,0,134,12
141,19151,388,71982,71987,0,134,5
141,19151,388,71987,72003,0,134,16
141,19151,388,72003,72023,0,134,20
141,19151,388,72023,72037,0,134,14
141,19151,2605,72037,72038,0,134,1
141,19151,2605,72038,72044,0,134,6
141,19151,2605,72044,72053,0,134,9
141,19151,2605,72053,72056,0,134,3
141,19151,2605,72056,72064,0,134,8
141,19151,2605,72064,72082,0,134,18
141,19151,2605,72082,72098,0,134,16
141,19151,2605,72098,72099,0,134,1
141,19151,2605,72099,72113,0,134,14
141,19151,2605,72113,72128,0,134,15
141,19151,2605,72128,72146,0,134,18
141,19151,2605,72146,72158,0,134,12
141,19151,2605,72158,72163,0,134,5
141,19151,2605,72163,72168,0,134,5
141,19151,386,72168,72187,0,134,19
141,19151,386,72187,72195,0,134,8
141,19151,386,72195,72213,0,134,18
141,19151,385,72213,72227,0,134,14
141,19151,385,72227,72243,0,134,16
141,19151,383,72243,72249,0,134,6
141,19151,381,72249,72261,0,134,12
141,19151,84,72261,72279,0,134,18
141,19151,1449,72279,72287,0,134,8
141,19151,31,72287,72297,0,134,10
141,19151,25,72297,72316,0,134,19
141,19151,38,72316,72321,0,134,5
141,19151,28,72321,72324,0,134,3
141,19151,28,72324,72338,0,134,14
141,19151,27,72338,72339,0,134,1
141,19151,27,72339,72340,0,134,1
141,19151,5,72340,72343,0,134,3
141,19151,5,72343,72349,0,134,6
141,19151,6,72349,72367,0,134,18
141,19151,6,72367,72385,0,134,18
141,19151,6,72385,72386,0,134,1
141,19151,1,72386,72406,0,134,20
141,19151,1,72406,72424,0,134,18
141,19151,1,72424,72433,0,134,9
141,19151,29,72433,72449,0,134,16
141,19151,29,72449,72464,0,134,15
141,19151,29,72464,72466,0,134,2
141,19151,29,72466,72470,0,134,4
141,19151,29,72470,72489,0,134,19
141,19151,101,72489,72495,0,134,6
141,19151,290,72495,72512,0,134,17
141,19151,290,72512,72521,0,134,9
141,19151,290,72521,72535,0,134,14
141,19151,290,72535,72555,0,134,20
141,19151,291,72555,72565,0,134,10
141,19151,291,72565,72580,0,134,15
141,19151,291,72580,72581,0,134,1
141,19151,404,72581,72583,0,134,2
141,19151,683,72583,72584,0,134,1
141,19151,683,72584,72591,0,134,7
141,19151,683,72591,72607,0,134,16
141,19151,48,72607,72620,0,134,13
141,19151,48,72620,72627,0,134,7
141,19151,48,72627,72645,0,134,18
141,19151,47,72645,72662,0,134,17
141,19151,47,72662,72663,0,134,1
141,19161,29,72663,72670,0,10,7
141,19161,41,72670,72682,0,10,12
141,19161,42,72682,72693,0,10,11
141,19161,44,72693,72707,0,10,14
141,19161,45,72707,72717,0,10,10
141,19161,45,72717,72732,0,10,15
141,19161,46,72732,72743,0,10,11
141,19161,46,72743,72762,0,10,19
141,19161,46,72762,72770,0,10,8
141,19171,29,72770,72788,0,31,18
141,19171,30,72788,72800,0,31,12
141,19171,30,72800,72813,0,31,13
141,19171,30,72813,72828,0,31,15
141,19171,114,72828,72844,0,31,16
141,19171,114,72844,72854,0,31,10
141,19171,114,72854,72866,0,31,12
141,19171,33,72866,72869,0,31,3
141,19171,33,72869,72882,0,31,13
141,19171,33,72882,72888,0,31,6
141,19171,33,72888,72900,0,31,12
141,19171,33,72900,72904,0,31,4
141,19171,33,72904,72905,0,31,1
141,19171,33,72905,72909,0,31,4
141,19171,33,72909,72926,0,31,17
141,19171,33,72926,72930,0,31,4
141,19171,33,72930,72932,0,31,2
141,19171,33,72932,72934,0,31,2
141,19171,87,72934,72949,0,31,15
141,19171,30,72949,72952,0,31,3
141,19171,30,72952,72956,0,31,4
141,19171,30,72956,72969,0,31,13
141,19171,29,72969,72977,0,31,8
141,19171,39,72977,72997,0,31,20
141,19171,39,72997,73003,0,31,6
141,19171,39,73003,73006,0,31,3
141,19171,30,73006,73020,0,31,14
141,19171,29,73020,73025,0,31,5
141,19171,29,73025,73036,0,31,11
141,19171,29,73036,73049,0,31,13
141,19181,29,73049,73064,0,18,15
141,19181,29,73064,73081,0,18,17
141,19181,29,73081,73100,0,18,19
141,19181,29,73100,73114,0,18,14
141,19181,40,73114,73125,0,18,11
141,19181,41,73125,73145,0,18,20
141,19181,42,73145,73156,0,18,11
141,19181,43,73156,73169,0,18,13
141,19181,44,73169,73170,0,18,1
141,19181,45,73170,73187,0,18,17
141,19181,46,73187,73188,0,18,1
141,19181,47,73188,73192,0,18,4
141,19181,47,73192,73195,0,18,3
141,19181,50,73195,73196,0,18,1
141,19181,47,73196,73201,0,18,5
141,19181,47,73201,73217,0,18,16
141,19181,47,73217,73225,0,18,8
141,19191,257,73225,73239,0,30,14
141,19191,257,73239,73243,0,30,4
141,19191,614,73243,73261,0,30,18
141,19191,614,73261,73273,0,30,12
141,19191,614,73273,73277,0,30,4
141,19191,614,73277,73278,0,30,1
141,19191,614,73278,73297,0,30,19
141,19191,294,73297,73315,0,30,18
141,19191,1201,73315,73318,0,30,3
141,19191,1201,73318,73338,0,30,20
141,19191,671,73338,73352,0,30,14
141,19191,671,73352,73372,0,30,20
141,19191,674,73372,73390,0,30,18
141,19191,685,73390,73401,0,30,11
141,19191,538,73401,73404,0,30,3
141,19191,684,73404,73415,0,30,11
141,19191,409,73415,73423,0,30,8
141,19191,409,73423,73440,0,30,17
141,19191,409,73440,73456,0,30,16
141,19191,683,73456,73464,0,30,8
141,19191,683,73464,73469,0,30,5
141,19191,46,73469,73485,0,30,16
141,19191,47,73485,73500,0,30,15
141,19191,50,73500,73501,0,30,1
141,19191,47,73501,73504,0,30,3
141,19191,47,73504,73508,0,30,4
141,19191,47,73508,73525,0,30,17
141,19191,47,73525,73543,0,30,18
141,19191,47,73543,73562,0,30,19
141,19201,51,73562,73573,0,100,11
141,19201,51,73573,73574,0,100,1
141,19201,51,73574,73584,0,100,10
141,19201,51,73584,73588,0,100,4
141,19201,51,73588,73598,0,100,10
141,19201,51,73598,73605,0,100,7
141,19201,80,73605,73613,0,100,8
141,19201,667,73613,73619,0,100,6
141,19201,667,73619,73621,0,100,2
141,19201,667,73621,73622,0,100,1
141,19201,667,73622,73640,0,100,18
141,19201,667,73640,73659,0,100,19
141,19201,667,73659,73661,0,100,2
141,19201,667,73661,73681,0,100,20
141,19201,667,73681,73691,0,100,10
141,19201,667,73691,73708,0,100,17
141,19201,667,73708,73725,0,100,17
141,19201,667,73725,73728,0,100,3
141,19201,667,73728,73744,0,100,16
141,19201,667,73744,73745,0,100,1
141,19201,667,73745,73750,0,100,5
141,19201,667,73750,73761,0,100,11
141,19201,260,73761,73778,0,100,17
141,19201,260,73778,73779,0,100,1
141,19201,260,73779,73784,0,100,5
141,19201,260,73784,73794,0,100,10
141,19201,264,73794,73800,0,100,6
141,19201,1351,73800,73810,0,100,10
141,19201,1358,73810,73821,0,100,11
141,19201,655,73821,73831,0,100,10
141,19201,523,73831,73842,0,100,11
141,19201,1353,73842,73859,0,100,17
141,19201,1205,73859,73864,0,100,5
141,19201,716,73864,73880,0,100,16
141,19201,299,73880,73888,0,100,8
141,19201,298,73888,73895,0,100,7
141,19201,242,73895,73908,0,100,13
141,19201,38,73908,73928,0,100,20
141,19201,368,73928,73930,0,100,2
141,19201,31,73930,73933,0,100,3
141,19201,370,73933,73934,0,100,1
141,19201,371,73934,73943,0,100,9
141,19201,371,73943,73958,0,100,15
141,19201,371,73958,73972,0,100,14
141,19201,371,73972,73980,0,100,8
141,19201,370,73980,73996,0,100,16
141,19201,370,73996,74007,0,100,11
141,19201,25,74007,74013,0,100,6
141,19201,38,74013,74029,0,100,16
141,19201,242,74029,74041,0,100,12
141,19201,299,74041,74047,0,100,6
141,19201,716,74047,74054,0,100,7
141,19201,1354,74054,74070,0,100,16
141,19201,1353,74070,74073,0,100,3
141,19201,655,74073,74090,0,100,17
141,19201,1352,74090,74106,0,100,16
141,19201,1358,74106,74107,0,100,1
141,19201,1351,74107,74119,0,100,12
141,19201,2177,74119,74129,0,100,10
141,19201,2177,74129,74147,0,100,18
141,19201,2177,74147,74163,0,100,16
141,19201,1351,74163,74175,0,100,12
141,19201,1642,74175,74190,0,100,15
141,19201,1642,74190,74206,0,100,16
141,19201,1642,74206,74225,0,100,19
141,19201,1642,74225,74244,0,100,19
141,19201,2344,74244,74246,0,100,2
141,19201,2344,74246,74248,0,100,2
141,19201,260,74248,74256,0,100,8
141,19201,260,74256,74260,0,100,4
141,19201,263,74260,74276,0,100,16
141,19201,261,74276,74294,0,100,18
141,19201,1648,74294,74304,0,100,10
141,19201,1648,74304,74320,0,100,16
141,19201,1648,74320,74330,0,100,10
141,19201,1648,74330,74331,0,100,1
141,19201,1582,74331,74335,0,100,4
141,19201,1582,74335,74339,0,100,4
141,19201,1582,74339,74344,0,100,5
141,19201,1582,74344,74364,0,100,20
141,19201,116,74364,74383,0,100,19
141,19201,116,74383,74386,0,100,3
141,19201,116,74386,74405,0,100,19
141,19201,116,74405,74419,0,100,14
141,19201,116,74419,74423,0,100,4
141,19201,116,74423,74428,0,100,5
141,19201,116,74428,74444,0,100,16
141,19201,116,74444,74457,0,100,13
141,19201,116,74457,74472,0,100,15
141,19201,262,74472,74478,0,100,6
141,19201,2514,74478,74493,0,100,15
141,19201,1765,74493,74502,0,100,9
141,19201,1455,74502,74516,0,100,14
141,19201,1455,74516,74536,0,100,20
141,19201,4261,74536,74551,0,100,15
141,19201,4500,74551,74566,0,100,15
141,19201,4501,74566,74578,0,100,12
141,19201,4502,74578,74588,0,100,10
141,19201,4503,74588,74606,0,100,18
141,19211,29,74606,74607,0,13,1
141,19211,29,74607,74616,0,13,9
141,19211,29,74616,74629,0,13,13
141,19211,40,74629,74630,0,13,1
141,19211,42,74630,74638,0,13,8
141,19211,43,74638,74657,0,13,19
141,19211,45,74657,74659,0,13,2
141,19211,46,74659,74673,0,13,14
141,19211,47,74673,74679,0,13,6
141,19211,50,74679,74696,0,13,17
141,19211,47,74696,74707,0,13,11
141,19211,47,74707,74714,0,13,7
141,19221,29,74714,74715,0,34,1
141,19221,29,74715,74727,0,34,12
141,19221,29,74727,74742,0,34,15
141,19221,29,74742,74749,0,34,7
141,19221,29,74749,74769,0,34,20
141,19221,29,74769,74779,0,34,10
141,19221,29,74779,74797,0,34,18
141,19221,29,74797,74817,0,34,20
141,19221,29,74817,74820,0,34,3
141,19221,29,74820,74835,0,34,15
141,19221,29,74835,74844,0,34,9
141,19221,29,74844,74847,0,34,3
141,19221,29,74847,74861,0,34,14
141,19221,29,74861,74879,0,34,18
141,19221,29,74879,74898,0,34,19
141,19221,29,74898,74916,0,34,18
141,19221,29,74916,74930,0,34,14
141,19221,29,74930,74937,0,34,7
141,19221,29,74937,74938,0,34,1
141,19221,29,74938,74956,0,34,18
141,19221,29,74956,74966,0,34,10
141,19221,40,74966,74980,0,34,14
141,19221,41,74980,74996,0,34,16
141,19221,43,74996,75000,0,34,4
141,19221,44,75000,75009,0,34,9
141,19221,45,75009,75027,0,34,18
141,19221,46,75027,75045,0,34,18
141,19221,47,75045,75062,0,34,17
141,19221,50,75062,75072,0,34,10
141,19221,50,75072,75092,0,34,20
141,19221,47,75092,75100,0,34,8
141,19221,47,75100,75104,0,34,4
141,19221,47,75104,75116,0,34,12
141,19231,29,75116,75128,0,30,12
141,19231,29,75128,75137,0,30,9
141,19231,29,75137,75142,0,30,5
141,19231,29,75142,75149,0,30,7
141,19231,39,75149,75159,0,30,10
141,19231,39,75159,75175,0,30,16
141,19231,39,75175,75176,0,30,1
141,19231,39,75176,75196,0,30,20
141,19231,39,75196,75212,0,30,16
141,19231,39,75212,75216,0,30,4
141,19231,39,75216,75227,0,30,11
141,19231,39,75227,75229,0,30,2
141,19231,296,75229,75238,0,30,9
141,19231,41,75238,75250,0,30,12
141,19231,42,75250,75270,0,30,20
141,19231,42,75270,75282,0,30,12
141,19231,290,75282,75290,0,30,8
141,19231,43,75290,75306,0,30,16
141,19231,43,75306,75309,0,30,3
141,19231,404,75309,75327,0,30,18
141,19231,404,75327,75334,0,30,7
141,19231,46,75334,75335,0,30,1
141,19231,46,75335,75351,0,30,16
141,19231,46,75351,75367,0,30,16
141,19231,47,75367,75383,0,30,16
141,19231,47,75383,75399,0,30,16
141,19231,47,75399,75403,0,30,4
141,19231,47,75403,75420,0,30,17
141,19231,47,75420,75422,0,30,2
141,19241,29,75422,75430,0,15,8
141,19241,29,75430,75441,0,15,11
141,19241,29,75441,75456,0,15,15
141,19241,29,75456,75457,0,15,1
141,19241,29,75457,75458,0,15,1
141,19241,40,75458,75478,0,15,20
141,19241,42,75478,75480,0,15,2
141,19241,43,75480,75500,0,15,20
141,19241,45,75500,75510,0,15,10
141,19241,46,75510,75526,0,15,16
141,19241,47,75526,75544,0,15,18
141,19241,50,75544,75546,0,15,2
141,19241,47,75546,75563,0,15,17
141,19241,47,75563,75568,0,15,5
141,19251,29,75568,75572,0,36,4
141,19251,29,75572,75586,0,36,14
141,19251,29,75586,75598,0,36,12
141,19251,23,75598,75607,0,36,9
141,19251,23,75607,75620,0,36,13
141,19251,23,75620,75627,0,36,7
141,19251,23,75627,75638,0,36,11
141,19251,23,75638,75647,0,36,9
141,19251,23,75647,75666,0,36,19
141,19251,24,75666,75675,0,36,9
141,19251,7,75675,75695,0,36,20
141,19251,24,75695,75707,0,36,12
141,19251,24,75707,75717,0,36,10
141,19251,24,75717,75726,0,36,9
141,19251,24,75726,75740,0,36,14
141,19251,24,75740,75755,0,36,15
141,19251,24,75755,75772,0,36,17
141,19251,24,75772,75774,0,36,2
141,19251,24,75774,75786,0,36,12
141,19251,24,75786,75789,0,36,3
141,19251,24,75789,75792,0,36,3
141,19251,24,75792,75793,0,36,1
141,19251,24,75793,75804,0,36,11
141,19251,24,75804,75819,0,36,15
141,19251,24,75819,75821,0,36,2
141,19251,24,75821,75840,0,36,19
141,19251,24,75840,75851,0,36,11
141,19251,24,75851,75867,0,36,16
141,19251,24,75867,75885,0,36,18
141,19251,24,75885,75892,0,36,7
141,19251,24,75892,75902,0,36,10
141,19251,24,75902,75915,0,36,13
141,19251,23,75915,75926,0,36,11
141,19251,29,75926,75945,0,36,19
141,19251,40,75945,75947,0,36,2
141,19261,46,75947,75960,0,12,13
141,19261,45,75960,75973,0,12,13
141,19261,43,75973,75986,0,12,13
141,19261,42,75986,76004,0,12,18
141,19261,41,76004,76017,0,12,13
141,19261,40,76017,76020,0,12,3
141,19261,40,76020,76037,0,12,17
141,19261,29,76037,76047,0,12,10
141,19261,39,76047,76062,0,12,15
141,19261,39,76062,76073,0,12,11
141,19261,29,76073,76074,0,12,1
141,19271,47,76074,76093,0,17,19
141,19271,46,76093,76098,0,17,5
141,19271,45,76098,76112,0,17,14
141,19271,44,76112,76130,0,17,18
141,19271,43,76130,76141,0,17,11
141,19271,42,76141,76145,0,17,4
141,19271,41,76145,76161,0,17,16
141,19271,41,76161,76171,0,17,10
141,19271,40,76171,76185,0,17,14
141,19271,40,76185,76203,0,17,18
141,19271,29,76203,76215,0,17,12
141,19271,29,76215,76217,0,17,2
141,19271,39,76217,76234,0,17,17
141,19271,39,76234,76247,0,17,13
141,19271,29,76247,76251,0,17,4
141,19271,29,76251,76264,0,17,13
141,19281,412,76264,76279,0,30,15
141,19281,412,76279,76282,0,30,3
141,19281,412,76282,76284,0,30,2
141,19281,412,76284,76303,0,30,19
141,19281,412,76303,76317,0,30,14
141,19281,411,76317,76325,0,30,8
141,19281,410,76325,76333,0,30,8
141,19281,684,76333,76349,0,30,16
141,19281,409,76349,76351,0,30,2
141,19281,408,76351,76366,0,30,15
141,19281,1326,76366,76386,0,30,20
141,19281,408,76386,76396,0,30,10
141,19281,292,76396,76398,0,30,2
141,19281,292,76398,76409,0,30,11
141,19281,292,76409,76425,0,30,16
141,19281,407,76425,76445,0,30,20
141,19281,407,76445,76461,0,30,16
141,19281,407,76461,76465,0,30,4
141,19281,365,76465,76485,0,30,20
141,19281,365,76485,76503,0,30,18
141,19281,365,76503,76511,0,30,8
141,19281,405,76511,76516,0,30,5
141,19281,405,76516,76518,0,30,2
141,19281,405,76518,76523,0,30,5
141,19281,39,76523,76529,0,30,6
141,19281,39,76529,76543,0,30,14
141,19281,29,76543,76546,0,30,3
141,19281,29,76546,76562,0,30,16
141,19281,29,76562,76563,0,30,1
141,19291,290,76563,76569,0,79,6
141,19291,407,76569,76583,0,79,14
141,19291,367,76583,76589,0,79,6
141,19291,105,76589,76591,0,79,2
141,19291,105,76591,76595,0,79,4
141,19291,105,76595,76609,0,79,14
141,19291,520,76609,76624,0,79,15
141,19291,104,76624,76632,0,79,8
141,19291,104,76632,76636,0,79,4
141,19291,96,76636,76651,0,79,15
141,19291,95,76651,76671,0,79,20
141,19291,95,76671,76690,0,79,19
141,19291,94,76690,76706,0,79,16
141,19291,94,76706,76724,0,79,18
141,19291,94,76724,76730,0,79,6
141,19291,93,76730,76744,0,79,14
141,19291,93,76744,76759,0,79,15
141,19291,17,76759,76774,0,79,15
141,19291,16,76774,76785,0,79,11
141,19291,497,76785,76803,0,79,18
141,19291,498,76803,76823,0,79,20
141,19291,498,76823,76841,0,79,18
141,19291,499,76841,76847,0,79,6
141,19291,500,76847,76851,0,79,4
141,19291,500,76851,76869,0,79,18
141,19291,500,76869,76871,0,79,2
141,19291,500,76871,76889,0,79,18
141,19291,500,76889,76900,0,79,11
141,19291,499,76900,76918,0,79,18
141,19291,514,76918,76932,0,79,14
141,19291,513,76932,76946,0,79,14
141,19291,617,76946,76959,0,79,13
141,19291,617,76959,76968,0,79,9
141,19291,638,76968,76987,0,79,19
141,19291,638,76987,76995,0,79,8
141,19291,638,76995,77011,0,79,16
141,19291,638,77011,77013,0,79,2
141,19291,638,77013,77028,0,79,15
141,19291,561,77028,77034,0,79,6
141,19291,561,77034,77043,0,79,9
141,19291,561,77043,77052,0,79,9
141,19291,562,77052,77069,0,79,17
141,19291,562,77069,77079,0,79,10
141,19291,562,77079,77087,0,79,8
141,19291,562,77087,77107,0,79,20
141,19291,562,77107,77121,0,79,14
141,19291,561,77121,77129,0,79,8
141,19291,561,77129,77140,0,79,11
141,19291,562,77140,77155,0,79,15
141,19291,563,77155,77170,0,79,15
141,19291,500,77170,77172,0,79,2
141,19291,500,77172,77179,0,79,7
141,19291,499,77179,77199,0,79,20
141,19291,498,77199,77207,0,79,8
141,19291,497,77207,77220,0,79,13
141,19291,16,77220,77222,0,79,2
141,19291,17,77222,77233,0,79,11
141,19291,93,77233,77242,0,79,9
141,19291,94,77242,77245,0,79,3
141,19291,94,77245,77252,0,79,7
141,19291,95,77252,77261,0,79,9
141,19291,96,77261,77278,0,79,17
141,19291,104,77278,77284,0,79,6
141,19291,520,77284,77290,0,79,6
141,19291,105,77290,77308,0,79,18
141,19291,105,77308,77321,0,79,13
141,19291,367,77321,77335,0,79,14
141,19291,407,77335,77341,0,79,6
141,19291,290,77341,77347,0,79,6
141,19291,44,77347,77360,0,79,13
141,19291,45,77360,77380,0,79,20
141,19291,46,77380,77400,0,79,20
141,19291,47,77400,77406,0,79,6
141,19291,50,77406,77411,0,79,5
141,19291,50,77411,77424,0,79,13
141,19291,50,77424,77426,0,79,2
141,19291,50,77426,77432,0,79,6
141,19291,50,77432,77436,0,79,4
141,19301,1553,77436,77445,0,34,9
141,19301,1553,77445,77462,0,34,17
141,19301,1554,77462,77475,0,34,13
141,19301,1554,77475,77491,0,34,16
141,19301,1555,77491,77507,0,34,16
141,19301,1555,77507,77513,0,34,6
141,19301,1556,77513,77527,0,34,14
141,19301,2284,77527,77536,0,34,9
141,19301,2283,77536,77551,0,34,15
141,19301,2282,77551,77562,0,34,11
141,19301,2281,77562,77577,0,34,15
141,19301,2308,77577,77588,0,34,11
141,19301,2280,77588,77591,0,34,3
141,19301,1993,77591,77601,0,34,10
141,19301,272,77601,77616,0,34,15
141,19301,1994,77616,77618,0,34,2
141,19301,1995,77618,77621,0,34,3
141,19301,2057,77621,77637,0,34,16
141,19301,1347,77637,77657,0,34,20
141,19301,1438,77657,77673,0,34,16
141,19301,1440,77673,77689,0,34,16
141,19301,1441,77689,77693,0,34,4
141,19301,682,77693,77713,0,34,20
141,19301,682,77713,77733,0,34,20
141,19301,75,77733,77742,0,34,9
141,19301,75,77742,77744,0,34,2
141,19301,73,77744,77747,0,34,3
141,19301,72,77747,77755,0,34,8
141,19301,71,77755,77774,0,34,19
141,19301,70,77774,77784,0,34,10
141,19301,70,77784,77797,0,34,13
141,19301,69,77797,77811,0,34,14
141,19301,69,77811,77814,0,34,3
141,19311,47,77814,77824,0,15,10
141,19311,46,77824,77836,0,15,12
141,19311,45,77836,77855,0,15,19
141,19311,44,77855,77862,0,15,7
141,19311,43,77862,77872,0,15,10
141,19311,42,77872,77884,0,15,12
141,19311,41,77884,77900,0,15,16
141,19311,41,77900,77913,0,15,13
141,19311,40,77913,77933,0,15,20
141,19311,23,77933,77947,0,15,14
141,19311,39,77947,77954,0,15,7
141,19311,39,77954,77966,0,15,12
141,19311,30,77966,77973,0,15,7
141,19311,29,77973,77980,0,15,7
141,19321,3481,77980,77999,0,89,19
141,19321,1762,77999,78008,0,89,9
141,19321,1762,78008,78010,0,89,2
141,19321,1617,78010,78020,0,89,10
141,19321,1616,78020,78029,0,89,9
141,19321,1615,78029,78033,0,89,4
141,19321,1615,78033,78051,0,89,18
141,19321,1613,78051,78071,0,89,20
141,19321,1613,78071,78073,0,89,2
141,19321,1612,78073,78085,0,89,12
141,19321,1611,78085,78103,0,89,18
141,19321,1610,78103,78110,0,89,7
141,19321,1609,78110,78124,0,89,14
141,19321,1608,78124,78131,0,89,7
141,19321,1607,78131,78141,0,89,10
141,19321,1606,78141,78144,0,89,3
141,19321,1605,78144,78162,0,89,18
141,19321,1604,78162,78179,0,89,17
141,19321,1603,78179,78180,0,89,1
141,19321,1602,78180,78192,0,89,12
141,19321,1602,78192,78206,0,89,14
141,19321,1601,78206,78211,0,89,5
141,19321,1601,78211,78228,0,89,17
141,19321,1600,78228,78229,0,89,1
141,19321,1644,78229,78243,0,89,14
141,19321,1625,78243,78250,0,89,7
141,19321,1469,78250,78266,0,89,16
141,19321,1467,78266,78269,0,89,3
141,19321,1465,78269,78281,0,89,12
141,19321,1474,78281,78299,0,89,18
141,19321,1475,78299,78302,0,89,3
141,19321,1519,78302,78303,0,89,1
141,19321,1477,78303,78306,0,89,3
141,19321,1461,78306,78317,0,89,11
141,19321,1504,78317,78324,0,89,7
141,19321,1459,78324,78340,0,89,16
141,19321,1458,78340,78355,0,89,15
141,19321,1480,78355,78360,0,89,5
141,19321,1492,78360,78380,0,89,20
141,19321,1491,78380,78397,0,89,17
141,19321,1490,78397,78417,0,89,20
141,19321,1455,78417,78421,0,89,4
141,19321,1454,78421,78436,0,89,15
141,19321,1488,78436,78450,0,89,14
141,19321,1521,78450,78452,0,89,2
141,19321,1482,78452,78467,0,89,15
141,19321,1451,78467,78474,0,89,7
141,19321,1848,78474,78483,0,89,9
141,19321,279,78483,78490,0,89,7
141,19321,278,78490,78501,0,89,11
141,19321,277,78501,78515,0,89,14
141,19321,276,78515,78522,0,89,7
141,19321,282,78522,78542,0,89,20
141,19321,274,78542,78543,0,89,1
141,19321,273,78543,78545,0,89,2
141,19321,272,78545,78560,0,89,15
141,19321,1382,78560,78561,0,89,1
141,19321,284,78561,78575,0,89,14
141,19321,284,78575,78590,0,89,15
141,19321,284,78590,78592,0,89,2
141,19321,284,78592,78600,0,89,8
141,19321,284,78600,78614,0,89,14
141,19321,284,78614,78624,0,89,10
141,19321,271,78624,78639,0,89,15
141,19321,711,78639,78652,0,89,13
141,19321,269,78652,78667,0,89,15
141,19321,289,78667,78679,0,89,12
141,19321,267,78679,78682,0,89,3
141,19321,266,78682,78701,0,89,19
141,19321,265,78701,78721,0,89,20
141,19321,260,78721,78740,0,89,19
141,19321,259,78740,78744,0,89,4
141,19321,80,78744,78746,0,89,2
141,19321,51,78746,78765,0,89,19
141,19321,50,78765,78769,0,89,4
141,19321,50,78769,78780,0,89,11
141,19321,47,78780,78796,0,89,16
141,19321,47,78796,78811,0,89,15
141,19321,50,78811,78829,0,89,18
141,19321,50,78829,78843,0,89,14
141,19321,50,78843,78844,0,89,1
141,19321,50,78844,78845,0,89,1
141,19321,50,78845,78856,0,89,11
141,19321,50,78856,78873,0,89,17
141,19321,47,78873,78886,0,89,13
141,19321,47,78886,78904,0,89,18
141,19321,47,78904,78907,0,89,3
141,19321,47,78907,78912,0,89,5
141,19331,50,78912,78919,0,119,7
141,19331,50,78919,78935,0,119,16
141,19331,50,78935,78939,0,119,4
141,19331,50,78939,78943,0,119,4
141,19331,50,78943,78944,0,119,1
141,19331,50,78944,78957,0,119,13
141,19331,50,78957,78969,0,119,12
141,19331,50,78969,78973,0,119,4
141,19331,50,78973,78980,0,119,7
141,19331,50,78980,78986,0,119,6
141,19331,50,78986,78987,0,119,1
141,19331,50,78987,78998,0,119,11
141,19331,50,78998,79005,0,119,7
141,19331,50,79005,79021,0,119,16
141,19331,50,79021,79040,0,119,19
141,19331,50,79040,79051,0,119,11
141,19331,50,79051,79057,0,119,6
141,19331,50,79057,79060,0,119,3
141,19331,50,79060,79077,0,119,17
141,19331,47,79077,79087,0,119,10
141,19331,47,79087,79101,0,119,14
141,19331,46,79101,79107,0,119,6
141,19331,46,79107,79120,0,119,13
141,19331,46,79120,79140,0,119,20
141,19331,46,79140,79156,0,119,16
141,19331,46,79156,79176,0,119,20
141,19331,46,79176,79193,0,119,17
141,19331,46,79193,79213,0,119,20
141,19331,46,79213,79228,0,119,15
141,19331,46,79228,79230,0,119,2
141,19331,46,79230,79234,0,119,4
141,19331,46,79234,79249,0,119,15
141,19331,45,79249,79265,0,119,16
141,19331,45,79265,79278,0,119,13
141,19331,44,79278,79288,0,119,10
141,19331,42,79288,79297,0,119,9
141,19331,41,79297,79303,0,119,6
141,19331,23,79303,79305,0,119,2
141,19331,1,79305,79319,0,119,14
141,19331,2,79319,79323,0,119,4
141,19331,3,79323,79336,0,119,13
141,19331,3,79336,79352,0,119,16
141,19331,3,79352,79358,0,119,6
141,19331,3,79358,79369,0,119,11
141,19331,3,79369,79386,0,119,17
141,19331,86,79386,79388,0,119,2
141,19331,86,79388,79400,0,119,12
141,19331,86,79400,79410,0,119,10
141,19331,86,79410,79425,0,119,15
141,19331,121,79425,79442,0,119,17
141,19331,121,79442,79462,0,119,20
141,19331,1773,79462,79474,0,119,12
141,19331,83,79474,79479,0,119,5
141,19331,81,79479,79488,0,119,9
141,19331,81,79488,79496,0,119,8
141,19331,4,79496,79507,0,119,11
141,19331,4,79507,79510,0,119,3
141,19331,4,79510,79522,0,119,12
141,19331,81,79522,79539,0,119,17
141,19331,81,79539,79554,0,119,15
141,19331,81,79554,79569,0,119,15
141,19331,81,79569,79570,0,119,1
141,19331,82,79570,79587,0,119,17
141,19331,82,79587,79589,0,119,2
141,19331,82,79589,79595,0,119,6
141,19331,84,79595,79602,0,119,7
141,19331,84,79602,79604,0,119,2
141,19331,381,79604,79618,0,119,14
141,19331,381,79618,79623,0,119,5
141,19331,382,79623,79626,0,119,3
141,19331,383,79626,79646,0,119,20
141,19331,384,79646,79659,0,119,13
141,19331,385,79659,79675,0,119,16
141,19331,385,79675,79692,0,119,17
141,19331,386,79692,79709,0,119,17
141,19331,386,79709,79729,0,119,20
141,19331,2605,79729,79741,0,119,12
141,19331,2605,79741,79746,0,119,5
141,19331,2605,79746,79762,0,119,16
141,19331,2605,79762,79772,0,119,10
141,19331,2605,79772,79784,0,119,12
141,19331,2605,79784,79797,0,119,13
141,19331,2605,79797,79814,0,119,17
141,19331,2605,79814,79830,0,119,16
141,19331,2605,79830,79849,0,119,19
141,19331,2605,79849,79864,0,119,15
141,19331,2605,79864,79870,0,119,6
141,19331,2605,79870,79879,0,119,9
141,19331,2605,79879,79887,0,119,8
141,19331,2605,79887,79894,0,119,7
141,19331,2605,79894,79899,0,119,5
141,19331,2605,79899,79913,0,119,14
141,19331,2605,79913,79918,0,119,5
141,19331,2605,79918,79919,0,119,1
141,19331,2605,79919,79939,0,119,20
141,19331,2605,79939,79942,0,119,3
141,19331,2605,79942,79952,0,119,10
141,19331,2605,79952,79961,0,119,9
141,19331,2605,79961,79980,0,119,19
141,19331,2605,79980,79991,0,119,11
141,19331,2605,79991,80007,0,119,16
141,19331,2605,80007,80015,0,119,8
141,19331,2605,80015,80027,0,119,12
141,19331,2605,80027,80044,0,119,17
141,19331,388,80044,80061,0,119,17
141,19331,388,80061,80067,0,119,6
141,19331,388,80067,80069,0,119,2
141,19331,2605,80069,80071,0,119,2
141,19331,2605,80071,80072,0,119,1
141,19331,2605,80072,80080,0,119,8
141,19331,2605,80080,80095,0,119,15
141,19331,2605,80095,80114,0,119,19
141,19331,2605,80114,80126,0,119,12
141,19331,2605,80126,80135,0,119,9
141,19331,2605,80135,80143,0,119,8
141,19331,2605,80143,80153,0,119,10
141,19331,2605,80153,80173,0,119,20
141,19331,2605,80173,80176,0,119,3
141,19341,50,80176,80194,0,31,18
141,19341,47,80194,80200,0,31,6
141,19341,46,80200,80216,0,31,16
141,19341,45,80216,80228,0,31,12
141,19341,44,80228,80247,0,31,19
141,19341,42,80247,80265,0,31,18
141,19341,41,80265,80268,0,31,3
141,19341,41,80268,80274,0,31,6
141,19341,40,80274,80278,0,31,4
141,19341,23,80278,80281,0,31,3
141,19341,29,80281,80289,0,31,8
141,19341,39,80289,80294,0,31,5
141,19341,29,80294,80304,0,31,10
141,19341,29,80304,80313,0,31,9
141,19341,30,80313,80333,0,31,20
141,19341,30,80333,80336,0,31,3
141,19341,30,80336,80354,0,31,18
141,19341,30,80354,80358,0,31,4
141,19341,30,80358,80359,0,31,1
141,19341,30,80359,80377,0,31,18
141,19341,101,80377,80382,0,31,5
141,19341,405,80382,80391,0,31,9
141,19341,405,80391,80403,0,31,12
141,19341,365,80403,80413,0,31,10
141,19341,407,80413,80417,0,31,4
141,19341,292,80417,80421,0,31,4
141,19341,408,80421,80440,0,31,19
141,19341,409,80440,80445,0,31,5
141,19341,411,80445,80447,0,31,2
141,19341,412,80447,80465,0,31,18
141,19351,29,80465,80470,0,15,5
141,19351,29,80470,80474,0,15,4
141,19351,29,80474,80486,0,15,12
141,19351,39,80486,80497,0,15,11
141,19351,41,80497,80508,0,15,11
141,19351,42,80508,80513,0,15,5
141,19351,44,80513,80520,0,15,7
141,19351,45,80520,80521,0,15,1
141,19351,46,80521,80540,0,15,19
141,19351,47,80540,80558,0,15,18
141,19351,50,80558,80569,0,15,11
141,19351,47,80569,80572,0,15,3
141,19351,47,80572,80579,0,15,7
141,19351,47,80579,80597,0,15,18
151,20371,39,80597,80605,0,6,8
151,20371,39,80605,80608,0,6,3
151,20371,39,80608,80609,0,6,1
151,20371,39,80609,80616,0,6,7
151,20371,39,80616,80621,0,6,5
151,20381,405,80621,80627,0,61,6
151,20381,405,80627,80644,0,61,17
151,20381,405,80644,80649,0,61,5
151,20381,405,80649,80665,0,61,16
151,20381,405,80665,80678,0,61,13
151,20381,295,80678,80697,0,61,19
151,20381,295,80697,80715,0,61,18
151,20381,295,80715,80727,0,61,12
151,20381,295,80727,80739,0,61,12
151,20381,366,80739,80751,0,61,12
151,20381,366,80751,80754,0,61,3
151,20381,366,80754,80761,0,61,7
151,20381,366,80761,80776,0,61,15
151,20381,366,80776,80792,0,61,16
151,20381,366,80792,80803,0,61,11
151,20381,367,80803,80821,0,61,18
151,20381,367,80821,80827,0,61,6
151,20381,367,80827,80844,0,61,17
151,20381,367,80844,80853,0,61,9
151,20381,367,80853,80864,0,61,11
151,20381,367,80864,80874,0,61,10
151,20381,367,80874,80894,0,61,20
151,20381,367,80894,80908,0,61,14
151,20381,367,80908,80916,0,61,8
151,20381,367,80916,80927,0,61,11
151,20381,367,80927,80929,0,61,2
151,20381,367,80929,80935,0,61,6
151,20381,367,80935,80936,0,61,1
151,20381,367,80936,80946,0,61,10
151,20381,105,80946,80963,0,61,17
151,20381,105,80963,80968,0,61,5
151,20381,105,80968,80985,0,61,17
151,20381,105,80985,80987,0,61,2
151,20381,105,80987,81004,0,61,17
151,20381,539,81004,81022,0,61,18
151,20381,539,81022,81040,0,61,18
151,20381,539,81040,81045,0,61,5
151,20381,539,81045,81046,0,61,1
151,20381,539,81046,81059,0,61,13
151,20381,539,81059,81062,0,61,3
151,20381,487,81062,81072,0,61,10
151,20381,487,81072,81086,0,61,14
151,20381,490,81086,81095,0,61,9
151,20381,490,81095,81112,0,61,17
151,20381,487,81112,81116,0,61,4
151,20381,248,81116,81130,0,61,14
151,20381,226,81130,81135,0,61,5
151,20381,227,81135,81148,0,61,13
151,20381,227,81148,81164,0,61,16
151,20381,228,81164,81166,0,61,2
151,20381,724,81166,81177,0,61,11
151,20381,931,81177,81196,0,61,19
151,20381,1891,81196,81213,0,61,17
151,20381,2456,81213,81231,0,61,18
151,20381,2456,81231,81249,0,61,18
151,20381,2456,81249,81269,0,61,20
151,20381,2956,81269,81270,0,61,1
151,20381,2956,81270,81288,0,61,18
151,20381,3511,81288,81290,0,61,2
151,20381,2956,81290,81302,0,61,12
151,20391,39,81302,81305,0,14,3
151,20391,39,81305,81308,0,14,3
151,20391,39,81308,81312,0,14,4
151,20391,39,81312,81317,0,14,5
151,20391,39,81317,81335,0,14,18
151,20391,39,81335,81341,0,14,6
151,20391,39,81341,81343,0,14,2
151,20391,39,81343,81345,0,14,2
151,20391,39,81345,81356,0,14,11
151,20391,39,81356,81365,0,14,9
151,20391,39,81365,81385,0,14,20
151,20391,39,81385,81389,0,14,4
151,20391,39,81389,81393,0,14,4
181,24921,29,81393,81401,0,2,8
