userID,trajID,poiID,startTime,endTime,#photo,trajLen,poiDuration
10005149@N03,1,5,1274095158,1274095158,1,1,0
10008488@N07,2,6,1354345925,1354346676,2,1,751
100320969@N08,3,2,1375140897,1375177592,200,1,36695
100354657@N04,4,8,1363864004,1363864004,1,1,0
10039169@N06,5,4,1202198535,1202198708,2,1,173
100436193@N03,6,1,1419228064,1419228064,1,1,0
100448554@N06,7,2,1340768886,1340768886,1,1,0
100459519@N02,8,1,1430730654,1430730654,1,1,0
100459519@N02,9,1,1462967483,1462967747,13,1,264
100483258@N08,10,6,1408182937,1408182937,1,1,0
10048675@N02,11,5,1233440737,1233440737,1,2,0
10048675@N02,11,8,1233454191,1233454191,1,2,0
10048675@N02,12,8,1234478064,1234478064,1,2,0
10048675@N02,12,2,1234477057,1234477844,3,2,787
10048675@N02,13,5,1234555645,1234555645,1,1,0
100506822@N02,14,4,1387784743,1387785150,6,2,407
100506822@N02,14,6,1387783960,1387784071,3,2,111
100620414@N03,15,5,1461551576,1461557108,8,3,5532
100620414@N03,15,8,1461545701,1461549019,3,3,3318
100620414@N03,15,11,1461545704,1461545704,1,3,0
100691062@N08,16,13,1403232016,1403232016,1,1,0
100747900@N02,17,1,1312430318,1312430318,1,1,0
100775193@N08,18,12,1384806405,1384806405,1,1,0
100775193@N08,19,4,1401150188,1401150188,1,1,0
100775237@N03,20,1,1341064800,1341064800,2,6,0
100775237@N03,20,5,1341064800,1341064800,1,6,0
100775237@N03,20,4,1341064800,1341064800,1,6,0
100775237@N03,20,10,1341064800,1341064800,2,6,0
100775237@N03,20,13,1341064800,1341064800,1,6,0
100775237@N03,20,8,1341064800,1341064800,1,6,0
100775237@N03,21,1,1372600800,1372600800,1,4,0
100775237@N03,21,5,1372600800,1372600800,1,4,0
100775237@N03,21,9,1372600800,1372600800,3,4,0
100775237@N03,21,10,1372600800,1372600800,1,4,0
100775237@N03,22,1,1405507959,1405507959,1,4,0
100775237@N03,22,9,1405504983,1405506385,3,4,1402
100775237@N03,22,10,1405491145,1405491257,2,4,112
100775237@N03,22,6,1405496170,1405496280,2,4,110
100775237@N03,23,1,1405731475,1405731475,1,4,0
100775237@N03,23,5,1405728273,1405728273,1,4,0
100775237@N03,23,10,1405728313,1405728313,1,4,0
100775237@N03,23,13,1405730809,1405730809,1,4,0
100775237@N03,24,1,1405859263,1405859405,2,2,142
100775237@N03,24,9,1405853910,1405854202,2,2,292
100822654@N07,25,2,1400915809,1400915809,1,2,0
100822654@N07,25,8,1400915881,1400915881,1,2,0
100822654@N07,26,10,1400966179,1400977867,7,3,11688
100822654@N07,26,6,1400977027,1400982959,4,3,5932
100822654@N07,26,4,1400958812,1400963442,6,3,4630
10084809@N04,27,10,1459769420,1459769420,1,1,0
100948027@N07,28,13,1315211339,1315211339,1,1,0
101044534@N02,29,8,1380945700,1380945700,1,2,0
101044534@N02,29,1,1380943080,1380943080,1,2,0
101195207@N02,30,2,1466752480,1466752743,8,5,263
101195207@N02,30,8,1466750230,1466750512,2,5,282
101195207@N02,30,5,1466739786,1466745873,4,5,6087
101195207@N02,30,1,1466739658,1466750092,2,5,10434
101195207@N02,30,10,1466733859,1466749876,7,5,16017
101282917@N07,31,1,1372820336,1372837689,4,1,17353
101324125@N05,32,12,1373089924,1373089953,4,4,29
101324125@N05,32,8,1373085892,1373085914,2,4,22
101324125@N05,32,6,1373096711,1373096711,1,4,0
101324125@N05,32,4,1373096671,1373096671,1,4,0
101445497@N05,33,2,1222056461,1222085250,4,2,28789
101445497@N05,33,1,1222056702,1222081802,2,2,25100
101445497@N05,34,2,1353322793,1353322793,1,3,0
101445497@N05,34,1,1353301772,1353302140,2,3,368
101445497@N05,34,6,1353311101,1353311101,1,3,0
101445497@N05,35,8,1369526812,1369526812,1,2,0
101445497@N05,35,4,1369527078,1369527078,1,2,0
101445497@N05,36,2,1433052961,1433064608,5,5,11647
101445497@N05,36,6,1433049345,1433063323,2,5,13978
101445497@N05,36,13,1433055154,1433055707,3,5,553
101445497@N05,36,1,1433060042,1433060042,1,5,0
101445497@N05,36,4,1433065021,1433065021,1,5,0
10156308@N03,37,9,1418894601,1418894645,3,2,44
10156308@N03,37,6,1418888793,1418889408,9,2,615
10156308@N03,38,8,1418955350,1418955350,1,1,0
10156308@N03,39,6,1419154366,1419154424,2,1,58
101593101@N02,40,6,1449044736,1449044736,1,1,0
101644764@N07,41,2,1287618396,1287618396,1,1,0
10175710@N03,42,5,1374552797,1374552797,1,1,0
10183029@N00,43,8,1326671795,1326703780,65,1,31985
10196023@N00,44,8,1342984200,1342984200,1,1,0
102284959@N03,45,1,1378513647,1378513958,3,1,311
102284959@N03,46,6,1380404127,1380404179,2,1,52
102284959@N03,47,13,1443012610,1443012610,1,2,0
102284959@N03,47,1,1443016325,1443022697,3,2,6372
10259875@N03,48,1,1204290000,1204290000,1,4,0
10259875@N03,48,10,1204290000,1204290000,1,4,0
10259875@N03,48,8,1204290000,1204290000,1,4,0
10259875@N03,48,2,1204290000,1204290000,1,4,0
10259875@N03,49,8,1206195892,1206195892,1,1,0
10259875@N03,50,8,1206244114,1206244114,1,1,0
10259875@N03,51,8,1231494447,1231494447,1,4,0
10259875@N03,51,2,1231457334,1231457334,1,4,0
10259875@N03,51,1,1231453610,1231477200,2,4,23590
10259875@N03,51,12,1231479743,1231479743,1,4,0
10259875@N03,52,1,1241348427,1241348437,2,1,10
10259875@N03,53,9,1262504628,1262505241,4,2,613
10259875@N03,53,1,1262493314,1262506367,8,2,13053
10259875@N03,54,10,1262565638,1262566972,4,8,1334
10259875@N03,54,6,1262589042,1262589566,2,8,524
10259875@N03,54,8,1262597911,1262600023,3,8,2112
10259875@N03,54,2,1262592780,1262600974,3,8,8194
10259875@N03,54,11,1262593108,1262593108,1,8,0
10259875@N03,54,1,1262564319,1262595557,6,8,31238
10259875@N03,54,13,1262588647,1262591122,2,8,2475
10259875@N03,54,5,1262567011,1262595338,8,8,28327
10259875@N03,55,6,1274065705,1274065705,1,5,0
10259875@N03,55,2,1274069480,1274072932,3,5,3452
10259875@N03,55,1,1274056085,1274082537,3,5,26452
10259875@N03,55,13,1274062221,1274062221,1,5,0
10259875@N03,55,5,1274054985,1274054985,1,5,0
10259875@N03,56,10,1303029633,1303029633,1,3,0
10259875@N03,56,9,1303033447,1303033447,1,3,0
10259875@N03,56,1,1303007011,1303008404,2,3,1393
10259875@N03,57,10,1322179228,1322179228,1,5,0
10259875@N03,57,8,1322175464,1322175464,1,5,0
10259875@N03,57,1,1322178313,1322178313,1,5,0
10259875@N03,57,12,1322177115,1322177115,1,5,0
10259875@N03,57,5,1322174101,1322174101,1,5,0
10259875@N03,58,11,1364599868,1364600284,4,3,416
10259875@N03,58,1,1364605221,1364605221,1,3,0
10259875@N03,58,5,1364607299,1364607988,2,3,689
10259875@N03,59,6,1392691202,1392701298,5,4,10096
10259875@N03,59,8,1392689359,1392690040,3,4,681
10259875@N03,59,1,1392699297,1392707089,4,4,7792
10259875@N03,59,5,1392703614,1392704352,2,4,738
10259875@N03,60,1,1428393713,1428399390,4,5,5677
10259875@N03,60,13,1428398337,1428398337,1,5,0
10259875@N03,60,5,1428395022,1428395022,1,5,0
10259875@N03,60,8,1428380197,1428398691,3,5,18494
10259875@N03,60,10,1428395321,1428395321,1,5,0
10266387@N07,61,4,1422264791,1422264791,1,1,0
10295241@N02,62,1,1446963129,1446963129,1,1,0
10297435@N03,63,1,1340772037,1340772743,12,1,706
10310250@N02,64,10,1281664988,1281664988,1,1,0
10350193@N07,65,6,1419593709,1419595241,5,1,1532
103792860@N03,66,4,1353211390,1353211630,7,1,240
103955312@N02,67,5,1402549370,1402551463,3,3,2093
103955312@N02,67,1,1402529256,1402529256,1,3,0
103955312@N02,67,10,1402554444,1402554444,1,3,0
10414404@N08,68,1,1406093648,1406097961,3,1,4313
104152796@N05,69,5,1423632576,1423632576,1,2,0
104152796@N05,69,9,1423636670,1423647518,2,2,10848
10455863@N03,70,4,1339240607,1339240607,1,2,0
10455863@N03,70,5,1339241244,1339241371,2,2,127
10495641@N00,71,4,1336173094,1336173094,1,1,0
105156445@N06,72,12,1408436263,1408436263,1,5,0
105156445@N06,72,6,1408430877,1408434557,4,5,3680
105156445@N06,72,1,1408429140,1408429140,1,5,0
105156445@N06,72,13,1408429237,1408429237,1,5,0
105156445@N06,72,4,1408439026,1408440405,2,5,1379
10529536@N05,73,8,1299034201,1299036355,3,1,2154
105380744@N04,74,1,1382059289,1382059297,2,4,8
105380744@N04,74,6,1382071908,1382080619,5,4,8711
105380744@N04,74,8,1382081162,1382081291,4,4,129
105380744@N04,74,5,1382057252,1382057252,1,4,0
10570686@N02,75,8,1236977235,1236983724,12,1,6489
10570686@N02,76,8,1268514597,1268532127,4,1,17530
10572043@N03,77,5,1305341252,1305341252,1,1,0
105763347@N06,78,1,1357035002,1357035002,1,3,0
105763347@N06,78,13,1357021189,1357021189,1,3,0
105763347@N06,78,6,1357027714,1357027714,1,3,0
10583070@N05,79,7,1228498558,1228498584,3,6,26
10583070@N05,79,5,1228495763,1228495849,3,6,86
10583070@N05,79,4,1228501615,1228501615,1,6,0
10583070@N05,79,1,1228501179,1228501179,1,6,0
10583070@N05,79,10,1228495023,1228495447,4,6,424
10583070@N05,79,8,1228498594,1228498664,2,6,70
105833253@N02,80,1,1375593594,1375593594,1,2,0
105833253@N02,80,6,1375576988,1375576988,1,2,0
106045902@N02,81,11,1366160963,1366160963,1,3,0
106045902@N02,81,8,1366156084,1366156084,1,3,0
106045902@N02,81,1,1366155945,1366173376,2,3,17431
10617321@N00,82,12,1464772284,1464772284,1,1,0
106475835@N05,83,7,1358599267,1358606981,4,1,7714
106475835@N05,84,7,1366984498,1366984498,1,1,0
106558608@N06,85,4,1463266795,1463291771,8,6,24976
106558608@N06,85,2,1463272332,1463273889,12,6,1557
106558608@N06,85,11,1463270583,1463270585,2,6,2
106558608@N06,85,8,1463269733,1463272632,3,6,2899
106558608@N06,85,9,1463307376,1463311638,11,6,4262
106558608@N06,85,5,1463269265,1463269281,3,6,16
10673595@N00,86,7,1463545160,1463545160,1,1,0
10692931@N08,87,10,1229564262,1229565042,2,4,780
10692931@N08,87,2,1229587000,1229587000,1,4,0
10692931@N08,87,1,1229591413,1229591413,1,4,0
10692931@N08,87,5,1229568631,1229568631,1,4,0
106980455@N06,88,7,1386386416,1386393082,3,7,6666
106980455@N06,88,1,1386383861,1386397242,6,7,13381
106980455@N06,88,5,1386384074,1386384074,1,7,0
106980455@N06,88,6,1386386928,1386400539,18,7,13611
106980455@N06,88,10,1386383408,1386383408,1,7,0
106980455@N06,88,8,1386386478,1386391086,3,7,4608
106980455@N06,88,2,1386386668,1386386683,2,7,15
10703707@N07,89,6,1320445808,1320445833,2,1,25
107084948@N08,90,1,1383875168,1383907400,65,1,32232
10774763@N05,91,13,1251949889,1251949889,1,4,0
10774763@N05,91,8,1251947838,1251948909,5,4,1071
10774763@N05,91,5,1251943774,1251947546,21,4,3772
10774763@N05,91,1,1251941192,1251947818,7,4,6626
10782871@N00,92,4,1399876292,1399876292,1,2,0
10782871@N00,92,1,1399879728,1399879728,1,2,0
107905375@N06,93,8,1455167185,1455167185,1,7,0
107905375@N06,93,13,1455173571,1455173571,1,7,0
107905375@N06,93,6,1455166868,1455175867,7,7,8999
107905375@N06,93,12,1455179453,1455179873,9,7,420
107905375@N06,93,1,1455178134,1455178134,1,7,0
107905375@N06,93,7,1455177806,1455179506,5,7,1700
107905375@N06,93,10,1455163940,1455164770,4,7,830
108140637@N08,94,9,1375178652,1375183505,20,4,4853
108140637@N08,94,1,1375178002,1375178006,2,4,4
108140637@N08,94,8,1375174229,1375177231,5,4,3002
108140637@N08,94,10,1375178149,1375178149,1,4,0
108207234@N02,95,1,1426378741,1426378741,1,2,0
108207234@N02,95,8,1426380439,1426380439,1,2,0
108207234@N02,96,1,1464334345,1464334698,3,2,353
108207234@N02,96,10,1464341933,1464341933,1,2,0
108231769@N08,97,6,1397719210,1397720643,4,1,1433
108231769@N08,98,9,1397750579,1397751933,6,1,1354
10857883@N05,99,9,1270875077,1270875748,4,2,671
10857883@N05,99,8,1270872006,1270872006,1,2,0
10858077@N00,100,2,1207263707,1207263707,1,1,0
10864775@N02,101,6,1299307707,1299307707,1,1,0
108906145@N05,102,5,1394678139,1394678139,1,1,0
109002055@N07,103,5,1367565166,1367565166,1,1,0
10902412@N03,104,5,1367877802,1367877802,1,1,0
10902412@N03,105,9,1367925858,1367925858,1,1,0
10905622@N03,106,1,1188881634,1188881634,1,1,0
10925918@N03,107,2,1277358586,1277358586,1,4,0
10925918@N03,107,8,1277368163,1277368163,1,4,0
10925918@N03,107,1,1277351159,1277351159,1,4,0
10925918@N03,107,6,1277365809,1277365809,1,4,0
10925918@N03,108,5,1362354481,1362354481,1,3,0
10925918@N03,108,6,1362372471,1362372471,1,3,0
10925918@N03,108,4,1362356439,1362356439,1,3,0
10925918@N03,109,10,1362544548,1362544548,1,3,0
10925918@N03,109,5,1362536223,1362536223,1,3,0
10925918@N03,109,9,1362551032,1362551032,1,3,0
109402089@N08,110,1,1381654050,1381654050,1,1,0
109554486@N07,111,8,1384488927,1384488927,1,4,0
109554486@N07,111,1,1384472828,1384487554,6,4,14726
109554486@N07,111,10,1384505777,1384505777,1,4,0
109554486@N07,111,6,1384483292,1384504708,24,4,21416
10983978@N03,112,11,1215939049,1215939049,1,1,0
10983978@N03,113,6,1221377395,1221377739,2,1,344
10983978@N03,114,8,1245506227,1245506227,1,1,0
10983978@N03,115,4,1256508723,1256508723,1,1,0
10983978@N03,116,11,1257032544,1257032544,1,1,0
10983978@N03,117,8,1271400342,1271400342,1,1,0
10983978@N03,118,1,1294054654,1294054654,1,1,0
10983978@N03,119,1,1302876000,1302876000,2,2,0
10983978@N03,119,8,1302876000,1302876000,1,2,0
10983978@N03,120,4,1306760345,1306760345,1,1,0
10983978@N03,121,5,1307023200,1307023200,1,1,0
10989907@N07,122,5,1385890848,1385892410,2,5,1562
10989907@N07,122,4,1385863636,1385863636,1,5,0
10989907@N07,122,8,1385854395,1385858080,3,5,3685
10989907@N07,122,1,1385854288,1385874222,2,5,19934
10989907@N07,122,6,1385854170,1385891072,7,5,36902
10989907@N07,123,12,1386399490,1386400820,6,1,1330
10989907@N07,124,6,1386589095,1386589095,1,1,0
10989907@N07,125,1,1417498202,1417498202,1,1,0
11014059@N02,126,1,1210859787,1210859787,1,3,0
11014059@N02,126,11,1210859555,1210859635,4,3,80
11014059@N02,126,2,1210845814,1210851225,17,3,5411
110166673@N02,127,6,1385518515,1385544885,58,6,26370
110166673@N02,127,7,1385532040,1385532096,8,6,56
110166673@N02,127,4,1385525341,1385527442,12,6,2101
110166673@N02,127,2,1385509875,1385542461,61,6,32586
110166673@N02,127,11,1385531572,1385531977,22,6,405
110166673@N02,127,8,1385520490,1385543670,13,6,23180
110223705@N07,128,1,1463780913,1463780913,1,1,0
110242495@N04,129,4,1395117282,1395117282,1,2,0
110242495@N04,129,5,1395112687,1395112687,1,2,0
110333758@N06,130,6,1386409898,1386410538,4,1,640
11036701@N06,131,11,1305617021,1305617021,1,1,0
11041171@N06,132,8,1358034605,1358034605,1,3,0
11041171@N06,132,7,1358056846,1358056846,1,3,0
11041171@N06,132,9,1358066722,1358067090,2,3,368
11041171@N06,133,6,1371861941,1371861941,1,1,0
110670053@N07,134,8,1425164427,1425183887,3,1,19460
110670053@N07,135,8,1426809871,1426809871,1,1,0
11136034@N06,136,8,1242653410,1242674723,19,1,21313
111364633@N02,137,3,1322010083,1322010083,1,1,0
11149127@N05,138,1,1300105565,1300105750,2,2,185
11149127@N05,138,8,1300105952,1300105952,1,2,0
111603867@N06,139,9,1390633783,1390636684,3,6,2901
111603867@N06,139,2,1390620130,1390640878,2,6,20748
111603867@N06,139,5,1390603411,1390604613,3,6,1202
111603867@N06,139,1,1390641183,1390641190,2,6,7
111603867@N06,139,8,1390611351,1390611424,2,6,73
111603867@N06,139,10,1390631897,1390631897,1,6,0
111603867@N06,140,6,1391047254,1391047254,1,2,0
111603867@N06,140,8,1391054522,1391054522,1,2,0
11171054@N04,141,7,1440154616,1440154616,1,2,0
11171054@N04,141,6,1440154613,1440154614,2,2,1
11201728@N02,142,8,1215299154,1215299429,3,1,275
112045904@N02,143,8,1385198750,1385198750,1,1,0
112593954@N05,144,2,1336178985,1336178992,2,1,7
11260538@N06,145,2,1348997214,1348997214,1,1,0
11260538@N06,146,6,1352440784,1352440784,1,1,0
11260538@N06,147,12,1352604975,1352604975,1,1,0
11260538@N06,148,6,1352708370,1352708370,1,1,0
11260538@N06,149,6,1355558747,1355558747,1,1,0
11260538@N06,150,8,1365303334,1365303740,2,3,406
11260538@N06,150,2,1365289306,1365289306,1,3,0
11260538@N06,150,4,1365306487,1365308013,2,3,1526
11260538@N06,151,7,1380845646,1380845646,1,1,0
112691972@N02,152,1,1399271310,1399271310,1,1,0
11269849@N03,153,10,1305960057,1305960057,1,4,0
11269849@N03,153,6,1305945796,1305954423,77,4,8627
11269849@N03,153,1,1305942651,1305943498,98,4,847
11269849@N03,153,4,1305955005,1305956747,19,4,1742
11269849@N03,154,1,1338604266,1338606451,28,1,2185
11269849@N03,155,1,1338691346,1338692301,58,1,955
112734542@N02,156,6,1396676251,1396676251,1,1,0
112734542@N02,157,8,1396855810,1396855812,2,3,2
112734542@N02,157,6,1396839062,1396839064,2,3,2
112734542@N02,157,12,1396854854,1396854856,2,3,2
112786774@N07,158,4,1416103198,1416103198,1,1,0
112861324@N05,159,6,1388358562,1388382534,2,1,23972
113086034@N04,160,2,1449170202,1449170241,2,1,39
113086034@N04,161,6,1459417455,1459417455,1,1,0
113086034@N04,162,6,1459464818,1459464818,1,1,0
11315654@N06,163,6,1261384389,1261385521,15,1,1132
113200565@N07,164,4,1388355161,1388355161,1,1,0
113552105@N07,165,10,1459917037,1459917037,1,1,0
11374644@N06,166,9,1289120750,1289122115,11,1,1365
113875683@N02,167,8,1355031131,1355031152,4,1,21
113875683@N02,168,6,1385278224,1385281002,15,1,2778
11429691@N03,169,8,1299925799,1299925799,1,3,0
11429691@N03,169,1,1299925803,1299925803,1,3,0
11429691@N03,169,10,1299925786,1299925786,1,3,0
11438118@N00,170,5,1189046374,1189046591,2,2,217
11438118@N00,170,1,1189049935,1189049935,1,2,0
11438118@N00,171,2,1194387758,1194400216,25,4,12458
11438118@N00,171,6,1194387353,1194387873,5,4,520
11438118@N00,171,5,1194406077,1194407648,6,4,1571
11438118@N00,171,4,1194387225,1194387225,1,4,0
11438118@N00,172,5,1196835912,1196836020,2,3,108
11438118@N00,172,1,1196835768,1196836286,5,3,518
11438118@N00,172,6,1196837475,1196839260,54,3,1785
11438118@N00,173,6,1197964343,1197965537,33,2,1194
11438118@N00,173,8,1197964040,1197967507,30,2,3467
11438118@N00,174,12,1205369780,1205371343,3,4,1563
11438118@N00,174,10,1205364488,1205364488,1,4,0
11438118@N00,174,8,1205374361,1205375346,17,4,985
11438118@N00,174,1,1205382334,1205382372,4,4,38
11438118@N00,175,2,1212023450,1212024954,7,3,1504
11438118@N00,175,5,1212019696,1212019823,3,3,127
11438118@N00,175,8,1212016994,1212016994,1,3,0
11438118@N00,176,2,1212196264,1212198389,17,3,2125
11438118@N00,176,5,1212192764,1212192764,1,3,0
11438118@N00,176,1,1212194065,1212202316,5,3,8251
11438118@N00,177,2,1230866787,1230866787,1,1,0
11438118@N00,178,6,1235767031,1235767031,1,4,0
11438118@N00,178,5,1235767803,1235768142,6,4,339
11438118@N00,178,9,1235767987,1235768003,2,4,16
11438118@N00,178,13,1235767315,1235768468,3,4,1153
11438118@N00,179,5,1244728829,1244728829,1,1,0
11438118@N00,180,11,1250319622,1250319622,1,2,0
11438118@N00,180,2,1250313623,1250313623,1,2,0
11439401@N07,181,6,1241694856,1241694856,1,1,0
11441631@N00,182,1,1348463094,1348464014,2,5,920
11441631@N00,182,9,1348475419,1348475419,1,5,0
11441631@N00,182,4,1348437987,1348443696,3,5,5709
11441631@N00,182,8,1348435140,1348435140,1,5,0
11441631@N00,182,5,1348433341,1348433341,1,5,0
11448601@N02,183,10,1368753757,1368754025,6,2,268
11448601@N02,183,6,1368764265,1368764265,4,2,0
114677615@N06,184,6,1350201596,1350201596,1,1,0
11479795@N00,185,6,1191383746,1191383746,1,2,0
11479795@N00,185,10,1191378537,1191378537,1,2,0
114862435@N06,186,6,1356852586,1356853041,5,1,455
11511707@N05,187,8,1273115226,1273142812,47,1,27586
11531720@N04,188,2,1359261324,1359261324,1,1,0
11541209@N06,189,8,1191152405,1191152405,1,1,0
11541209@N06,190,5,1193908590,1193908590,1,1,0
115511286@N06,191,5,1392327104,1392327104,1,5,0
115511286@N06,191,1,1392325603,1392328317,2,5,2714
115511286@N06,191,11,1392304308,1392304308,1,5,0
115511286@N06,191,8,1392304253,1392325838,2,5,21585
115511286@N06,191,6,1392313359,1392313359,1,5,0
115653984@N07,192,4,1388278739,1388278739,1,1,0
11581147@N06,193,4,1432616461,1432616461,1,2,0
11581147@N06,193,13,1432607697,1432608738,2,2,1041
11611067@N02,194,13,1342856825,1342856825,1,8,0
11611067@N02,194,5,1342845605,1342872106,13,8,26501
11611067@N02,194,8,1342847624,1342873626,5,8,26002
11611067@N02,194,6,1342837568,1342838091,5,8,523
11611067@N02,194,1,1342873685,1342873685,1,8,0
11611067@N02,194,10,1342833389,1342833389,1,8,0
11611067@N02,194,2,1342834074,1342859712,6,8,25638
11611067@N02,194,4,1342863884,1342869056,6,8,5172
11632646@N02,195,6,1187949064,1187949064,1,1,0
11654579@N07,196,1,1370128776,1370128776,1,1,0
11699747@N03,197,4,1388731483,1388731483,1,1,0
11724486@N02,198,2,1384908953,1384911772,9,6,2819
11724486@N02,198,1,1384908453,1384938069,3,6,29616
11724486@N02,198,4,1384937778,1384937779,2,6,1
11724486@N02,198,10,1384938229,1384938229,1,6,0
11724486@N02,198,13,1384915596,1384915775,6,6,179
11724486@N02,198,6,1384913450,1384937738,29,6,24288
11724486@N02,199,1,1385000166,1385000168,2,2,2
11724486@N02,199,5,1384998537,1384998537,1,2,0
117386007@N08,200,5,1323920060,1323922676,3,1,2616
11752574@N06,201,8,1194867072,1194871533,11,2,4461
11752574@N06,201,9,1194863070,1194863281,2,2,211
11752574@N06,202,11,1347879470,1347879470,1,1,0
11752574@N06,203,4,1348187570,1348187570,1,2,0
11752574@N06,203,1,1348201983,1348201983,1,2,0
117536444@N07,204,6,1373787970,1373787970,1,1,0
11785705@N02,205,8,1291541664,1291541664,1,3,0
11785705@N02,205,5,1291530596,1291530596,1,3,0
11785705@N02,205,7,1291532404,1291532404,1,3,0
11825945@N00,206,1,1370011964,1370011964,1,1,0
11825945@N00,207,1,1378248428,1378248428,1,1,0
11825945@N00,208,1,1379048071,1379048071,1,1,0
11825945@N00,209,5,1389493193,1389493193,1,1,0
11825945@N00,210,8,1403344473,1403344473,1,1,0
118757159@N03,211,8,1393023130,1393023130,1,2,0
118757159@N03,211,1,1393023090,1393023811,5,2,721
11901577@N03,212,4,1425168331,1425179544,2,1,11213
11901577@N03,213,4,1432261320,1432261320,1,1,0
11901577@N03,214,4,1432338691,1432338691,1,1,0
11901577@N03,215,4,1432451575,1432475348,2,1,23773
11915551@N07,216,8,1195799564,1195816421,2,6,16857
11915551@N07,216,4,1195799188,1195804591,2,6,5403
11915551@N07,216,1,1195802798,1195816563,2,6,13765
11915551@N07,216,5,1195802623,1195802623,1,6,0
11915551@N07,216,13,1195808062,1195809616,4,6,1554
11915551@N07,216,6,1195813785,1195813785,1,6,0
11928454@N04,217,8,1244675136,1244698922,4,11,23786
11928454@N04,217,7,1244686426,1244686426,1,11,0
11928454@N04,217,5,1244680974,1244682559,6,11,1585
11928454@N04,217,9,1244723220,1244724917,3,11,1697
11928454@N04,217,2,1244677924,1244711429,5,11,33505
11928454@N04,217,1,1244675038,1244688623,5,11,13585
11928454@N04,217,6,1244711876,1244714402,6,11,2526
11928454@N04,217,12,1244688394,1244706728,4,11,18334
11928454@N04,217,10,1244674345,1244674345,1,11,0
11928454@N04,217,4,1244694841,1244700950,2,11,6109
11928454@N04,217,11,1244710500,1244710633,2,11,133
11935368@N00,218,8,1292293768,1292297656,8,5,3888
11935368@N00,218,5,1292275368,1292282059,5,5,6691
11935368@N00,218,2,1292284750,1292284750,1,5,0
11935368@N00,218,6,1292289058,1292307160,5,5,18102
11935368@N00,218,1,1292275254,1292275254,1,5,0
11935368@N00,219,8,1292833788,1292833796,2,2,8
11935368@N00,219,1,1292833783,1292833801,2,2,18
119422749@N03,220,1,1395021135,1395021135,1,1,0
11954862@N00,221,4,1394585766,1394596075,3,1,10309
119796978@N03,222,7,1393222670,1393222670,1,1,0
119993435@N06,223,5,1381530041,1381530046,2,1,5
119993435@N06,224,9,1381570055,1381570069,3,2,14
119993435@N06,224,2,1381571785,1381573107,7,2,1322
12004667@N02,225,8,1294189062,1294189062,1,1,0
12008385@N00,226,12,1291337758,1291337758,1,1,0
120147674@N05,227,5,1395541082,1395541091,2,1,9
120147674@N05,228,6,1395637555,1395637555,1,1,0
12036424@N04,229,5,1305535719,1305535719,1,2,0
12036424@N04,229,2,1305518103,1305518135,2,2,32
12044368@N04,230,2,1409520858,1409520858,1,1,0
12044368@N04,231,4,1410646605,1410646605,1,1,0
120533378@N03,232,11,1443222844,1443246925,32,1,24081
120533378@N03,233,4,1443319571,1443319596,3,5,25
120533378@N03,233,2,1443308605,1443308793,6,5,188
120533378@N03,233,11,1443315586,1443325884,2,5,10298
120533378@N03,233,1,1443311457,1443311457,1,5,0
120533378@N03,233,6,1443308889,1443318172,5,5,9283
120533378@N03,234,11,1443607640,1443607663,3,1,23
120533378@N03,235,11,1443935613,1443935613,1,1,0
120756153@N05,236,2,1344919542,1344934333,5,1,14791
120756153@N05,237,6,1386733041,1386733626,4,1,585
12083014@N05,238,1,1222338668,1222338668,1,1,0
12083014@N05,239,8,1253679229,1253679229,1,3,0
12083014@N05,239,5,1253670181,1253670181,1,3,0
12083014@N05,239,1,1253679313,1253679313,1,3,0
12083014@N05,240,5,1298270423,1298278543,2,1,8120
12084245@N08,241,1,1247561926,1247583015,8,1,21089
12084245@N08,242,1,1247644483,1247644483,1,1,0
12084245@N08,243,1,1247727888,1247736826,5,1,8938
121354827@N08,244,4,1370574691,1370576176,6,3,1485
121354827@N08,244,13,1370576162,1370576162,1,3,0
121354827@N08,244,5,1370565558,1370565558,1,3,0
121499845@N05,245,4,1404350364,1404350364,1,1,0
121655138@N03,246,6,1395807500,1395807500,1,8,0
121655138@N03,246,7,1395792790,1395792790,1,8,0
121655138@N03,246,2,1395802896,1395805842,4,8,2946
121655138@N03,246,13,1395794652,1395794680,2,8,28
121655138@N03,246,1,1395792479,1395814343,8,8,21864
121655138@N03,246,8,1395787851,1395815428,9,8,27577
121655138@N03,246,5,1395812371,1395812374,2,8,3
121655138@N03,246,10,1395791030,1395791570,8,8,540
121655138@N03,247,6,1396012693,1396012693,1,1,0
121861619@N03,248,1,1423627678,1423627795,2,5,117
121861619@N03,248,4,1423628127,1423633767,4,5,5640
121861619@N03,248,2,1423630357,1423630393,3,5,36
121861619@N03,248,8,1423630435,1423632026,5,5,1591
121861619@N03,248,6,1423628184,1423630139,19,5,1955
121861619@N03,249,1,1423696686,1423696778,3,9,92
121861619@N03,249,8,1423719902,1423719902,1,9,0
121861619@N03,249,11,1423719872,1423719872,1,9,0
121861619@N03,249,3,1423699821,1423704437,7,9,4616
121861619@N03,249,2,1423719967,1423720008,2,9,41
121861619@N03,249,13,1423720251,1423720754,4,9,503
121861619@N03,249,7,1423719812,1423719812,1,9,0
121861619@N03,249,10,1423713858,1423715145,14,9,1287
121861619@N03,249,6,1423703159,1423703336,2,9,177
12186997@N00,250,6,1356773316,1356773316,1,1,0
12197785@N03,251,8,1246159959,1246159959,1,1,0
12197785@N03,252,11,1259912134,1259912134,1,2,0
12197785@N03,252,8,1259915628,1259915628,1,2,0
12197785@N03,253,5,1287889790,1287889790,1,3,0
12197785@N03,253,13,1287875234,1287875234,1,3,0
12197785@N03,253,1,1287888667,1287889462,2,3,795
12205233@N02,254,8,1227527503,1227527503,1,1,0
122353703@N02,255,1,1421211481,1421211544,3,1,63
122353703@N02,256,1,1421727073,1421727117,4,3,44
122353703@N02,256,7,1421727030,1421727039,3,3,9
122353703@N02,256,8,1421727179,1421727188,3,3,9
122353703@N02,257,1,1421813229,1421813462,9,3,233
122353703@N02,257,7,1421813172,1421813179,3,3,7
122353703@N02,257,8,1421813274,1421813274,1,3,0
12247055@N00,258,12,1461203879,1461204030,2,3,151
12247055@N00,258,5,1461200710,1461200710,1,3,0
12247055@N00,258,13,1461198101,1461217228,12,3,19127
12247055@N00,259,13,1461307605,1461307605,1,1,0
12277777@N04,260,6,1311230777,1311230777,1,3,0
12277777@N04,260,1,1311224040,1311224049,2,3,9
12277777@N04,260,3,1311222580,1311222580,1,3,0
122876725@N05,261,1,1406328033,1406328133,6,7,100
122876725@N05,261,5,1406328219,1406351276,7,7,23057
122876725@N05,261,8,1406328494,1406331463,7,7,2969
122876725@N05,261,11,1406331436,1406331436,1,7,0
122876725@N05,261,7,1406328478,1406328478,1,7,0
122876725@N05,261,2,1406331469,1406331615,10,7,146
122876725@N05,261,4,1406335757,1406335876,9,7,119
122876725@N05,262,1,1407227832,1407236200,5,6,8368
122876725@N05,262,5,1407229209,1407229212,2,6,3
122876725@N05,262,10,1407236349,1407236402,6,6,53
122876725@N05,262,3,1407233240,1407233240,1,6,0
122876725@N05,262,9,1407237093,1407239825,76,6,2732
122876725@N05,262,4,1407233187,1407233219,4,6,32
122876725@N05,263,1,1407286640,1407323603,6,5,36963
122876725@N05,263,5,1407298072,1407323422,12,5,25350
122876725@N05,263,10,1407298102,1407299064,19,5,962
122876725@N05,263,6,1407289500,1407289500,1,5,0
122876725@N05,263,9,1407298308,1407299081,4,5,773
123065585@N07,264,5,1398926501,1398926501,1,1,0
12316147@N05,265,1,1459493156,1459493165,2,3,9
12316147@N05,265,6,1459470454,1459481737,21,3,11283
12316147@N05,265,7,1459490076,1459492985,27,3,2909
123398648@N02,266,6,1349566143,1349566143,1,2,0
123398648@N02,266,2,1349564597,1349564648,2,2,51
12353441@N02,267,1,1191317489,1191318497,2,1,1008
12381123@N06,268,1,1324337047,1324349120,8,3,12073
12381123@N06,268,6,1324351939,1324351939,1,3,0
12381123@N06,268,5,1324337348,1324337348,1,3,0
12395214@N08,269,7,1357922286,1357945329,114,1,23043
12395214@N08,270,7,1432984860,1432989948,43,1,5088
124146448@N07,271,2,1357095263,1357095263,1,1,0
124235757@N05,272,1,1342655347,1342655347,1,1,0
124235757@N05,273,11,1342688161,1342688161,1,4,0
124235757@N05,273,4,1342685908,1342685908,1,4,0
124235757@N05,273,6,1342685927,1342685927,1,4,0
124235757@N05,273,2,1342688302,1342688543,2,4,241
124370052@N08,274,10,1396654429,1396654429,1,1,0
12445963@N00,275,8,1412820400,1412820400,1,1,0
124601595@N06,276,5,1398490852,1398498134,18,2,7282
124601595@N06,276,1,1398489903,1398499596,4,2,9693
124601595@N06,277,5,1398700558,1398700558,1,1,0
124601595@N06,278,10,1398740509,1398741852,8,4,1343
124601595@N06,278,6,1398748319,1398748622,14,4,303
124601595@N06,278,1,1398744113,1398744113,1,4,0
124601595@N06,278,4,1398746307,1398748255,6,4,1948
124948917@N04,279,8,1433632952,1433632952,1,2,0
124948917@N04,279,1,1433652614,1433652629,3,2,15
12508217@N08,280,8,1301708081,1301708081,1,1,0
12508217@N08,281,4,1318562490,1318562490,1,1,0
12508217@N08,282,6,1337489572,1337489572,1,3,0
12508217@N08,282,13,1337478253,1337478262,3,3,9
12508217@N08,282,4,1337481245,1337483000,6,3,1755
12508217@N08,283,8,1368837134,1368840695,5,2,3561
12508217@N08,283,7,1368865161,1368865519,8,2,358
125837856@N05,284,5,1404208123,1404209580,6,8,1457
125837856@N05,284,10,1404164483,1404164483,1,8,0
125837856@N05,284,13,1404201969,1404203855,27,8,1886
125837856@N05,284,1,1404186991,1404195836,7,8,8845
125837856@N05,284,9,1404213120,1404213996,6,8,876
125837856@N05,284,8,1404169667,1404181714,6,8,12047
125837856@N05,284,4,1404176846,1404189349,4,8,12503
125837856@N05,284,6,1404174187,1404174187,1,8,0
125863683@N08,285,2,1417827013,1417837124,3,5,10111
125863683@N08,285,10,1417843396,1417843396,1,5,0
125863683@N08,285,6,1417851414,1417851414,1,5,0
125863683@N08,285,8,1417839217,1417839937,4,5,720
125863683@N08,285,5,1417822774,1417825583,5,5,2809
12592520@N03,286,11,1230859384,1230859384,1,7,0
12592520@N03,286,5,1230872358,1230872358,1,7,0
12592520@N03,286,8,1230892404,1230892404,1,7,0
12592520@N03,286,1,1230855282,1230855282,1,7,0
12592520@N03,286,13,1230875775,1230875775,1,7,0
12592520@N03,286,6,1230884385,1230884385,1,7,0
12592520@N03,286,7,1230866516,1230866516,1,7,0
12592520@N03,287,5,1231380138,1231380138,1,4,0
12592520@N03,287,8,1231390313,1231390313,1,4,0
12592520@N03,287,13,1231385729,1231385729,1,4,0
12592520@N03,287,10,1231377861,1231378338,2,4,477
126190379@N03,288,8,1376882057,1376882058,2,2,1
126190379@N03,288,2,1376893303,1376893303,1,2,0
126521704@N08,289,1,1404261446,1404261446,1,3,0
126521704@N08,289,8,1404266385,1404266385,1,3,0
126521704@N08,289,6,1404279502,1404279502,1,3,0
12658090@N00,290,4,1358664971,1358664971,1,1,0
12658090@N00,291,4,1400924621,1400924621,1,1,0
12659736@N02,292,9,1210244057,1210246282,83,5,2225
12659736@N02,292,1,1210237752,1210243643,12,5,5891
12659736@N02,292,2,1210232781,1210232791,5,5,10
12659736@N02,292,5,1210243785,1210246469,4,5,2684
12659736@N02,292,6,1210229645,1210233116,8,5,3471
12659736@N02,293,9,1232785190,1232785453,2,3,263
12659736@N02,293,1,1232783534,1232783796,2,3,262
12659736@N02,293,2,1232783434,1232783434,1,3,0
12659736@N02,294,10,1420769262,1420769321,11,1,59
126776752@N03,295,8,1437183741,1437183741,1,1,0
126776752@N03,296,4,1449272650,1449272650,1,1,0
126977796@N08,297,5,1460087003,1460087138,2,6,135
126977796@N08,297,7,1460080958,1460080975,4,6,17
126977796@N08,297,4,1460073729,1460073848,2,6,119
126977796@N08,297,12,1460089210,1460089234,2,6,24
126977796@N08,297,6,1460080500,1460080500,1,6,0
126977796@N08,297,1,1460093084,1460093084,1,6,0
127278883@N08,298,1,1439708144,1439708166,7,1,22
12742129@N00,299,5,1300693783,1300704172,3,1,10389
12742129@N00,300,5,1340111218,1340111218,1,1,0
127484878@N05,301,9,1444712678,1444712678,1,1,0
127662106@N04,302,9,1413540143,1413540157,4,2,14
127662106@N04,302,1,1413535724,1413535724,1,2,0
127662106@N04,303,6,1415516270,1415517247,13,1,977
127662106@N04,304,8,1420860330,1420860330,1,2,0
127662106@N04,304,1,1420859803,1420863499,3,2,3696
127662106@N04,305,8,1421815194,1421816284,4,2,1090
127662106@N04,305,1,1421815074,1421815074,1,2,0
127662106@N04,306,8,1422160895,1422171496,7,1,10601
127662106@N04,307,12,1453535275,1453535306,2,1,31
127662106@N04,308,6,1459916121,1459916600,5,1,479
127662106@N04,309,6,1462610016,1462610169,4,1,153
127662106@N04,310,1,1466164069,1466164507,9,2,438
127662106@N04,310,6,1466153387,1466153406,2,2,19
127662106@N04,311,6,1470728837,1470729062,9,1,225
127810693@N08,312,6,1259088424,1259089697,4,1,1273
128509080@N04,313,1,1417536180,1417566483,2,6,30303
128509080@N04,313,6,1417525200,1417567544,10,6,42344
128509080@N04,313,2,1417525200,1417565069,2,6,39869
128509080@N04,313,5,1417575138,1417575138,1,6,0
128509080@N04,313,8,1417516295,1417536701,2,6,20406
128509080@N04,313,12,1417571598,1417571598,1,6,0
128526407@N07,314,2,1416192751,1416192751,1,1,0
128526407@N07,315,2,1416338751,1416338751,1,1,0
128526407@N07,316,6,1418085124,1418085124,1,1,0
128526407@N07,317,5,1418536656,1418536656,1,1,0
128799974@N05,318,9,1367752429,1367752429,1,1,0
129438227@N06,319,2,1417427790,1417427790,1,1,0
129438227@N06,320,8,1419417584,1419417584,1,1,0
129438227@N06,321,2,1451984782,1451984782,1,1,0
129455250@N03,322,10,1438653146,1438653146,1,1,0
12989776@N03,323,8,1272943898,1272943898,1,1,0
12989776@N03,324,7,1300520787,1300520787,1,1,0
130069612@N06,325,1,1433328716,1433328716,1,2,0
130069612@N06,325,7,1433329556,1433329556,1,2,0
130069612@N06,326,2,1433577683,1433578569,2,2,886
130069612@N06,326,1,1433585112,1433585112,1,2,0
130069612@N06,327,4,1463294171,1463294171,1,2,0
130069612@N06,327,5,1463305163,1463305163,1,2,0
130069612@N06,328,5,1463528599,1463540876,2,1,12277
130069612@N06,329,1,1464085658,1464085658,1,2,0
130069612@N06,329,5,1464082999,1464082999,1,2,0
130127205@N04,330,10,1455940324,1455940350,3,1,26
13137063@N05,331,5,1370252355,1370252558,2,1,203
131412080@N05,332,1,1451080331,1451098671,6,8,18340
131412080@N05,332,4,1451087118,1451088176,5,8,1058
131412080@N05,332,3,1451087174,1451087217,2,8,43
131412080@N05,332,8,1451084641,1451086102,14,8,1461
131412080@N05,332,9,1451116953,1451118344,10,8,1391
131412080@N05,332,5,1451080600,1451094185,23,8,13585
131412080@N05,332,2,1451085411,1451085895,10,8,484
131412080@N05,332,6,1451085970,1451090139,8,8,4169
13156986@N08,333,1,1391969825,1391969825,1,2,0
13156986@N08,333,11,1391981290,1391981290,1,2,0
131849702@N06,334,4,1436316755,1436316755,1,6,0
131849702@N06,334,2,1436322638,1436322638,1,6,0
131849702@N06,334,8,1436328926,1436328926,2,6,0
131849702@N06,334,7,1436316484,1436316494,5,6,10
131849702@N06,334,11,1436321588,1436321588,1,6,0
131849702@N06,334,5,1436333187,1436333196,6,6,9
131918782@N02,335,4,1422340951,1422341044,3,4,93
131918782@N02,335,1,1422315818,1422315822,2,4,4
131918782@N02,335,6,1422334804,1422340583,12,4,5779
131918782@N02,335,12,1422313687,1422315863,12,4,2176
131918782@N02,336,4,1422572207,1422600277,3,4,28070
131918782@N02,336,8,1422577414,1422577422,2,4,8
131918782@N02,336,2,1422576107,1422576131,2,4,24
131918782@N02,336,6,1422583055,1422600237,23,4,17182
131918782@N02,337,2,1442272718,1442272722,2,3,4
131918782@N02,337,8,1442277766,1442288712,4,3,10946
131918782@N02,337,6,1442290519,1442295114,2,3,4595
13199533@N04,338,1,1311001232,1311006673,2,1,5441
132132547@N04,339,1,1428746744,1428746744,1,3,0
132132547@N04,339,7,1428730693,1428730825,4,3,132
132132547@N04,339,5,1428733361,1428746688,2,3,13327
13230685@N08,340,1,1359522689,1359522689,1,1,0
132357461@N07,341,9,1405676940,1405676940,1,1,0
132472019@N05,342,9,1440158775,1440158775,1,2,0
132472019@N05,342,5,1440147326,1440147326,1,2,0
13259518@N00,343,13,1245212278,1245212278,1,5,0
13259518@N00,343,4,1245209192,1245209192,1,5,0
13259518@N00,343,2,1245205525,1245205525,1,5,0
13259518@N00,343,5,1245202276,1245202327,2,5,51
13259518@N00,343,1,1245201951,1245224180,3,5,22229
13269428@N04,344,4,1233713431,1233713431,1,1,0
13269428@N04,345,11,1233807238,1233807241,2,1,3
132959156@N02,346,12,1433151402,1433151658,3,1,256
132959156@N02,347,8,1440155875,1440155875,1,1,0
132959156@N02,348,13,1463571900,1463571900,1,1,0
13352060@N06,349,1,1278543315,1278543315,1,1,0
13359849@N00,350,12,1383785496,1383785496,1,2,0
13359849@N00,350,5,1383773232,1383774857,2,2,1625
13403703@N06,351,9,1200030835,1200030835,1,1,0
13417605@N00,352,8,1441418552,1441418552,1,1,0
13417605@N00,353,13,1441586292,1441586292,1,1,0
134211944@N07,354,1,1460345320,1460345320,1,1,0
134814033@N03,355,4,1452219092,1452219092,3,6,0
134814033@N03,355,1,1452211986,1452221852,2,6,9866
134814033@N03,355,12,1452217451,1452217451,1,6,0
134814033@N03,355,13,1452215309,1452215750,3,6,441
134814033@N03,355,8,1452217781,1452234768,4,6,16987
134814033@N03,355,10,1452207050,1452207050,2,6,0
13487696@N04,356,12,1378704825,1378704825,1,1,0
135022299@N07,357,12,1442801913,1442834984,5,1,33071
135322752@N06,358,5,1439807744,1439807744,1,1,0
13599014@N08,359,8,1376953098,1376953098,1,5,0
13599014@N08,359,7,1376952812,1376953153,25,5,341
13599014@N08,359,11,1376952813,1376952823,6,5,10
13599014@N08,359,1,1376952814,1376953120,14,5,306
13599014@N08,359,12,1376952818,1376952818,1,5,0
13599014@N08,360,7,1377134668,1377134673,9,1,5
13600026@N07,361,5,1389308967,1389308967,1,1,0
13613904@N05,362,4,1211443621,1211446060,2,3,2439
13613904@N05,362,2,1211447600,1211447600,1,3,0
13613904@N05,362,9,1211455351,1211455615,5,3,264
13613904@N05,363,8,1274515171,1274515171,1,2,0
13613904@N05,363,2,1274501816,1274501816,1,2,0
13613904@N05,364,4,1275035555,1275041368,2,2,5813
13613904@N05,364,8,1275028967,1275028967,1,2,0
13613904@N05,365,9,1275103263,1275103263,1,3,0
13613904@N05,365,10,1275114337,1275114337,1,3,0
13613904@N05,365,8,1275102526,1275102526,1,3,0
13613904@N05,366,5,1336801910,1336801910,1,1,0
13616389@N04,367,8,1329006550,1329026492,26,1,19942
13619351@N06,368,4,1336136605,1336143027,3,1,6422
13644648@N03,369,12,1254032430,1254032430,1,1,0
13644648@N03,370,2,1254659293,1254659293,1,3,0
13644648@N03,370,10,1254659323,1254659323,1,3,0
13644648@N03,370,8,1254659321,1254659321,1,3,0
13644648@N03,371,2,1287810311,1287810311,1,6,0
13644648@N03,371,4,1287810307,1287810307,1,6,0
13644648@N03,371,1,1287810306,1287810309,2,6,3
13644648@N03,371,10,1287810312,1287810312,1,6,0
13644648@N03,371,8,1287810302,1287810305,3,6,3
13644648@N03,371,5,1287810298,1287810313,6,6,15
13722851@N04,372,2,1302064394,1302064394,1,1,0
13764100@N05,373,1,1237086011,1237114633,21,2,28622
13764100@N05,373,5,1237082833,1237096639,3,2,13806
13764100@N05,374,10,1348974549,1348974872,3,3,323
13764100@N05,374,1,1348976162,1348996299,19,3,20137
13764100@N05,374,5,1348996911,1348996911,1,3,0
13813159@N00,375,1,1353907681,1353908166,2,1,485
13813159@N00,376,6,1353984511,1353984511,1,4,0
13813159@N00,376,5,1353959938,1353960434,5,4,496
13813159@N00,376,12,1353994681,1354003624,5,4,8943
13813159@N00,376,4,1353984775,1353984990,3,4,215
13813159@N00,377,12,1354035706,1354035706,1,1,0
13818837@N05,378,4,1308782454,1308782454,1,1,0
13880897@N06,379,6,1361063737,1361089863,4,5,26126
13880897@N06,379,12,1361078367,1361078435,2,5,68
13880897@N06,379,5,1361066410,1361066482,6,5,72
13880897@N06,379,8,1361059509,1361065161,4,5,5652
13880897@N06,379,1,1361058670,1361090265,6,5,31595
13880897@N06,380,2,1403171102,1403171102,1,1,0
13885531@N00,381,1,1226210481,1226210481,1,3,0
13885531@N00,381,6,1226209498,1226209498,1,3,0
13885531@N00,381,10,1226211296,1226211296,1,3,0
13901020@N02,382,1,1190414975,1190415294,32,6,319
13901020@N02,382,6,1190415008,1190415023,4,6,15
13901020@N02,382,5,1190415298,1190415361,6,6,63
13901020@N02,382,13,1190414988,1190414993,2,6,5
13901020@N02,382,4,1190415242,1190415252,3,6,10
13901020@N02,382,8,1190404931,1190404931,1,6,0
139081931@N05,383,9,1409568772,1409568772,1,1,0
139081931@N05,384,4,1458382876,1458382876,1,1,0
13929738@N04,385,9,1194859537,1194859537,1,2,0
13929738@N04,385,1,1194834579,1194849944,2,2,15365
13933131@N08,386,1,1317274851,1317281498,7,5,6647
13933131@N08,386,10,1317274556,1317281146,7,5,6590
13933131@N08,386,5,1317275262,1317275742,4,5,480
13933131@N08,386,12,1317278102,1317278300,2,5,198
13933131@N08,386,7,1317282300,1317282300,1,5,0
13933131@N08,387,8,1381622995,1381648305,8,1,25310
13933131@N08,388,8,1381684496,1381703863,13,1,19367
13945854@N00,389,8,1423618271,1423618271,1,1,0
13959240@N08,390,5,1346548916,1346548916,1,3,0
13959240@N08,390,2,1346555378,1346555378,1,3,0
13959240@N08,390,4,1346556867,1346556867,1,3,0
13991097@N02,391,4,1323158666,1323158766,4,2,100
13991097@N02,391,6,1323158826,1323159579,8,2,753
14022320@N00,392,8,1314313160,1314353389,42,1,40229
14057191@N07,393,8,1266814236,1266814236,1,1,0
14101284@N07,394,1,1191105702,1191105702,1,1,0
14101284@N07,395,1,1228450578,1228450578,1,1,0
14101284@N07,396,1,1250814419,1250814419,1,1,0
14125170@N02,397,7,1273586401,1273586401,1,1,0
14129109@N07,398,8,1344320411,1344339324,17,1,18913
14129109@N07,399,8,1345184141,1345209588,12,1,25447
14130502@N07,400,13,1310257714,1310257714,1,3,0
14130502@N07,400,1,1310256568,1310256568,1,3,0
14130502@N07,400,8,1310251429,1310251441,2,3,12
14135751@N07,401,6,1368851632,1368851632,1,3,0
14135751@N07,401,8,1368852285,1368852336,4,3,51
14135751@N07,401,2,1368851927,1368851927,1,3,0
14135751@N07,402,1,1400291999,1400292074,7,2,75
14135751@N07,402,2,1400286007,1400286007,1,2,0
14135751@N07,403,4,1433059296,1433059296,1,1,0
14249123@N02,404,5,1211158308,1211158308,1,2,0
14249123@N02,404,1,1211158281,1211158281,1,2,0
14280458@N05,405,6,1284371603,1284378535,6,1,6932
14332482@N05,406,5,1452849225,1452849225,1,1,0
14334279@N02,407,4,1420334546,1420334546,1,1,0
14344313@N05,408,8,1203662646,1203665278,2,1,2632
14344313@N05,409,8,1203802839,1203819131,10,2,16292
14344313@N05,409,9,1203834599,1203838016,2,2,3417
14363548@N07,410,13,1230812002,1230812002,1,1,0
14370802@N05,411,8,1402719439,1402719439,1,1,0
14370802@N05,412,4,1433588285,1433588285,1,1,0
14404008@N00,413,6,1223608123,1223608123,1,5,0
14404008@N00,413,12,1223595857,1223596527,3,5,670
14404008@N00,413,4,1223593052,1223597499,3,5,4447
14404008@N00,413,1,1223596705,1223596729,2,5,24
14404008@N00,413,8,1223589196,1223589196,1,5,0
14428367@N00,414,2,1287284346,1287284346,1,2,0
14428367@N00,414,8,1287281995,1287282096,2,2,101
14449931@N08,415,12,1378615345,1378615345,1,2,0
14449931@N08,415,6,1378599526,1378599526,1,2,0
14449931@N08,416,2,1378889530,1378890994,2,2,1464
14449931@N08,416,13,1378889195,1378889195,1,2,0
14449931@N08,417,8,1400191821,1400197010,2,1,5189
14449931@N08,418,8,1400312910,1400316684,2,1,3774
14449931@N08,419,8,1400398660,1400410656,3,1,11996
14453171@N00,420,4,1322884544,1322884544,1,1,0
14479515@N03,421,9,1199779456,1199781990,26,9,2534
14479515@N03,421,8,1199764250,1199778381,9,9,14131
14479515@N03,421,1,1199751777,1199778588,59,9,26811
14479515@N03,421,4,1199752335,1199763909,11,9,11574
14479515@N03,421,6,1199753428,1199753695,9,9,267
14479515@N03,421,7,1199774242,1199775287,7,9,1045
14479515@N03,421,10,1199751414,1199751436,2,9,22
14479515@N03,421,5,1199754423,1199758861,4,9,4438
14479515@N03,421,13,1199763636,1199771518,37,9,7882
14479515@N03,422,1,1254095190,1254113612,11,1,18422
14479515@N03,423,8,1254463673,1254463682,4,1,9
14484378@N08,424,1,1189833248,1189833248,1,1,0
14484378@N08,425,1,1190567402,1190567402,1,1,0
14484378@N08,426,1,1191085877,1191086475,16,1,598
14484378@N08,427,1,1192464551,1192464623,5,1,72
14484378@N08,428,1,1195920516,1195921194,8,1,678
14484378@N08,429,1,1197648566,1197649278,4,1,712
14484378@N08,430,9,1204749180,1204750157,4,1,977
14484378@N08,431,9,1205440587,1205441658,6,1,1071
14484378@N08,432,9,1209052808,1209053871,10,1,1063
14484378@N08,433,9,1210350120,1210350120,1,1,0
14484378@N08,434,9,1211385644,1211386661,16,1,1017
14484378@N08,435,9,1211493629,1211495127,5,1,1498
14484378@N08,436,9,1211558953,1211560420,7,1,1467
14484378@N08,437,9,1212163769,1212163970,6,1,201
14484378@N08,438,9,1212508983,1212509637,5,1,654
14484378@N08,439,9,1212682044,1212682250,2,1,206
14484378@N08,440,9,1213372997,1213373515,2,1,518
14484378@N08,441,8,1216348200,1216348500,10,1,300
14484378@N08,442,9,1216679550,1216679608,2,1,58
14484378@N08,443,9,1217866449,1217866449,1,1,0
14484378@N08,444,9,1218730219,1218730293,3,1,74
14484378@N08,445,12,1218814664,1218814664,1,2,0
14484378@N08,445,9,1218816555,1218817000,3,2,445
14484378@N08,446,9,1219420756,1219420852,2,1,96
14484378@N08,447,9,1219853542,1219853772,5,1,230
14484378@N08,448,9,1220996060,1220997341,6,1,1281
14484378@N08,449,8,1221217721,1221242046,22,1,24325
14484378@N08,450,9,1222204641,1222204967,3,1,326
14484378@N08,451,9,1222290050,1222291549,20,1,1499
14484378@N08,452,9,1222377151,1222377867,17,1,716
14580956@N08,453,11,1281222752,1281258518,102,1,35766
14617498@N00,454,13,1227339665,1227341219,2,3,1554
14617498@N00,454,5,1227347194,1227348090,3,3,896
14617498@N00,454,1,1227349233,1227349372,2,3,139
14617498@N00,455,6,1229247802,1229250312,4,2,2510
14617498@N00,455,9,1229243628,1229244846,10,2,1218
14617498@N00,456,11,1229309180,1229309180,1,1,0
14617498@N00,457,8,1255831444,1255831444,1,1,0
14617498@N00,458,4,1318633716,1318633716,1,1,0
14625004@N00,459,6,1195716233,1195716337,2,1,104
14625004@N00,460,1,1195773036,1195773046,2,6,10
14625004@N00,460,13,1195779618,1195779849,2,6,231
14625004@N00,460,5,1195773998,1195773998,1,6,0
14625004@N00,460,8,1195775070,1195775076,2,6,6
14625004@N00,460,4,1195789206,1195789206,1,6,0
14625004@N00,460,6,1195794032,1195794037,2,6,5
14667816@N02,461,8,1228788885,1228812441,8,1,23556
14764161@N00,462,2,1383224400,1383224400,4,1,0
14769156@N08,463,6,1417954936,1417954936,1,1,0
14769156@N08,464,11,1433253058,1433253118,2,3,60
14769156@N08,464,2,1433253262,1433253286,4,3,24
14769156@N08,464,8,1433252970,1433253147,2,3,177
14845075@N00,465,6,1407554317,1407568905,3,5,14588
14845075@N00,465,4,1407569142,1407569142,1,5,0
14845075@N00,465,8,1407551662,1407570338,4,5,18676
14845075@N00,465,1,1407550832,1407570838,7,5,20006
14845075@N00,465,13,1407549100,1407549100,1,5,0
14873749@N02,466,1,1215684786,1215706353,17,2,21567
14873749@N02,466,8,1215710003,1215710048,2,2,45
14873749@N02,467,7,1220336845,1220336845,1,1,0
14873749@N02,468,8,1309952226,1309971601,6,1,19375
14873749@N02,469,1,1311172500,1311172500,1,1,0
14877255@N04,470,4,1442659777,1442659777,1,1,0
14884361@N02,471,8,1264405412,1264405603,5,4,191
14884361@N02,471,10,1264401277,1264401277,1,4,0
14884361@N02,471,3,1264402432,1264407407,6,4,4975
14884361@N02,471,13,1264411368,1264414234,45,4,2866
14903923@N07,472,5,1242014701,1242014701,1,1,0
14915921@N00,473,1,1196487856,1196490697,10,6,2841
14915921@N00,473,8,1196490719,1196491111,11,6,392
14915921@N00,473,7,1196493921,1196494070,5,6,149
14915921@N00,473,10,1196467633,1196467633,1,6,0
14915921@N00,473,5,1196455452,1196488254,3,6,32802
14915921@N00,473,13,1196495712,1196495848,2,6,136
14921024@N02,474,11,1199590942,1199607556,9,1,16614
14921024@N02,475,11,1199787739,1199787743,2,1,4
14934218@N03,476,8,1214902758,1214902758,1,3,0
14934218@N03,476,5,1214902661,1214902661,1,3,0
14934218@N03,476,6,1214902856,1214902856,1,3,0
14934218@N03,477,1,1251933852,1251936795,5,5,2943
14934218@N03,477,8,1251936680,1251954472,14,5,17792
14934218@N03,477,13,1251943847,1251943985,2,5,138
14934218@N03,477,5,1251933724,1251933724,1,5,0
14934218@N03,477,6,1251955094,1251955094,1,5,0
14958748@N00,478,5,1380171518,1380171518,1,2,0
14958748@N00,478,2,1380188037,1380188037,1,2,0
15021432@N00,479,8,1199657570,1199670893,6,3,13323
15021432@N00,479,10,1199653800,1199653800,1,3,0
15021432@N00,479,6,1199660969,1199660969,1,3,0
15021432@N00,480,8,1209270101,1209271383,5,1,1282
15021432@N00,481,7,1213239626,1213239626,1,1,0
15021432@N00,482,8,1214626618,1214627414,5,1,796
15021432@N00,483,8,1216440289,1216441115,4,1,826
15021432@N00,484,8,1222575947,1222576519,7,1,572
15021432@N00,485,6,1230716561,1230719233,3,3,2672
15021432@N00,485,8,1230722084,1230723378,5,3,1294
15021432@N00,485,1,1230715308,1230715840,5,3,532
15021432@N00,486,1,1234418286,1234422957,4,1,4671
15021432@N00,487,1,1238304720,1238304720,1,1,0
15021432@N00,488,1,1241125116,1241125290,2,2,174
15021432@N00,488,8,1241151856,1241152604,9,2,748
15021432@N00,489,2,1241218816,1241228644,2,2,9828
15021432@N00,489,5,1241252884,1241252884,1,2,0
15048974@N00,490,2,1465087870,1465087870,1,1,0
15066420@N00,491,5,1207865873,1207865873,1,1,0
15079826@N00,492,8,1327723941,1327723941,1,2,0
15079826@N00,492,4,1327722045,1327729760,2,2,7715
15079826@N00,493,2,1400900924,1400901080,4,1,156
15239812@N00,494,6,1352532700,1352532700,1,1,0
15268966@N00,495,12,1212472510,1212472510,1,6,0
15268966@N00,495,8,1212472535,1212472546,2,6,11
15268966@N00,495,2,1212491783,1212491783,1,6,0
15268966@N00,495,10,1212469915,1212469915,1,6,0
15268966@N00,495,1,1212476741,1212476757,2,6,16
15268966@N00,495,5,1212470531,1212478907,2,6,8376
15279029@N02,496,11,1257119414,1257155516,88,1,36102
15403331@N00,497,8,1420451295,1420451645,2,1,350
15409357@N07,498,5,1393455272,1393455518,2,2,246
15409357@N07,498,6,1393464345,1393464345,1,2,0
15409357@N07,499,5,1393625846,1393625846,1,1,0
15409357@N07,500,6,1418972657,1418972657,1,1,0
15409357@N07,501,1,1431734730,1431734730,1,1,0
15409357@N07,502,1,1431775291,1431775291,1,1,0
15473418@N00,503,5,1212576774,1212576842,2,3,68
15473418@N00,503,8,1212574914,1212580760,4,3,5846
15473418@N00,503,9,1212575687,1212576311,7,3,624
15473418@N00,504,10,1212812974,1212812974,1,5,0
15473418@N00,504,8,1212819406,1212819423,2,5,17
15473418@N00,504,4,1212813607,1212820546,13,5,6939
15473418@N00,504,11,1212806532,1212806532,1,5,0
15473418@N00,504,1,1212813274,1212820674,2,5,7400
15473418@N00,505,7,1212911183,1212911895,3,5,712
15473418@N00,505,5,1212920092,1212920092,1,5,0
15473418@N00,505,8,1212909837,1212909837,1,5,0
15473418@N00,505,4,1212919271,1212919271,1,5,0
15473418@N00,505,11,1212909753,1212919616,6,5,9863
15515205@N02,506,7,1226446055,1226446055,1,2,0
15515205@N02,506,6,1226452037,1226452472,2,2,435
15515205@N02,507,6,1226536803,1226536803,1,1,0
15530177@N05,508,1,1319067489,1319101149,161,1,33660
15531512@N00,509,4,1365736907,1365739515,6,1,2608
15531512@N00,510,6,1426468641,1426477658,12,4,9017
15531512@N00,510,2,1426458684,1426477206,17,4,18522
15531512@N00,510,8,1426458670,1426477661,15,4,18991
15531512@N00,510,4,1426463251,1426473885,15,4,10634
15551876@N04,511,6,1376789152,1376789152,1,1,0
15578904@N00,512,5,1370672505,1370672505,1,1,0
15652554@N07,513,8,1224817380,1224851536,72,1,34156
15790231@N02,514,4,1222557377,1222559152,9,9,1775
15790231@N02,514,2,1222557202,1222559303,3,9,2101
15790231@N02,514,10,1222555640,1222570768,9,9,15128
15790231@N02,514,1,1222555954,1222578702,20,9,22748
15790231@N02,514,13,1222556168,1222559393,4,9,3225
15790231@N02,514,11,1222556492,1222565224,13,9,8732
15790231@N02,514,8,1222556038,1222556038,1,9,0
15790231@N02,514,5,1222555506,1222578685,6,9,23179
15790231@N02,514,12,1222567316,1222568579,10,9,1263
15802258@N04,515,5,1433057103,1433057553,2,1,450
15949547@N04,516,4,1398481260,1398481260,1,1,0
16035349@N05,517,10,1234678038,1234696120,6,1,18082
16088786@N03,518,9,1403367631,1403367631,1,1,0
16137863@N00,519,6,1345627502,1345627502,1,1,0
16137863@N00,520,8,1345884852,1345884852,1,2,0
16137863@N00,520,4,1345885728,1345887406,2,2,1678
16272116@N03,521,8,1207367876,1207368676,4,2,800
16272116@N03,521,5,1207375736,1207375736,1,2,0
16355945@N00,522,2,1315527310,1315527310,1,1,0
16355945@N00,523,7,1355138817,1355138817,1,1,0
16429538@N00,524,9,1246960083,1246965970,7,1,5887
16678301@N02,525,12,1406778124,1406778124,1,1,0
16691514@N07,526,13,1411199392,1411199392,1,1,0
16899467@N03,527,13,1200557284,1200558842,9,2,1558
16899467@N03,527,4,1200557206,1200557206,1,2,0
16903393@N07,528,12,1243208713,1243212112,37,2,3399
16903393@N07,528,1,1243212254,1243215984,29,2,3730
16985502@N04,529,9,1292576087,1292576599,2,1,512
16985502@N04,530,6,1324197476,1324198274,3,1,798
16985502@N04,531,13,1324366174,1324366174,1,2,0
16985502@N04,531,6,1324368692,1324368692,1,2,0
16985502@N04,532,10,1353655329,1353655329,1,4,0
16985502@N04,532,13,1353652495,1353653219,3,4,724
16985502@N04,532,6,1353665551,1353665988,3,4,437
16985502@N04,532,9,1353660845,1353660892,2,4,47
17017714@N04,533,4,1295146865,1295147804,5,2,939
17017714@N04,533,5,1295144135,1295144135,1,2,0
17017714@N04,534,8,1306850400,1306850400,3,2,0
17017714@N04,534,5,1306850400,1306850400,1,2,0
17057923@N06,535,5,1311748164,1311749982,4,9,1818
17057923@N06,535,8,1311717933,1311729338,3,9,11405
17057923@N06,535,10,1311712437,1311748588,94,9,36151
17057923@N06,535,12,1311740708,1311742112,72,9,1404
17057923@N06,535,4,1311721891,1311727075,23,9,5184
17057923@N06,535,6,1311721744,1311739381,22,9,17637
17057923@N06,535,7,1311737943,1311747244,9,9,9301
17057923@N06,535,1,1311712524,1311718186,6,9,5662
17057923@N06,535,2,1311718597,1311725108,40,9,6511
17099253@N00,536,1,1350258900,1350258911,2,3,11
17099253@N00,536,10,1350265539,1350265551,2,3,12
17099253@N00,536,5,1350259027,1350259027,1,3,0
17109883@N00,537,6,1301180532,1301204089,11,6,23557
17109883@N00,537,4,1301180404,1301197890,4,6,17486
17109883@N00,537,2,1301182033,1301185587,5,6,3554
17109883@N00,537,8,1301186114,1301186162,2,6,48
17109883@N00,537,5,1301190159,1301191856,4,6,1697
17109883@N00,537,13,1301186670,1301189415,24,6,2745
17145135@N00,538,2,1330380768,1330380768,1,4,0
17145135@N00,538,5,1330385020,1330385020,1,4,0
17145135@N00,538,11,1330400055,1330400055,1,4,0
17145135@N00,538,6,1330390177,1330397172,2,4,6995
17328804@N05,539,8,1268823694,1268823694,1,1,0
17386110@N00,540,13,1373462288,1373462288,1,1,0
17450418@N08,541,4,1452941466,1452941466,1,1,0
17567960@N00,542,10,1322815720,1322815720,1,2,0
17567960@N00,542,6,1322788947,1322788947,1,2,0
17595434@N07,543,8,1400825401,1400825401,1,1,0
17599044@N08,544,5,1220427915,1220427915,1,2,0
17599044@N08,544,3,1220410255,1220410255,1,2,0
17657655@N00,545,6,1305512674,1305512674,1,1,0
17657655@N00,546,6,1321086902,1321086902,1,1,0
17671095@N04,547,8,1244144041,1244144106,2,1,65
17725987@N00,548,5,1386945640,1386945669,3,1,29
17754571@N02,549,5,1353101652,1353101764,2,1,112
17893195@N03,550,13,1362274893,1362274893,1,2,0
17893195@N03,550,12,1362270687,1362270687,1,2,0
17966142@N08,551,1,1432354655,1432354655,1,3,0
17966142@N08,551,4,1432341759,1432341759,1,3,0
17966142@N08,551,8,1432347231,1432347235,2,3,4
18081271@N00,552,4,1324256937,1324256937,1,1,0
18081271@N00,553,6,1324450953,1324450953,1,2,0
18081271@N00,553,10,1324456477,1324456477,1,2,0
18081271@N00,554,6,1324628956,1324629064,3,1,108
18097936@N00,555,13,1330340719,1330378084,42,1,37365
18097936@N00,556,13,1330408565,1330408565,1,1,0
18214853@N00,557,6,1346137072,1346137124,2,3,52
18214853@N00,557,13,1346137034,1346137034,1,3,0
18214853@N00,557,4,1346136990,1346136990,1,3,0
18226236@N00,558,8,1230694033,1230694033,1,1,0
18229944@N04,559,1,1272389989,1272389989,1,3,0
18229944@N04,559,2,1272389054,1272389054,1,3,0
18229944@N04,559,8,1272386828,1272386828,1,3,0
18229944@N04,560,5,1272893529,1272893529,1,1,0
18229944@N04,561,1,1317060054,1317060054,1,1,0
18307147@N00,562,1,1228093973,1228093973,1,3,0
18307147@N00,562,10,1228088967,1228088967,1,3,0
18307147@N00,562,6,1228117448,1228117492,3,3,44
18581554@N04,563,7,1463537575,1463551964,13,1,14389
18647653@N08,564,6,1376871749,1376871759,2,2,10
18647653@N08,564,13,1376893202,1376893202,1,2,0
18703622@N06,565,13,1353625628,1353646395,8,2,20767
18703622@N06,565,2,1353647868,1353651971,16,2,4103
18703622@N06,566,8,1359410470,1359427541,11,1,17071
18703622@N06,567,7,1359684017,1359685523,5,1,1506
18748204@N00,568,2,1401088646,1401097427,4,2,8781
18748204@N00,568,8,1401098127,1401098127,1,2,0
18862724@N00,569,1,1338804910,1338804910,1,1,0
19026178@N00,570,1,1195015345,1195015354,2,2,9
19026178@N00,570,7,1195015402,1195015402,1,2,0
19201870@N00,571,1,1265870931,1265870931,1,2,0
19201870@N00,571,8,1265871092,1265871098,2,2,6
19213110@N00,572,5,1232688475,1232688475,1,1,0
19262297@N03,573,8,1286262527,1286262527,1,1,0
19262297@N03,574,10,1286872575,1286872575,1,1,0
19307177@N00,575,4,1331956915,1331956915,1,1,0
19344501@N00,576,1,1276644718,1276660046,34,1,15328
19555551@N00,577,7,1276745964,1276747636,2,3,1672
19555551@N00,577,8,1276745857,1276747274,2,3,1417
19555551@N00,577,11,1276745849,1276745849,1,3,0
19585456@N00,578,4,1359260688,1359260688,1,1,0
19682872@N00,579,13,1451428370,1451453702,25,1,25332
19709423@N04,580,2,1278878299,1278878310,2,2,11
19709423@N04,580,1,1278883944,1278884815,73,2,871
19709423@N04,581,5,1387784872,1387784872,1,1,0
19709423@N04,582,6,1393114125,1393114125,1,1,0
19712216@N08,583,11,1200365381,1200367740,2,1,2359
19712216@N08,584,11,1200597223,1200600946,8,1,3723
19712216@N08,585,11,1318714524,1318714524,1,1,0
19771234@N00,586,8,1322966435,1322966435,1,1,0
19840488@N05,587,1,1221375544,1221375544,1,1,0
19936517@N07,588,2,1385957711,1385957711,1,1,0
19951106@N03,589,3,1320121657,1320121657,1,4,0
19951106@N03,589,8,1320117972,1320117978,2,4,6
19951106@N03,589,12,1320113298,1320113309,3,4,11
19951106@N03,589,4,1320121513,1320123165,6,4,1652
19951106@N03,590,8,1368922637,1368926374,27,2,3737
19951106@N03,590,4,1368943852,1368943875,6,2,23
20008009@N05,591,7,1431159591,1431159812,2,2,221
20008009@N05,591,4,1431148452,1431148452,1,2,0
20035490@N00,592,5,1355615444,1355615444,1,1,0
20154444@N04,593,8,1278225183,1278225183,1,1,0
20184646@N04,594,4,1317087155,1317088624,4,2,1469
20184646@N04,594,12,1317099255,1317099545,4,2,290
20229609@N03,595,8,1341210697,1341210697,1,4,0
20229609@N03,595,6,1341215083,1341218774,8,4,3691
20229609@N03,595,2,1341211416,1341211765,4,4,349
20229609@N03,595,11,1341213165,1341213168,2,4,3
20268128@N05,596,7,1402714606,1402714606,1,1,0
20287222@N00,597,2,1290232446,1290232466,3,2,20
20287222@N00,597,6,1290234102,1290234374,2,2,272
20322483@N05,598,8,1198848196,1198848196,1,2,0
20322483@N05,598,5,1198845213,1198845249,2,2,36
20322483@N05,599,10,1198936340,1198936340,1,2,0
20322483@N05,599,1,1198932344,1198933785,2,2,1441
20322483@N05,600,7,1204324244,1204324244,1,3,0
20322483@N05,600,5,1204323326,1204323326,2,3,0
20322483@N05,600,1,1204322934,1204323087,2,3,153
20322483@N05,601,8,1218494020,1218494714,3,1,694
20322483@N05,602,13,1218628884,1218628884,1,4,0
20322483@N05,602,6,1218625552,1218625552,1,4,0
20322483@N05,602,8,1218627324,1218627324,1,4,0
20322483@N05,602,1,1218627482,1218628523,3,4,1041
20322483@N05,603,13,1225421313,1225424066,8,1,2753
20333966@N07,604,4,1419980334,1419980334,1,1,0
20544000@N00,605,4,1416104158,1416104158,1,1,0
20677928@N06,606,13,1237137888,1237137888,1,5,0
20677928@N06,606,8,1237125999,1237127240,4,5,1241
20677928@N06,606,12,1237150320,1237152234,5,5,1914
20677928@N06,606,1,1237142106,1237142106,1,5,0
20677928@N06,606,4,1237132299,1237133462,6,5,1163
20677928@N06,607,12,1238006442,1238008801,3,2,2359
20677928@N06,607,1,1237981023,1237981023,1,2,0
20701570@N00,608,7,1319100012,1319100012,1,4,0
20701570@N00,608,2,1319100450,1319102107,3,4,1657
20701570@N00,608,1,1319099730,1319099730,1,4,0
20701570@N00,608,8,1319099861,1319100186,5,4,325
20701570@N00,609,2,1319244268,1319244268,1,2,0
20701570@N00,609,4,1319237913,1319238356,2,2,443
20701570@N00,610,5,1349002162,1349006560,3,1,4398
20701570@N00,611,2,1349052858,1349052858,1,2,0
20701570@N00,611,4,1349053884,1349053884,1,2,0
20701570@N00,612,10,1402198631,1402198631,1,2,0
20701570@N00,612,2,1402198633,1402198646,3,2,13
20704576@N04,613,6,1197964523,1197965143,5,1,620
20704576@N04,614,2,1226287392,1226289997,4,1,2605
20715134@N00,615,13,1237678007,1237678007,1,4,0
20715134@N00,615,1,1237690406,1237690447,5,4,41
20715134@N00,615,4,1237663687,1237665888,2,4,2201
20715134@N00,615,6,1237678902,1237678902,1,4,0
20719638@N00,616,8,1206743129,1206743281,2,6,152
20719638@N00,616,6,1206741336,1206743867,5,6,2531
20719638@N00,616,1,1206741779,1206741779,1,6,0
20719638@N00,616,13,1206741854,1206742196,2,6,342
20719638@N00,616,10,1206742303,1206742303,1,6,0
20719638@N00,616,4,1206741400,1206744162,2,6,2762
20727999@N06,617,8,1304849300,1304850788,4,4,1488
20727999@N06,617,6,1304832970,1304832970,1,4,0
20727999@N06,617,2,1304836724,1304836724,1,4,0
20727999@N06,617,5,1304831219,1304851616,4,4,20397
20727999@N06,618,5,1305243208,1305250620,8,5,7412
20727999@N06,618,6,1305242567,1305242605,2,5,38
20727999@N06,618,1,1305249345,1305249475,7,5,130
20727999@N06,618,13,1305242887,1305258617,8,5,15730
20727999@N06,618,4,1305240570,1305240570,1,5,0
20771338@N00,619,4,1222043827,1222043865,2,2,38
20771338@N00,619,5,1222041628,1222041628,1,2,0
20869901@N08,620,8,1249545688,1249558970,18,1,13282
20869901@N08,621,8,1249859152,1249881365,76,1,22213
20869901@N08,622,8,1249948361,1249955744,38,1,7383
20885794@N00,623,8,1467601679,1467609514,10,7,7835
20885794@N00,623,1,1467601374,1467601457,3,7,83
20885794@N00,623,2,1467609546,1467610085,4,7,539
20885794@N00,623,13,1467614693,1467614693,1,7,0
20885794@N00,623,12,1467611720,1467611720,1,7,0
20885794@N00,623,7,1467608485,1467608525,5,7,40
20885794@N00,623,4,1467616374,1467617572,7,7,1198
21038859@N08,624,8,1209778440,1209778440,1,3,0
21038859@N08,624,1,1209776202,1209776202,1,3,0
21038859@N08,624,4,1209786677,1209786677,1,3,0
21038859@N08,625,8,1209898309,1209898309,1,3,0
21038859@N08,625,9,1209896950,1209896950,1,3,0
21038859@N08,625,4,1209880322,1209880322,1,3,0
21045041@N06,626,1,1206072456,1206074452,11,1,1996
21126148@N00,627,12,1211001600,1211001600,1,1,0
21138471@N00,628,12,1224741979,1224743149,4,2,1170
21138471@N00,628,8,1224744163,1224744163,1,2,0
21155738@N04,629,6,1293269947,1293270064,6,1,117
21212744@N07,630,6,1199170978,1199171083,6,1,105
21254904@N02,631,13,1219977199,1219977199,1,1,0
21288866@N04,632,2,1383267791,1383267791,1,1,0
21329192@N06,633,8,1252750757,1252772886,14,1,22129
21361334@N02,634,1,1255233135,1255243144,4,2,10009
21361334@N02,634,7,1255226989,1255226989,1,2,0
21369373@N00,635,5,1353713221,1353713221,1,1,0
21377282@N00,636,6,1221192600,1221192600,1,1,0
21377282@N00,637,4,1402703699,1402703699,1,1,0
21383026@N06,638,12,1243646687,1243649199,2,1,2512
21383026@N06,639,12,1247395199,1247395199,2,1,0
21422300@N00,640,13,1197679944,1197684317,2,1,4373
21422300@N00,641,6,1218258158,1218258158,1,1,0
21422300@N00,642,1,1298098142,1298108145,4,2,10003
21422300@N00,642,8,1298107736,1298107736,1,2,0
21422300@N00,643,9,1337681467,1337681467,1,1,0
21432876@N06,644,5,1248936771,1248936771,1,2,0
21432876@N06,644,4,1248916603,1248916603,1,2,0
21619670@N03,645,1,1196900432,1196900432,1,1,0
21641933@N00,646,6,1336538829,1336538829,1,1,0
21641933@N00,647,12,1377836871,1377836881,2,2,10
21641933@N00,647,1,1377837483,1377837483,1,2,0
21652490@N06,648,8,1196427600,1196427600,81,1,0
21652490@N06,649,8,1217512800,1217512800,66,1,0
21652490@N06,650,8,1259586000,1259586000,53,1,0
21652490@N06,651,8,1275314400,1275314400,33,1,0
21652490@N06,652,8,1288530000,1288530000,1,1,0
21652490@N06,653,8,1314799200,1314799200,44,1,0
21652490@N06,654,8,1354280400,1354280400,2,1,0
21652490@N06,655,8,1359637200,1359637200,9,1,0
21667128@N00,656,10,1293434278,1293435043,2,2,765
21667128@N00,656,5,1293435736,1293435736,1,2,0
21668671@N04,657,4,1336032657,1336032657,1,5,0
21668671@N04,657,6,1336024940,1336035774,4,5,10834
21668671@N04,657,9,1336040297,1336040440,13,5,143
21668671@N04,657,8,1336019679,1336022011,12,5,2332
21668671@N04,657,1,1336036852,1336036852,1,5,0
21668671@N04,658,2,1339300070,1339303371,6,1,3301
21668671@N04,659,4,1343267074,1343267611,2,3,537
21668671@N04,659,6,1343269233,1343269613,5,3,380
21668671@N04,659,3,1343266738,1343266738,1,3,0
21668671@N04,660,9,1343800030,1343800093,3,1,63
21685693@N02,661,12,1195640219,1195640219,1,2,0
21685693@N02,661,7,1195640267,1195640267,1,2,0
21685693@N02,662,12,1197160054,1197160055,3,1,1
21685693@N02,663,13,1257374586,1257374586,1,1,0
21705920@N08,664,7,1369954288,1369954288,1,1,0
21739162@N04,665,4,1254025425,1254025467,2,7,42
21739162@N04,665,1,1254008264,1254030226,8,7,21962
21739162@N04,665,10,1254007504,1254007590,2,7,86
21739162@N04,665,5,1254008390,1254008464,3,7,74
21739162@N04,665,2,1254014146,1254014636,11,7,490
21739162@N04,665,6,1254018225,1254025269,3,7,7044
21739162@N04,665,8,1254011397,1254014114,5,7,2717
21739162@N04,666,4,1302426872,1302427302,2,10,430
21739162@N04,666,1,1302426108,1302426108,1,10,0
21739162@N04,666,13,1302399340,1302399340,1,10,0
21739162@N04,666,10,1302421757,1302422946,7,10,1189
21739162@N04,666,5,1302392747,1302392777,2,10,30
21739162@N04,666,6,1302401757,1302411159,11,10,9402
21739162@N04,666,12,1302396406,1302416290,8,10,19884
21739162@N04,666,8,1302396304,1302426129,6,10,29825
21739162@N04,666,9,1302436534,1302438483,10,10,1949
21739162@N04,666,2,1302402131,1302415215,4,10,13084
21748548@N00,667,8,1420679391,1420679459,3,5,68
21748548@N00,667,13,1420682621,1420684322,2,5,1701
21748548@N00,667,4,1420668219,1420668239,2,5,20
21748548@N00,667,1,1420670224,1420670224,1,5,0
21748548@N00,667,9,1420704244,1420705532,23,5,1288
21748548@N00,668,12,1420874883,1420875088,2,3,205
21748548@N00,668,6,1420877027,1420877027,1,3,0
21748548@N00,668,8,1420877055,1420877055,1,3,0
21748548@N00,669,2,1420940093,1420940093,1,1,0
21807174@N04,670,2,1233776905,1233776905,1,1,0
21807174@N04,671,1,1309508492,1309508492,1,1,0
21807174@N04,672,1,1309920112,1309933995,10,1,13883
21876388@N00,673,6,1291360862,1291361002,2,1,140
21882182@N03,674,12,1347136894,1347136894,1,2,0
21882182@N03,674,10,1347136030,1347136057,2,2,27
21978090@N03,675,6,1323218107,1323218107,1,3,0
21978090@N03,675,2,1323213369,1323213369,1,3,0
21978090@N03,675,12,1323222231,1323222587,3,3,356
22024026@N03,676,5,1392334520,1392334530,3,3,10
22024026@N03,676,8,1392328741,1392331299,2,3,2558
22024026@N03,676,2,1392351182,1392373008,4,3,21826
22046456@N04,677,13,1280416779,1280416779,1,1,0
22068918@N00,678,9,1237968757,1237968785,2,6,28
22068918@N00,678,8,1237965888,1237965901,2,6,13
22068918@N00,678,13,1237962625,1237966478,3,6,3853
22068918@N00,678,5,1237936119,1237948940,2,6,12821
22068918@N00,678,10,1237948656,1237948656,1,6,0
22068918@N00,678,6,1237946907,1237964932,4,6,18025
22107206@N00,679,4,1369528001,1369528007,2,1,6
22151340@N02,680,5,1198647502,1198652821,2,1,5319
22151340@N02,681,7,1208596694,1208596694,1,4,0
22151340@N02,681,6,1208596152,1208596152,1,4,0
22151340@N02,681,5,1208572160,1208602977,10,4,30817
22151340@N02,681,10,1208603380,1208603380,1,4,0
22151340@N02,682,5,1209288292,1209288581,2,1,289
22151340@N02,683,2,1212890752,1212907558,3,4,16806
22151340@N02,683,5,1212892693,1212910214,3,4,17521
22151340@N02,683,1,1212889309,1212889309,1,4,0
22151340@N02,683,4,1212903509,1212903509,1,4,0
22151340@N02,684,6,1213254828,1213254828,1,4,0
22151340@N02,684,2,1213235008,1213244697,4,4,9689
22151340@N02,684,5,1213238407,1213238407,1,4,0
22151340@N02,684,4,1213249749,1213249749,1,4,0
22151340@N02,685,2,1214189325,1214189847,3,3,522
22151340@N02,685,5,1214194504,1214216997,4,3,22493
22151340@N02,685,8,1214189952,1214189952,1,3,0
22151340@N02,686,6,1216534981,1216534981,1,1,0
22185077@N06,687,1,1356962806,1356962806,1,2,0
22185077@N06,687,2,1356963856,1356963856,1,2,0
22232518@N05,688,2,1218609689,1218609689,1,1,0
22232518@N05,689,9,1275928618,1275928627,13,1,9
22232518@N05,690,4,1313029189,1313029205,2,1,16
22255270@N04,691,1,1194478645,1194508445,19,2,29800
22255270@N04,691,10,1194509355,1194509646,3,2,291
22261589@N00,692,10,1194302419,1194311690,2,1,9271
22261589@N00,693,1,1194927018,1194927018,1,1,0
22261589@N00,694,1,1203833031,1203833031,1,1,0
22261589@N00,695,1,1240993297,1240993297,1,1,0
22261589@N00,696,8,1291512965,1291513431,3,3,466
22261589@N00,696,7,1291512014,1291512047,2,3,33
22261589@N00,696,12,1291509421,1291509421,1,3,0
22261589@N00,697,9,1291895627,1291895627,1,2,0
22261589@N00,697,4,1291890232,1291890232,1,2,0
22261589@N00,698,8,1292300291,1292300291,1,2,0
22261589@N00,698,4,1292293689,1292293689,1,2,0
22261589@N00,699,10,1337298885,1337298885,1,4,0
22261589@N00,699,8,1337295956,1337302561,2,4,6605
22261589@N00,699,1,1337296112,1337310476,2,4,14364
22261589@N00,699,5,1337296239,1337296239,1,4,0
22261589@N00,700,1,1337901326,1337903694,6,1,2368
22261589@N00,701,1,1346764852,1346764864,2,4,12
22261589@N00,701,8,1346764840,1346764892,2,4,52
22261589@N00,701,5,1346764818,1346764818,1,4,0
22261589@N00,701,10,1346764882,1346764882,1,4,0
22261589@N00,702,1,1386024533,1386026850,2,3,2317
22261589@N00,702,6,1386054374,1386054380,2,3,6
22261589@N00,702,3,1386028717,1386028717,1,3,0
22265703@N06,703,6,1246970420,1246970420,1,1,0
22273519@N07,704,4,1315872562,1315873082,6,2,520
22273519@N07,704,6,1315880103,1315880186,2,2,83
22295147@N05,705,5,1284886983,1284886983,1,1,0
22326950@N05,706,10,1199130496,1199130569,3,2,73
22326950@N05,706,5,1199130500,1199130556,5,2,56
22326950@N05,707,4,1217840984,1217842390,4,3,1406
22326950@N05,707,1,1217842684,1217842727,2,3,43
22326950@N05,707,9,1217843470,1217853777,16,3,10307
22326950@N05,708,10,1217918304,1217918310,2,3,6
22326950@N05,708,1,1217918470,1217918470,1,3,0
22326950@N05,708,11,1217918628,1217923873,19,3,5245
22326950@N05,709,10,1243028036,1243028036,1,2,0
22326950@N05,709,4,1243041471,1243041471,1,2,0
22326950@N05,710,10,1243359860,1243384793,2,2,24933
22326950@N05,710,4,1243376341,1243376517,5,2,176
22326950@N05,711,1,1247485976,1247485986,2,3,10
22326950@N05,711,8,1247486290,1247487021,6,3,731
22326950@N05,711,4,1247488606,1247488606,1,3,0
22326950@N05,712,8,1247623783,1247623783,1,1,0
22423587@N03,713,11,1217726975,1217727410,5,5,435
22423587@N03,713,2,1217730886,1217731077,4,5,191
22423587@N03,713,6,1217730240,1217730240,1,5,0
22423587@N03,713,1,1217726205,1217726325,2,5,120
22423587@N03,713,8,1217728220,1217728220,1,5,0
22423587@N03,714,1,1284885713,1284885713,1,1,0
22423587@N03,715,11,1291783298,1291783298,1,2,0
22423587@N03,715,1,1291785882,1291785882,1,2,0
22423587@N03,716,2,1297576403,1297576403,1,2,0
22423587@N03,716,8,1297566560,1297580557,2,2,13997
22423587@N03,717,1,1299317334,1299317334,1,1,0
22423587@N03,718,1,1319417115,1319417439,2,1,324
22423587@N03,719,1,1323663675,1323663675,1,1,0
22446827@N02,720,1,1401249463,1401249463,1,1,0
22462637@N00,721,1,1301810466,1301810466,1,3,0
22462637@N00,721,13,1301808706,1301809489,2,3,783
22462637@N00,721,4,1301814104,1301814104,1,3,0
22473198@N00,722,5,1319260527,1319260527,1,2,0
22473198@N00,722,4,1319254899,1319255926,2,2,1027
22474934@N00,723,11,1382502935,1382502976,6,6,41
22474934@N00,723,3,1382500322,1382500465,2,6,143
22474934@N00,723,4,1382500486,1382507573,11,6,7087
22474934@N00,723,13,1382497551,1382497551,1,6,0
22474934@N00,723,8,1382512454,1382512454,1,6,0
22474934@N00,723,1,1382503374,1382506005,15,6,2631
22496843@N03,724,9,1207648782,1207649472,3,5,690
22496843@N03,724,8,1207647639,1207647719,2,5,80
22496843@N03,724,5,1207622173,1207646046,28,5,23873
22496843@N03,724,1,1207647896,1207652607,3,5,4711
22496843@N03,724,6,1207610175,1207637459,11,5,27284
22597539@N03,725,1,1301872434,1301872434,1,1,0
22659528@N06,726,12,1347266071,1347266071,1,5,0
22659528@N06,726,6,1347251891,1347251891,1,5,0
22659528@N06,726,8,1347275229,1347275229,1,5,0
22659528@N06,726,4,1347270010,1347270010,1,5,0
22659528@N06,726,9,1347275497,1347279831,2,5,4334
22659528@N06,727,1,1347321853,1347321853,1,1,0
22659528@N06,728,12,1347689750,1347701243,3,1,11493
22659528@N06,729,12,1348138769,1348138769,1,3,0
22659528@N06,729,4,1348133278,1348133278,1,3,0
22659528@N06,729,11,1348126437,1348126437,1,3,0
22659528@N06,730,4,1348189497,1348189497,1,1,0
22659528@N06,731,6,1348367556,1348367556,1,1,0
22659528@N06,732,7,1401434890,1401434890,1,1,0
22659528@N06,733,6,1401525953,1401525953,1,2,0
22659528@N06,733,2,1401520202,1401520202,1,2,0
22659528@N06,734,8,1401594959,1401594959,1,1,0
22659528@N06,735,2,1402042248,1402042248,1,1,0
22659528@N06,736,13,1407400923,1407400923,1,1,0
22659528@N06,737,1,1407570144,1407585136,3,1,14992
22687691@N02,738,4,1194396023,1194401585,2,1,5562
22687691@N02,739,6,1225767179,1225767179,1,1,0
22696986@N08,740,11,1339317214,1339317214,1,3,0
22696986@N08,740,8,1339309939,1339316954,2,3,7015
22696986@N08,740,5,1339325479,1339325479,1,3,0
22720103@N06,741,1,1346284620,1346289667,3,3,5047
22720103@N06,741,12,1346284226,1346284226,1,3,0
22720103@N06,741,8,1346287974,1346303554,3,3,15580
22786107@N06,742,4,1206844730,1206847093,3,3,2363
22786107@N06,742,2,1206849633,1206849633,1,3,0
22786107@N06,742,1,1206852549,1206852549,1,3,0
22802028@N08,743,4,1209626627,1209626627,1,4,0
22802028@N08,743,8,1209631097,1209634805,3,4,3708
22802028@N08,743,6,1209629875,1209631973,4,4,2098
22802028@N08,743,9,1209634552,1209636144,11,4,1592
22802028@N08,744,5,1209862528,1209863527,4,1,999
22808487@N04,745,1,1260071110,1260071265,3,5,155
22808487@N04,745,5,1260071092,1260071168,2,5,76
22808487@N04,745,11,1260078372,1260078658,6,5,286
22808487@N04,745,6,1260081290,1260088370,24,5,7080
22808487@N04,745,8,1260069883,1260069890,2,5,7
22854594@N07,746,2,1380014125,1380014125,1,1,0
22854594@N07,747,8,1381444628,1381444628,1,2,0
22854594@N07,747,6,1381421737,1381421737,1,2,0
22866792@N00,748,6,1291435272,1291439184,7,5,3912
22866792@N00,748,1,1291434699,1291434699,1,5,0
22866792@N00,748,4,1291434998,1291435064,2,5,66
22866792@N00,748,12,1291439887,1291440293,2,5,406
22866792@N00,748,8,1291437489,1291437489,1,5,0
22884021@N06,749,1,1262851928,1262851928,1,3,0
22884021@N06,749,8,1262861760,1262861760,1,3,0
22884021@N06,749,5,1262861512,1262861512,1,3,0
22937808@N04,750,1,1367885201,1367885201,1,1,0
22937808@N04,751,8,1462232120,1462232120,1,1,0
22966062@N04,752,6,1198571566,1198571566,1,2,0
22966062@N04,752,5,1198574137,1198574137,1,2,0
22967174@N06,753,8,1341119760,1341119760,1,1,0
23012921@N08,754,1,1305432604,1305432604,1,1,0
23012921@N08,755,1,1309780827,1309780827,1,1,0
23028801@N03,756,11,1350231018,1350231018,1,1,0
23041412@N08,757,2,1243308805,1243308966,2,1,161
23041412@N08,758,2,1243576693,1243581080,2,1,4387
23043254@N03,759,10,1197096135,1197096135,1,1,0
23043254@N03,760,6,1198133661,1198134415,3,1,754
23043254@N03,761,5,1201476549,1201476549,1,2,0
23043254@N03,761,4,1201481395,1201481395,1,2,0
23070886@N08,762,5,1277106418,1277106418,1,1,0
23071450@N02,763,11,1283755007,1283755007,1,1,0
23099604@N06,764,8,1199947153,1199947153,1,1,0
23108813@N00,765,5,1226209572,1226209572,1,1,0
23108813@N00,766,1,1242545490,1242545490,1,1,0
23108813@N00,767,6,1260082955,1260082955,1,1,0
23108813@N00,768,11,1264659905,1264659905,1,1,0
23108813@N00,769,12,1279597387,1279597387,1,1,0
23108813@N00,770,2,1281179316,1281179316,1,1,0
23108813@N00,771,4,1294366390,1294366390,1,1,0
23108813@N00,772,6,1337423353,1337423353,1,1,0
23108813@N00,773,1,1337564502,1337564502,1,1,0
23108813@N00,774,10,1358905863,1358905863,1,1,0
23108813@N00,775,6,1384500183,1384500183,1,1,0
23108813@N00,776,6,1416390033,1416390033,1,1,0
23108813@N00,777,5,1423429130,1423429130,1,1,0
23108813@N00,778,8,1430778952,1430778952,1,1,0
23108813@N00,779,11,1432200997,1432200997,1,1,0
23108813@N00,780,6,1450861084,1450861084,1,1,0
23108813@N00,781,1,1459502294,1459502294,1,1,0
23108813@N00,782,4,1462961334,1462961334,1,1,0
23117061@N05,783,5,1331108190,1331108190,1,1,0
23205379@N02,784,5,1400815301,1400815301,1,3,0
23205379@N02,784,9,1400834060,1400834060,1,3,0
23205379@N02,784,2,1400820543,1400820543,1,3,0
23205379@N02,785,5,1408742573,1408742573,1,1,0
23212779@N04,786,11,1291773094,1291773094,1,1,0
23237004@N06,787,1,1351067693,1351071381,2,1,3688
23288611@N00,788,2,1232175283,1232175283,1,1,0
23311397@N04,789,8,1246831982,1246838921,11,2,6939
23311397@N04,789,1,1246831927,1246856845,5,2,24918
23319775@N04,790,13,1394452693,1394454621,2,6,1928
23319775@N04,790,10,1394456309,1394456309,1,6,0
23319775@N04,790,2,1394461485,1394461485,1,6,0
23319775@N04,790,5,1394458305,1394458342,2,6,37
23319775@N04,790,8,1394483229,1394483229,1,6,0
23319775@N04,790,12,1394464558,1394464852,2,6,294
23322134@N02,791,6,1201299218,1201299218,1,4,0
23322134@N02,791,1,1201296001,1201304282,2,4,8281
23322134@N02,791,2,1201297241,1201297729,2,4,488
23322134@N02,791,5,1201293247,1201295320,4,4,2073
23322134@N02,792,6,1213669690,1213669690,1,2,0
23322134@N02,792,13,1213666693,1213666693,1,2,0
23322134@N02,793,9,1226826138,1226827495,7,4,1357
23322134@N02,793,1,1226834099,1226834099,1,4,0
23322134@N02,793,8,1226829004,1226834717,3,4,5713
23322134@N02,793,5,1226831300,1226833097,4,4,1797
23322134@N02,794,3,1245239548,1245239548,1,7,0
23322134@N02,794,6,1245246049,1245246049,1,7,0
23322134@N02,794,1,1245228563,1245234491,3,7,5928
23322134@N02,794,11,1245200917,1245200917,1,7,0
23322134@N02,794,8,1245213548,1245214354,3,7,806
23322134@N02,794,5,1245197193,1245233250,5,7,36057
23322134@N02,794,4,1245239237,1245239237,1,7,0
23322134@N02,795,3,1260072565,1260072565,1,4,0
23322134@N02,795,6,1260058900,1260058900,1,4,0
23322134@N02,795,1,1260054999,1260081657,3,4,26658
23322134@N02,795,8,1260076219,1260076219,1,4,0
23322134@N02,796,6,1267837742,1267837742,1,4,0
23322134@N02,796,10,1267849645,1267849645,1,4,0
23322134@N02,796,1,1267824681,1267830078,6,4,5397
23322134@N02,796,2,1267836685,1267836685,1,4,0
23322134@N02,797,1,1291411296,1291429796,2,2,18500
23322134@N02,797,11,1291422604,1291422604,1,2,0
23322134@N02,798,6,1291535114,1291547381,3,1,12267
23322134@N02,799,1,1301611116,1301615595,2,1,4479
23322134@N02,800,4,1310466892,1310466892,1,5,0
23322134@N02,800,8,1310429560,1310429560,1,5,0
23322134@N02,800,10,1310461120,1310461120,1,5,0
23322134@N02,800,5,1310436525,1310461233,2,5,24708
23322134@N02,800,2,1310440257,1310440257,1,5,0
23322134@N02,801,10,1310609460,1310609460,1,1,0
23322134@N02,802,11,1325490387,1325490387,1,1,0
23380822@N05,803,4,1385630587,1385630587,1,2,0
23380822@N05,803,6,1385629678,1385630495,27,2,817
23492103@N03,804,11,1223261086,1223266560,4,1,5474
23531325@N00,805,11,1242194190,1242194190,1,1,0
23566994@N06,806,8,1218693800,1218693813,2,1,13
23566994@N06,807,8,1233289601,1233289612,3,1,11
23573205@N05,808,4,1278901466,1278911376,21,6,9910
23573205@N05,808,13,1278898932,1278903182,18,6,4250
23573205@N05,808,6,1278904024,1278914752,31,6,10728
23573205@N05,808,2,1278906613,1278907230,2,6,617
23573205@N05,808,1,1278898714,1278898714,1,6,0
23573205@N05,808,8,1278911478,1278911478,1,6,0
23673310@N02,809,1,1200183095,1200183095,1,2,0
23673310@N02,809,4,1200182905,1200182965,3,2,60
23673310@N02,810,12,1200454372,1200454372,1,8,0
23673310@N02,810,5,1200434876,1200435197,2,8,321
23673310@N02,810,4,1200446108,1200446539,3,8,431
23673310@N02,810,6,1200442771,1200444110,12,8,1339
23673310@N02,810,9,1200469402,1200472207,38,8,2805
23673310@N02,810,8,1200447270,1200448103,9,8,833
23673310@N02,810,1,1200434213,1200457230,22,8,23017
23673310@N02,810,7,1200450643,1200450673,2,8,30
23673310@N02,811,4,1204368603,1204368855,7,3,252
23673310@N02,811,6,1204368283,1204368564,7,3,281
23673310@N02,811,1,1204368002,1204368978,11,3,976
23673310@N02,812,2,1212920296,1212922582,13,1,2286
23673310@N02,813,3,1213428131,1213428373,4,7,242
23673310@N02,813,4,1213408047,1213431514,51,7,23467
23673310@N02,813,11,1213422925,1213422925,1,7,0
23673310@N02,813,2,1213402432,1213404291,2,7,1859
23673310@N02,813,6,1213412464,1213429674,13,7,17210
23673310@N02,813,8,1213417646,1213424535,28,7,6889
23673310@N02,813,1,1213419692,1213420611,24,7,919
23673310@N02,814,4,1213926582,1213927138,10,4,556
23673310@N02,814,2,1213929821,1213930959,6,4,1138
23673310@N02,814,5,1213932252,1213932252,1,4,0
23673310@N02,814,10,1213918512,1213934552,3,4,16040
23673310@N02,815,6,1214020414,1214020829,6,1,415
23673310@N02,816,12,1292635632,1292635964,3,6,332
23673310@N02,816,4,1292631194,1292662151,2,6,30957
23673310@N02,816,2,1292623265,1292659210,7,6,35945
23673310@N02,816,5,1292633301,1292633301,1,6,0
23673310@N02,816,11,1292624949,1292625510,2,6,561
23673310@N02,816,6,1292627491,1292662116,24,6,34625
23673310@N02,817,2,1304118791,1304119986,2,2,1195
23673310@N02,817,5,1304122415,1304124596,4,2,2181
23673310@N02,818,3,1339233009,1339233030,2,10,21
23673310@N02,818,13,1339212521,1339214964,3,10,2443
23673310@N02,818,4,1339212997,1339213148,3,10,151
23673310@N02,818,2,1339201887,1339202713,3,10,826
23673310@N02,818,5,1339194875,1339196285,2,10,1410
23673310@N02,818,6,1339227530,1339228195,4,10,665
23673310@N02,818,10,1339193405,1339193416,2,10,11
23673310@N02,818,9,1339239547,1339241138,4,10,1591
23673310@N02,818,8,1339200285,1339210319,24,10,10034
23673310@N02,818,1,1339193576,1339238260,31,10,44684
23673310@N02,819,3,1415434472,1415434472,1,4,0
23673310@N02,819,12,1415428708,1415431777,7,4,3069
23673310@N02,819,2,1415426085,1415426085,1,4,0
23673310@N02,819,6,1415432443,1415434236,38,4,1793
23684642@N08,820,1,1254278861,1254278861,1,2,0
23684642@N08,820,12,1254273780,1254273780,1,2,0
23684642@N08,821,8,1259641514,1259652388,2,3,10874
23684642@N08,821,10,1259645002,1259645002,1,3,0
23684642@N08,821,12,1259632543,1259632543,1,3,0
23684642@N08,822,1,1259890676,1259890676,1,1,0
23684642@N08,823,7,1261022220,1261023307,3,4,1087
23684642@N08,823,5,1261034262,1261034262,1,4,0
23684642@N08,823,6,1261035526,1261035550,2,4,24
23684642@N08,823,1,1261014189,1261014189,1,4,0
23684642@N08,824,2,1272005609,1272005609,1,1,0
23684642@N08,825,6,1275442804,1275463796,2,1,20992
23684642@N08,826,13,1275620945,1275620945,1,2,0
23684642@N08,826,6,1275609830,1275626276,3,2,16446
23684642@N08,827,8,1285045788,1285045788,1,1,0
23693999@N05,828,6,1224819100,1224819100,1,1,0
23693999@N05,829,8,1346394382,1346394382,1,3,0
23693999@N05,829,2,1346390822,1346390822,1,3,0
23693999@N05,829,4,1346380047,1346380556,2,3,509
23701913@N04,830,4,1442480644,1442480644,1,1,0
23716209@N02,831,4,1347208146,1347208146,1,1,0
23720661@N08,832,1,1244683423,1244693636,2,3,10213
23720661@N08,832,5,1244693150,1244693150,1,3,0
23720661@N08,832,8,1244687130,1244687130,1,3,0
23720661@N08,833,1,1262743730,1262743984,2,3,254
23720661@N08,833,5,1262741869,1262763475,2,3,21606
23720661@N08,833,8,1262749881,1262749881,1,3,0
23720661@N08,834,5,1275216147,1275216235,2,3,88
23720661@N08,834,1,1275211922,1275211922,1,3,0
23720661@N08,834,8,1275212987,1275212987,1,3,0
23720661@N08,835,11,1275282060,1275282060,1,4,0
23720661@N08,835,1,1275282900,1275282900,1,4,0
23720661@N08,835,8,1275272856,1275272856,1,4,0
23720661@N08,835,10,1275271014,1275271014,1,4,0
23720661@N08,836,6,1302166235,1302166235,1,1,0
23720661@N08,837,5,1307329070,1307329291,3,5,221
23720661@N08,837,6,1307335234,1307335234,1,5,0
23720661@N08,837,1,1307324980,1307325004,2,5,24
23720661@N08,837,8,1307326810,1307328075,3,5,1265
23720661@N08,837,10,1307336387,1307336387,1,5,0
23720661@N08,838,4,1331086160,1331086160,1,6,0
23720661@N08,838,3,1331084451,1331084801,4,6,350
23720661@N08,838,6,1331081686,1331081686,1,6,0
23720661@N08,838,5,1331078097,1331078189,2,6,92
23720661@N08,838,13,1331086431,1331086529,4,6,98
23720661@N08,838,8,1331080323,1331088068,5,6,7745
23720661@N08,839,6,1369720601,1369720601,1,4,0
23720661@N08,839,1,1369708560,1369711709,2,4,3149
23720661@N08,839,5,1369708614,1369708792,3,4,178
23720661@N08,839,8,1369710134,1369715966,4,4,5832
23720661@N08,840,1,1369885994,1369885994,1,5,0
23720661@N08,840,10,1369887425,1369893421,2,5,5996
23720661@N08,840,8,1369882021,1369882585,3,5,564
23720661@N08,840,3,1369884039,1369884039,1,5,0
23720661@N08,840,4,1369883198,1369883198,1,5,0
23720661@N08,841,5,1370073738,1370073738,1,1,0
23724661@N00,842,1,1299355574,1299355574,1,1,0
23734263@N03,843,6,1375236660,1375236660,1,1,0
23828731@N02,844,8,1226360279,1226360507,2,5,228
23828731@N02,844,4,1226373962,1226374000,2,5,38
23828731@N02,844,12,1226359920,1226359920,1,5,0
23828731@N02,844,6,1226377010,1226384906,3,5,7896
23828731@N02,844,2,1226361764,1226361764,1,5,0
23828731@N02,845,10,1287264775,1287264775,1,5,0
23828731@N02,845,1,1287264392,1287264756,3,5,364
23828731@N02,845,8,1287264463,1287264469,2,5,6
23828731@N02,845,5,1287264885,1287265794,11,5,909
23828731@N02,845,2,1287264553,1287264676,2,5,123
23828731@N02,846,1,1339128025,1339128025,1,6,0
23828731@N02,846,8,1339128526,1339140798,9,6,12272
23828731@N02,846,4,1339128536,1339139949,3,6,11413
23828731@N02,846,5,1339130644,1339130657,3,6,13
23828731@N02,846,6,1339140219,1339140219,1,6,0
23828731@N02,846,2,1339135377,1339140510,6,6,5133
23828731@N02,847,1,1341298818,1341298923,2,5,105
23828731@N02,847,8,1341298769,1341298769,1,5,0
23828731@N02,847,13,1341298344,1341302968,3,5,4624
23828731@N02,847,4,1341302848,1341302848,1,5,0
23828731@N02,847,3,1341301290,1341301290,1,5,0
23828731@N02,848,7,1344848394,1344848394,1,1,0
23828731@N02,849,2,1345358067,1345361165,2,1,3098
23828731@N02,850,2,1346654101,1346654101,1,1,0
23828731@N02,851,6,1357368754,1357370361,29,1,1607
23828731@N02,852,1,1367645804,1367645821,2,1,17
23828731@N02,853,2,1368178464,1368178464,1,1,0
23833168@N04,854,1,1354779579,1354780669,5,3,1090
23833168@N04,854,13,1354758378,1354758676,12,3,298
23833168@N04,854,6,1354772599,1354779534,6,3,6935
23942903@N00,855,6,1326513632,1326513632,1,3,0
23942903@N00,855,1,1326524173,1326524173,1,3,0
23942903@N00,855,2,1326505935,1326505935,1,3,0
23953488@N03,856,8,1226106633,1226106633,1,2,0
23953488@N03,856,1,1226102392,1226102392,1,2,0
24021297@N00,857,1,1307150939,1307150939,1,3,0
24021297@N00,857,2,1307150779,1307150779,1,3,0
24021297@N00,857,4,1307150724,1307150724,1,3,0
24021297@N00,858,10,1343612634,1343615123,3,1,2489
24021297@N00,859,8,1371370439,1371370439,1,1,0
24048284@N02,860,8,1203846224,1203846282,2,5,58
24048284@N02,860,6,1203846223,1203846223,1,5,0
24048284@N02,860,5,1203846220,1203846281,3,5,61
24048284@N02,860,10,1203846219,1203846275,2,5,56
24048284@N02,860,1,1203846276,1203846277,2,5,1
24083444@N03,861,6,1305962453,1305962453,1,1,0
24143798@N08,862,4,1432963056,1432966559,2,1,3503
24213326@N04,863,4,1345201654,1345201654,1,1,0
24230954@N06,864,5,1201260203,1201260203,1,1,0
24232695@N00,865,13,1325310710,1325310747,2,3,37
24232695@N00,865,6,1325302815,1325303147,2,3,332
24232695@N00,865,2,1325298026,1325301369,7,3,3343
24306356@N00,866,8,1386128698,1386128704,2,2,6
24306356@N00,866,4,1386109717,1386111985,6,2,2268
24345053@N06,867,4,1290728212,1290728212,1,2,0
24345053@N06,867,12,1290748318,1290748318,1,2,0
24364723@N08,868,6,1349421194,1349421194,1,1,0
24386268@N05,869,6,1204259651,1204259708,3,1,57
24386374@N00,870,8,1378360270,1378373026,7,1,12756
24386374@N00,871,8,1378455226,1378465054,23,1,9828
24386374@N00,872,8,1378607567,1378614773,3,1,7206
24391317@N05,873,6,1275726185,1275726185,1,1,0
24435279@N00,874,9,1194743041,1194743045,2,2,4
24435279@N00,874,10,1194744029,1194744588,6,2,559
24435279@N00,875,4,1204949346,1204949367,3,2,21
24435279@N00,875,11,1204944748,1204944748,1,2,0
24435279@N00,876,1,1205021903,1205035549,27,6,13646
24435279@N00,876,2,1205027379,1205027598,4,6,219
24435279@N00,876,8,1205022040,1205029221,23,6,7181
24435279@N00,876,11,1205022226,1205022623,14,6,397
24435279@N00,876,6,1205028633,1205028640,2,6,7
24435279@N00,876,12,1205026660,1205026712,5,6,52
24435279@N00,877,1,1208917983,1208920380,6,6,2397
24435279@N00,877,2,1208921495,1208921495,1,6,0
24435279@N00,877,8,1208917775,1208917907,8,6,132
24435279@N00,877,11,1208917519,1208918109,6,6,590
24435279@N00,877,6,1208921708,1208923562,11,6,1854
24435279@N00,877,12,1208918364,1208919056,30,6,692
24435279@N00,878,1,1217718745,1217718745,1,4,0
24435279@N00,878,11,1217718605,1217718654,8,4,49
24435279@N00,878,12,1217718792,1217718952,6,4,160
24435279@N00,878,10,1217716359,1217716730,4,4,371
24435279@N00,879,1,1222567241,1222586050,20,7,18809
24435279@N00,879,5,1222584710,1222584762,6,7,52
24435279@N00,879,4,1222582305,1222582663,16,7,358
24435279@N00,879,2,1222568150,1222568295,3,7,145
24435279@N00,879,8,1222568423,1222587676,58,7,19253
24435279@N00,879,6,1222571095,1222571106,3,7,11
24435279@N00,879,12,1222584391,1222584409,3,7,18
24435279@N00,880,8,1224401169,1224401178,3,3,9
24435279@N00,880,10,1224400775,1224400817,4,3,42
24435279@N00,880,2,1224401718,1224406023,52,3,4305
24435279@N00,881,8,1226736879,1226736879,1,2,0
24435279@N00,881,10,1226746525,1226746568,4,2,43
24435279@N00,882,9,1226786601,1226786839,7,2,238
24435279@N00,882,6,1226802552,1226805074,13,2,2522
24435279@N00,883,8,1228551137,1228551358,14,2,221
24435279@N00,883,6,1228547923,1228547928,2,2,5
24435279@N00,884,12,1240633940,1240633993,6,5,53
24435279@N00,884,11,1240635121,1240635129,3,5,8
24435279@N00,884,1,1240633121,1240645017,65,5,11896
24435279@N00,884,7,1240635300,1240637291,20,5,1991
24435279@N00,884,2,1240633097,1240633111,3,5,14
24435279@N00,885,5,1241129706,1241150105,9,7,20399
24435279@N00,885,1,1241130791,1241130794,2,7,3
24435279@N00,885,8,1241131063,1241165071,23,7,34008
24435279@N00,885,10,1241168606,1241168652,5,7,46
24435279@N00,885,2,1241156821,1241156821,1,7,0
24435279@N00,885,6,1241138310,1241143803,4,7,5493
24435279@N00,885,11,1241134011,1241134043,7,7,32
24435279@N00,886,1,1241237392,1241237753,6,1,361
24435279@N00,887,7,1241327090,1241328331,6,1,1241
24519194@N08,888,5,1381042337,1381042337,1,2,0
24519194@N08,888,8,1381042679,1381042679,1,2,0
24519194@N08,889,12,1381558621,1381558621,1,1,0
24557725@N03,890,5,1366001937,1366001937,1,1,0
24568538@N00,891,5,1306560738,1306560738,1,1,0
24616128@N00,892,1,1285901907,1285904625,3,5,2718
24616128@N00,892,8,1285912704,1285912892,4,5,188
24616128@N00,892,2,1285908428,1285908428,1,5,0
24616128@N00,892,4,1285907713,1285907713,1,5,0
24616128@N00,892,6,1285912536,1285915438,5,5,2902
24616128@N00,893,1,1286067198,1286070800,6,2,3602
24616128@N00,893,7,1286058043,1286064791,15,2,6748
24704473@N07,894,1,1189658146,1189666958,16,6,8812
24704473@N07,894,7,1189666572,1189666572,1,6,0
24704473@N07,894,13,1189658559,1189661453,17,6,2894
24704473@N07,894,6,1189664495,1189664692,5,6,197
24704473@N07,894,4,1189664819,1189664840,2,6,21
24704473@N07,894,8,1189662744,1189665066,5,6,2322
24704473@N07,895,1,1237675676,1237708130,14,9,32454
24704473@N07,895,7,1237704337,1237704379,2,9,42
24704473@N07,895,13,1237675837,1237707606,26,9,31769
24704473@N07,895,2,1237677208,1237704965,5,9,27757
24704473@N07,895,5,1237678614,1237678614,1,9,0
24704473@N07,895,6,1237692207,1237705899,22,9,13692
24704473@N07,895,4,1237693350,1237706403,12,9,13053
24704473@N07,895,8,1237676072,1237704583,13,9,28511
24704473@N07,895,12,1237677722,1237703916,22,9,26194
24704473@N07,896,1,1238048865,1238062260,26,10,13395
24704473@N07,896,13,1238060939,1238060977,2,10,38
24704473@N07,896,8,1238055785,1238058264,9,10,2479
24704473@N07,896,7,1238058099,1238058099,1,10,0
24704473@N07,896,2,1238058287,1238058287,1,10,0
24704473@N07,896,5,1238049077,1238061912,14,10,12835
24704473@N07,896,6,1238058743,1238058910,4,10,167
24704473@N07,896,11,1238058177,1238058177,1,10,0
24704473@N07,896,4,1238059385,1238060679,14,10,1294
24704473@N07,896,12,1238058152,1238058375,4,10,223
24733811@N04,897,7,1218409811,1218409811,1,2,0
24733811@N04,897,12,1218412901,1218414069,2,2,1168
24738734@N00,898,11,1228198923,1228198923,1,1,0
24738911@N08,899,8,1219892416,1219892416,1,1,0
24738911@N08,900,8,1229917325,1229917511,2,1,186
24738911@N08,901,8,1234423545,1234426291,12,1,2746
24738911@N08,902,8,1239332684,1239334208,3,1,1524
24738911@N08,903,8,1258704136,1258708540,6,1,4404
24738911@N08,904,8,1259567979,1259567979,1,1,0
24738911@N08,905,1,1266204330,1266204330,1,1,0
24767349@N02,906,8,1207389762,1207389762,1,2,0
24767349@N02,906,7,1207379245,1207379245,1,2,0
24767349@N02,907,9,1207996367,1207996367,1,1,0
24850040@N07,908,11,1244877898,1244878477,3,4,579
24850040@N07,908,8,1244874313,1244876347,18,4,2034
24850040@N07,908,7,1244878599,1244880681,28,4,2082
24850040@N07,908,6,1244871122,1244873675,18,4,2553
24850040@N07,909,2,1244965995,1244967330,7,2,1335
24850040@N07,909,11,1244967426,1244967426,1,2,0
24872311@N07,910,13,1317539128,1317539128,1,3,0
24872311@N07,910,8,1317524775,1317524775,1,3,0
24872311@N07,910,6,1317524970,1317525027,2,3,57
24889779@N03,911,5,1254632400,1254632400,1,1,0
24897645@N04,912,2,1209866333,1209866333,1,1,0
24897645@N04,913,10,1212629454,1212629454,1,1,0
24897645@N04,914,8,1212898206,1212906527,3,3,8321
24897645@N04,914,5,1212909648,1212909648,1,3,0
24897645@N04,914,6,1212904868,1212904915,2,3,47
24897645@N04,915,5,1213324720,1213325102,2,2,382
24897645@N04,915,1,1213321285,1213327664,20,2,6379
24897645@N04,916,11,1214107680,1214107680,1,2,0
24897645@N04,916,5,1214110234,1214110234,1,2,0
24897645@N04,917,7,1215484517,1215484517,1,3,0
24897645@N04,917,11,1215488575,1215488671,2,3,96
24897645@N04,917,10,1215481031,1215481031,1,3,0
24897645@N04,918,7,1217044457,1217044977,2,6,520
24897645@N04,918,4,1217043246,1217043246,1,6,0
24897645@N04,918,12,1217057988,1217057988,1,6,0
24897645@N04,918,8,1217042530,1217045512,2,6,2982
24897645@N04,918,11,1217042419,1217042419,1,6,0
24897645@N04,918,1,1217055984,1217059413,3,6,3429
24942927@N03,919,8,1238399451,1238399451,1,1,0
25027171@N08,920,13,1399692569,1399695250,9,10,2681
25027171@N08,920,8,1399681881,1399719325,13,10,37444
25027171@N08,920,2,1399683029,1399685175,7,10,2146
25027171@N08,920,5,1399691512,1399691581,2,10,69
25027171@N08,920,9,1399725353,1399726639,51,10,1286
25027171@N08,920,7,1399680093,1399692225,4,10,12132
25027171@N08,920,6,1399683727,1399690242,15,10,6515
25027171@N08,920,10,1399679355,1399720407,25,10,41052
25027171@N08,920,11,1399681591,1399681808,3,10,217
25027171@N08,920,1,1399679615,1399719613,19,10,39998
25027171@N08,921,6,1449557771,1449558059,7,1,288
25027171@N08,922,4,1449995342,1449995399,6,3,57
25027171@N08,922,6,1449993786,1449995442,70,3,1656
25027171@N08,922,10,1449996016,1449996468,6,3,452
25050086@N07,923,8,1389581821,1389581821,1,3,0
25050086@N07,923,1,1389581266,1389581266,1,3,0
25050086@N07,923,6,1389572738,1389572738,1,3,0
25083094@N04,924,4,1399163932,1399163932,1,1,0
25083094@N04,925,1,1400286887,1400287644,12,2,757
25083094@N04,925,8,1400282582,1400304355,2,2,21773
25126729@N00,926,8,1228785195,1228814337,5,4,29142
25126729@N00,926,6,1228778960,1228813108,6,4,34148
25126729@N00,926,2,1228789534,1228789534,1,4,0
25126729@N00,926,9,1228810895,1228811076,2,4,181
25126729@N00,927,1,1276165027,1276165027,1,2,0
25126729@N00,927,5,1276165572,1276167004,2,2,1432
25126729@N00,928,12,1276228388,1276228388,1,7,0
25126729@N00,928,8,1276208918,1276208918,1,7,0
25126729@N00,928,1,1276222613,1276222613,1,7,0
25126729@N00,928,13,1276217327,1276218042,13,7,715
25126729@N00,928,6,1276212297,1276212297,1,7,0
25126729@N00,928,2,1276212459,1276212473,2,7,14
25126729@N00,928,5,1276220975,1276220975,1,7,0
25126729@N00,929,11,1307582051,1307582051,1,3,0
25126729@N00,929,12,1307596483,1307596483,1,3,0
25126729@N00,929,9,1307618457,1307618656,2,3,199
25126729@N00,930,5,1307662611,1307662611,1,1,0
25152546@N04,931,6,1441939115,1441939579,2,2,464
25152546@N04,931,5,1441950587,1441950587,1,2,0
25183144@N03,932,2,1344075122,1344075122,1,1,0
25282313@N08,933,8,1308359904,1308364547,2,1,4643
25358521@N05,934,12,1330065934,1330065934,1,2,0
25358521@N05,934,7,1330048499,1330048499,1,2,0
25360342@N02,935,4,1395792311,1395792311,1,6,0
25360342@N02,935,11,1395795841,1395795841,1,6,0
25360342@N02,935,1,1395788820,1395788820,1,6,0
25360342@N02,935,12,1395794148,1395803158,3,6,9010
25360342@N02,935,8,1395796228,1395804976,2,6,8748
25360342@N02,935,6,1395790413,1395807408,2,6,16995
25360342@N02,936,4,1408798373,1408798443,2,6,70
25360342@N02,936,2,1408796981,1408796981,1,6,0
25360342@N02,936,1,1408781979,1408799579,16,6,17600
25360342@N02,936,5,1408785737,1408785737,1,6,0
25360342@N02,936,6,1408797807,1408798970,6,6,1163
25360342@N02,936,10,1408800578,1408800769,2,6,191
25360342@N02,937,1,1454719008,1454719008,1,1,0
25382096@N05,938,5,1462537753,1462537753,1,1,0
25385084@N07,939,1,1269899554,1269899554,1,1,0
25387061@N06,940,6,1327207635,1327207635,1,1,0
25437583@N00,941,5,1240594683,1240594683,1,2,0
25437583@N00,941,1,1240595638,1240599884,4,2,4246
25438065@N03,942,8,1212876142,1212911470,29,1,35328
25438065@N03,943,8,1213312014,1213325193,23,1,13179
25548984@N06,944,5,1210252456,1210252456,1,2,0
25548984@N06,944,13,1210264692,1210264692,1,2,0
25548984@N06,945,1,1229016027,1229016224,3,2,197
25548984@N06,945,8,1229017543,1229017543,1,2,0
25548984@N06,946,1,1233593951,1233596724,5,2,2773
25548984@N06,946,8,1233586363,1233587061,7,2,698
25548984@N06,947,8,1235051965,1235055480,7,1,3515
25585962@N06,948,2,1412483815,1412483815,1,8,0
25585962@N06,948,5,1412511653,1412511653,1,8,0
25585962@N06,948,6,1412487180,1412489082,9,8,1902
25585962@N06,948,10,1412482919,1412482919,1,8,0
25585962@N06,948,13,1412491840,1412491840,1,8,0
25585962@N06,948,4,1412492043,1412508213,2,8,16170
25585962@N06,948,8,1412483657,1412524774,5,8,41117
25585962@N06,948,1,1412496111,1412525756,14,8,29645
25627071@N00,949,8,1312169083,1312187407,15,1,18324
25651350@N06,950,6,1227942016,1227942431,13,1,415
25651350@N06,951,6,1229067523,1229069162,7,1,1639
25651350@N06,952,6,1257917521,1257924700,3,1,7179
25651350@N06,953,6,1258787871,1258787871,1,1,0
25651350@N06,954,8,1307093067,1307093084,2,2,17
25651350@N06,954,1,1307092892,1307093184,6,2,292
25686649@N00,955,5,1371340663,1371340663,1,1,0
25686649@N00,956,5,1373265762,1373265762,1,2,0
25686649@N00,956,4,1373270566,1373270566,1,2,0
25737136@N06,957,8,1307493528,1307493528,1,1,0
25823827@N00,958,9,1447823532,1447823532,1,2,0
25823827@N00,958,10,1447823389,1447823389,1,2,0
25825657@N05,959,11,1355189610,1355189610,1,1,0
25827417@N00,960,12,1430438108,1430441534,2,1,3426
25846522@N00,961,9,1360398391,1360398391,1,3,0
25846522@N00,961,6,1360371168,1360371345,2,3,177
25846522@N00,961,1,1360405281,1360405281,1,3,0
25854008@N00,962,8,1352501221,1352501221,1,1,0
25905065@N00,963,5,1336993452,1336993452,1,7,0
25905065@N00,963,3,1336977677,1336977677,1,7,0
25905065@N00,963,8,1336969996,1336977514,4,7,7518
25905065@N00,963,10,1336963740,1336995329,2,7,31589
25905065@N00,963,7,1336990324,1336990326,2,7,2
25905065@N00,963,12,1336990321,1336990321,1,7,0
25905065@N00,963,13,1336989881,1336989922,3,7,41
25905065@N00,964,8,1362892135,1362892582,18,1,447
26094090@N00,965,5,1338083064,1338083064,1,1,0
26094090@N00,966,1,1338509120,1338509120,1,1,0
26143366@N00,967,6,1205535324,1205537140,4,1,1816
26153219@N00,968,2,1308981773,1308982916,19,2,1143
26153219@N00,968,11,1308952257,1308956510,4,2,4253
26211887@N07,969,1,1224058471,1224058471,1,2,0
26211887@N07,969,10,1224048878,1224048878,1,2,0
26247897@N03,970,10,1337981464,1337981975,2,2,511
26247897@N03,970,1,1337981884,1337981884,1,2,0
26284290@N05,971,8,1189346402,1189346402,1,2,0
26284290@N05,971,1,1189346401,1189346401,1,2,0
26284290@N05,972,8,1220796001,1220796001,1,2,0
26284290@N05,972,2,1220796000,1220796000,1,2,0
26284290@N05,973,12,1284904801,1284904801,1,2,0
26284290@N05,973,2,1284904800,1284904802,2,2,2
26284290@N05,974,8,1305295203,1305295204,2,1,1
26284290@N05,975,1,1321607394,1321607394,1,1,0
26334284@N00,976,6,1200866168,1200892941,155,1,26773
26334284@N00,977,6,1201219730,1201236640,574,1,16910
26342127@N00,978,1,1264487888,1264487888,1,1,0
26393454@N00,979,13,1423185328,1423185328,1,1,0
26443143@N03,980,8,1305841451,1305841451,1,1,0
26475432@N03,981,10,1410912615,1410912615,1,1,0
26522673@N07,982,8,1227841118,1227841118,1,2,0
26522673@N07,982,13,1227841116,1227841116,1,2,0
26522673@N07,983,12,1283330827,1283330827,1,8,0
26522673@N07,983,8,1283306880,1283324818,2,8,17938
26522673@N07,983,2,1283307871,1283310614,2,8,2743
26522673@N07,983,13,1283311848,1283334065,17,8,22217
26522673@N07,983,10,1283306146,1283334953,4,8,28807
26522673@N07,983,6,1283329188,1283333968,2,8,4780
26522673@N07,983,5,1283317521,1283320755,4,8,3234
26522673@N07,983,1,1283306467,1283334294,5,8,27827
26522673@N07,984,1,1346640084,1346687120,4,7,47036
26522673@N07,984,8,1346642587,1346686345,6,7,43758
26522673@N07,984,13,1346645455,1346661099,6,7,15644
26522673@N07,984,10,1346640090,1346640090,1,7,0
26522673@N07,984,6,1346653487,1346653831,2,7,344
26522673@N07,984,2,1346658135,1346658135,1,7,0
26522673@N07,984,7,1346666937,1346666937,1,7,0
26522673@N07,985,8,1382326983,1382326983,1,7,0
26522673@N07,985,2,1382340470,1382340796,2,7,326
26522673@N07,985,13,1382338238,1382338238,1,7,0
26522673@N07,985,10,1382333586,1382333586,1,7,0
26522673@N07,985,6,1382343606,1382344256,2,7,650
26522673@N07,985,5,1382329575,1382334508,2,7,4933
26522673@N07,985,1,1382327166,1382352615,5,7,25449
26531284@N02,986,8,1320314071,1320314071,1,5,0
26531284@N02,986,2,1320311918,1320311924,2,5,6
26531284@N02,986,6,1320295235,1320297627,2,5,2392
26531284@N02,986,12,1320305743,1320305743,1,5,0
26531284@N02,986,11,1320304492,1320304534,4,5,42
26531284@N02,987,2,1352327968,1352341524,4,4,13556
26531284@N02,987,8,1352342961,1352342961,1,4,0
26531284@N02,987,10,1352347884,1352347884,1,4,0
26531284@N02,987,5,1352329579,1352329678,2,4,99
26546859@N00,988,8,1247361408,1247378090,12,1,16682
26573031@N05,989,8,1465964587,1465964587,1,5,0
26573031@N05,989,12,1465955061,1465956131,3,5,1070
26573031@N05,989,4,1465968659,1465968697,3,5,38
26573031@N05,989,2,1465950973,1465975115,2,5,24142
26573031@N05,989,6,1465949940,1465949940,1,5,0
26603119@N00,990,2,1367373798,1367373798,1,4,0
26603119@N00,990,12,1367365160,1367365160,1,4,0
26603119@N00,990,4,1367375497,1367375497,1,4,0
26603119@N00,990,7,1367366144,1367366144,1,4,0
26603119@N00,991,8,1400064643,1400064643,1,2,0
26603119@N00,991,13,1400060209,1400060209,1,2,0
26603119@N00,992,2,1400104103,1400104103,1,1,0
26603119@N00,993,8,1462967313,1462967325,4,3,12
26603119@N00,993,4,1462959360,1462963018,4,3,3658
26603119@N00,993,13,1462960011,1462962790,3,3,2779
26603119@N00,994,8,1463183298,1463183786,2,3,488
26603119@N00,994,12,1463173792,1463177177,13,3,3385
26603119@N00,994,11,1463178458,1463178458,1,3,0
26619856@N00,995,8,1350991019,1350991019,1,2,0
26619856@N00,995,5,1350983204,1350983204,1,2,0
26633936@N03,996,7,1400460409,1400460409,1,3,0
26633936@N03,996,5,1400463313,1400463313,1,3,0
26633936@N03,996,8,1400486571,1400486571,1,3,0
26650546@N07,997,5,1311634730,1311634730,1,1,0
26652894@N06,998,12,1195433697,1195433697,1,1,0
26670433@N07,999,8,1232672648,1232689018,3,1,16370
26678134@N04,1000,6,1356253121,1356253183,2,1,62
26678134@N04,1001,8,1360907651,1360907928,2,2,277
26678134@N04,1001,4,1360900577,1360900577,1,2,0
26678134@N04,1002,4,1381462530,1381463381,2,2,851
26678134@N04,1002,6,1381462194,1381462194,1,2,0
26678134@N04,1003,6,1383899196,1383899765,2,1,569
26678134@N04,1004,10,1387173797,1387173797,1,1,0
26678134@N04,1005,4,1387436526,1387436526,1,2,0
26678134@N04,1005,6,1387437739,1387437995,6,2,256
26678134@N04,1006,5,1411783117,1411783117,1,1,0
26678134@N04,1007,6,1417161628,1417165615,9,2,3987
26678134@N04,1007,1,1417160715,1417160740,2,2,25
26678134@N04,1008,4,1419322095,1419322095,1,2,0
26678134@N04,1008,6,1419321958,1419321958,1,2,0
26678134@N04,1009,4,1446799235,1446799235,1,2,0
26678134@N04,1009,6,1446798397,1446798995,2,2,598
26678134@N04,1010,6,1451725449,1451727944,11,1,2495
26680632@N04,1011,7,1275806212,1275806212,1,1,0
26695377@N00,1012,8,1330163493,1330163493,1,2,0
26695377@N00,1012,11,1330168393,1330168393,1,2,0
26728047@N05,1013,8,1281777250,1281795197,67,1,17947
26874770@N06,1014,1,1197197729,1197197729,1,2,0
26874770@N06,1014,6,1197190468,1197190468,1,2,0
26874770@N06,1015,6,1199169519,1199172437,6,1,2918
26874770@N06,1016,10,1204166244,1204166244,1,1,0
26874770@N06,1017,13,1204418637,1204418637,1,1,0
26874770@N06,1018,1,1235798370,1235798370,1,7,0
26874770@N06,1018,6,1235800653,1235801290,2,7,637
26874770@N06,1018,5,1235776853,1235780567,9,7,3714
26874770@N06,1018,8,1235781854,1235803988,6,7,22134
26874770@N06,1018,2,1235775071,1235775071,1,7,0
26874770@N06,1018,4,1235799448,1235799448,1,7,0
26874770@N06,1018,12,1235794169,1235794461,5,7,292
26874770@N06,1019,5,1236162321,1236162350,2,2,29
26874770@N06,1019,10,1236162306,1236162306,1,2,0
26874770@N06,1020,10,1241183785,1241183785,1,1,0
26874770@N06,1021,11,1242518408,1242518408,1,1,0
26874770@N06,1022,12,1245465327,1245465634,5,3,307
26874770@N06,1022,5,1245464860,1245464860,1,3,0
26874770@N06,1022,11,1245465904,1245465904,1,3,0
26874770@N06,1023,5,1281589589,1281608541,4,5,18952
26874770@N06,1023,10,1281570589,1281570589,1,5,0
26874770@N06,1023,3,1281607924,1281607924,1,5,0
26874770@N06,1023,12,1281609848,1281610161,8,5,313
26874770@N06,1023,1,1281616926,1281616952,3,5,26
26874770@N06,1024,10,1281769625,1281770357,6,6,732
26874770@N06,1024,4,1281778350,1281788428,3,6,10078
26874770@N06,1024,12,1281784986,1281785392,3,6,406
26874770@N06,1024,13,1281778993,1281798983,14,6,19990
26874770@N06,1024,2,1281771915,1281771915,1,6,0
26874770@N06,1024,8,1281784467,1281795094,10,6,10627
26888485@N08,1025,9,1371544153,1371544153,1,1,0
26897917@N02,1026,8,1365022786,1365027454,2,1,4668
27027561@N03,1027,5,1382606413,1382606413,1,2,0
27027561@N03,1027,1,1382608691,1382608691,1,2,0
27174905@N03,1028,6,1345698506,1345698506,1,1,0
27182886@N02,1029,12,1452557961,1452557961,1,1,0
27193990@N00,1030,13,1363999104,1363999104,1,1,0
27207509@N00,1031,12,1426639474,1426639532,4,1,58
27233089@N04,1032,13,1256612909,1256612909,1,1,0
27270108@N05,1033,4,1275633069,1275633069,1,1,0
27270108@N05,1034,1,1306633579,1306633670,4,1,91
27270108@N05,1035,1,1306726625,1306726638,3,2,13
27270108@N05,1035,6,1306723874,1306723874,1,2,0
27270108@N05,1036,7,1306884482,1306884482,1,3,0
27270108@N05,1036,6,1306881321,1306881408,4,3,87
27270108@N05,1036,4,1306885005,1306887508,4,3,2503
27270108@N05,1037,1,1307057486,1307057486,1,3,0
27270108@N05,1037,10,1307052621,1307052621,1,3,0
27270108@N05,1037,5,1307055645,1307057147,4,3,1502
27270108@N05,1038,6,1339201829,1339206594,2,2,4765
27270108@N05,1038,5,1339198217,1339198904,4,2,687
27270108@N05,1039,1,1339285352,1339285527,2,3,175
27270108@N05,1039,6,1339282691,1339282694,2,3,3
27270108@N05,1039,5,1339284956,1339284956,1,3,0
27270108@N05,1040,10,1339494926,1339494985,3,2,59
27270108@N05,1040,1,1339492409,1339493245,9,2,836
27270108@N05,1041,4,1356742602,1356742602,1,1,0
27270108@N05,1042,3,1357192638,1357192835,3,2,197
27270108@N05,1042,6,1357201144,1357204196,10,2,3052
27292880@N03,1043,7,1294965134,1294965551,19,3,417
27292880@N03,1043,11,1294978578,1294978694,3,3,116
27292880@N03,1043,8,1294965349,1294965349,1,3,0
27312248@N04,1044,5,1203553036,1203555204,9,6,2168
27312248@N04,1044,13,1203570145,1203570671,3,6,526
27312248@N04,1044,7,1203578733,1203579272,6,6,539
27312248@N04,1044,4,1203556838,1203557648,5,6,810
27312248@N04,1044,2,1203564284,1203564284,1,6,0
27312248@N04,1044,9,1203586616,1203587785,21,6,1169
27312248@N04,1045,6,1216121662,1216125520,18,1,3858
27338137@N06,1046,8,1253917358,1253918228,3,1,870
27372897@N00,1047,4,1353265769,1353265769,1,1,0
27429042@N08,1048,6,1188880952,1188880952,1,2,0
27429042@N08,1048,7,1188873345,1188873345,1,2,0
27429042@N08,1049,5,1219980259,1219980259,1,1,0
27429042@N08,1050,8,1231364912,1231380250,6,5,15338
27429042@N08,1050,1,1231370036,1231390716,2,5,20680
27429042@N08,1050,5,1231385624,1231385624,1,5,0
27429042@N08,1050,6,1231368222,1231368504,2,5,282
27429042@N08,1050,12,1231384299,1231384850,2,5,551
27429042@N08,1051,13,1231637326,1231637326,1,4,0
27429042@N08,1051,8,1231630980,1231645672,5,4,14692
27429042@N08,1051,11,1231631491,1231631491,1,4,0
27429042@N08,1051,5,1231639165,1231639229,2,4,64
27429042@N08,1052,5,1232347232,1232347232,1,1,0
27429042@N08,1053,6,1232431864,1232431864,1,1,0
27429042@N08,1054,10,1253257593,1253257593,1,2,0
27429042@N08,1054,8,1253256321,1253256321,1,2,0
27429042@N08,1055,8,1263624588,1263624588,1,3,0
27429042@N08,1055,1,1263621711,1263621711,1,3,0
27429042@N08,1055,5,1263618876,1263618876,1,3,0
27429042@N08,1056,8,1265685266,1265685266,1,2,0
27429042@N08,1056,12,1265685461,1265686545,2,2,1084
27429042@N08,1057,5,1266302449,1266302449,1,1,0
27429042@N08,1058,8,1267496657,1267496657,1,3,0
27429042@N08,1058,1,1267496973,1267497388,2,3,415
27429042@N08,1058,6,1267495298,1267495298,1,3,0
27429042@N08,1059,8,1271122089,1271122089,1,2,0
27429042@N08,1059,5,1271116813,1271120125,7,2,3312
27429042@N08,1060,5,1273625902,1273625902,1,3,0
27429042@N08,1060,12,1273619406,1273619406,1,3,0
27429042@N08,1060,8,1273621598,1273621598,1,3,0
27429042@N08,1061,11,1292389787,1292389787,1,3,0
27429042@N08,1061,5,1292369156,1292369156,1,3,0
27429042@N08,1061,12,1292389899,1292389899,1,3,0
27429042@N08,1062,6,1292746302,1292746302,1,2,0
27429042@N08,1062,1,1292748212,1292748212,1,2,0
27429042@N08,1063,5,1301029456,1301029456,1,2,0
27429042@N08,1063,6,1301011584,1301011944,2,2,360
27429042@N08,1064,6,1313057651,1313057672,2,1,21
27429042@N08,1065,10,1323311288,1323311288,1,1,0
27429042@N08,1066,8,1324189075,1324189075,1,1,0
27429042@N08,1067,8,1331003475,1331003475,1,2,0
27429042@N08,1067,13,1330993437,1330993437,1,2,0
27527078@N05,1068,3,1360544458,1360544458,1,7,0
27527078@N05,1068,1,1360542229,1360574882,9,7,32653
27527078@N05,1068,12,1360566722,1360571117,8,7,4395
27527078@N05,1068,10,1360541654,1360556657,20,7,15003
27527078@N05,1068,6,1360542905,1360543139,4,7,234
27527078@N05,1068,2,1360562331,1360562331,1,7,0
27527078@N05,1068,11,1360564069,1360564070,2,7,1
27539218@N06,1069,13,1208064987,1208064987,1,1,0
27539218@N06,1070,10,1219715199,1219716432,7,1,1233
27539218@N06,1071,13,1231657323,1231657437,2,1,114
27539218@N06,1072,1,1241755575,1241755625,2,1,50
27539218@N06,1073,10,1246856612,1246857952,22,1,1340
27539218@N06,1074,8,1251623295,1251624650,6,1,1355
27539218@N06,1075,2,1254991150,1254991150,1,1,0
27539218@N06,1076,8,1276320301,1276320301,1,1,0
27599409@N02,1077,11,1200357671,1200384082,59,1,26411
27599409@N02,1078,11,1200632660,1200632665,3,1,5
27599409@N02,1079,11,1213380971,1213381450,3,1,479
27810107@N08,1080,7,1232328142,1232331058,3,4,2916
27810107@N08,1080,8,1232326269,1232326415,2,4,146
27810107@N08,1080,1,1232336872,1232336872,1,4,0
27810107@N08,1080,12,1232326496,1232326512,2,4,16
27813472@N00,1081,6,1422426934,1422426934,1,1,0
27853624@N00,1082,6,1230083882,1230083882,1,2,0
27853624@N00,1082,7,1230098588,1230098588,1,2,0
27853624@N00,1083,1,1230431438,1230431484,2,1,46
27874898@N00,1084,5,1349823054,1349846102,5,6,23048
27874898@N00,1084,8,1349826198,1349832586,8,6,6388
27874898@N00,1084,1,1349821417,1349826072,3,6,4655
27874898@N00,1084,6,1349826399,1349831283,13,6,4884
27874898@N00,1084,2,1349831534,1349831787,6,6,253
27874898@N00,1084,4,1349828849,1349828879,3,6,30
27874898@N00,1085,13,1350000710,1350003795,35,2,3085
27874898@N00,1085,5,1350009020,1350009020,1,2,0
27874898@N00,1086,8,1368055294,1368055294,1,4,0
27874898@N00,1086,6,1368067998,1368068015,2,4,17
27874898@N00,1086,2,1368056240,1368056240,1,4,0
27874898@N00,1086,4,1368067243,1368067290,3,4,47
27874898@N00,1087,5,1368232673,1368232673,1,7,0
27874898@N00,1087,8,1368234586,1368238273,4,7,3687
27874898@N00,1087,1,1368232547,1368232547,1,7,0
27874898@N00,1087,6,1368240430,1368242657,3,7,2227
27874898@N00,1087,2,1368239259,1368258912,2,7,19653
27874898@N00,1087,13,1368249599,1368249599,1,7,0
27874898@N00,1087,4,1368242862,1368242935,4,7,73
27874898@N00,1088,4,1370669673,1370669684,2,2,11
27874898@N00,1088,1,1370669317,1370669660,11,2,343
27874898@N00,1089,5,1378713142,1378713142,1,4,0
27874898@N00,1089,1,1378712230,1378725133,7,4,12903
27874898@N00,1089,2,1378722696,1378722696,1,4,0
27874898@N00,1089,4,1378721799,1378721862,3,4,63
27874898@N00,1090,2,1379080148,1379080148,1,5,0
27874898@N00,1090,4,1379069068,1379069091,2,5,23
27874898@N00,1090,5,1379064074,1379064074,1,5,0
27874898@N00,1090,8,1379066624,1379068526,33,5,1902
27874898@N00,1090,1,1379038310,1379038310,1,5,0
27967379@N08,1091,6,1410422526,1410422918,9,2,392
27967379@N08,1091,5,1410406740,1410408906,3,2,2166
27975788@N07,1092,1,1218799818,1218799818,1,1,0
27976717@N05,1093,2,1221171115,1221171115,1,1,0
28019195@N07,1094,6,1419282466,1419282466,1,1,0
28044472@N08,1095,8,1300178378,1300178378,1,1,0
28065533@N00,1096,6,1356150018,1356150018,1,1,0
28083255@N00,1097,2,1416286070,1416286949,2,1,879
28090908@N04,1098,1,1241425685,1241425685,1,1,0
28163344@N08,1099,5,1446937346,1446937346,1,1,0
28203925@N08,1100,13,1344918721,1344918721,1,4,0
28203925@N08,1100,8,1344920995,1344927278,3,4,6283
28203925@N08,1100,6,1344917273,1344917312,2,4,39
28203925@N08,1100,1,1344928206,1344928206,1,4,0
28203925@N08,1101,10,1345026408,1345026408,1,2,0
28203925@N08,1101,1,1345031658,1345031687,2,2,29
28215341@N07,1102,4,1367806307,1367810542,2,2,4235
28215341@N07,1102,13,1367813410,1367813410,1,2,0
28215341@N07,1103,4,1402706593,1402740977,6,2,34384
28215341@N07,1103,13,1402720040,1402728197,3,2,8157
28215341@N07,1104,4,1402788795,1402796989,3,1,8194
28215341@N07,1105,13,1424410972,1424410972,1,1,0
28215341@N07,1106,4,1434162139,1434162139,1,1,0
28236477@N08,1107,2,1222039691,1222040867,2,1,1176
28245557@N00,1108,2,1416871279,1416871279,1,2,0
28245557@N00,1108,6,1416872349,1416872349,1,2,0
28289318@N07,1109,8,1433116467,1433162953,33,1,46486
28289318@N07,1110,8,1433414368,1433417199,10,1,2831
28407078@N08,1111,13,1215422530,1215422530,1,1,0
28407078@N08,1112,13,1215505384,1215505384,1,1,0
28446856@N00,1113,5,1383271449,1383283089,2,1,11640
28450912@N02,1114,3,1220149145,1220149181,3,6,36
28450912@N02,1114,4,1220147619,1220149133,4,6,1514
28450912@N02,1114,5,1220147132,1220147132,2,6,0
28450912@N02,1114,8,1220147476,1220157982,11,6,10506
28450912@N02,1114,1,1220147319,1220147447,6,6,128
28450912@N02,1114,11,1220143920,1220143920,2,6,0
28450912@N02,1115,12,1235779604,1235779890,2,6,286
28450912@N02,1115,10,1235773724,1235784544,2,6,10820
28450912@N02,1115,7,1235780733,1235780733,1,6,0
28450912@N02,1115,5,1235775721,1235776045,3,6,324
28450912@N02,1115,8,1235780816,1235780816,1,6,0
28450912@N02,1115,1,1235784403,1235784772,7,6,369
28450912@N02,1116,12,1243060946,1243060958,2,6,12
28450912@N02,1116,13,1243034028,1243034028,1,6,0
28450912@N02,1116,4,1243064176,1243064176,1,6,0
28450912@N02,1116,1,1243033806,1243033806,1,6,0
28450912@N02,1116,2,1243061222,1243063513,5,6,2291
28450912@N02,1116,6,1243040702,1243063762,3,6,23060
28450912@N02,1117,2,1243145193,1243145355,3,1,162
28450912@N02,1118,4,1249893127,1249893127,1,7,0
28450912@N02,1118,5,1249892916,1249892916,2,7,0
28450912@N02,1118,8,1249892921,1249893127,2,7,206
28450912@N02,1118,1,1249893128,1249893128,1,7,0
28450912@N02,1118,2,1249893131,1249893150,8,7,19
28450912@N02,1118,6,1249893128,1249893135,5,7,7
28450912@N02,1118,11,1249893131,1249893131,1,7,0
28450912@N02,1119,7,1278481003,1278481003,1,3,0
28450912@N02,1119,5,1278480521,1278480663,2,3,142
28450912@N02,1119,1,1278480198,1278480961,4,3,763
28450912@N02,1120,5,1324019180,1324019480,4,2,300
28450912@N02,1120,8,1324018637,1324018637,1,2,0
28450912@N02,1121,4,1324075589,1324075891,4,3,302
28450912@N02,1121,7,1324073137,1324073162,2,3,25
28450912@N02,1121,8,1324073118,1324073671,8,3,553
28450912@N02,1122,13,1368947608,1368947627,4,1,19
28450912@N02,1123,6,1400193114,1400193114,1,2,0
28450912@N02,1123,1,1400201112,1400201154,3,2,42
28450912@N02,1124,3,1400283804,1400283812,2,3,8
28450912@N02,1124,13,1400283926,1400283926,1,3,0
28450912@N02,1124,4,1400283548,1400283548,1,3,0
28450912@N02,1125,8,1416103998,1416104470,3,2,472
28450912@N02,1125,1,1416103340,1416103522,2,2,182
28474359@N03,1126,10,1217181963,1217181963,1,2,0
28474359@N03,1126,5,1217181919,1217181919,1,2,0
28474359@N03,1127,1,1217310130,1217310130,1,3,0
28474359@N03,1127,8,1217302770,1217302770,1,3,0
28474359@N03,1127,5,1217278459,1217278748,2,3,289
28478615@N03,1128,8,1331932839,1331947266,2,2,14427
28478615@N03,1128,10,1331953677,1331953677,1,2,0
28495936@N03,1129,13,1390614373,1390615123,3,2,750
28495936@N03,1129,1,1390616128,1390616343,2,2,215
28527853@N00,1130,6,1335400636,1335400636,1,3,0
28527853@N00,1130,4,1335392584,1335392584,1,3,0
28527853@N00,1130,2,1335409813,1335409813,1,3,0
28527853@N00,1131,6,1335832283,1335833683,2,2,1400
28527853@N00,1131,4,1335833754,1335834497,4,2,743
28527853@N00,1132,6,1354597356,1354597356,1,2,0
28527853@N00,1132,4,1354597470,1354597470,1,2,0
28527853@N00,1133,6,1354664759,1354664759,1,2,0
28527853@N00,1133,4,1354662333,1354664453,2,2,2120
28527853@N00,1134,2,1368238243,1368238243,1,1,0
28530387@N06,1135,5,1470290910,1470290910,1,3,0
28530387@N06,1135,7,1470295160,1470295160,1,3,0
28530387@N06,1135,12,1470289873,1470289873,1,3,0
28572085@N03,1136,9,1216944765,1216944799,3,7,34
28572085@N03,1136,12,1216923394,1216943077,16,7,19683
28572085@N03,1136,8,1216905899,1216906570,20,7,671
28572085@N03,1136,5,1216929303,1216929303,1,7,0
28572085@N03,1136,11,1216914882,1216915186,4,7,304
28572085@N03,1136,10,1216930039,1216932176,68,7,2137
28572085@N03,1136,2,1216909338,1216911190,23,7,1852
28572085@N03,1137,8,1217018452,1217018640,7,3,188
28572085@N03,1137,5,1217025594,1217025594,1,3,0
28572085@N03,1137,6,1217018943,1217019014,3,3,71
28572085@N03,1138,12,1219054623,1219069356,11,3,14733
28572085@N03,1138,8,1219069357,1219069361,6,3,4
28572085@N03,1138,11,1219054663,1219055366,38,3,703
28598412@N04,1139,5,1251475906,1251475906,1,1,0
28598412@N04,1140,5,1251818524,1251818524,1,2,0
28598412@N04,1140,10,1251823584,1251823588,2,2,4
28712708@N06,1141,4,1314612217,1314612217,1,2,0
28712708@N06,1141,8,1314586155,1314586155,1,2,0
28715213@N00,1142,9,1197095533,1197097047,25,6,1514
28715213@N00,1142,5,1197097568,1197097568,1,6,0
28715213@N00,1142,6,1197087976,1197089225,2,6,1249
28715213@N00,1142,10,1197098412,1197098412,1,6,0
28715213@N00,1142,8,1197097987,1197097987,1,6,0
28715213@N00,1142,1,1197097619,1197097895,2,6,276
28715213@N00,1143,6,1207184925,1207184925,1,1,0
28724781@N04,1144,1,1229055107,1229055107,1,3,0
28724781@N04,1144,10,1229049901,1229050045,2,3,144
28724781@N04,1144,8,1229055166,1229055232,3,3,66
28724781@N04,1145,1,1229119875,1229119875,1,3,0
28724781@N04,1145,2,1229120095,1229121759,3,3,1664
28724781@N04,1145,5,1229119581,1229119581,1,3,0
28724781@N04,1146,1,1231375460,1231388964,2,6,13504
28724781@N04,1146,12,1231383734,1231391787,3,6,8053
28724781@N04,1146,8,1231384263,1231384303,2,6,40
28724781@N04,1146,2,1231363749,1231363749,1,6,0
28724781@N04,1146,11,1231362519,1231362519,1,6,0
28724781@N04,1146,4,1231391976,1231391976,1,6,0
28732514@N00,1147,8,1304412986,1304412986,1,1,0
28761221@N00,1148,1,1187990880,1187994476,6,1,3596
28761221@N00,1149,1,1201924574,1201941880,17,1,17306
28761221@N00,1150,1,1230965994,1230985634,86,1,19640
28782167@N03,1151,1,1357422944,1357422944,1,1,0
28827568@N05,1152,5,1222391665,1222391665,1,2,0
28827568@N05,1152,8,1222386305,1222386305,1,2,0
28835512@N07,1153,13,1302759097,1302759837,4,3,740
28835512@N07,1153,6,1302763558,1302763558,1,3,0
28835512@N07,1153,2,1302764680,1302764680,1,3,0
28917843@N02,1154,5,1328876506,1328876506,1,1,0
28946471@N00,1155,4,1378024138,1378024138,1,1,0
28959709@N05,1156,7,1291963959,1291963959,1,1,0
28971971@N00,1157,8,1194825407,1194825852,10,8,445
28971971@N00,1157,1,1194842956,1194849250,38,8,6294
28971971@N00,1157,7,1194826362,1194826362,1,8,0
28971971@N00,1157,10,1194822843,1194852847,2,8,30004
28971971@N00,1157,4,1194828761,1194829476,6,8,715
28971971@N00,1157,12,1194833203,1194833913,6,8,710
28971971@N00,1157,2,1194831549,1194831559,2,8,10
28971971@N00,1157,13,1194835229,1194837115,5,8,1886
28971971@N00,1158,8,1195167897,1195167897,1,5,0
28971971@N00,1158,2,1195172265,1195172288,2,5,23
28971971@N00,1158,1,1195169152,1195169171,2,5,19
28971971@N00,1158,4,1195171976,1195171980,2,5,4
28971971@N00,1158,6,1195169685,1195204778,9,5,35093
28971971@N00,1159,12,1297407984,1297408231,4,1,247
28977782@N00,1160,7,1192157633,1192158490,6,4,857
28977782@N00,1160,6,1192149695,1192171345,8,4,21650
28977782@N00,1160,12,1192162126,1192162140,2,4,14
28977782@N00,1160,8,1192175267,1192175267,1,4,0
28977782@N00,1161,7,1324314762,1324314762,1,6,0
28977782@N00,1161,2,1324314376,1324314376,1,6,0
28977782@N00,1161,6,1324313152,1324313152,1,6,0
28977782@N00,1161,13,1324319792,1324319858,2,6,66
28977782@N00,1161,12,1324315319,1324315319,1,6,0
28977782@N00,1161,8,1324316279,1324316279,1,6,0
28977782@N00,1162,5,1324575885,1324576577,3,2,692
28977782@N00,1162,2,1324562920,1324563412,2,2,492
28977782@N00,1163,1,1324755290,1324755365,2,1,75
29000027@N05,1164,1,1432289734,1432289734,1,1,0
29000027@N05,1165,12,1436513781,1436516233,3,1,2452
29000027@N05,1166,10,1441624636,1441625074,6,1,438
29000027@N05,1167,12,1449468562,1449476963,15,1,8401
29000027@N05,1168,12,1449891867,1449892575,16,1,708
29000027@N05,1169,6,1456873195,1456874196,5,1,1001
29044494@N00,1170,9,1272622466,1272622466,1,2,0
29044494@N00,1170,8,1272627375,1272627375,1,2,0
29057323@N07,1171,3,1207365019,1207388143,3,4,23124
29057323@N07,1171,5,1207380656,1207399710,2,4,19054
29057323@N07,1171,8,1207380477,1207380477,1,4,0
29057323@N07,1171,13,1207388031,1207388031,1,4,0
29057323@N07,1172,13,1207808157,1207808208,2,1,51
29108089@N04,1173,1,1385945775,1385945775,1,3,0
29108089@N04,1173,2,1385969756,1385973820,13,3,4064
29108089@N04,1173,4,1385949973,1385951749,3,3,1776
29129621@N05,1174,6,1291547999,1291547999,1,1,0
29129621@N05,1175,4,1321146112,1321146112,1,1,0
29129621@N05,1176,2,1348901803,1348901803,1,2,0
29129621@N05,1176,3,1348898060,1348898060,1,2,0
29168905@N00,1177,4,1313816225,1313827548,10,2,11323
29168905@N00,1177,1,1313841787,1313841787,1,2,0
29210960@N04,1178,8,1370732279,1370732279,1,1,0
29225947@N00,1179,4,1380155632,1380157967,2,5,2335
29225947@N00,1179,5,1380162778,1380181538,22,5,18760
29225947@N00,1179,6,1380158119,1380162441,27,5,4322
29225947@N00,1179,13,1380155412,1380155452,4,5,40
29225947@N00,1179,10,1380162553,1380162620,2,5,67
29225947@N00,1180,5,1380251573,1380252859,20,1,1286
29232178@N03,1181,8,1411760417,1411760417,1,1,0
29259314@N04,1182,8,1286082638,1286091530,4,2,8892
29259314@N04,1182,13,1286088579,1286088597,2,2,18
29259314@N04,1183,1,1286133040,1286134664,5,3,1624
29259314@N04,1183,4,1286133044,1286133044,1,3,0
29259314@N04,1183,5,1286144343,1286144343,1,3,0
29352917@N00,1184,9,1255335515,1255335515,1,1,0
29352917@N00,1185,5,1255563895,1255568607,2,2,4712
29352917@N00,1185,2,1255558149,1255558198,2,2,49
29384095@N00,1186,4,1253768413,1253768413,1,1,0
29568026@N07,1187,8,1397282177,1397282177,1,1,0
29583624@N04,1188,13,1223027989,1223028003,2,2,14
29583624@N04,1188,5,1223020390,1223020398,2,2,8
29618911@N04,1189,6,1329890072,1329890072,1,2,0
29618911@N04,1189,13,1329883076,1329883686,2,2,610
29619840@N00,1190,1,1209968023,1209976176,9,7,8153
29619840@N00,1190,5,1209968381,1209981467,12,7,13086
29619840@N00,1190,12,1209977886,1209979072,13,7,1186
29619840@N00,1190,7,1209976184,1209989049,5,7,12865
29619840@N00,1190,8,1209979587,1209989108,10,7,9521
29619840@N00,1190,9,1209982038,1209986717,41,7,4679
29619840@N00,1190,10,1209966867,1209981586,13,7,14719
29619840@N00,1191,1,1210150326,1210151258,6,5,932
29619840@N00,1191,4,1210139613,1210147542,3,5,7929
29619840@N00,1191,8,1210147662,1210150183,13,5,2521
29619840@N00,1191,13,1210144645,1210146415,9,5,1770
29619840@N00,1191,6,1210139766,1210144117,2,5,4351
29648523@N05,1192,13,1258608982,1258609656,2,5,674
29648523@N05,1192,4,1258611301,1258611301,1,5,0
29648523@N05,1192,5,1258603406,1258603459,2,5,53
29648523@N05,1192,8,1258602750,1258619500,2,5,16750
29648523@N05,1192,7,1258619406,1258619406,1,5,0
29675024@N05,1193,5,1275963365,1275963923,2,2,558
29675024@N05,1193,1,1275963050,1275963050,1,2,0
29756928@N03,1194,12,1398993649,1398993649,1,1,0
29797746@N08,1195,4,1234062536,1234062536,1,1,0
29797746@N08,1196,8,1277002264,1277022354,42,1,20090
29826898@N00,1197,11,1206815580,1206830158,6,1,14578
29838859@N08,1198,4,1433458923,1433463949,2,1,5026
29845947@N00,1199,2,1278655639,1278665004,8,3,9365
29845947@N00,1199,1,1278640308,1278649181,22,3,8873
29845947@N00,1199,6,1278651880,1278657330,20,3,5450
29865634@N04,1200,1,1204160567,1204160567,1,4,0
29865634@N04,1200,10,1204156047,1204168453,4,4,12406
29865634@N04,1200,5,1204158122,1204168629,2,4,10507
29865634@N04,1200,7,1204165111,1204165111,1,4,0
29865634@N04,1201,4,1214552205,1214552205,2,2,0
29865634@N04,1201,5,1214553628,1214553628,1,2,0
29865634@N04,1202,1,1214630451,1214630451,1,1,0
29865634@N04,1203,5,1222490598,1222491982,9,2,1384
29865634@N04,1203,1,1222494440,1222494440,1,2,0
29865634@N04,1204,4,1229675495,1229675495,1,3,0
29865634@N04,1204,1,1229678435,1229678470,2,3,35
29865634@N04,1204,6,1229674334,1229675330,9,3,996
29865634@N04,1205,4,1249478967,1249479120,2,3,153
29865634@N04,1205,1,1249475234,1249477867,3,3,2633
29865634@N04,1205,12,1249474841,1249474841,1,3,0
29865634@N04,1206,1,1250952376,1250952533,2,1,157
29865634@N04,1207,5,1250985255,1250986084,2,1,829
29865634@N04,1208,1,1251027873,1251028703,2,1,830
29865634@N04,1209,1,1251058148,1251094349,13,3,36201
29865634@N04,1209,6,1251082045,1251086870,7,3,4825
29865634@N04,1209,8,1251080994,1251080994,1,3,0
29865634@N04,1210,8,1251805194,1251806852,3,1,1658
29870124@N02,1211,4,1333966857,1333966857,1,1,0
29870124@N02,1212,1,1334191035,1334203686,2,1,12651
29924665@N05,1213,10,1454818209,1454818209,1,7,0
29924665@N05,1213,8,1454819820,1454834412,2,7,14592
29924665@N05,1213,3,1454825690,1454825690,1,7,0
29924665@N05,1213,1,1454822886,1454822886,1,7,0
29924665@N05,1213,12,1454821599,1454821749,4,7,150
29924665@N05,1213,13,1454808645,1454808645,1,7,0
29924665@N05,1213,4,1454795177,1454810459,32,7,15282
29980560@N06,1214,12,1287909105,1287909105,1,1,0
30022156@N00,1215,1,1336173110,1336186799,22,1,13689
30030726@N05,1216,1,1437461138,1437461138,1,1,0
30042168@N03,1217,7,1328505901,1328505901,1,5,0
30042168@N03,1217,12,1328505926,1328505926,1,5,0
30042168@N03,1217,4,1328507953,1328507970,3,5,17
30042168@N03,1217,11,1328519367,1328519367,1,5,0
30042168@N03,1217,6,1328508134,1328508569,3,5,435
30042168@N03,1218,4,1328740242,1328760131,4,2,19889
30042168@N03,1218,1,1328735835,1328736401,4,2,566
30042168@N03,1219,2,1328924151,1328924151,1,3,0
30042168@N03,1219,11,1328924226,1328924226,1,3,0
30042168@N03,1219,6,1328933948,1328934066,3,3,118
30052360@N08,1220,1,1340955550,1340964690,18,1,9140
30197109@N03,1221,1,1343546637,1343546637,1,1,0
30269754@N05,1222,6,1327720154,1327724443,8,5,4289
30269754@N05,1222,1,1327712377,1327714951,3,5,2574
30269754@N05,1222,4,1327716184,1327716184,1,5,0
30269754@N05,1222,5,1327714437,1327714437,1,5,0
30269754@N05,1222,13,1327715215,1327715215,1,5,0
30269754@N05,1223,1,1380937896,1380937902,2,4,6
30269754@N05,1223,4,1380947030,1380947132,3,4,102
30269754@N05,1223,5,1380938053,1380938061,3,4,8
30269754@N05,1223,13,1380944865,1380946431,5,4,1566
30375980@N02,1224,8,1247519671,1247519952,30,1,281
30452086@N07,1225,8,1376458770,1376458770,1,1,0
30485540@N03,1226,8,1244915331,1244915331,1,1,0
30493847@N04,1227,2,1317622966,1317622966,1,1,0
30498826@N00,1228,1,1310203352,1310203358,4,1,6
30586074@N07,1229,6,1242958541,1242975519,54,1,16978
30586074@N07,1230,8,1243043030,1243043828,35,3,798
30586074@N07,1230,6,1243050083,1243059498,94,3,9415
30586074@N07,1230,10,1243061270,1243061314,4,3,44
30586074@N07,1231,6,1243137250,1243143601,19,1,6351
30586074@N07,1232,1,1307062046,1307062956,40,3,910
30586074@N07,1232,6,1307063014,1307073814,44,3,10800
30586074@N07,1232,4,1307078234,1307078937,10,3,703
30586074@N07,1233,6,1307213996,1307256051,51,2,42055
30586074@N07,1233,4,1307259155,1307259155,1,2,0
30629351@N00,1234,10,1218271763,1218273907,17,6,2144
30629351@N00,1234,7,1218276885,1218277541,7,6,656
30629351@N00,1234,1,1218271244,1218278112,2,6,6868
30629351@N00,1234,6,1218268490,1218268656,4,6,166
30629351@N00,1234,8,1218262253,1218263090,3,6,837
30629351@N00,1234,2,1218262416,1218262494,2,6,78
30650680@N02,1235,4,1434354800,1434354800,1,2,0
30650680@N02,1235,8,1434354110,1434354110,1,2,0
30701202@N03,1236,10,1339819644,1339820549,4,1,905
30706862@N02,1237,8,1307193085,1307217822,10,1,24737
30738244@N07,1238,5,1201759662,1201766646,4,2,6984
30738244@N07,1238,8,1201759589,1201759589,1,2,0
30738244@N07,1239,9,1204446900,1204446900,1,1,0
30738244@N07,1240,9,1218107968,1218110182,16,1,2214
30796335@N08,1241,2,1362311077,1362311570,3,5,493
30796335@N08,1241,10,1362306169,1362306169,1,5,0
30796335@N08,1241,6,1362313826,1362313826,1,5,0
30796335@N08,1241,11,1362311052,1362311052,1,5,0
30796335@N08,1241,7,1362309580,1362309580,1,5,0
30796335@N08,1242,6,1362354291,1362354291,1,1,0
30829906@N00,1243,1,1203133250,1203133250,1,1,0
30831872@N08,1244,2,1241305887,1241305887,1,5,0
30831872@N08,1244,12,1241332580,1241332580,1,5,0
30831872@N08,1244,11,1241318201,1241326618,4,5,8417
30831872@N08,1244,7,1241332522,1241332522,1,5,0
30831872@N08,1244,13,1241330240,1241331657,2,5,1417
30891516@N08,1245,4,1305179964,1305179964,1,4,0
30891516@N08,1245,9,1305201039,1305201039,1,4,0
30891516@N08,1245,12,1305190839,1305190839,1,4,0
30891516@N08,1245,6,1305177796,1305191401,3,4,13605
30954521@N08,1246,5,1197192777,1197192777,1,1,0
31073542@N07,1247,9,1471247814,1471247814,1,2,0
31073542@N07,1247,5,1471247365,1471247365,1,2,0
31169813@N04,1248,12,1232852365,1232880505,10,8,28140
31169813@N04,1248,8,1232849064,1232882483,11,8,33419
31169813@N04,1248,10,1232882979,1232882979,1,8,0
31169813@N04,1248,6,1232847284,1232865112,9,8,17828
31169813@N04,1248,2,1232844680,1232865456,7,8,20776
31169813@N04,1248,4,1232847230,1232859444,2,8,12214
31169813@N04,1248,1,1232850662,1232858047,3,8,7385
31169813@N04,1248,5,1232838620,1232878510,9,8,39890
31169813@N04,1249,9,1233216052,1233217478,12,4,1426
31169813@N04,1249,10,1233202579,1233203916,2,4,1337
31169813@N04,1249,1,1233218674,1233218863,2,4,189
31169813@N04,1249,5,1233208099,1233208099,1,4,0
31223689@N00,1250,5,1222056423,1222056423,1,1,0
31223689@N00,1251,1,1230620578,1230620578,1,4,0
31223689@N00,1251,9,1230622636,1230622636,1,4,0
31223689@N00,1251,5,1230620854,1230620854,1,4,0
31223689@N00,1251,8,1230620694,1230620694,1,4,0
31291728@N05,1252,8,1461728643,1461728643,1,1,0
31291728@N05,1253,2,1461935521,1461935521,1,2,0
31291728@N05,1253,4,1461928816,1461928877,2,2,61
31369133@N04,1254,2,1292161107,1292161107,1,1,0
31429098@N03,1255,12,1375672097,1375672097,1,2,0
31429098@N03,1255,6,1375673351,1375673351,1,2,0
31449648@N05,1256,2,1365844048,1365844048,1,1,0
31449648@N05,1257,5,1375152347,1375152347,1,1,0
31449648@N05,1258,1,1383377396,1383377396,1,1,0
31449648@N05,1259,6,1383984076,1383984127,2,1,51
31535569@N00,1260,5,1255132920,1255132920,1,1,0
31565537@N00,1261,12,1281151632,1281165165,6,1,13533
31608675@N00,1262,8,1253335339,1253335339,1,1,0
31681108@N07,1263,6,1246529871,1246529871,1,1,0
31681108@N07,1264,5,1247299973,1247299973,1,1,0
31692641@N00,1265,11,1228375841,1228377602,2,5,1761
31692641@N00,1265,13,1228367543,1228367543,1,5,0
31692641@N00,1265,1,1228374984,1228377603,6,5,2619
31692641@N00,1265,8,1228377601,1228377601,1,5,0
31692641@N00,1265,2,1228376067,1228378523,5,5,2456
31692641@N00,1266,5,1228568404,1228568413,3,3,9
31692641@N00,1266,1,1228568400,1228568402,3,3,2
31692641@N00,1266,2,1228568411,1228568411,1,3,0
31692641@N00,1267,6,1228624039,1228624039,1,4,0
31692641@N00,1267,1,1228628970,1228628970,1,4,0
31692641@N00,1267,5,1228602562,1228602562,1,4,0
31692641@N00,1267,2,1228599253,1228626645,4,4,27392
31692641@N00,1268,4,1317560426,1317560428,3,3,2
31692641@N00,1268,1,1317560401,1317560431,14,3,30
31692641@N00,1268,2,1317560413,1317560440,14,3,27
31692641@N00,1269,1,1317598832,1317633532,2,2,34700
31692641@N00,1269,2,1317606136,1317627791,6,2,21655
31764887@N02,1270,6,1333198800,1333198800,1,2,0
31764887@N02,1270,1,1333198800,1333198800,2,2,0
31764887@N02,1271,1,1364734800,1364734800,2,1,0
31770349@N02,1272,2,1223683998,1223683998,1,5,0
31770349@N02,1272,6,1223678892,1223690510,2,5,11618
31770349@N02,1272,4,1223691560,1223691560,1,5,0
31770349@N02,1272,8,1223676162,1223677688,2,5,1526
31770349@N02,1272,3,1223690589,1223690622,2,5,33
31846143@N08,1273,8,1238903159,1238903208,43,1,49
31924266@N02,1274,2,1304725378,1304725378,1,1,0
31937081@N07,1275,6,1421901500,1421901713,2,4,213
31937081@N07,1275,5,1421888515,1421888515,1,4,0
31937081@N07,1275,10,1421893820,1421893820,1,4,0
31937081@N07,1275,4,1421884121,1421884121,1,4,0
31947407@N00,1276,12,1333980004,1333980016,13,1,12
31947407@N00,1277,12,1334013181,1334023191,22,1,10010
31947407@N00,1278,12,1334066433,1334066477,45,1,44
31947407@N00,1279,12,1334127890,1334142919,47,1,15029
31957707@N08,1280,4,1419663768,1419663768,1,1,0
31964360@N00,1281,6,1420005682,1420005682,1,1,0
31964360@N00,1282,4,1420145379,1420145379,1,3,0
31964360@N00,1282,2,1420151340,1420151340,1,3,0
31964360@N00,1282,6,1420153383,1420153403,3,3,20
32018985@N00,1283,4,1455330894,1455346452,5,6,15558
32018985@N00,1283,2,1455332746,1455347723,6,6,14977
32018985@N00,1283,9,1455349997,1455349997,1,6,0
32018985@N00,1283,12,1455322123,1455328567,11,6,6444
32018985@N00,1283,1,1455333386,1455333386,1,6,0
32018985@N00,1283,8,1455321488,1455321489,2,6,1
32040587@N04,1284,5,1304140012,1304160061,2,1,20049
32077113@N00,1285,4,1269473556,1269473556,1,1,0
32090737@N04,1286,5,1224811259,1224811259,1,1,0
32090737@N04,1287,4,1225963133,1225963133,1,2,0
32090737@N04,1287,5,1225962362,1225962362,1,2,0
32090737@N04,1288,5,1238987438,1238987438,1,1,0
32263245@N00,1289,8,1243730269,1243752537,31,1,22268
32263245@N00,1290,8,1260006957,1260008826,5,1,1869
32263245@N00,1291,6,1291540749,1291543344,2,1,2595
32359947@N00,1292,8,1243573796,1243573796,1,5,0
32359947@N00,1292,13,1243575317,1243595541,3,5,20224
32359947@N00,1292,6,1243581791,1243587963,2,5,6172
32359947@N00,1292,1,1243579267,1243598745,14,5,19478
32359947@N00,1292,4,1243581598,1243581761,2,5,163
32370701@N02,1293,4,1292644243,1292644243,1,1,0
32372198@N00,1294,5,1360898722,1360901224,2,3,2502
32372198@N00,1294,4,1360908066,1360909534,6,3,1468
32372198@N00,1294,12,1360907403,1360907403,1,3,0
32399171@N00,1295,10,1300751976,1300751976,1,1,0
32527241@N04,1296,8,1266274707,1266313133,86,1,38426
32617425@N00,1297,6,1352531094,1352535224,44,2,4130
32617425@N00,1297,10,1352537809,1352537845,2,2,36
32617425@N00,1298,4,1415436211,1415436322,7,4,111
32617425@N00,1298,6,1415420874,1415435499,11,4,14625
32617425@N00,1298,1,1415419183,1415419187,2,4,4
32617425@N00,1298,13,1415430074,1415430097,3,4,23
32644191@N07,1299,10,1254458688,1254475384,2,1,16696
32644191@N07,1300,10,1255255102,1255255102,1,1,0
32644191@N07,1301,6,1255653773,1255655330,2,3,1557
32644191@N07,1301,10,1255667208,1255672018,2,3,4810
32644191@N07,1301,2,1255667745,1255667745,1,3,0
32907388@N08,1302,6,1300769379,1300769512,3,1,133
33029321@N00,1303,2,1331645197,1331656029,15,1,10832
33050020@N08,1304,9,1360967332,1360967332,1,1,0
33063488@N02,1305,6,1229244677,1229244677,1,1,0
33063488@N02,1306,4,1231057827,1231057827,1,1,0
33063488@N02,1307,11,1238424122,1238424122,1,1,0
33115152@N06,1308,1,1248226272,1248247159,2,1,20887
33121758@N04,1309,8,1229134184,1229167670,30,1,33486
33121758@N04,1310,8,1316846928,1316846928,1,1,0
33121758@N04,1311,11,1350196246,1350196246,1,1,0
33121758@N04,1312,4,1352614506,1352614506,1,2,0
33121758@N04,1312,6,1352620222,1352620222,1,2,0
33121758@N04,1313,1,1368871438,1368871438,1,1,0
33121758@N04,1314,1,1386397860,1386397860,1,2,0
33121758@N04,1314,6,1386413381,1386413381,1,2,0
33197996@N07,1315,2,1396643036,1396643036,1,1,0
33197996@N07,1316,4,1396993018,1396993058,2,1,40
33197996@N07,1317,5,1405876378,1405876378,1,1,0
33197996@N07,1318,4,1409174665,1409174665,1,1,0
33197996@N07,1319,11,1410472954,1410472954,1,1,0
33197996@N07,1320,4,1433569084,1433585567,2,1,16483
33197996@N07,1321,6,1452066687,1452066687,1,1,0
33244915@N00,1322,4,1328924642,1328924646,2,6,4
33244915@N00,1322,3,1328928454,1328928454,1,6,0
33244915@N00,1322,5,1328914600,1328941648,6,6,27048
33244915@N00,1322,10,1328921462,1328921784,2,6,322
33244915@N00,1322,6,1328926086,1328928460,2,6,2374
33244915@N00,1322,2,1328946482,1328946500,3,6,18
33244915@N00,1323,5,1329042596,1329042662,5,4,66
33244915@N00,1323,1,1329042580,1329043160,18,4,580
33244915@N00,1323,8,1329043092,1329043128,4,4,36
33244915@N00,1323,6,1329042910,1329043078,11,4,168
33244915@N00,1324,7,1329101126,1329106276,5,5,5150
33244915@N00,1324,4,1329129378,1329129598,10,5,220
33244915@N00,1324,12,1329103180,1329129358,16,5,26178
33244915@N00,1324,8,1329097828,1329098002,3,5,174
33244915@N00,1324,6,1329129616,1329130156,28,5,540
33244915@N00,1325,9,1329211520,1329213566,91,2,2046
33244915@N00,1325,6,1329210636,1329211478,42,2,842
33257765@N05,1326,5,1333877888,1333878025,3,1,137
33277678@N03,1327,13,1393235328,1393235944,3,7,616
33277678@N03,1327,10,1393240081,1393250114,23,7,10033
33277678@N03,1327,1,1393230553,1393230553,1,7,0
33277678@N03,1327,8,1393237039,1393259638,17,7,22599
33277678@N03,1327,4,1393241526,1393241558,2,7,32
33277678@N03,1327,9,1393259670,1393261046,2,7,1376
33277678@N03,1327,6,1393250248,1393250450,3,7,202
33277678@N03,1328,9,1393308214,1393308214,1,1,0
33312419@N07,1329,8,1354072400,1354072400,1,1,0
33312419@N07,1330,12,1458437028,1458437028,1,1,0
33352249@N03,1331,2,1331679694,1331679694,1,1,0
33360568@N05,1332,13,1389141658,1389141776,2,4,118
33360568@N05,1332,1,1389138856,1389170517,4,4,31661
33360568@N05,1332,10,1389139406,1389139406,1,4,0
33360568@N05,1332,5,1389153336,1389153381,5,4,45
33386366@N06,1333,8,1237524315,1237524315,1,1,0
33404394@N00,1334,5,1435399085,1435399085,1,1,0
33441892@N00,1335,10,1380844029,1380883025,6,11,38996
33441892@N00,1335,13,1380847604,1380870840,25,11,23236
33441892@N00,1335,7,1380844977,1380846058,4,11,1081
33441892@N00,1335,2,1380874369,1380881185,12,11,6816
33441892@N00,1335,1,1380844655,1380878334,6,11,33679
33441892@N00,1335,12,1380845151,1380849422,23,11,4271
33441892@N00,1335,4,1380854464,1380860708,15,11,6244
33441892@N00,1335,6,1380856656,1380859175,3,11,2519
33441892@N00,1335,9,1380886348,1380886528,6,11,180
33441892@N00,1335,8,1380879601,1380879608,2,11,7
33441892@N00,1335,3,1380855112,1380855116,2,11,4
33484476@N00,1336,10,1192727433,1192727504,12,1,71
33494202@N04,1337,11,1252558483,1252559026,4,10,543
33494202@N04,1337,6,1252551857,1252551857,1,10,0
33494202@N04,1337,12,1252539744,1252540525,3,10,781
33494202@N04,1337,10,1252534656,1252548654,4,10,13998
33494202@N04,1337,7,1252537334,1252537334,1,10,0
33494202@N04,1337,2,1252535969,1252536297,3,10,328
33494202@N04,1337,3,1252551828,1252551828,1,10,0
33494202@N04,1337,5,1252549598,1252579021,2,10,29423
33494202@N04,1337,1,1252556072,1252556332,3,10,260
33494202@N04,1337,9,1252575407,1252576480,6,10,1073
33507016@N05,1338,1,1385475436,1385475436,1,1,0
33507605@N03,1339,8,1250140918,1250152818,12,1,11900
33507605@N03,1340,8,1250227014,1250237222,24,1,10208
33507605@N03,1341,8,1250441850,1250443076,6,1,1226
33546659@N08,1342,7,1323480142,1323480142,1,4,0
33546659@N08,1342,11,1323491320,1323522332,3,4,31012
33546659@N08,1342,12,1323495784,1323495784,1,4,0
33546659@N08,1342,2,1323495771,1323525102,5,4,29331
33546659@N08,1343,7,1323667953,1323668284,2,2,331
33546659@N08,1343,8,1323667771,1323668019,2,2,248
33557908@N02,1344,5,1333274107,1333274107,1,1,0
33563310@N06,1345,5,1349421576,1349421576,1,2,0
33563310@N06,1345,1,1349415819,1349420772,2,2,4953
33563310@N06,1346,4,1357090917,1357090917,1,3,0
33563310@N06,1346,8,1357085164,1357085200,3,3,36
33563310@N06,1346,6,1357086782,1357090405,2,3,3623
33572008@N03,1347,13,1420013227,1420013357,3,4,130
33572008@N03,1347,1,1420018892,1420023792,9,4,4900
33572008@N03,1347,8,1420016607,1420017215,4,4,608
33572008@N03,1347,2,1420016460,1420016460,1,4,0
33598193@N03,1348,6,1355637763,1355645838,3,2,8075
33598193@N03,1348,8,1355629825,1355633802,2,2,3977
33598193@N03,1349,6,1385284763,1385284763,1,1,0
33598193@N03,1350,6,1385445443,1385445443,1,1,0
33598193@N03,1351,12,1393623811,1393623811,1,2,0
33598193@N03,1351,7,1393624173,1393624173,1,2,0
33598193@N03,1352,9,1401604097,1401604899,2,1,802
33598193@N03,1353,5,1402882591,1402882591,1,1,0
33598193@N03,1354,6,1416041198,1416041695,2,1,497
33623158@N04,1355,8,1238401887,1238401887,1,1,0
33667899@N07,1356,11,1318389385,1318389385,2,3,0
33667899@N07,1356,5,1318390912,1318390954,2,3,42
33667899@N07,1356,1,1318369984,1318393674,9,3,23690
33667899@N07,1357,5,1318829678,1318829686,2,1,8
33667899@N07,1358,13,1349840478,1349840478,1,3,0
33667899@N07,1358,5,1349844596,1349844602,2,3,6
33667899@N07,1358,4,1349826616,1349826616,1,3,0
33667899@N07,1359,2,1381978638,1381978638,1,3,0
33667899@N07,1359,4,1381981594,1381984593,2,3,2999
33667899@N07,1359,10,1381960252,1381990354,3,3,30102
33667899@N07,1360,9,1382137603,1382137603,1,1,0
33680092@N03,1361,6,1451202267,1451203014,3,1,747
33680092@N03,1362,6,1455093917,1455093917,1,1,0
33704098@N00,1363,2,1389406954,1389413194,4,8,6240
33704098@N00,1363,9,1389428706,1389428718,2,8,12
33704098@N00,1363,5,1389420406,1389423344,5,8,2938
33704098@N00,1363,6,1389410222,1389413012,7,8,2790
33704098@N00,1363,4,1389408963,1389412531,13,8,3568
33704098@N00,1363,8,1389406204,1389408272,6,8,2068
33704098@N00,1363,10,1389401638,1389401778,2,8,140
33704098@N00,1363,13,1389402744,1389405542,8,8,2798
33754377@N03,1364,1,1423098856,1423098856,1,1,0
33786609@N02,1365,13,1437264290,1437264290,1,1,0
33812931@N04,1366,11,1390193326,1390193326,1,1,0
33822743@N08,1367,8,1229192074,1229192074,1,2,0
33822743@N08,1367,1,1229191707,1229191857,3,2,150
33822743@N08,1368,6,1230192415,1230192570,10,2,155
33822743@N08,1368,1,1230191067,1230191257,4,2,190
33822743@N08,1369,2,1240157195,1240157502,11,2,307
33822743@N08,1369,1,1240150058,1240152090,6,2,2032
33822743@N08,1370,6,1273196029,1273199500,2,1,3471
33824882@N07,1371,6,1398210914,1398211162,3,1,248
33897253@N07,1372,5,1232849221,1232849221,1,1,0
33929547@N03,1373,9,1430738267,1430739007,12,2,740
33929547@N03,1373,1,1430730904,1430730904,1,2,0
33934966@N00,1374,8,1290481623,1290481623,1,3,0
33934966@N00,1374,5,1290482152,1290483003,10,3,851
33934966@N00,1374,6,1290491094,1290492453,2,3,1359
33934966@N00,1375,9,1291038562,1291040524,18,3,1962
33934966@N00,1375,8,1291042849,1291042908,3,3,59
33934966@N00,1375,6,1291041625,1291042362,11,3,737
33934966@N00,1376,1,1320325153,1320326154,5,3,1001
33934966@N00,1376,8,1320325038,1320326313,2,3,1275
33934966@N00,1376,5,1320328037,1320328071,2,3,34
33934966@N00,1377,4,1320557453,1320578716,5,1,21263
33971415@N07,1378,4,1254572014,1254572014,1,1,0
34008756@N07,1379,1,1268695748,1268695748,1,1,0
34041523@N06,1380,4,1355982437,1355982760,4,2,323
34041523@N06,1380,6,1355987196,1355987341,4,2,145
34127338@N04,1381,11,1446014847,1446014857,4,8,10
34127338@N04,1381,6,1445990731,1446017667,3,8,26936
34127338@N04,1381,13,1446001376,1446001376,1,8,0
34127338@N04,1381,1,1446019114,1446019115,2,8,1
34127338@N04,1381,7,1446014458,1446014458,1,8,0
34127338@N04,1381,4,1445999869,1446011543,3,8,11674
34127338@N04,1381,2,1446017369,1446017369,1,8,0
34127338@N04,1381,8,1446014387,1446019066,2,8,4679
34127338@N04,1382,6,1446172584,1446172662,2,2,78
34127338@N04,1382,2,1446177440,1446177440,1,2,0
34153311@N05,1383,6,1292830201,1292831142,5,1,941
34153311@N05,1384,6,1318999056,1318999559,2,4,503
34153311@N05,1384,10,1318997620,1318997620,1,4,0
34153311@N05,1384,1,1319001342,1319010967,6,4,9625
34153311@N05,1384,9,1319009835,1319011062,3,4,1227
34153311@N05,1385,8,1361151197,1361151197,1,4,0
34153311@N05,1385,2,1361146253,1361146253,1,4,0
34153311@N05,1385,6,1361147635,1361147665,3,4,30
34153311@N05,1385,4,1361139436,1361153342,3,4,13906
34153311@N05,1386,2,1408656991,1408658876,5,2,1885
34153311@N05,1386,4,1408658428,1408661232,4,2,2804
34153311@N05,1387,6,1408757759,1408758201,13,2,442
34153311@N05,1387,5,1408750991,1408750991,1,2,0
34153311@N05,1388,2,1409222620,1409222630,4,1,10
34176066@N00,1389,9,1319531384,1319531390,2,1,6
34176066@N00,1390,12,1319684518,1319684569,2,3,51
34176066@N00,1390,10,1319673429,1319676139,13,3,2710
34176066@N00,1390,1,1319688185,1319689008,45,3,823
34239398@N00,1391,6,1197188577,1197188781,3,1,204
34239398@N00,1392,7,1197243898,1197244011,2,2,113
34239398@N00,1392,1,1197243690,1197243841,3,2,151
34361916@N00,1393,5,1339717601,1339752398,2,2,34797
34361916@N00,1393,4,1339727422,1339748378,2,2,20956
34390084@N07,1394,8,1231521274,1231528607,2,2,7333
34390084@N07,1394,7,1231527917,1231527917,1,2,0
34390084@N07,1395,8,1233233918,1233233918,1,1,0
34390084@N07,1396,1,1234408182,1234408585,4,1,403
34390084@N07,1397,1,1234478571,1234478571,1,1,0
34390084@N07,1398,8,1235774211,1235807401,9,4,33190
34390084@N07,1398,5,1235784632,1235785156,3,4,524
34390084@N07,1398,12,1235773628,1235773628,1,4,0
34390084@N07,1398,7,1235773975,1235773975,1,4,0
34390084@N07,1399,8,1238796831,1238796831,1,2,0
34390084@N07,1399,11,1238796512,1238796512,1,2,0
34390084@N07,1400,1,1241168236,1241169220,4,3,984
34390084@N07,1400,8,1241167071,1241167924,2,3,853
34390084@N07,1400,6,1241161888,1241161888,1,3,0
34390084@N07,1401,7,1256390797,1256390797,1,3,0
34390084@N07,1401,13,1256392597,1256392597,1,3,0
34390084@N07,1401,8,1256390895,1256391128,2,3,233
34390084@N07,1402,6,1258619828,1258624891,12,1,5063
34390084@N07,1403,6,1260615371,1260616487,7,1,1116
34482114@N07,1404,5,1398668448,1398668448,1,1,0
34522551@N02,1405,7,1340860047,1340876536,12,1,16489
34544450@N05,1406,5,1360111062,1360112429,2,3,1367
34544450@N05,1406,13,1360123084,1360123084,1,3,0
34544450@N05,1406,12,1360126645,1360126652,3,3,7
34544916@N07,1407,8,1355620378,1355620378,1,1,0
34612686@N08,1408,5,1427183668,1427185043,3,1,1375
34695087@N00,1409,10,1203539195,1203539195,1,1,0
34695134@N00,1410,9,1197885753,1197886975,7,1,1222
34703628@N00,1411,3,1300177528,1300177528,1,4,0
34703628@N00,1411,7,1300156679,1300156679,1,4,0
34703628@N00,1411,8,1300163656,1300163656,1,4,0
34703628@N00,1411,6,1300177270,1300177270,1,4,0
34727974@N05,1412,12,1291607749,1291607807,2,2,58
34727974@N05,1412,1,1291604460,1291604460,1,2,0
34783369@N05,1413,8,1340446956,1340449060,5,1,2104
34848373@N03,1414,4,1230329589,1230329589,1,1,0
34945596@N06,1415,12,1220191200,1220191200,3,1,0
35034348373@N01,1416,6,1364178052,1364178052,1,2,0
35034348373@N01,1416,4,1364194309,1364194309,1,2,0
35034363370@N01,1417,13,1414886582,1414890144,10,11,3562
35034363370@N01,1417,2,1414902551,1414902968,2,11,417
35034363370@N01,1417,10,1414878579,1414878623,2,11,44
35034363370@N01,1417,12,1414879632,1414880390,11,11,758
35034363370@N01,1417,8,1414879297,1414909102,8,11,29805
35034363370@N01,1417,7,1414879602,1414879602,1,11,0
35034363370@N01,1417,1,1414917110,1414921704,3,11,4594
35034363370@N01,1417,9,1414918033,1414920521,13,11,2488
35034363370@N01,1417,4,1414898289,1414898289,1,11,0
35034363370@N01,1417,6,1414884172,1414912314,9,11,28142
35034363370@N01,1417,3,1414898521,1414898592,2,11,71
35034364890@N01,1418,10,1194477407,1194502955,4,8,25548
35034364890@N01,1418,1,1194516766,1194520525,3,8,3759
35034364890@N01,1418,9,1194513604,1194515833,5,8,2229
35034364890@N01,1418,4,1194482218,1194482218,1,8,0
35034364890@N01,1418,6,1194483371,1194494609,7,8,11238
35034364890@N01,1418,5,1194495946,1194501202,3,8,5256
35034364890@N01,1418,8,1194478177,1194482510,3,8,4333
35034364890@N01,1418,2,1194490949,1194490949,1,8,0
35041397@N00,1419,10,1287099237,1287100315,5,7,1078
35041397@N00,1419,13,1287103824,1287105413,5,7,1589
35041397@N00,1419,8,1287102410,1287102410,1,7,0
35041397@N00,1419,5,1287096527,1287097781,2,7,1254
35041397@N00,1419,6,1287105778,1287108013,3,7,2235
35041397@N00,1419,1,1287095999,1287098329,2,7,2330
35041397@N00,1419,2,1287115911,1287115911,1,7,0
35082889@N05,1420,5,1415245384,1415245384,1,1,0
35155400@N03,1421,7,1403330456,1403330456,1,1,0
35155400@N03,1422,7,1410085049,1410085049,2,1,0
35155400@N03,1423,8,1425698983,1425698983,1,2,0
35155400@N03,1423,1,1425698984,1425698984,1,2,0
35155400@N03,1424,7,1425779763,1425779763,1,1,0
35167741@N05,1425,2,1461642068,1461642068,1,2,0
35167741@N05,1425,1,1461596810,1461645119,103,2,48309
35170449@N06,1426,8,1234420411,1234439481,80,1,19070
35209467@N02,1427,1,1295737996,1295737996,1,1,0
35237092727@N01,1428,5,1344512994,1344512994,1,1,0
35261894@N00,1429,2,1404211299,1404213650,10,5,2351
35261894@N00,1429,1,1404201825,1404201830,3,5,5
35261894@N00,1429,6,1404205105,1404210849,5,5,5744
35261894@N00,1429,4,1404204331,1404207672,6,5,3341
35261894@N00,1429,13,1404199781,1404207522,7,5,7741
35356940@N00,1430,5,1368829337,1368829337,1,4,0
35356940@N00,1430,6,1368839070,1368839070,1,4,0
35356940@N00,1430,4,1368840848,1368840848,1,4,0
35356940@N00,1430,12,1368859709,1368860824,10,4,1115
35378947@N07,1431,4,1205175844,1205175844,1,2,0
35378947@N07,1431,8,1205168481,1205177869,25,2,9388
35378947@N07,1432,8,1205412828,1205414604,3,1,1776
35378947@N07,1433,8,1233976761,1233985062,12,1,8301
35378947@N07,1434,8,1234149222,1234159429,31,1,10207
35378947@N07,1435,2,1259885915,1259902519,9,2,16604
35378947@N07,1435,8,1259877709,1259906064,38,2,28355
35378947@N07,1436,6,1260095210,1260096659,29,4,1449
35378947@N07,1436,4,1260093654,1260093654,1,4,0
35378947@N07,1436,5,1260098178,1260098178,1,4,0
35378947@N07,1436,8,1260092358,1260093293,2,4,935
35378947@N07,1437,12,1281690093,1281690253,8,2,160
35378947@N07,1437,8,1281685245,1281685245,1,2,0
35378947@N07,1438,12,1281743654,1281744171,2,5,517
35378947@N07,1438,2,1281744664,1281744838,6,5,174
35378947@N07,1438,6,1281745583,1281745598,2,5,15
35378947@N07,1438,7,1281743689,1281744133,2,5,444
35378947@N07,1438,8,1281745693,1281745693,1,5,0
35378947@N07,1439,2,1284515353,1284515353,1,3,0
35378947@N07,1439,5,1284513560,1284513575,2,3,15
35378947@N07,1439,1,1284509648,1284510889,4,3,1241
35378947@N07,1440,1,1285135993,1285135993,1,2,0
35378947@N07,1440,12,1285136005,1285136005,1,2,0
35378947@N07,1441,10,1305077775,1305078891,3,6,1116
35378947@N07,1441,8,1305074848,1305074848,1,6,0
35378947@N07,1441,7,1305075233,1305097955,6,6,22722
35378947@N07,1441,2,1305087097,1305087097,1,6,0
35378947@N07,1441,12,1305080751,1305097845,4,6,17094
35378947@N07,1441,6,1305074508,1305074508,1,6,0
35378947@N07,1442,5,1305337131,1305337131,1,1,0
35378947@N07,1443,8,1305545369,1305545369,1,5,0
35378947@N07,1443,1,1305524346,1305524937,9,5,591
35378947@N07,1443,7,1305520461,1305520540,2,5,79
35378947@N07,1443,2,1305519751,1305530751,2,5,11000
35378947@N07,1443,12,1305520093,1305553427,11,5,33334
35378947@N07,1444,1,1305767782,1305773372,3,2,5590
35378947@N07,1444,13,1305767664,1305770326,2,2,2662
35378947@N07,1445,8,1328405757,1328415520,24,1,9763
35378947@N07,1446,8,1328575780,1328578123,12,1,2343
35378947@N07,1447,8,1411685276,1411697932,2,1,12656
35380796@N03,1448,10,1230728400,1230728400,1,3,0
35380796@N03,1448,7,1230728400,1230728400,1,3,0
35380796@N03,1448,11,1230728400,1230728400,1,3,0
35380796@N03,1449,5,1292372317,1292398086,4,4,25769
35380796@N03,1449,7,1292399693,1292399693,1,4,0
35380796@N03,1449,6,1292375440,1292403945,17,4,28505
35380796@N03,1449,8,1292369553,1292374844,4,4,5291
35380796@N03,1450,1,1318644306,1318644324,2,5,18
35380796@N03,1450,11,1318627816,1318629218,6,5,1402
35380796@N03,1450,4,1318631625,1318640991,3,5,9366
35380796@N03,1450,6,1318632953,1318633205,6,5,252
35380796@N03,1450,8,1318638535,1318647373,8,5,8838
35380796@N03,1451,4,1318750689,1318750689,1,3,0
35380796@N03,1451,5,1318753531,1318755553,5,3,2022
35380796@N03,1451,6,1318751800,1318751928,2,3,128
35473328@N00,1452,1,1272155097,1272155097,1,2,0
35473328@N00,1452,8,1272159860,1272159860,1,2,0
35498711@N04,1453,1,1346217456,1346227310,3,3,9854
35498711@N04,1453,13,1346204146,1346204146,1,3,0
35498711@N04,1453,8,1346189463,1346189463,1,3,0
35498711@N04,1454,6,1346562462,1346565791,2,1,3329
35570988@N08,1455,2,1344548547,1344548547,1,1,0
35602564@N00,1456,8,1299196341,1299224608,86,1,28267
35617346@N02,1457,5,1375508464,1375508464,1,1,0
35617346@N02,1458,5,1404134991,1404134991,1,1,0
35657441@N02,1459,8,1418528121,1418528121,1,2,0
35657441@N02,1459,9,1418546799,1418546799,1,2,0
35736481@N00,1460,10,1258605708,1258619367,3,1,13659
35736481@N00,1461,10,1258670876,1258670876,1,1,0
35736481@N00,1462,4,1296366436,1296366436,1,6,0
35736481@N00,1462,12,1296352070,1296354789,7,6,2719
35736481@N00,1462,1,1296350716,1296374209,5,6,23493
35736481@N00,1462,5,1296375672,1296375672,1,6,0
35736481@N00,1462,6,1296358568,1296361012,6,6,2444
35736481@N00,1462,10,1296350385,1296350385,1,6,0
35736481@N00,1463,5,1335755597,1335756912,3,1,1315
35758162@N00,1464,1,1194768169,1194768169,1,2,0
35758162@N00,1464,12,1194768104,1194768104,1,2,0
35816811@N04,1465,6,1379899659,1379899659,1,1,0
35816811@N04,1466,6,1388909212,1388909212,1,1,0
35850424@N05,1467,5,1278811613,1278811613,1,1,0
35853462@N00,1468,4,1283828758,1283836613,4,4,7855
35853462@N00,1468,6,1283825907,1283825919,3,4,12
35853462@N00,1468,2,1283822884,1283823320,2,4,436
35853462@N00,1468,12,1283840701,1283841048,4,4,347
35853462@N00,1469,1,1284020927,1284020927,1,1,0
35853462@N00,1470,1,1284089635,1284089635,1,1,0
35853462@N00,1471,5,1388964300,1388970572,3,2,6272
35853462@N00,1471,4,1388967112,1388968611,4,2,1499
35853462@N00,1472,5,1389251320,1389251347,4,4,27
35853462@N00,1472,12,1389236628,1389238955,2,4,2327
35853462@N00,1472,1,1389228893,1389248229,3,4,19336
35853462@N00,1472,9,1389252615,1389254498,11,4,1883
35872939@N00,1473,6,1233713500,1233723277,3,4,9777
35872939@N00,1473,7,1233702222,1233719334,5,4,17112
35872939@N00,1473,8,1233717602,1233718346,8,4,744
35872939@N00,1473,4,1233698770,1233698770,1,4,0
35872939@N00,1474,7,1233879353,1233880930,5,6,1577
35872939@N00,1474,8,1233902439,1233902439,1,6,0
35872939@N00,1474,12,1233895562,1233899396,6,6,3834
35872939@N00,1474,10,1233883473,1233884481,4,6,1008
35872939@N00,1474,11,1233891348,1233894764,3,6,3416
35872939@N00,1474,1,1233877747,1233907740,2,6,29993
35872939@N00,1475,3,1267335195,1267335195,1,7,0
35872939@N00,1475,6,1267327399,1267327399,1,7,0
35872939@N00,1475,7,1267319510,1267326210,5,7,6700
35872939@N00,1475,8,1267314203,1267347282,19,7,33079
35872939@N00,1475,12,1267320524,1267320524,1,7,0
35872939@N00,1475,11,1267347662,1267347662,1,7,0
35872939@N00,1475,9,1267344644,1267346210,9,7,1566
35888901@N00,1476,8,1325062189,1325062189,1,3,0
35888901@N00,1476,1,1325068779,1325068779,1,3,0
35888901@N00,1476,5,1325072444,1325072444,1,3,0
35897523@N04,1477,5,1283998083,1283998083,1,1,0
35909485@N03,1478,1,1217719880,1217732949,3,1,13069
35928519@N00,1479,6,1322971706,1322971706,1,1,0
35928519@N00,1480,6,1323134664,1323134664,1,2,0
35928519@N00,1480,4,1323126283,1323126283,1,2,0
35928519@N00,1481,5,1323383431,1323383431,1,2,0
35928519@N00,1481,12,1323381367,1323381367,1,2,0
35928519@N00,1482,6,1386024788,1386024788,1,1,0
35928519@N00,1483,12,1386287764,1386287764,1,2,0
35928519@N00,1483,5,1386290400,1386290400,1,2,0
36101699447@N01,1484,6,1357087178,1357094531,2,1,7353
36101699447@N01,1485,5,1357127014,1357127014,1,1,0
36101699901@N01,1486,1,1224926658,1224926658,1,1,0
36101699901@N01,1487,1,1260930786,1260930786,1,1,0
36226805@N03,1488,8,1222402820,1222402820,1,3,0
36226805@N03,1488,1,1222390592,1222390592,1,3,0
36226805@N03,1488,7,1222412884,1222412884,1,3,0
36226805@N03,1489,1,1238853210,1238853210,1,1,0
36226805@N03,1490,1,1240751967,1240751967,1,1,0
36226805@N03,1491,5,1246373131,1246373131,1,1,0
36226805@N03,1492,12,1253685077,1253685077,1,5,0
36226805@N03,1492,5,1253681440,1253681440,1,5,0
36226805@N03,1492,11,1253684754,1253685375,2,5,621
36226805@N03,1492,2,1253679812,1253679812,1,5,0
36226805@N03,1492,7,1253685338,1253685338,1,5,0
36226805@N03,1493,5,1284962366,1284962555,2,1,189
36226805@N03,1494,12,1316498263,1316498263,1,7,0
36226805@N03,1494,5,1316503681,1316507655,11,7,3974
36226805@N03,1494,1,1316499813,1316506564,4,7,6751
36226805@N03,1494,7,1316499006,1316499864,9,7,858
36226805@N03,1494,10,1316503559,1316506587,7,7,3028
36226805@N03,1494,3,1316502460,1316502659,2,7,199
36226805@N03,1494,2,1316490419,1316500425,5,7,10006
36226805@N03,1495,13,1347523894,1347523894,1,9,0
36226805@N03,1495,12,1347506045,1347523776,4,9,17731
36226805@N03,1495,5,1347514898,1347523385,10,9,8487
36226805@N03,1495,11,1347507485,1347521574,2,9,14089
36226805@N03,1495,1,1347506598,1347523805,3,9,17207
36226805@N03,1495,8,1347506557,1347506557,1,9,0
36226805@N03,1495,7,1347506854,1347507652,2,9,798
36226805@N03,1495,10,1347513353,1347515748,2,9,2395
36226805@N03,1495,2,1347517512,1347522950,8,9,5438
36226805@N03,1496,2,1378966616,1378967161,4,1,545
36258343@N03,1497,9,1361172756,1361172756,1,1,0
36335057@N00,1498,13,1392940443,1392940443,1,1,0
36399194@N03,1499,10,1389333988,1389333988,1,1,0
36450627@N08,1500,1,1243405088,1243405088,1,1,0
36521978259@N01,1501,5,1304324483,1304324483,1,1,0
36606366@N00,1502,4,1380011488,1380011488,1,5,0
36606366@N00,1502,8,1379998766,1379998766,1,5,0
36606366@N00,1502,1,1380013969,1380013969,1,5,0
36606366@N00,1502,6,1380010909,1380010909,1,5,0
36606366@N00,1502,5,1380006134,1380006134,1,5,0
36606366@N00,1503,8,1380099063,1380099063,1,4,0
36606366@N00,1503,1,1380084421,1380084421,1,4,0
36606366@N00,1503,11,1380069860,1380069860,1,4,0
36606366@N00,1503,7,1380080874,1380080874,1,4,0
36606366@N00,1504,5,1380315019,1380315019,1,1,0
36607954@N05,1505,1,1246965982,1246965982,1,3,0
36607954@N05,1505,5,1246966882,1246967358,3,3,476
36607954@N05,1505,8,1246970520,1246970520,1,3,0
36671802@N04,1506,8,1364257024,1364284136,50,1,27112
36671802@N04,1507,8,1425790620,1425799038,9,1,8418
36694655@N08,1508,2,1402275669,1402275669,1,2,0
36694655@N08,1508,8,1402271776,1402282820,3,2,11044
36702908@N05,1509,8,1422157679,1422157679,1,5,0
36702908@N05,1509,2,1422157035,1422157645,3,5,610
36702908@N05,1509,10,1422174247,1422174247,1,5,0
36702908@N05,1509,6,1422152592,1422168506,16,5,15914
36702908@N05,1509,9,1422179729,1422179732,2,5,3
36702908@N05,1510,1,1422236546,1422236546,1,2,0
36702908@N05,1510,5,1422248968,1422249607,5,2,639
36735086@N07,1511,4,1252204318,1252204318,1,2,0
36735086@N07,1511,6,1252199973,1252199973,1,2,0
36801190@N00,1512,6,1357257212,1357257212,1,2,0
36801190@N00,1512,5,1357257078,1357257078,1,2,0
36895960@N00,1513,5,1423110607,1423110607,1,1,0
36911028@N00,1514,8,1332138001,1332138001,1,2,0
36911028@N00,1514,4,1332141661,1332141661,1,2,0
36911028@N00,1515,5,1332453587,1332453587,1,1,0
36916766@N08,1516,11,1261464182,1261464182,1,4,0
36916766@N08,1516,6,1261467110,1261467738,2,4,628
36916766@N08,1516,2,1261445946,1261445946,1,4,0
36916766@N08,1516,8,1261464667,1261464667,1,4,0
36916766@N08,1517,6,1275879497,1275879497,1,2,0
36916766@N08,1517,1,1275903633,1275903633,1,2,0
36916766@N08,1518,4,1276329230,1276329230,1,3,0
36916766@N08,1518,6,1276329240,1276329240,1,3,0
36916766@N08,1518,2,1276329265,1276329284,3,3,19
37046031@N00,1519,8,1225876032,1225876032,1,3,0
37046031@N00,1519,5,1225870693,1225870693,1,3,0
37046031@N00,1519,4,1225870173,1225870173,1,3,0
37046031@N00,1520,5,1226149200,1226149200,1,1,0
37046031@N00,1521,5,1226196927,1226196927,1,1,0
37046031@N00,1522,3,1226358429,1226359172,3,2,743
37046031@N00,1522,8,1226360300,1226360300,1,2,0
37046031@N00,1523,4,1226667600,1226667600,1,1,0
37088822@N00,1524,5,1237085732,1237086108,9,4,376
37088822@N00,1524,4,1237088733,1237089026,15,4,293
37088822@N00,1524,13,1237090785,1237091440,32,4,655
37088822@N00,1524,2,1237101162,1237101344,17,4,182
37088822@N00,1525,1,1237425807,1237426552,16,2,745
37088822@N00,1525,2,1237417269,1237418134,18,2,865
37097738@N02,1526,6,1450059427,1450059427,1,6,0
37097738@N02,1526,5,1450050279,1450050279,1,6,0
37097738@N02,1526,1,1450049893,1450050192,2,6,299
37097738@N02,1526,4,1450042897,1450055321,8,6,12424
37097738@N02,1526,13,1450059900,1450064194,48,6,4294
37097738@N02,1526,8,1450041653,1450049788,16,6,8135
37159320@N00,1527,2,1274494394,1274507127,4,2,12733
37159320@N00,1527,10,1274508275,1274508275,1,2,0
37159320@N00,1528,2,1274573032,1274577317,5,2,4285
37159320@N00,1528,10,1274572286,1274572305,2,2,19
37159320@N00,1529,2,1274693293,1274693744,2,2,451
37159320@N00,1529,6,1274696264,1274696264,1,2,0
37159320@N00,1530,8,1359958025,1359958070,2,4,45
37159320@N00,1530,5,1359949697,1359949697,1,4,0
37159320@N00,1530,6,1359952420,1359952420,1,4,0
37159320@N00,1530,4,1359953992,1359961555,2,4,7563
37159320@N00,1531,8,1379310061,1379310061,1,4,0
37159320@N00,1531,5,1379307314,1379307314,1,4,0
37159320@N00,1531,10,1379312121,1379312121,1,4,0
37159320@N00,1531,1,1379327036,1379327036,1,4,0
37186095@N08,1532,11,1306016600,1306016600,1,2,0
37186095@N08,1532,8,1306016192,1306032443,2,2,16251
37186095@N08,1533,13,1306071846,1306071846,1,1,0
37186095@N08,1534,5,1317270897,1317270897,1,5,0
37186095@N08,1534,2,1317278384,1317278384,1,5,0
37186095@N08,1534,7,1317295622,1317295622,1,5,0
37186095@N08,1534,1,1317271016,1317295697,7,5,24681
37186095@N08,1534,10,1317276162,1317277486,5,5,1324
37186095@N08,1535,5,1330567841,1330567841,1,2,0
37186095@N08,1535,8,1330579772,1330580527,3,2,755
37206648@N00,1536,5,1242860421,1242860540,2,2,119
37206648@N00,1536,8,1242882086,1242882086,1,2,0
37216383@N05,1537,5,1336208002,1336208002,1,1,0
37216383@N05,1538,8,1337422801,1337423268,3,1,467
37216383@N05,1539,6,1352877758,1352877758,1,1,0
37216383@N05,1540,5,1358903512,1358903512,1,1,0
37274056@N05,1541,8,1295578424,1295578424,1,4,0
37274056@N05,1541,4,1295578926,1295579019,2,4,93
37274056@N05,1541,2,1295580006,1295584066,11,4,4060
37274056@N05,1541,13,1295574366,1295574529,5,4,163
37276158@N05,1542,8,1305291933,1305291933,1,1,0
37287420@N08,1543,6,1357369260,1357370027,4,2,767
37287420@N08,1543,4,1357351740,1357369932,3,2,18192
37460376@N08,1544,11,1381279817,1381279817,1,1,0
37504803@N00,1545,6,1198841226,1198841881,5,1,655
37515566@N00,1546,7,1358228968,1358233343,3,1,4375
37541950@N08,1547,1,1286059856,1286059856,2,1,0
37541950@N08,1548,7,1286173131,1286173132,2,1,1
37553034@N03,1549,9,1317196673,1317196673,1,2,0
37553034@N03,1549,1,1317183825,1317192030,2,2,8205
37553034@N03,1550,5,1322785184,1322785184,1,1,0
37561427@N04,1551,12,1345365954,1345366608,3,5,654
37561427@N04,1551,7,1345346878,1345365840,5,5,18962
37561427@N04,1551,5,1345366300,1345366300,1,5,0
37561427@N04,1551,1,1345366565,1345366565,1,5,0
37561427@N04,1551,8,1345354224,1345354224,1,5,0
37572076@N08,1552,4,1329540244,1329540244,1,3,0
37572076@N08,1552,10,1329539096,1329540668,2,3,1572
37572076@N08,1552,5,1329545717,1329545717,1,3,0
37572297@N00,1553,10,1211205604,1211205604,1,9,0
37572297@N00,1553,6,1211205620,1211205625,3,9,5
37572297@N00,1553,8,1211205601,1211205619,2,9,18
37572297@N00,1553,13,1211205615,1211205633,10,9,18
37572297@N00,1553,7,1211205635,1211205635,1,9,0
37572297@N00,1553,1,1211205600,1211205616,7,9,16
37572297@N00,1553,5,1211205605,1211205640,2,9,35
37572297@N00,1553,12,1211205634,1211205634,1,9,0
37572297@N00,1553,4,1211205636,1211205639,4,9,3
37585370@N00,1554,5,1263552350,1263552350,1,2,0
37585370@N00,1554,10,1263552019,1263552019,1,2,0
37595844@N08,1555,6,1286846082,1286846082,1,3,0
37595844@N08,1555,2,1286844431,1286844960,2,3,529
37595844@N08,1555,8,1286843864,1286843864,1,3,0
37620552@N06,1556,8,1325939264,1325939264,1,1,0
37620552@N06,1557,7,1367497638,1367497638,1,1,0
37620552@N06,1558,2,1367567931,1367567931,1,1,0
37657436@N04,1559,6,1262264550,1262273716,2,3,9166
37657436@N04,1559,13,1262272375,1262272435,2,3,60
37657436@N04,1559,10,1262275408,1262275408,1,3,0
37709784@N00,1560,4,1239264951,1239264975,2,2,24
37709784@N00,1560,2,1239264940,1239264940,1,2,0
37714481@N00,1561,8,1189721954,1189737879,32,1,15925
37718677660@N01,1562,1,1290424142,1290424142,1,1,0
37729827@N05,1563,6,1337468672,1337469165,3,3,493
37729827@N05,1563,13,1337482397,1337482397,1,3,0
37729827@N05,1563,4,1337470515,1337478235,15,3,7720
37729827@N05,1564,2,1337643135,1337643365,4,3,230
37729827@N05,1564,13,1337652852,1337652862,3,3,10
37729827@N05,1564,1,1337646294,1337646294,1,3,0
37729827@N05,1565,2,1337986374,1337986374,1,1,0
37747991@N02,1566,8,1240629173,1240629181,2,5,8
37747991@N02,1566,1,1240622218,1240622218,1,5,0
37747991@N02,1566,13,1240636989,1240637446,3,5,457
37747991@N02,1566,4,1240634152,1240636354,3,5,2202
37747991@N02,1566,11,1240625634,1240625634,1,5,0
37775700@N02,1567,1,1303930684,1303930684,1,3,0
37775700@N02,1567,13,1303935007,1303935007,1,3,0
37775700@N02,1567,8,1303931369,1303931369,1,3,0
37775700@N02,1568,5,1304186556,1304186556,1,3,0
37775700@N02,1568,11,1304192316,1304192316,1,3,0
37775700@N02,1568,2,1304191621,1304191621,1,3,0
37869753@N06,1569,1,1313009986,1313044378,6,4,34392
37869753@N06,1569,2,1313017455,1313017455,1,4,0
37869753@N06,1569,8,1313032671,1313032671,1,4,0
37869753@N06,1569,5,1313011696,1313011696,1,4,0
37869753@N06,1570,11,1376516187,1376516187,1,2,0
37869753@N06,1570,4,1376523158,1376523200,2,2,42
37869753@N06,1571,7,1377039451,1377039459,2,1,8
37919954@N07,1572,8,1463752409,1463752409,1,1,0
37996603748@N01,1573,8,1418259561,1418260367,2,1,806
37996603748@N01,1574,12,1418340997,1418340997,1,2,0
37996603748@N01,1574,1,1418336873,1418346519,4,2,9646
37996654902@N01,1575,5,1355657698,1355657698,1,1,0
37996654902@N01,1576,4,1355884748,1355897413,4,2,12665
37996654902@N01,1576,13,1355897374,1355897766,2,2,392
38022350@N04,1577,1,1241851635,1241851635,1,1,0
38053290@N08,1578,8,1198132424,1198141941,74,1,9517
38053290@N08,1579,8,1275289007,1275290151,27,1,1144
38067879@N08,1580,9,1323405220,1323405220,1,2,0
38067879@N08,1580,5,1323399677,1323408072,2,2,8395
38067879@N08,1581,2,1348480915,1348481140,2,1,225
38067879@N08,1582,9,1348538166,1348538166,1,1,0
38067879@N08,1583,4,1348792201,1348792201,1,3,0
38067879@N08,1583,10,1348804024,1348804024,1,3,0
38067879@N08,1583,6,1348797569,1348797814,2,3,245
38067879@N08,1584,4,1349724932,1349724932,1,1,0
38067879@N08,1585,5,1368740497,1368752193,3,1,11696
38067879@N08,1586,2,1412045911,1412045911,1,1,0
38067879@N08,1587,6,1449296172,1449296172,1,1,0
38084526@N06,1588,5,1229556396,1229556396,1,1,0
38084526@N06,1589,6,1229592326,1229592326,1,1,0
38084526@N06,1590,5,1240480219,1240480219,1,1,0
38084526@N06,1591,1,1284886195,1284886195,1,1,0
38084526@N06,1592,4,1285366087,1285367304,2,1,1217
38084526@N06,1593,11,1315448439,1315448439,1,1,0
38088964@N00,1594,13,1330654465,1330654465,1,1,0
38088964@N00,1595,6,1330739046,1330739046,1,1,0
38090510@N06,1596,11,1246879454,1246879454,1,1,0
38102706@N05,1597,1,1256366660,1256366692,5,2,32
38102706@N05,1597,8,1256366751,1256366761,3,2,10
38102706@N05,1598,8,1258868492,1258868492,1,2,0
38102706@N05,1598,11,1258869122,1258869139,2,2,17
38102706@N05,1599,2,1262240583,1262241390,4,2,807
38102706@N05,1599,1,1262239145,1262239400,4,2,255
38102706@N05,1600,5,1263799086,1263799086,1,1,0
38102706@N05,1601,8,1264415585,1264415585,1,4,0
38102706@N05,1601,1,1264385555,1264385555,1,4,0
38102706@N05,1601,7,1264391734,1264415959,7,4,24225
38102706@N05,1601,2,1264386223,1264409177,30,4,22954
38102706@N05,1602,1,1277528560,1277529568,33,1,1008
38102706@N05,1603,6,1286937861,1286937861,1,2,0
38102706@N05,1603,10,1286936437,1286936437,1,2,0
38102706@N05,1604,13,1348542575,1348542575,1,1,0
38102706@N05,1605,6,1384153944,1384154174,2,1,230
38102706@N05,1606,12,1389145349,1389145349,1,1,0
38102706@N05,1607,5,1402567139,1402567139,1,1,0
38117199@N07,1608,8,1253687344,1253690038,3,1,2694
38145706@N05,1609,1,1384865640,1384865920,2,1,280
38145706@N05,1610,6,1384897889,1384897889,1,1,0
38153332@N00,1611,4,1372747292,1372747292,1,2,0
38153332@N00,1611,8,1372746963,1372746963,1,2,0
38155459@N05,1612,12,1400312637,1400312637,1,1,0
38189526@N02,1613,2,1240927200,1240927201,2,2,1
38189526@N02,1613,8,1240927202,1240927202,1,2,0
38194020@N00,1614,10,1220040384,1220043887,3,1,3503
38194020@N00,1615,8,1220272170,1220272202,2,2,32
38194020@N00,1615,2,1220270061,1220270826,8,2,765
38235069@N00,1616,6,1451535694,1451562564,6,7,26870
38235069@N00,1616,13,1451554836,1451555317,7,7,481
38235069@N00,1616,12,1451531789,1451531883,9,7,94
38235069@N00,1616,8,1451535004,1451535250,6,7,246
38235069@N00,1616,1,1451531284,1451546452,20,7,15168
38235069@N00,1616,10,1451539396,1451539409,3,7,13
38235069@N00,1616,5,1451537905,1451537905,1,7,0
38235069@N00,1617,6,1451617262,1451619421,27,4,2159
38235069@N00,1617,9,1451634627,1451637054,6,4,2427
38235069@N00,1617,7,1451622430,1451622430,1,4,0
38235069@N00,1617,8,1451624389,1451624389,1,4,0
38235069@N00,1618,8,1451790980,1451790980,1,1,0
38251487@N03,1619,6,1388473256,1388473256,1,1,0
38323338@N02,1620,1,1274771697,1274771697,1,1,0
38359273@N00,1621,7,1220607029,1220617428,15,1,10399
38359273@N00,1622,7,1252744999,1252756871,15,1,11872
38359273@N00,1623,7,1299295993,1299303042,50,1,7049
38359273@N00,1624,7,1306031989,1306042874,20,1,10885
38359273@N00,1625,7,1307745964,1307766824,60,1,20860
38359273@N00,1626,7,1324368483,1324370500,14,1,2017
38359273@N00,1627,7,1337568745,1337589625,38,1,20880
38359273@N00,1628,7,1339203138,1339210691,47,1,7553
38359273@N00,1629,7,1353128793,1353148055,42,1,19262
38359273@N00,1630,7,1369530018,1369567651,22,1,37633
38359273@N00,1631,7,1370731100,1370744388,37,1,13288
38359273@N00,1632,7,1385252463,1385265738,12,1,13275
38359273@N00,1633,7,1386466653,1386494784,40,1,28131
38359273@N00,1634,7,1396769968,1396772552,10,1,2584
38359273@N00,1635,7,1400364723,1400402714,40,1,37991
38359273@N00,1636,7,1400983548,1400994869,24,1,11321
38359273@N00,1637,7,1402187704,1402213989,46,1,26285
38359273@N00,1638,7,1402627807,1402636493,31,1,8686
38359273@N00,1639,7,1408400976,1408416910,23,1,15934
38359273@N00,1640,7,1417591485,1417592754,12,1,1269
38359273@N00,1641,7,1431663514,1431671531,21,1,8017
38359273@N00,1642,7,1432334987,1432343752,30,1,8765
38359273@N00,1643,7,1433476019,1433484029,18,1,8010
38359273@N00,1644,7,1434061300,1434084354,32,1,23054
38359273@N00,1645,7,1450158986,1450168242,30,1,9256
38359273@N00,1646,7,1459400571,1459402669,13,1,2098
38492497@N02,1647,7,1344841027,1344841027,1,2,0
38492497@N02,1647,1,1344837783,1344837783,1,2,0
38519746@N04,1648,4,1197011491,1197011491,1,1,0
38604142@N08,1649,2,1317769485,1317769485,1,2,0
38604142@N08,1649,8,1317789354,1317801331,4,2,11977
38642555@N06,1650,8,1238376161,1238403411,372,1,27250
38773853@N06,1651,2,1342459418,1342459418,1,1,0
38789043@N02,1652,10,1368848294,1368848294,1,2,0
38789043@N02,1652,6,1368840216,1368840216,1,2,0
38794272@N04,1653,10,1321097066,1321098003,11,1,937
38794272@N04,1654,6,1321205127,1321214589,88,1,9462
38848642@N00,1655,1,1218085341,1218085353,2,1,12
38848642@N00,1656,1,1218611411,1218611411,1,1,0
38848642@N00,1657,1,1255924313,1255935923,3,1,11610
38848642@N00,1658,6,1275731618,1275731618,1,1,0
38848642@N00,1659,6,1408674137,1408674141,2,1,4
38855106@N04,1660,5,1437887241,1437887241,1,2,0
38855106@N04,1660,4,1437883107,1437883107,1,2,0
38879474@N04,1661,4,1360309997,1360309997,1,2,0
38879474@N04,1661,13,1360309632,1360309632,1,2,0
38879474@N04,1662,8,1361396852,1361396852,1,1,0
38879474@N04,1663,10,1363125714,1363125714,1,1,0
38879474@N04,1664,13,1381953017,1381953017,1,1,0
38937312@N00,1665,10,1449892608,1449892608,1,1,0
39146060@N00,1666,13,1190678550,1190681088,4,4,2538
39146060@N00,1666,8,1190705196,1190705362,3,4,166
39146060@N00,1666,5,1190704844,1190704844,1,4,0
39146060@N00,1666,1,1190704740,1190705040,4,4,300
39146060@N00,1667,8,1190932122,1190932122,1,4,0
39146060@N00,1667,12,1190931866,1190931886,2,4,20
39146060@N00,1667,5,1190927864,1190935354,6,4,7490
39146060@N00,1667,1,1190927452,1190931994,2,4,4542
39146060@N00,1668,8,1228919303,1228919920,2,5,617
39146060@N00,1668,7,1228918482,1228918482,1,5,0
39146060@N00,1668,4,1228921069,1228921069,1,5,0
39146060@N00,1668,5,1228925477,1228925668,2,5,191
39146060@N00,1668,1,1228925540,1228925540,1,5,0
39146060@N00,1669,8,1229203611,1229204032,2,4,421
39146060@N00,1669,6,1229201485,1229201485,1,4,0
39146060@N00,1669,5,1229205679,1229205679,1,4,0
39146060@N00,1669,1,1229204217,1229204217,1,4,0
39149225@N08,1670,8,1418680470,1418697185,2,5,16715
39149225@N08,1670,12,1418689278,1418691148,3,5,1870
39149225@N08,1670,10,1418678885,1418707398,3,5,28513
39149225@N08,1670,4,1418694450,1418694498,2,5,48
39149225@N08,1670,5,1418681765,1418700121,3,5,18356
39179826@N04,1671,7,1255217677,1255217677,1,2,0
39179826@N04,1671,1,1255229670,1255229670,1,2,0
39179826@N04,1672,1,1265155143,1265155143,1,1,0
39179826@N04,1673,8,1350675221,1350675221,1,1,0
39198272@N04,1674,11,1369100794,1369100794,1,1,0
39198272@N04,1675,4,1400283850,1400283908,5,5,58
39198272@N04,1675,2,1400279878,1400279878,1,5,0
39198272@N04,1675,13,1400276555,1400276594,3,5,39
39198272@N04,1675,6,1400279998,1400280020,3,5,22
39198272@N04,1675,1,1400290497,1400291326,52,5,829
39276962@N07,1676,1,1259387346,1259396279,24,1,8933
39279716@N00,1677,1,1215783489,1215783489,1,1,0
39360988@N05,1678,2,1300400208,1300400208,1,1,0
39403274@N00,1679,5,1255779998,1255779998,1,1,0
39414936@N05,1680,8,1267137983,1267137983,1,1,0
39444366@N06,1681,11,1241266474,1241266474,1,1,0
39444366@N06,1682,11,1271060660,1271060660,1,1,0
39707801@N00,1683,4,1195353015,1195363535,5,1,10520
39747657@N08,1684,5,1362174571,1362174571,1,1,0
39784714@N03,1685,4,1422150353,1422150353,1,1,0
39864275@N02,1686,6,1417681084,1417681255,5,1,171
39893757@N00,1687,5,1314956749,1314956749,1,1,0
39909510@N07,1688,12,1232842668,1232842673,4,2,5
39909510@N07,1688,7,1232842639,1232842650,4,2,11
39925495@N00,1689,6,1327973574,1327973574,1,2,0
39925495@N00,1689,5,1327987732,1327987732,1,2,0
39925495@N00,1690,5,1356958800,1356958800,1,2,0
39925495@N00,1690,4,1356958800,1356958800,2,2,0
39926012@N04,1691,5,1313889755,1313889755,1,1,0
39939148@N00,1692,4,1306226315,1306226315,1,1,0
39953677@N06,1693,6,1348295797,1348295797,1,2,0
39953677@N06,1693,2,1348283777,1348283777,1,2,0
40021579@N00,1694,6,1375765859,1375765859,1,1,0
40041746@N00,1695,9,1381912349,1381913859,55,1,1510
40170821@N06,1696,1,1345765421,1345765421,1,2,0
40170821@N06,1696,4,1345774133,1345774133,1,2,0
40262057@N06,1697,8,1236565950,1236566157,3,4,207
40262057@N06,1697,10,1236560921,1236560921,1,4,0
40262057@N06,1697,13,1236567872,1236573492,24,4,5620
40262057@N06,1697,5,1236561439,1236564676,6,4,3237
40262057@N06,1698,8,1236992423,1236992423,2,5,0
40262057@N06,1698,2,1237004542,1237004901,8,5,359
40262057@N06,1698,7,1237005021,1237005021,1,5,0
40262057@N06,1698,5,1237000949,1237001221,9,5,272
40262057@N06,1698,12,1237005112,1237005112,1,5,0
40262057@N06,1699,6,1354864563,1354866858,6,4,2295
40262057@N06,1699,4,1354858944,1354859068,6,4,124
40262057@N06,1699,10,1354857074,1354857074,1,4,0
40262057@N06,1699,5,1354857175,1354863902,8,4,6727
40291653@N08,1700,8,1318750190,1318750190,1,1,0
40303166@N06,1701,13,1288220484,1288220484,1,1,0
40303166@N06,1702,8,1288987794,1288987794,1,7,0
40303166@N06,1702,10,1288983905,1289000488,2,7,16583
40303166@N06,1702,1,1288998201,1288998201,1,7,0
40303166@N06,1702,7,1288990963,1288999410,3,7,8447
40303166@N06,1702,4,1288987443,1288987443,1,7,0
40303166@N06,1702,12,1288995454,1288998045,3,7,2591
40303166@N06,1702,5,1288998403,1288998403,1,7,0
40303166@N06,1703,8,1289116354,1289117430,2,6,1076
40303166@N06,1703,7,1289115812,1289116153,2,6,341
40303166@N06,1703,10,1289108864,1289118255,2,6,9391
40303166@N06,1703,1,1289117681,1289117681,1,6,0
40303166@N06,1703,12,1289116013,1289116058,2,6,45
40303166@N06,1703,5,1289114425,1289115028,3,6,603
40303166@N06,1704,4,1289284537,1289284537,1,3,0
40303166@N06,1704,12,1289289106,1289289106,1,3,0
40303166@N06,1704,6,1289284559,1289286424,15,3,1865
40379233@N00,1705,8,1278135633,1278135633,1,1,0
40472186@N08,1706,11,1261540846,1261546340,2,1,5494
40563308@N02,1707,2,1250368404,1250378032,2,3,9628
40563308@N02,1707,13,1250400083,1250403546,5,3,3463
40563308@N02,1707,6,1250370765,1250370765,1,3,0
40563308@N02,1708,13,1312935286,1312935852,2,2,566
40563308@N02,1708,1,1312924745,1312924745,1,2,0
40647915@N03,1709,1,1290638109,1290638109,1,1,0
40745887@N05,1710,1,1284626191,1284626191,1,2,0
40745887@N05,1710,10,1284626264,1284626553,2,2,289
40788961@N05,1711,4,1304219892,1304220158,2,2,266
40788961@N05,1711,10,1304214228,1304214228,1,2,0
40897907@N08,1712,5,1354148346,1354148346,1,2,0
40897907@N08,1712,12,1354157141,1354157141,1,2,0
40897907@N08,1713,5,1354315804,1354315804,1,1,0
40897907@N08,1714,13,1354487106,1354487106,1,1,0
40901879@N07,1715,8,1207054805,1207054823,14,1,18
40901879@N07,1716,8,1207116756,1207116756,1,2,0
40901879@N07,1716,1,1207123945,1207123945,1,2,0
40908775@N04,1717,10,1248789626,1248789626,1,1,0
40919416@N06,1718,4,1281306445,1281342962,4,2,36517
40919416@N06,1718,10,1281334352,1281334369,2,2,17
40919416@N06,1719,5,1281788431,1281788431,1,5,0
40919416@N06,1719,4,1281777006,1281781352,27,5,4346
40919416@N06,1719,8,1281786952,1281786974,2,5,22
40919416@N06,1719,13,1281783191,1281786088,76,5,2897
40919416@N06,1719,1,1281789234,1281791290,52,5,2056
40919416@N06,1720,4,1310592645,1310595390,11,2,2745
40919416@N06,1720,5,1310597812,1310597812,1,2,0
40919416@N06,1721,4,1326587963,1326615979,3,3,28016
40919416@N06,1721,13,1326586400,1326598760,3,3,12360
40919416@N06,1721,6,1326589688,1326599288,3,3,9600
40937461@N02,1722,8,1329223493,1329239972,2,6,16479
40937461@N02,1722,4,1329224157,1329224169,2,6,12
40937461@N02,1722,5,1329228220,1329228220,1,6,0
40937461@N02,1722,1,1329259010,1329259010,1,6,0
40937461@N02,1722,11,1329223635,1329223635,1,6,0
40937461@N02,1722,6,1329224017,1329224017,1,6,0
40937461@N02,1723,8,1329627058,1329627058,1,3,0
40937461@N02,1723,9,1329639906,1329639906,1,3,0
40937461@N02,1723,6,1329630073,1329630073,1,3,0
40979501@N04,1724,8,1307333695,1307352615,6,1,18920
41117712@N05,1725,6,1361752610,1361752610,1,3,0
41117712@N05,1725,7,1361741479,1361741479,1,3,0
41117712@N05,1725,9,1361767544,1361779702,3,3,12158
41126359@N00,1726,9,1283684286,1283684305,2,1,19
41126359@N00,1727,1,1326967421,1326967421,1,1,0
41126359@N00,1728,12,1360988537,1360988537,1,1,0
41134616@N00,1729,11,1225323330,1225323330,1,8,0
41134616@N00,1729,1,1225320854,1225320854,1,8,0
41134616@N00,1729,12,1225352590,1225352645,2,8,55
41134616@N00,1729,10,1225330996,1225330996,1,8,0
41134616@N00,1729,9,1225356258,1225356258,1,8,0
41134616@N00,1729,8,1225327852,1225327852,1,8,0
41134616@N00,1729,5,1225320574,1225320574,1,8,0
41134616@N00,1729,13,1225327836,1225342413,11,8,14577
41138825@N00,1730,6,1452914792,1452914792,1,4,0
41138825@N00,1730,12,1452917778,1452917778,1,4,0
41138825@N00,1730,7,1452917697,1452917697,1,4,0
41138825@N00,1730,4,1452916749,1452916807,3,4,58
41197583@N00,1731,5,1250299933,1250299933,1,2,0
41197583@N00,1731,4,1250290600,1250290600,1,2,0
41236077@N02,1732,6,1291360329,1291360397,2,1,68
41236077@N02,1733,8,1326703458,1326703458,1,1,0
41407408@N00,1734,8,1212759003,1212759003,1,1,0
41407408@N00,1735,1,1369170136,1369170136,1,1,0
41407408@N00,1736,2,1415655585,1415655628,2,1,43
41407408@N00,1737,8,1417644248,1417644248,1,1,0
41407408@N00,1738,1,1422315816,1422315816,1,1,0
41427544@N00,1739,2,1297653087,1297653087,1,1,0
41446425@N03,1740,10,1402651230,1402651230,1,1,0
41476650@N00,1741,5,1414296027,1414296027,1,1,0
41545932@N02,1742,4,1356845266,1356846187,2,1,921
41624223@N08,1743,6,1338282716,1338282787,3,6,71
41624223@N08,1743,5,1338274163,1338274163,1,6,0
41624223@N08,1743,2,1338279993,1338280181,2,6,188
41624223@N08,1743,13,1338262490,1338262490,1,6,0
41624223@N08,1743,1,1338265475,1338269526,6,6,4051
41624223@N08,1743,10,1338255466,1338271640,2,6,16174
41644332@N07,1744,8,1263198936,1263198936,1,1,0
41661621@N00,1745,1,1240549116,1240550497,28,9,1381
41661621@N00,1745,13,1240553896,1240553896,1,9,0
41661621@N00,1745,11,1240550973,1240550973,1,9,0
41661621@N00,1745,4,1240530789,1240553793,4,9,23004
41661621@N00,1745,10,1240529070,1240529070,1,9,0
41661621@N00,1745,2,1240532913,1240552614,4,9,19701
41661621@N00,1745,7,1240547635,1240548366,14,9,731
41661621@N00,1745,12,1240535979,1240538034,27,9,2055
41661621@N00,1745,6,1240553052,1240553551,5,9,499
41661621@N00,1746,1,1392250895,1392259071,5,8,8176
41661621@N00,1746,11,1392258579,1392258625,2,8,46
41661621@N00,1746,4,1392251365,1392256640,4,8,5275
41661621@N00,1746,2,1392258529,1392258529,1,8,0
41661621@N00,1746,10,1392250684,1392250684,1,8,0
41661621@N00,1746,7,1392258685,1392258734,3,8,49
41661621@N00,1746,12,1392253861,1392255207,19,8,1346
41661621@N00,1746,8,1392256179,1392258443,6,8,2264
41662207@N05,1747,5,1393139021,1393139021,1,1,0
41662207@N05,1748,5,1405733489,1405733489,1,1,0
41693381@N00,1749,1,1292048144,1292055491,3,3,7347
41693381@N00,1749,2,1292041559,1292041559,1,3,0
41693381@N00,1749,6,1292043957,1292043957,1,3,0
41693381@N00,1750,8,1292152804,1292152804,1,2,0
41693381@N00,1750,10,1292157485,1292157485,1,2,0
41693381@N00,1751,8,1337422389,1337423858,8,1,1469
41693381@N00,1752,5,1337609368,1337609490,2,1,122
41693381@N00,1753,1,1337728072,1337728072,1,3,0
41693381@N00,1753,5,1337740720,1337740720,1,3,0
41693381@N00,1753,2,1337726673,1337726673,1,3,0
41693381@N00,1754,5,1337928554,1337928554,1,1,0
41693381@N00,1755,8,1430469487,1430471715,2,2,2228
41693381@N00,1755,1,1430470404,1430470404,1,2,0
41693381@N00,1756,8,1431680461,1431680461,1,2,0
41693381@N00,1756,1,1431687867,1431687867,1,2,0
41693381@N00,1757,13,1433069189,1433069189,1,1,0
41693381@N00,1758,13,1434187761,1434187761,1,1,0
41693381@N00,1759,8,1441960191,1441960191,1,1,0
41693381@N00,1760,6,1446969987,1446971257,2,1,1270
41693381@N00,1761,6,1447848122,1447849681,3,1,1559
41693381@N00,1762,1,1456125701,1456125701,1,3,0
41693381@N00,1762,6,1456126695,1456127735,2,3,1040
41693381@N00,1762,13,1456130310,1456130310,1,3,0
41872770@N05,1763,7,1229021175,1229021175,1,1,0
41872770@N05,1764,5,1252210202,1252210202,1,1,0
41872770@N05,1765,5,1266017040,1266017040,1,4,0
41872770@N05,1765,6,1266023643,1266030087,3,4,6444
41872770@N05,1765,1,1266017408,1266017408,1,4,0
41872770@N05,1765,2,1266023232,1266023232,1,4,0
41878212@N00,1766,3,1281750208,1281750291,2,1,83
41878212@N00,1767,6,1419407788,1419411178,2,2,3390
41878212@N00,1767,5,1419416131,1419416131,1,2,0
41894167453@N01,1768,4,1323148624,1323148849,2,1,225
41894170742@N01,1769,8,1274887158,1274888591,7,1,1433
41894185936@N01,1770,7,1381389483,1381389483,1,1,0
41967511@N00,1771,7,1275519490,1275519497,2,4,7
41967511@N00,1771,5,1275515380,1275517029,4,4,1649
41967511@N00,1771,2,1275519544,1275521182,5,4,1638
41967511@N00,1771,1,1275513515,1275513515,1,4,0
41976006@N02,1772,8,1304990251,1304990251,1,1,0
42118699@N08,1773,12,1210227243,1210227243,1,2,0
42118699@N08,1773,1,1210227403,1210227403,1,2,0
42118699@N08,1774,6,1254516048,1254516048,1,4,0
42118699@N08,1774,12,1254522603,1254522603,1,4,0
42118699@N08,1774,4,1254514229,1254514355,2,4,126
42118699@N08,1774,11,1254518724,1254518724,1,4,0
42118699@N08,1775,8,1257800947,1257800947,1,2,0
42118699@N08,1775,12,1257801918,1257802075,3,2,157
42118699@N08,1776,4,1367613062,1367613062,1,1,0
42118699@N08,1777,8,1368732202,1368732202,1,3,0
42118699@N08,1777,5,1368733613,1368733613,1,3,0
42118699@N08,1777,4,1368734565,1368738067,5,3,3502
42118699@N08,1778,8,1460599625,1460601877,4,1,2252
42151752@N05,1779,10,1448390540,1448390540,1,1,0
42320709@N06,1780,4,1453523502,1453523502,1,1,0
42327762@N03,1781,13,1258090650,1258090864,9,6,214
42327762@N03,1781,7,1258075334,1258075334,1,6,0
42327762@N03,1781,2,1258080342,1258080342,1,6,0
42327762@N03,1781,4,1258088085,1258088085,1,6,0
42327762@N03,1781,12,1258075869,1258075876,2,6,7
42327762@N03,1781,1,1258071619,1258071801,2,6,182
42327762@N03,1782,6,1286165936,1286166908,12,1,972
42340071@N05,1783,12,1349574488,1349574488,1,1,0
42363455@N02,1784,1,1252763256,1252763256,1,1,0
42398872@N03,1785,2,1325581900,1325581900,1,4,0
42398872@N03,1785,6,1325570241,1325580208,2,4,9967
42398872@N03,1785,10,1325549636,1325549636,1,4,0
42398872@N03,1785,4,1325556096,1325556096,1,4,0
42399173@N05,1786,12,1345772561,1345772561,1,4,0
42399173@N05,1786,1,1345770558,1345770610,3,4,52
42399173@N05,1786,7,1345772522,1345772522,1,4,0
42399173@N05,1786,8,1345770748,1345772493,2,4,1745
42399173@N05,1787,1,1345805489,1345805548,4,1,59
42399173@N05,1788,13,1386554548,1386554950,4,6,402
42399173@N05,1788,11,1386557291,1386557291,1,6,0
42399173@N05,1788,6,1386577047,1386577661,6,6,614
42399173@N05,1788,4,1386577790,1386577790,1,6,0
42399173@N05,1788,8,1386556361,1386556646,2,6,285
42399173@N05,1788,1,1386550052,1386556004,10,6,5952
42399173@N05,1789,1,1386739938,1386745746,24,3,5808
42399173@N05,1789,7,1386739800,1386739894,3,3,94
42399173@N05,1789,10,1386744125,1386744125,1,3,0
42416044@N04,1790,6,1291680363,1291680363,1,3,0
42416044@N04,1790,4,1291678062,1291678062,1,3,0
42416044@N04,1790,2,1291674104,1291674509,3,3,405
42419824@N03,1791,7,1383264830,1383309218,141,1,44388
42486569@N00,1792,5,1299888517,1299888649,3,2,132
42486569@N00,1792,1,1299891877,1299891877,1,2,0
42504117@N06,1793,7,1257414046,1257414046,1,1,0
42504117@N06,1794,7,1259439215,1259455198,6,1,15983
42504117@N06,1795,7,1259829890,1259829893,3,1,3
42504117@N06,1796,5,1356558973,1356558973,1,3,0
42504117@N06,1796,9,1356591438,1356591438,1,3,0
42504117@N06,1796,12,1356568465,1356587998,5,3,19533
42508926@N03,1797,12,1329172075,1329193589,25,1,21514
42533701@N00,1798,8,1215045617,1215050785,8,1,5168
42533701@N00,1799,8,1215165965,1215176998,15,1,11033
42580834@N08,1800,10,1256444697,1256467317,3,11,22620
42580834@N08,1800,2,1256439748,1256461497,2,11,21749
42580834@N08,1800,12,1256440074,1256440736,2,11,662
42580834@N08,1800,8,1256425618,1256459370,7,11,33752
42580834@N08,1800,9,1256466154,1256466186,2,11,32
42580834@N08,1800,1,1256425724,1256454041,4,11,28317
42580834@N08,1800,5,1256444686,1256448501,2,11,3815
42580834@N08,1800,13,1256432354,1256432354,1,11,0
42580834@N08,1800,11,1256459433,1256459454,2,11,21
42580834@N08,1800,4,1256428918,1256433521,8,11,4603
42580834@N08,1800,6,1256434535,1256461682,2,11,27147
42580834@N08,1801,10,1256610140,1256610140,1,5,0
42580834@N08,1801,2,1256600979,1256600979,1,5,0
42580834@N08,1801,1,1256609021,1256609021,1,5,0
42580834@N08,1801,13,1256606517,1256606561,3,5,44
42580834@N08,1801,4,1256605808,1256606377,4,5,569
42580834@N08,1802,10,1350089157,1350090039,4,2,882
42580834@N08,1802,1,1350090701,1350090701,1,2,0
42580834@N08,1803,12,1350193672,1350193672,1,3,0
42580834@N08,1803,9,1350210292,1350210589,3,3,297
42580834@N08,1803,1,1350193424,1350204744,2,3,11320
42580834@N08,1804,13,1350433842,1350433842,1,2,0
42580834@N08,1804,4,1350433617,1350433617,1,2,0
42614577@N03,1805,1,1335779280,1335779576,5,9,296
42614577@N03,1805,10,1335778774,1335778810,4,9,36
42614577@N03,1805,13,1335783838,1335785432,5,9,1594
42614577@N03,1805,7,1335781200,1335781738,4,9,538
42614577@N03,1805,6,1335778708,1335781575,3,9,2867
42614577@N03,1805,12,1335781235,1335781306,2,9,71
42614577@N03,1805,9,1335786461,1335786674,4,9,213
42614577@N03,1805,4,1335784100,1335785070,8,9,970
42614577@N03,1805,8,1335781829,1335781837,2,9,8
42688661@N06,1806,10,1442227094,1442227094,1,2,0
42688661@N06,1806,5,1442228547,1442229112,2,2,565
42688661@N06,1807,8,1442366238,1442366238,1,5,0
42688661@N06,1807,6,1442368527,1442368880,2,5,353
42688661@N06,1807,4,1442369186,1442369359,2,5,173
42688661@N06,1807,2,1442378787,1442378787,1,5,0
42688661@N06,1807,5,1442381341,1442382321,5,5,980
42688661@N06,1808,1,1442558358,1442558358,1,1,0
42730389@N03,1809,8,1427544439,1427544439,1,3,0
42730389@N03,1809,4,1427511149,1427516610,2,3,5461
42730389@N03,1809,1,1427511079,1427516605,2,3,5526
42786185@N06,1810,13,1446351768,1446351768,1,1,0
42848911@N05,1811,5,1298429969,1298429969,1,2,0
42848911@N05,1811,13,1298420460,1298420460,1,2,0
42912996@N00,1812,10,1380065221,1380065221,1,2,0
42912996@N00,1812,5,1380056663,1380056663,1,2,0
42912996@N00,1813,9,1380097027,1380097027,1,1,0
43074401@N07,1814,5,1386459588,1386459664,2,1,76
43082306@N00,1815,8,1233463828,1233463828,1,2,0
43082306@N00,1815,5,1233463164,1233463164,1,2,0
43082306@N00,1816,10,1234660975,1234660975,1,2,0
43082306@N00,1816,1,1234662534,1234667627,2,2,5093
43082306@N00,1817,8,1241158023,1241158023,1,2,0
43082306@N00,1817,1,1241142453,1241142544,2,2,91
43082306@N00,1818,10,1244875652,1244876563,2,3,911
43082306@N00,1818,11,1244867727,1244868233,2,3,506
43082306@N00,1818,13,1244871433,1244872169,2,3,736
43082306@N00,1819,8,1256961186,1256966759,3,1,5573
43082306@N00,1820,13,1266648004,1266648004,1,1,0
43082306@N00,1821,5,1273217591,1273217591,1,1,0
43082306@N00,1822,5,1282436434,1282436434,1,3,0
43082306@N00,1822,13,1282438072,1282438072,1,3,0
43082306@N00,1822,1,1282439006,1282439006,1,3,0
43082306@N00,1823,13,1295664395,1295664395,1,2,0
43082306@N00,1823,10,1295672362,1295672362,1,2,0
43082306@N00,1824,3,1305818401,1305819642,2,1,1241
43082306@N00,1825,1,1315710318,1315710318,1,1,0
43082306@N00,1826,1,1326960605,1326960605,1,1,0
43082306@N00,1827,13,1336190675,1336190675,1,2,0
43082306@N00,1827,8,1336194623,1336194623,1,2,0
43082306@N00,1828,13,1337409234,1337409234,1,2,0
43082306@N00,1828,8,1337423053,1337423053,1,2,0
43082306@N00,1829,13,1338696387,1338696387,1,2,0
43082306@N00,1829,1,1338688359,1338688359,1,2,0
43082306@N00,1830,1,1355028632,1355028632,1,1,0
43082306@N00,1831,13,1382237194,1382237194,1,1,0
43082306@N00,1832,10,1401536949,1401536949,1,1,0
43082306@N00,1833,13,1432468335,1432468335,1,1,0
43082306@N00,1834,13,1437998065,1437998065,1,1,0
43082306@N00,1835,10,1453539783,1453539783,1,1,0
43082306@N00,1836,9,1462015296,1462015296,1,1,0
43091652@N03,1837,10,1318675968,1318698984,11,1,23016
43108539@N03,1838,13,1278935700,1278935700,1,3,0
43108539@N03,1838,6,1278935194,1278935194,1,3,0
43108539@N03,1838,1,1278933474,1278933474,1,3,0
43108539@N03,1839,8,1279124240,1279124240,1,2,0
43108539@N03,1839,1,1279120240,1279128230,2,2,7990
43122711@N02,1840,1,1253875931,1253875932,2,1,1
43195725@N00,1841,7,1220892605,1220892605,1,1,0
43198257@N03,1842,6,1362788848,1362822676,255,1,33828
43244835@N00,1843,6,1354149487,1354181834,3,2,32347
43244835@N00,1843,4,1354150876,1354154167,2,2,3291
43245053@N00,1844,8,1332758091,1332758091,1,1,0
43245053@N00,1845,6,1353055156,1353056144,2,1,988
43245053@N00,1846,8,1380849717,1380849717,1,2,0
43245053@N00,1846,11,1380877154,1380877154,1,2,0
43245053@N00,1847,6,1415524919,1415525146,2,1,227
43297700@N00,1848,5,1321741679,1321741679,1,1,0
43365284@N00,1849,8,1246846180,1246868181,162,1,22001
43365284@N00,1850,8,1246989878,1247008484,4,1,18606
43391619@N06,1851,10,1269778196,1269778196,1,1,0
43391619@N06,1852,2,1278562276,1278562276,1,2,0
43391619@N06,1852,5,1278574891,1278574891,1,2,0
43391619@N06,1853,5,1290640912,1290640912,1,1,0
43391619@N06,1854,5,1306625651,1306625651,1,1,0
43535605@N00,1855,4,1360570361,1360570361,1,2,0
43535605@N00,1855,1,1360570767,1360570767,1,2,0
43545301@N03,1856,3,1331802590,1331802590,1,3,0
43545301@N03,1856,13,1331802636,1331802636,1,3,0
43545301@N03,1856,6,1331802584,1331802584,1,3,0
43549138@N00,1857,2,1201226486,1201226486,1,1,0
43606766@N00,1858,4,1434178696,1434183003,2,1,4307
43612819@N03,1859,6,1256174881,1256174881,1,1,0
43612819@N03,1860,1,1284936188,1284938741,2,1,2553
43612819@N03,1861,6,1291450492,1291450492,1,1,0
43612819@N03,1862,7,1325839943,1325839943,1,1,0
43636216@N00,1863,2,1228644571,1228644571,1,2,0
43636216@N00,1863,10,1228635711,1228635711,1,2,0
43642153@N04,1864,1,1412291730,1412291730,1,5,0
43642153@N04,1864,10,1412293862,1412302150,3,5,8288
43642153@N04,1864,9,1412294783,1412294783,1,5,0
43642153@N04,1864,8,1412292195,1412292195,1,5,0
43642153@N04,1864,12,1412296364,1412296364,1,5,0
43642153@N04,1865,9,1412331317,1412332033,4,1,716
43643415@N07,1866,5,1292895633,1292895633,1,1,0
43652558@N00,1867,4,1462706095,1462706095,1,1,0
43667163@N00,1868,8,1256623731,1256634058,4,1,10327
43700437@N06,1869,5,1363386014,1363386014,1,1,0
43700437@N06,1870,8,1373968201,1373968201,1,5,0
43700437@N06,1870,10,1373963077,1373963108,4,5,31
43700437@N06,1870,13,1373969006,1373969167,3,5,161
43700437@N06,1870,4,1373965881,1373965881,1,5,0
43700437@N06,1870,1,1373963343,1373963343,1,5,0
43700437@N06,1871,1,1383341073,1383341073,1,1,0
43700437@N06,1872,1,1418182518,1418182518,1,1,0
43700437@N06,1873,13,1440665600,1440665600,1,1,0
43730464@N07,1874,7,1341204475,1341224828,18,1,20353
43749215@N03,1875,1,1368269479,1368269479,1,1,0
43808803@N00,1876,5,1462163574,1462166742,6,4,3168
43808803@N00,1876,2,1462182417,1462182417,1,4,0
43808803@N00,1876,10,1462165489,1462165489,1,4,0
43808803@N00,1876,7,1462181270,1462181270,1,4,0
43808803@N00,1877,5,1462614926,1462614926,1,1,0
43808803@N00,1878,6,1462787069,1462787069,1,4,0
43808803@N00,1878,8,1462779898,1462780721,6,4,823
43808803@N00,1878,4,1462786508,1462788401,2,4,1893
43808803@N00,1878,12,1462789176,1462789176,1,4,0
43854580@N03,1879,4,1330661078,1330665131,22,5,4053
43854580@N03,1879,1,1330650106,1330659419,10,5,9313
43854580@N03,1879,10,1330652093,1330652099,2,5,6
43854580@N03,1879,8,1330665179,1330665567,7,5,388
43854580@N03,1879,13,1330660106,1330660695,5,5,589
43906182@N04,1880,10,1271392925,1271392995,2,1,70
43906182@N04,1881,1,1271546509,1271546509,1,1,0
43906182@N04,1882,1,1271632603,1271632603,1,1,0
43906182@N04,1883,1,1271706683,1271706683,1,1,0
43906182@N04,1884,1,1272794252,1272794252,1,1,0
43906182@N04,1885,8,1275529629,1275529629,1,1,0
44022769@N00,1886,5,1344650882,1344650882,1,1,0
44022769@N00,1887,8,1344733244,1344733244,1,2,0
44022769@N00,1887,5,1344732148,1344732148,1,2,0
44023757@N04,1888,10,1321674496,1321674692,4,2,196
44023757@N04,1888,8,1321674953,1321695270,12,2,20317
44023757@N04,1889,10,1321784862,1321784914,2,4,52
44023757@N04,1889,6,1321776643,1321782104,148,4,5461
44023757@N04,1889,1,1321784152,1321784262,3,4,110
44023757@N04,1889,8,1321782340,1321784129,10,4,1789
44031443@N04,1890,4,1442192363,1442192363,1,1,0
44031443@N04,1891,9,1442231569,1442231569,1,1,0
44033839@N05,1892,1,1288994401,1288994401,1,2,0
44033839@N05,1892,2,1288994400,1288994400,1,2,0
44082489@N00,1893,6,1230715248,1230715338,3,2,90
44082489@N00,1893,9,1230710356,1230713230,9,2,2874
44082489@N00,1894,12,1395545045,1395545045,1,3,0
44082489@N00,1894,6,1395538077,1395538180,2,3,103
44082489@N00,1894,1,1395558367,1395558367,1,3,0
44082489@N00,1895,6,1395875796,1395875796,1,1,0
44124305550@N01,1896,6,1189663523,1189664991,8,3,1468
44124305550@N01,1896,5,1189669094,1189669746,4,3,652
44124305550@N01,1896,1,1189652965,1189654924,3,3,1959
44124305550@N01,1897,5,1189829240,1189829240,1,1,0
44124341154@N01,1898,6,1353220153,1353220153,1,2,0
44124341154@N01,1898,1,1353225028,1353229905,6,2,4877
44124341154@N01,1899,13,1353390472,1353391081,2,4,609
44124341154@N01,1899,4,1353392604,1353393144,3,4,540
44124341154@N01,1899,6,1353386273,1353386273,1,4,0
44124341154@N01,1899,2,1353372605,1353375421,5,4,2816
44124341154@N01,1900,4,1353633228,1353633228,1,2,0
44124341154@N01,1900,2,1353622817,1353639310,7,2,16493
44124364198@N01,1901,6,1420760107,1420760107,1,2,0
44124364198@N01,1901,4,1420765508,1420766047,2,2,539
44124366632@N01,1902,8,1293769454,1293801066,19,3,31612
44124366632@N01,1902,5,1293786442,1293786442,1,3,0
44124366632@N01,1902,6,1293797870,1293797870,1,3,0
44124372331@N01,1903,8,1217413228,1217413228,1,1,0
44124377471@N01,1904,4,1306565272,1306565272,1,1,0
44124401501@N01,1905,2,1360454487,1360454487,1,1,0
44124401501@N01,1906,2,1360916126,1360917885,4,1,1759
44124426205@N01,1907,10,1271587747,1271587747,1,1,0
44124426205@N01,1908,6,1271639223,1271648029,2,1,8806
44124426205@N01,1909,6,1272007882,1272007882,1,1,0
44124426205@N01,1910,2,1352497626,1352497626,1,2,0
44124426205@N01,1910,4,1352501663,1352501663,1,2,0
44124426205@N01,1911,6,1352541162,1352541162,1,1,0
44124426205@N01,1912,6,1352887495,1352887495,1,1,0
44124426205@N01,1913,6,1354166457,1354166457,1,1,0
44124426205@N01,1914,6,1385971527,1385973294,4,1,1767
44124426205@N01,1915,1,1386116773,1386140337,2,1,23564
44124426205@N01,1916,12,1386242030,1386242030,1,1,0
44124426205@N01,1917,6,1386317731,1386319656,2,1,1925
44124427374@N01,1918,9,1202283727,1202283727,1,1,0
44124427374@N01,1919,6,1348718202,1348718202,1,1,0
44124427374@N01,1920,5,1348877752,1348877752,1,1,0
44124427374@N01,1921,8,1415401023,1415401023,1,4,0
44124427374@N01,1921,6,1415408650,1415408650,1,4,0
44124427374@N01,1921,5,1415407264,1415407264,1,4,0
44124427374@N01,1921,1,1415400570,1415400570,1,4,0
44124427374@N01,1922,6,1415609436,1415609507,3,1,71
44164246@N00,1923,13,1267750191,1267750191,1,1,0
44180995@N05,1924,8,1288367866,1288367866,1,1,0
44275181@N00,1925,8,1368862354,1368862354,1,1,0
44275181@N00,1926,2,1382848555,1382848555,1,1,0
44275181@N00,1927,8,1402013474,1402013474,1,1,0
44275181@N00,1928,1,1425867584,1425867584,1,1,0
44275181@N00,1929,4,1442718691,1442720433,3,2,1742
44275181@N00,1929,5,1442735445,1442735445,1,2,0
44318907@N08,1930,8,1286279199,1286305586,2,2,26387
44318907@N08,1930,5,1286276458,1286276458,1,2,0
44318907@N08,1931,13,1296695121,1296703404,3,3,8283
44318907@N08,1931,10,1296689166,1296689166,1,3,0
44318907@N08,1931,5,1296691994,1296716552,9,3,24558
44318907@N08,1932,8,1298503843,1298503843,1,1,0
44318907@N08,1933,8,1302346383,1302346383,1,1,0
44318907@N08,1934,2,1305498145,1305498145,1,1,0
44318907@N08,1935,5,1307312679,1307312679,1,1,0
44318907@N08,1936,2,1308176721,1308176721,1,1,0
44318907@N08,1937,5,1309738326,1309738326,1,1,0
44318907@N08,1938,2,1309818499,1309818499,1,1,0
44318907@N08,1939,5,1310337016,1310337016,1,1,0
44318907@N08,1940,5,1310682813,1310682813,1,1,0
44318907@N08,1941,5,1317276293,1317283302,4,3,7009
44318907@N08,1941,1,1317284608,1317284608,1,3,0
44318907@N08,1941,8,1317282292,1317283935,2,3,1643
44318907@N08,1942,6,1317429330,1317429437,2,2,107
44318907@N08,1942,5,1317419032,1317419032,1,2,0
44318907@N08,1943,9,1317623097,1317623097,1,2,0
44318907@N08,1943,5,1317624679,1317624679,1,2,0
44318907@N08,1944,5,1321998468,1321998468,1,1,0
44318907@N08,1945,10,1328940618,1328940618,1,3,0
44318907@N08,1945,5,1328922526,1328937818,3,3,15292
44318907@N08,1945,8,1328931507,1328931634,2,3,127
44318907@N08,1946,5,1329120416,1329120416,1,1,0
44318907@N08,1947,5,1329346000,1329347366,3,3,1366
44318907@N08,1947,8,1329360094,1329360421,3,3,327
44318907@N08,1947,1,1329368893,1329368893,1,3,0
44318907@N08,1948,8,1346800029,1346800029,1,1,0
44318907@N08,1949,5,1359065721,1359065721,1,1,0
44318907@N08,1950,8,1361696309,1361696309,1,4,0
44318907@N08,1950,9,1361693732,1361693732,1,4,0
44318907@N08,1950,10,1361683981,1361684329,2,4,348
44318907@N08,1950,5,1361695286,1361695714,2,4,428
44318907@N08,1951,8,1361842456,1361842456,1,1,0
44318907@N08,1952,8,1361954059,1361954059,1,3,0
44318907@N08,1952,4,1361948697,1361948697,1,3,0
44318907@N08,1952,5,1361951725,1361953152,4,3,1427
44318907@N08,1953,5,1371852569,1371852569,1,1,0
44437814@N00,1954,1,1256477056,1256477056,1,1,0
44490358@N04,1955,6,1312619536,1312619536,1,1,0
44490358@N04,1956,1,1313484334,1313484375,2,1,41
44490358@N04,1957,1,1319241736,1319241772,3,1,36
44510773@N08,1958,1,1441256924,1441256924,1,1,0
44603553@N03,1959,13,1352345331,1352345331,1,1,0
44621966@N00,1960,4,1428453728,1428456209,52,2,2481
44621966@N00,1960,1,1428478075,1428478075,1,2,0
44621966@N00,1961,2,1428824810,1428824810,1,1,0
44813763@N07,1962,2,1425351928,1425351928,1,4,0
44813763@N07,1962,4,1425358915,1425359075,3,4,160
44813763@N07,1962,12,1425352069,1425352069,1,4,0
44813763@N07,1962,6,1425362707,1425365018,2,4,2311
44816688@N00,1963,4,1371293320,1371293499,2,1,179
44816688@N00,1964,8,1371413374,1371413374,1,1,0
44816688@N00,1965,7,1374032730,1374032865,2,4,135
44816688@N00,1965,8,1374019790,1374032655,3,4,12865
44816688@N00,1965,11,1374033861,1374033861,1,4,0
44816688@N00,1965,2,1374032941,1374032941,1,4,0
44816688@N00,1966,4,1431735465,1431749684,12,1,14219
44816688@N00,1967,8,1432078261,1432078261,1,1,0
44816688@N00,1968,4,1433949822,1433949822,1,1,0
44816688@N00,1969,4,1441770195,1441770195,1,1,0
44816688@N00,1970,12,1449093099,1449115191,30,1,22092
44816688@N00,1971,4,1453315754,1453315754,1,1,0
44816688@N00,1972,4,1461980274,1461980274,1,1,0
44816688@N00,1973,4,1465851301,1465851602,2,1,301
44867875@N00,1974,1,1385681119,1385681119,1,1,0
44948268@N02,1975,13,1327971170,1327971710,4,1,540
44948268@N02,1976,13,1329994343,1329994343,1,1,0
44948268@N02,1977,8,1398830866,1398830866,1,2,0
44948268@N02,1977,7,1398837474,1398837474,1,2,0
44948268@N02,1978,13,1399511976,1399511976,1,3,0
44948268@N02,1978,6,1399521019,1399521019,1,3,0
44948268@N02,1978,2,1399530172,1399530172,1,3,0
44948268@N02,1979,2,1421377515,1421377515,1,1,0
44948268@N02,1980,8,1422430723,1422430723,1,2,0
44948268@N02,1980,4,1422428651,1422428651,1,2,0
44948268@N02,1981,1,1422760859,1422760859,1,1,0
44957651@N00,1982,10,1320656511,1320656511,1,1,0
44978333@N06,1983,2,1305500745,1305500745,1,1,0
45032460@N06,1984,11,1380778643,1380779029,9,7,386
45032460@N06,1984,8,1380762403,1380762593,2,7,190
45032460@N06,1984,10,1380753047,1380782375,15,7,29328
45032460@N06,1984,1,1380754217,1380782948,5,7,28731
45032460@N06,1984,6,1380754813,1380770708,10,7,15895
45032460@N06,1984,2,1380754451,1380777640,9,7,23189
45032460@N06,1984,13,1380785523,1380786355,4,7,832
45032460@N06,1985,12,1380934749,1380934749,1,1,0
45033503@N06,1986,1,1249842978,1249842978,1,1,0
45033503@N06,1987,11,1260844597,1260844597,1,1,0
45033503@N06,1988,13,1269392718,1269392718,1,2,0
45033503@N06,1988,1,1269391090,1269394504,3,2,3414
45033503@N06,1989,1,1285728292,1285733500,3,1,5208
45033503@N06,1990,1,1289973913,1289973913,1,2,0
45033503@N06,1990,6,1289978143,1289978143,1,2,0
45033503@N06,1991,1,1290140331,1290148459,2,1,8128
45033503@N06,1992,2,1305550191,1305550191,1,1,0
45033503@N06,1993,13,1315962079,1315962079,1,1,0
45067258@N00,1994,4,1305771699,1305771699,1,1,0
45067258@N00,1995,4,1339716479,1339716479,1,3,0
45067258@N00,1995,5,1339719593,1339719593,1,3,0
45067258@N00,1995,1,1339715331,1339723086,2,3,7755
45067258@N00,1996,3,1339842342,1339846203,5,1,3861
45067258@N00,1997,5,1355083235,1355083235,1,1,0
45067258@N00,1998,6,1355374630,1355385355,28,1,10725
45067258@N00,1999,8,1370402936,1370402936,1,3,0
45067258@N00,1999,5,1370395934,1370400199,16,3,4265
45067258@N00,1999,1,1370394729,1370404143,4,3,9414
45067258@N00,2000,6,1383894273,1383894924,4,1,651
45067258@N00,2001,1,1432328612,1432380674,17,4,52062
45067258@N00,2001,4,1432350072,1432351302,2,4,1230
45067258@N00,2001,10,1432352459,1432360078,18,4,7619
45067258@N00,2001,8,1432343933,1432381686,35,4,37753
45067258@N00,2002,1,1432457489,1432462493,18,1,5004
45067258@N00,2003,13,1432710979,1432710990,3,2,11
45067258@N00,2003,4,1432706412,1432711004,19,2,4592
45067258@N00,2004,1,1432854526,1432857526,3,6,3000
45067258@N00,2004,13,1432865565,1432865565,1,6,0
45067258@N00,2004,5,1432855545,1432855545,1,6,0
45067258@N00,2004,4,1432895489,1432898827,12,6,3338
45067258@N00,2004,10,1432860776,1432892402,25,6,31626
45067258@N00,2004,8,1432866615,1432866800,3,6,185
45072542@N00,2005,7,1317509669,1317509706,4,4,37
45072542@N00,2005,1,1317512294,1317514445,3,4,2151
45072542@N00,2005,12,1317509540,1317509664,5,4,124
45072542@N00,2005,2,1317509870,1317528392,6,4,18522
45083310@N06,2006,4,1358122990,1358122990,1,6,0
45083310@N06,2006,6,1358118037,1358118052,2,6,15
45083310@N06,2006,10,1358125237,1358125237,1,6,0
45083310@N06,2006,13,1358122931,1358124371,5,6,1440
45083310@N06,2006,3,1358143782,1358143782,1,6,0
45083310@N06,2006,8,1358136563,1358136793,5,6,230
45228416@N03,2007,1,1298621101,1298621101,1,3,0
45228416@N03,2007,11,1298623305,1298623305,1,3,0
45228416@N03,2007,8,1298622680,1298624073,3,3,1393
45411733@N00,2008,6,1270942371,1270942371,1,1,0
45444404@N04,2009,4,1426743264,1426744570,7,3,1306
45444404@N04,2009,8,1426742372,1426742515,13,3,143
45444404@N04,2009,13,1426747374,1426747374,1,3,0
45537774@N02,2010,1,1310464006,1310464006,1,1,0
45561435@N00,2011,1,1295128532,1295128532,1,3,0
45561435@N00,2011,5,1295130754,1295136038,5,3,5284
45561435@N00,2011,10,1295146347,1295146347,1,3,0
45561435@N00,2012,6,1426557385,1426586537,3,7,29152
45561435@N00,2012,1,1426563970,1426586189,5,7,22219
45561435@N00,2012,5,1426564381,1426583715,15,7,19334
45561435@N00,2012,8,1426572996,1426587568,9,7,14572
45561435@N00,2012,9,1426581152,1426591640,6,7,10488
45561435@N00,2012,10,1426583607,1426587928,2,7,4321
45561435@N00,2012,4,1426554115,1426574775,6,7,20660
45571875@N06,2013,8,1265532936,1265533336,3,1,400
45571875@N06,2014,1,1282711336,1282711336,1,2,0
45571875@N06,2014,5,1282711607,1282711613,2,2,6
45571875@N06,2015,8,1337248272,1337248272,1,1,0
45571875@N06,2016,12,1348705053,1348705053,1,3,0
45571875@N06,2016,5,1348706383,1348706383,1,3,0
45571875@N06,2016,13,1348710731,1348711327,3,3,596
45571875@N06,2017,8,1400327004,1400327004,1,1,0
45571875@N06,2018,6,1415191430,1415191430,1,1,0
45614589@N02,2019,7,1226012491,1226015856,3,1,3365
45614589@N02,2020,7,1289697924,1289697924,1,1,0
45614589@N02,2021,7,1320704313,1320721021,12,1,16708
45614589@N02,2022,7,1352156101,1352175913,8,1,19812
45614589@N02,2023,7,1352705171,1352719703,5,1,14532
45629924@N03,2024,6,1278244321,1278244363,5,1,42
45681479@N04,2025,8,1298640020,1298641867,9,6,1847
45681479@N04,2025,1,1298636435,1298646512,18,6,10077
45681479@N04,2025,4,1298638026,1298646504,7,6,8478
45681479@N04,2025,10,1298636528,1298636674,2,6,146
45681479@N04,2025,5,1298636760,1298637789,7,6,1029
45681479@N04,2025,6,1298638165,1298639481,8,6,1316
45716980@N00,2026,6,1327184458,1327205447,7,9,20989
45716980@N00,2026,7,1327195987,1327195987,1,9,0
45716980@N00,2026,5,1327200738,1327203385,6,9,2647
45716980@N00,2026,8,1327183713,1327195791,3,9,12078
45716980@N00,2026,4,1327186983,1327223557,8,9,36574
45716980@N00,2026,12,1327196280,1327196605,5,9,325
45716980@N00,2026,2,1327184134,1327195825,8,9,11691
45716980@N00,2026,1,1327189952,1327189952,1,9,0
45716980@N00,2026,13,1327216788,1327216788,1,9,0
45716980@N00,2027,7,1361831954,1361839891,3,12,7937
45716980@N00,2027,4,1361836114,1361839255,4,12,3141
45716980@N00,2027,10,1361828449,1361852442,2,12,23993
45716980@N00,2027,6,1361845587,1361849392,18,12,3805
45716980@N00,2027,5,1361845224,1361846766,20,12,1542
45716980@N00,2027,8,1361829513,1361849655,14,12,20142
45716980@N00,2027,3,1361834101,1361851979,10,12,17878
45716980@N00,2027,11,1361831028,1361831663,3,12,635
45716980@N00,2027,12,1361831777,1361849771,3,12,17994
45716980@N00,2027,2,1361829374,1361840607,10,12,11233
45716980@N00,2027,1,1361825126,1361852243,43,12,27117
45716980@N00,2027,13,1361835916,1361846849,3,12,10933
45749280@N00,2028,2,1303779130,1303793820,12,5,14690
45749280@N00,2028,5,1303806563,1303806563,1,5,0
45749280@N00,2028,8,1303793433,1303797563,15,5,4130
45749280@N00,2028,9,1303815461,1303815619,2,5,158
45749280@N00,2028,13,1303786332,1303798926,5,5,12594
45749280@N00,2029,5,1304320576,1304324810,7,1,4234
45749280@N00,2030,13,1413178819,1413178819,1,4,0
45749280@N00,2030,4,1413180953,1413181000,3,4,47
45749280@N00,2030,6,1413180560,1413180560,1,4,0
45749280@N00,2030,3,1413181460,1413181460,1,4,0
45749280@N00,2031,5,1413969063,1413978900,3,2,9837
45749280@N00,2031,9,1413986393,1413986393,1,2,0
45805775@N08,2032,13,1326317150,1326321404,4,1,4254
45842774@N00,2033,8,1223874040,1223874040,1,1,0
45842803@N00,2034,5,1254551834,1254552103,4,2,269
45842803@N00,2034,10,1254547421,1254547421,1,2,0
45865730@N02,2035,5,1364268257,1364268257,1,1,0
45865730@N02,2036,2,1364427548,1364430313,3,3,2765
45865730@N02,2036,8,1364419117,1364419119,2,3,2
45865730@N02,2036,6,1364425841,1364425841,1,3,0
45886439@N06,2037,1,1301791756,1301791756,1,1,0
45959609@N00,2038,5,1343881848,1343909639,2,3,27791
45959609@N00,2038,4,1343887583,1343909884,4,3,22301
45959609@N00,2038,8,1343888216,1343910196,4,3,21980
45959609@N00,2039,4,1408160935,1408160935,1,2,0
45959609@N00,2039,9,1408178139,1408178139,1,2,0
45959609@N00,2040,5,1444456657,1444456657,1,1,0
45959609@N00,2041,13,1456526917,1456526917,1,1,0
45959609@N00,2042,4,1462510630,1462510630,1,1,0
45965611@N06,2043,6,1333290292,1333290292,1,1,0
46027550@N00,2044,2,1236747189,1236747189,1,2,0
46027550@N00,2044,1,1236743294,1236760326,3,2,17032
46050386@N03,2045,5,1242804650,1242804915,3,1,265
46050386@N03,2046,4,1242858566,1242858566,1,2,0
46050386@N03,2046,12,1242866120,1242866120,1,2,0
46050386@N03,2047,13,1242969841,1242969841,1,1,0
46134803@N05,2048,4,1370752271,1370752271,1,1,0
46134803@N05,2049,4,1370782502,1370782502,1,1,0
46364076@N02,2050,8,1258745980,1258751591,8,1,5611
46364076@N02,2051,8,1284880797,1284881069,60,1,272
46419214@N06,2052,10,1277465482,1277465482,1,1,0
46453719@N00,2053,5,1205616206,1205616206,1,1,0
46536427@N04,2054,8,1357342812,1357377684,20,1,34872
46536427@N04,2055,8,1357599201,1357618217,16,1,19016
46592338@N04,2056,10,1262042867,1262042867,1,2,0
46592338@N04,2056,5,1262044666,1262044666,1,2,0
46602694@N00,2057,1,1355009891,1355009891,1,1,0
46602694@N00,2058,2,1355650796,1355650796,1,2,0
46602694@N00,2058,6,1355650888,1355650888,1,2,0
46602694@N00,2059,13,1357940716,1357940716,1,1,0
46623443@N00,2060,5,1392548674,1392548674,1,1,0
46649528@N04,2061,8,1285737832,1285737832,1,1,0
46649528@N04,2062,6,1348487278,1348487278,1,1,0
46659210@N07,2063,1,1319674132,1319674132,1,1,0
46671006@N00,2064,4,1253338038,1253338128,2,1,90
46724048@N00,2065,5,1295321314,1295321314,1,3,0
46724048@N00,2065,1,1295321078,1295321078,1,3,0
46724048@N00,2065,8,1295318968,1295318968,1,3,0
46866298@N02,2066,10,1280021975,1280022416,2,1,441
46866350@N00,2067,5,1294020492,1294020492,1,2,0
46866350@N00,2067,6,1294010309,1294010309,1,2,0
46993481@N04,2068,8,1271033948,1271070699,14,1,36751
47084049@N07,2069,8,1361850892,1361850892,1,1,0
47125846@N08,2070,8,1261560421,1261560421,1,1,0
47125846@N08,2071,1,1276392039,1276393612,2,3,1573
47125846@N08,2071,8,1276396403,1276396807,3,3,404
47125846@N08,2071,6,1276400542,1276400612,2,3,70
47125846@N08,2072,1,1291547008,1291547008,1,3,0
47125846@N08,2072,5,1291547597,1291547597,1,3,0
47125846@N08,2072,6,1291539387,1291552656,5,3,13269
47125846@N08,2073,1,1291787446,1291787659,3,2,213
47125846@N08,2073,5,1291788652,1291789690,10,2,1038
47125846@N08,2074,8,1297406960,1297406960,1,1,0
47125846@N08,2075,13,1301819508,1301819508,1,1,0
47125846@N08,2076,4,1305810678,1305817503,10,2,6825
47125846@N08,2076,3,1305811303,1305816753,18,2,5450
47125846@N08,2077,1,1307238530,1307245928,2,5,7398
47125846@N08,2077,12,1307240699,1307240699,1,5,0
47125846@N08,2077,8,1307255598,1307255694,2,5,96
47125846@N08,2077,5,1307258236,1307258236,1,5,0
47125846@N08,2077,13,1307234307,1307243087,7,5,8780
47125846@N08,2078,5,1310900088,1310900088,1,3,0
47125846@N08,2078,13,1310896700,1310896700,1,3,0
47125846@N08,2078,6,1310905077,1310905077,1,3,0
47125846@N08,2079,4,1311506670,1311506670,1,4,0
47125846@N08,2079,5,1311507845,1311507845,1,4,0
47125846@N08,2079,9,1311510791,1311510791,1,4,0
47125846@N08,2079,6,1311504399,1311506162,2,4,1763
47125846@N08,2080,6,1313820991,1313821503,2,1,512
47125846@N08,2081,6,1319332735,1319332735,1,4,0
47125846@N08,2081,1,1319344737,1319344926,2,4,189
47125846@N08,2081,5,1319350149,1319350467,2,4,318
47125846@N08,2081,13,1319345724,1319348755,7,4,3031
47125846@N08,2082,8,1321772271,1321772390,2,3,119
47125846@N08,2082,6,1321765242,1321765517,3,3,275
47125846@N08,2082,4,1321765695,1321765695,1,3,0
47125846@N08,2083,6,1323420790,1323420790,1,1,0
47125846@N08,2084,8,1323938120,1323938120,1,2,0
47125846@N08,2084,6,1323939066,1323940529,3,2,1463
47125846@N08,2085,8,1326960603,1326960603,1,1,0
47125846@N08,2086,4,1327206306,1327206306,1,1,0
47125846@N08,2087,5,1329562100,1329562100,1,1,0
47125846@N08,2088,6,1338091566,1338091566,1,1,0
47125846@N08,2089,1,1338688186,1338688186,1,1,0
47125846@N08,2090,13,1339305478,1339306196,3,4,718
47125846@N08,2090,8,1339312947,1339321336,9,4,8389
47125846@N08,2090,6,1339308795,1339308795,1,4,0
47125846@N08,2090,4,1339307614,1339307614,1,4,0
47125846@N08,2091,4,1344680689,1344680689,1,1,0
47125846@N08,2092,13,1346653205,1346654693,2,1,1488
47125846@N08,2093,8,1355043903,1355043903,1,4,0
47125846@N08,2093,1,1355028085,1355028183,2,4,98
47125846@N08,2093,5,1355048123,1355048123,1,4,0
47125846@N08,2093,6,1355049549,1355054013,4,4,4464
47125846@N08,2094,9,1367064188,1367064188,1,1,0
47125846@N08,2095,1,1367668468,1367668468,1,1,0
47125846@N08,2096,1,1370740144,1370740744,2,1,600
47125846@N08,2097,8,1372940946,1372940946,1,1,0
47125846@N08,2098,7,1375591467,1375591514,2,2,47
47125846@N08,2098,13,1375600812,1375601526,2,2,714
47125846@N08,2099,1,1378115084,1378115809,3,1,725
47125846@N08,2100,3,1379063750,1379063750,1,2,0
47125846@N08,2100,10,1379057750,1379057750,1,2,0
47125846@N08,2101,8,1381047951,1381047951,1,1,0
47125846@N08,2102,2,1386481336,1386481336,1,2,0
47125846@N08,2102,13,1386484001,1386484001,1,2,0
47125846@N08,2103,5,1387074135,1387074135,1,1,0
47125846@N08,2104,5,1391234893,1391234893,1,3,0
47125846@N08,2104,1,1391235708,1391235708,1,3,0
47125846@N08,2104,8,1391236265,1391236265,1,3,0
47125846@N08,2105,5,1394293434,1394293434,1,1,0
47125846@N08,2106,5,1396073084,1396073084,1,1,0
47136771@N03,2107,1,1346832362,1346832362,1,2,0
47136771@N03,2107,13,1346821659,1346822061,9,2,402
47145167@N03,2108,8,1317383081,1317383081,1,1,0
47189760@N05,2109,5,1359732181,1359732181,1,1,0
47223527@N05,2110,10,1412151015,1412151015,1,1,0
47363316@N08,2111,8,1330126953,1330126953,1,2,0
47363316@N08,2111,5,1330131655,1330133277,2,2,1622
47363316@N08,2112,5,1330249863,1330249956,2,1,93
47365658@N00,2113,1,1278852499,1278852499,1,2,0
47365658@N00,2113,4,1278841356,1278841356,1,2,0
47423151@N06,2114,5,1318253976,1318253976,1,1,0
47423151@N06,2115,1,1368529847,1368529847,1,1,0
47423151@N06,2116,6,1381126392,1381126392,1,1,0
47615165@N04,2117,5,1357782067,1357798834,26,1,16767
47615165@N04,2118,10,1357963768,1357964112,2,1,344
47705525@N06,2119,8,1306240356,1306240394,2,2,38
47705525@N06,2119,11,1306235836,1306235836,1,2,0
47705525@N06,2120,11,1306315981,1306315981,1,1,0
47705525@N06,2121,8,1306400422,1306400676,5,1,254
47705525@N06,2122,8,1307073767,1307074022,5,1,255
47705525@N06,2123,10,1307179728,1307179774,2,5,46
47705525@N06,2123,11,1307181053,1307181089,2,5,36
47705525@N06,2123,8,1307179165,1307182791,4,5,3626
47705525@N06,2123,4,1307170109,1307170229,4,5,120
47705525@N06,2123,5,1307179844,1307179844,1,5,0
47705525@N06,2124,8,1307245594,1307245594,1,1,0
47705525@N06,2125,7,1312975283,1312975283,1,1,0
47705525@N06,2126,8,1314356779,1314356810,3,3,31
47705525@N06,2126,12,1314356817,1314356817,1,3,0
47705525@N06,2126,13,1314356875,1314356875,1,3,0
47716066@N05,2127,1,1307267841,1307267841,1,1,0
47716066@N05,2128,1,1314608578,1314608999,4,2,421
47716066@N05,2128,8,1314607982,1314609386,2,2,1404
47785122@N06,2129,5,1349509366,1349509366,1,1,0
47826387@N03,2130,4,1339420351,1339420351,1,1,0
47845995@N00,2131,10,1338593070,1338593070,1,2,0
47845995@N00,2131,4,1338595106,1338595933,4,2,827
47861479@N02,2132,6,1355709448,1355709448,1,1,0
47861479@N02,2133,9,1355909479,1355909479,1,2,0
47861479@N02,2133,4,1355904735,1355904735,1,2,0
47861479@N02,2134,10,1381654732,1381654732,1,3,0
47861479@N02,2134,2,1381646188,1381647152,3,3,964
47861479@N02,2134,8,1381652663,1381652663,1,3,0
47861479@N02,2135,10,1418623721,1418623721,1,2,0
47861479@N02,2135,2,1418628967,1418628985,2,2,18
47894833@N04,2136,4,1459393680,1459393680,1,1,0
47953315@N04,2137,8,1199150039,1199152372,35,1,2333
48103768@N00,2138,5,1460160569,1460160569,1,2,0
48103768@N00,2138,10,1460160946,1460161776,2,2,830
48105777@N00,2139,2,1370150879,1370150879,1,3,0
48105777@N00,2139,13,1370158951,1370158951,1,3,0
48105777@N00,2139,5,1370154667,1370154667,1,3,0
48121645@N00,2140,8,1231970658,1231970828,4,1,170
48121645@N00,2141,8,1254089762,1254089834,7,1,72
48271781@N00,2142,10,1261995617,1261995617,1,1,0
48275668@N02,2143,4,1347035697,1347035697,1,1,0
48275668@N02,2144,7,1347085158,1347085203,2,2,45
48275668@N02,2144,12,1347090231,1347090231,1,2,0
48275668@N02,2145,13,1363561956,1363561956,1,1,0
48275668@N02,2146,1,1410402447,1410402447,1,1,0
48275668@N02,2147,5,1469008395,1469008395,1,1,0
48311919@N00,2148,2,1194824849,1194844093,18,1,19244
48311919@N00,2149,2,1221778551,1221796375,33,1,17824
48311919@N00,2150,2,1228460195,1228463396,6,1,3201
48311919@N00,2151,2,1228611373,1228627640,12,1,16267
48311919@N00,2152,2,1418370302,1418377347,64,1,7045
48311919@N00,2153,5,1430737855,1430739201,10,2,1346
48311919@N00,2153,2,1430714731,1430721073,71,2,6342
48311919@N00,2154,7,1440741082,1440757313,199,2,16231
48311919@N00,2154,8,1440736881,1440738779,15,2,1898
48311919@N00,2155,12,1443248263,1443248263,1,1,0
48311919@N00,2156,7,1443835677,1443864001,50,3,28324
48311919@N00,2156,12,1443838926,1443872194,599,3,33268
48311919@N00,2156,1,1443838372,1443872188,59,3,33816
48311919@N00,2157,7,1453430739,1453450455,57,1,19716
48391953@N02,2158,1,1286350927,1286351850,2,1,923
48427787@N00,2159,2,1320450634,1320450683,2,4,49
48427787@N00,2159,5,1320445523,1320445523,1,4,0
48427787@N00,2159,6,1320452044,1320452456,6,4,412
48427787@N00,2159,4,1320446259,1320446315,2,4,56
48481127@N08,2160,6,1356828145,1356832333,2,4,4188
48481127@N08,2160,1,1356820058,1356820058,1,4,0
48481127@N08,2160,4,1356836378,1356836378,1,4,0
48481127@N08,2160,5,1356816833,1356816833,1,4,0
48481127@N08,2161,5,1372785299,1372785299,1,1,0
48494440@N04,2162,4,1253418809,1253418809,1,2,0
48494440@N04,2162,2,1253416905,1253416905,1,2,0
48600084713@N01,2163,10,1314494811,1314494811,1,1,0
48603464@N05,2164,13,1458189749,1458189823,2,1,74
48658532@N06,2165,6,1311070684,1311070684,1,2,0
48658532@N06,2165,8,1311079276,1311079917,2,2,641
48658532@N06,2166,7,1352621986,1352623827,3,1,1841
48661840@N08,2167,5,1406793037,1406793037,1,1,0
48763139@N00,2168,1,1380166498,1380166614,2,1,116
48826873@N08,2169,8,1326385794,1326385794,1,2,0
48826873@N08,2169,1,1326372950,1326372950,1,2,0
48886342@N00,2170,6,1293958142,1293958142,1,1,0
48889050018@N01,2171,11,1296955887,1296955887,1,4,0
48889050018@N01,2171,4,1296947573,1296947573,1,4,0
48889050018@N01,2171,1,1296944173,1296944173,1,4,0
48889050018@N01,2171,8,1296955958,1296955965,2,4,7
48889119686@N01,2172,4,1352437740,1352438699,9,1,959
48891180@N00,2173,1,1230057992,1230057992,1,4,0
48891180@N00,2173,9,1230059456,1230059456,1,4,0
48891180@N00,2173,4,1230038269,1230038269,1,4,0
48891180@N00,2173,8,1230049349,1230066073,4,4,16724
48926352@N00,2174,8,1278805220,1278853134,92,1,47914
48938973@N07,2175,4,1379467998,1379467998,1,2,0
48938973@N07,2175,6,1379473063,1379473063,1,2,0
48999318@N00,2176,8,1256191580,1256208986,62,1,17406
49014295@N06,2177,9,1396600230,1396601752,8,4,1522
49014295@N06,2177,3,1396580064,1396580064,1,4,0
49014295@N06,2177,13,1396584306,1396585951,3,4,1645
49014295@N06,2177,8,1396565026,1396602846,3,4,37820
49027661@N03,2178,1,1318639298,1318645919,13,1,6621
49027661@N03,2179,6,1400572115,1400572153,5,1,38
49032331@N05,2180,5,1339220981,1339221042,2,3,61
49032331@N05,2180,1,1339210724,1339210822,4,3,98
49032331@N05,2180,8,1339210065,1339240794,6,3,30729
49103297@N04,2181,9,1408100566,1408102101,63,5,1535
49103297@N04,2181,6,1408092102,1408092102,1,5,0
49103297@N04,2181,10,1408083331,1408084720,44,5,1389
49103297@N04,2181,1,1408103264,1408103791,7,5,527
49103297@N04,2181,13,1408087107,1408088929,27,5,1822
49109678@N04,2182,8,1309390449,1309390449,1,4,0
49109678@N04,2182,10,1309387689,1309391801,2,4,4112
49109678@N04,2182,13,1309387901,1309387901,1,4,0
49109678@N04,2182,3,1309389095,1309389095,1,4,0
49109678@N04,2183,13,1343782505,1343782505,1,4,0
49109678@N04,2183,5,1343788312,1343817408,3,4,29096
49109678@N04,2183,3,1343781366,1343781366,1,4,0
49109678@N04,2183,1,1343778902,1343817856,2,4,38954
49109678@N04,2184,2,1365146394,1365146394,1,1,0
49126050@N00,2185,2,1312849941,1312849941,1,1,0
49165041@N00,2186,12,1281746519,1281746615,2,4,96
49165041@N00,2186,13,1281753698,1281753698,1,4,0
49165041@N00,2186,6,1281753442,1281753442,1,4,0
49165041@N00,2186,1,1281746387,1281746514,2,4,127
49169223@N00,2187,3,1231074004,1231074004,1,7,0
49169223@N00,2187,7,1231074014,1231074016,3,7,2
49169223@N00,2187,12,1231074000,1231074000,1,7,0
49169223@N00,2187,2,1231074017,1231074021,5,7,4
49169223@N00,2187,6,1231074012,1231074013,2,7,1
49169223@N00,2187,10,1231074001,1231074023,2,7,22
49169223@N00,2187,5,1231074022,1231074022,1,7,0
49169223@N00,2188,13,1231333224,1231333224,1,2,0
49169223@N00,2188,1,1231333225,1231333226,2,2,1
49275237@N00,2189,8,1206994419,1206994419,1,4,0
49275237@N00,2189,1,1207001469,1207001469,1,4,0
49275237@N00,2189,5,1206994564,1206998764,5,4,4200
49275237@N00,2189,10,1206994472,1206997677,6,4,3205
49275237@N00,2190,13,1329620709,1329620884,8,8,175
49275237@N00,2190,4,1329625945,1329625945,1,8,0
49275237@N00,2190,9,1329631377,1329632893,29,8,1516
49275237@N00,2190,10,1329619454,1329619454,1,8,0
49275237@N00,2190,11,1329601337,1329637462,22,8,36125
49275237@N00,2190,1,1329619789,1329638207,11,8,18418
49275237@N00,2190,8,1329626095,1329626150,7,8,55
49275237@N00,2190,6,1329604886,1329610446,17,8,5560
49299827@N06,2191,1,1467239161,1467239161,1,1,0
49305593@N05,2192,8,1429530903,1429530903,1,1,0
49345884@N06,2193,8,1286850045,1286867086,15,1,17041
49348048@N03,2194,6,1387871753,1387871753,1,1,0
49502978053@N01,2195,4,1316062252,1316062252,1,1,0
49502978053@N01,2196,10,1317470654,1317470685,3,8,31
49502978053@N01,2196,13,1317466871,1317466894,2,8,23
49502978053@N01,2196,2,1317469584,1317469584,1,8,0
49502978053@N01,2196,4,1317470703,1317470703,1,8,0
49502978053@N01,2196,8,1317469225,1317469225,1,8,0
49502978053@N01,2196,5,1317470706,1317470706,1,8,0
49502978053@N01,2196,1,1317467050,1317469210,3,8,2160
49502978053@N01,2196,6,1317469597,1317469625,3,8,28
49502987176@N01,2197,6,1275091159,1275091179,3,1,20
49502987176@N01,2198,6,1314171816,1314171816,1,2,0
49502987176@N01,2198,1,1314175279,1314175279,1,2,0
49503114584@N01,2199,8,1217611904,1217611904,1,2,0
49503114584@N01,2199,13,1217603969,1217603969,1,2,0
49503114584@N01,2200,8,1218364071,1218364679,3,1,608
49503114584@N01,2201,11,1343868884,1343868884,1,4,0
49503114584@N01,2201,1,1343900737,1343908155,2,4,7418
49503114584@N01,2201,6,1343874287,1343874287,1,4,0
49503114584@N01,2201,4,1343870915,1343879634,3,4,8719
49503114584@N01,2202,8,1344386513,1344386513,1,3,0
49503114584@N01,2202,6,1344391012,1344391012,1,3,0
49503114584@N01,2202,4,1344389041,1344416896,2,3,27855
49503114584@N01,2203,8,1344730738,1344730738,1,4,0
49503114584@N01,2203,4,1344731150,1344731150,1,4,0
49503114584@N01,2203,2,1344737951,1344737951,1,4,0
49503114584@N01,2203,6,1344739402,1344740907,2,4,1505
49503114584@N01,2204,12,1406784592,1406784592,1,1,0
49503128117@N01,2205,11,1391367185,1391367185,1,3,0
49503128117@N01,2205,9,1391369286,1391369286,1,3,0
49503128117@N01,2205,4,1391367188,1391367188,1,3,0
49645702@N00,2206,6,1363397306,1363397482,8,4,176
49645702@N00,2206,8,1363395814,1363395984,5,4,170
49645702@N00,2206,1,1363391200,1363391375,6,4,175
49645702@N00,2206,4,1363395179,1363395469,12,4,290
49675952@N07,2207,1,1272711568,1272711568,1,1,0
49677598@N00,2208,12,1221126900,1221126960,2,1,60
49677598@N00,2209,1,1221196200,1221197940,5,4,1740
49677598@N00,2209,6,1221185400,1221185670,4,4,270
49677598@N00,2209,7,1221190800,1221195780,5,4,4980
49677598@N00,2209,12,1221193140,1221195300,6,4,2160
49679809@N07,2210,1,1291687050,1291687050,1,1,0
49679809@N07,2211,1,1291879421,1291887858,4,1,8437
49679809@N07,2212,1,1322610716,1322628922,7,1,18206
49679809@N07,2213,1,1352086672,1352093978,3,1,7306
49679809@N07,2214,1,1352185239,1352196676,17,1,11437
49679809@N07,2215,1,1367652566,1367673639,11,1,21073
49679809@N07,2216,1,1382923087,1382923463,2,1,376
49679809@N07,2217,1,1383196232,1383210754,21,1,14522
49679809@N07,2218,1,1401004659,1401021786,13,1,17127
49679809@N07,2219,1,1414867423,1414873301,3,1,5878
49679809@N07,2220,1,1415252778,1415263081,11,1,10303
49679809@N07,2221,1,1445752904,1445775324,9,1,22420
49679809@N07,2222,1,1446089978,1446089978,1,1,0
49708289@N04,2223,10,1297925164,1297973409,8,1,48245
49708289@N04,2224,10,1298888384,1298901033,16,1,12649
49708289@N04,2225,10,1299579900,1299579900,1,1,0
49738389@N00,2226,12,1287461233,1287462798,4,3,1565
49738389@N00,2226,2,1287474025,1287474061,3,3,36
49738389@N00,2226,6,1287465472,1287465472,1,3,0
49824012@N00,2227,7,1324594545,1324594545,1,1,0
49855440@N00,2228,4,1297128439,1297128439,1,1,0
49887039@N04,2229,5,1283319237,1283321699,2,8,2462
49887039@N04,2229,4,1283324674,1283324674,1,8,0
49887039@N04,2229,8,1283322322,1283358521,12,8,36199
49887039@N04,2229,1,1283319011,1283358659,3,8,39648
49887039@N04,2229,13,1283344544,1283345180,3,8,636
49887039@N04,2229,2,1283318751,1283318751,1,8,0
49887039@N04,2229,10,1283349354,1283359488,6,8,10134
49887039@N04,2229,11,1283318641,1283318827,2,8,186
49887039@N04,2230,4,1283849035,1283849035,1,1,0
49887039@N04,2231,9,1284028398,1284029645,4,1,1247
49887039@N04,2232,10,1346942995,1346942995,1,2,0
49887039@N04,2232,9,1346954553,1346954553,1,2,0
49887039@N04,2233,2,1347033638,1347034671,2,1,1033
49887039@N04,2234,1,1347106996,1347106996,1,5,0
49887039@N04,2234,2,1347106865,1347106906,2,5,41
49887039@N04,2234,12,1347118640,1347118640,1,5,0
49887039@N04,2234,8,1347118582,1347118582,1,5,0
49887039@N04,2234,5,1347118387,1347119345,3,5,958
49887039@N04,2235,4,1347735473,1347735473,1,3,0
49887039@N04,2235,8,1347714856,1347714856,1,3,0
49887039@N04,2235,6,1347714957,1347714957,1,3,0
49887039@N04,2236,5,1361358785,1361358785,1,1,0
49934509@N00,2237,2,1291785877,1291785877,1,3,0
49934509@N00,2237,10,1291780917,1291780917,1,3,0
49934509@N00,2237,6,1291783696,1291783717,2,3,21
49934509@N00,2238,13,1326686344,1326703137,5,1,16793
49934509@N00,2239,1,1326949845,1326949845,1,1,0
49934509@N00,2240,1,1327121503,1327121503,1,1,0
49934509@N00,2241,9,1351584244,1351584244,1,3,0
49934509@N00,2241,1,1351574803,1351582927,3,3,8124
49934509@N00,2241,6,1351577764,1351577952,2,3,188
49934509@N00,2242,13,1351738036,1351738036,1,4,0
49934509@N00,2242,1,1351732788,1351732881,2,4,93
49934509@N00,2242,4,1351736657,1351736657,1,4,0
49934509@N00,2242,12,1351752876,1351752898,5,4,22
49934509@N00,2243,9,1354413363,1354413363,1,1,0
49981237@N02,2244,5,1379629294,1379629294,1,1,0
50073458@N00,2245,8,1339575387,1339575392,2,2,5
50073458@N00,2245,6,1339551318,1339551318,1,2,0
50073458@N00,2246,9,1340462316,1340462316,1,1,0
50158065@N00,2247,8,1390299734,1390299734,1,2,0
50158065@N00,2247,2,1390301315,1390301315,1,2,0
50216293@N04,2248,6,1260086556,1260087709,3,1,1153
50267281@N07,2249,8,1354603806,1354615470,7,1,11664
50267281@N07,2250,8,1354664619,1354679313,5,1,14694
50267281@N07,2251,10,1415423651,1415423651,1,1,0
50267281@N07,2252,8,1415608611,1415616824,35,2,8213
50267281@N07,2252,6,1415609564,1415609564,1,2,0
50267281@N07,2253,6,1452085518,1452085518,1,1,0
50287784@N00,2254,8,1206003147,1206003147,1,1,0
50287784@N00,2255,8,1206057442,1206077924,53,1,20482
50514133@N00,2256,8,1267401243,1267436894,3,1,35651
50581274@N07,2257,6,1259136551,1259136551,1,1,0
50624286@N00,2258,8,1310026365,1310026365,1,1,0
50679269@N07,2259,5,1425450316,1425450316,1,1,0
50722289@N02,2260,5,1275316042,1275316042,1,1,0
50755034@N04,2261,10,1316564715,1316564715,1,2,0
50755034@N04,2261,4,1316576631,1316576631,1,2,0
50968580@N00,2262,6,1356868260,1356868260,1,3,0
50968580@N00,2262,8,1356861971,1356868087,2,3,6116
50968580@N00,2262,5,1356857489,1356858271,2,3,782
50968580@N00,2263,2,1377933594,1377933594,1,1,0
51011933@N00,2264,13,1366106822,1366106822,1,3,0
51011933@N00,2264,12,1366102858,1366102858,1,3,0
51011933@N00,2264,6,1366094592,1366094592,1,3,0
51011933@N00,2265,13,1366151487,1366151487,1,1,0
51035769302@N01,2266,13,1275122832,1275122832,1,1,0
51038094@N04,2267,8,1361288007,1361288007,1,1,0
51038094@N04,2268,8,1401596157,1401596157,1,1,0
51038094@N04,2269,8,1401637075,1401637075,1,1,0
51048990@N00,2270,13,1322273881,1322273881,1,2,0
51048990@N00,2270,5,1322281452,1322289472,4,2,8020
51099190@N00,2271,6,1356066806,1356094582,7,3,27776
51099190@N00,2271,4,1356061511,1356076784,2,3,15273
51099190@N00,2271,5,1356064113,1356064113,1,3,0
51103472@N04,2272,10,1457567528,1457567528,1,1,0
51141147@N02,2273,12,1335061175,1335061175,1,5,0
51141147@N02,2273,1,1335065471,1335082795,13,5,17324
51141147@N02,2273,11,1335067373,1335071258,2,5,3885
51141147@N02,2273,5,1335064826,1335065300,3,5,474
51141147@N02,2273,7,1335079694,1335079694,1,5,0
51166785@N06,2274,5,1352071994,1352099305,10,7,27311
51166785@N06,2274,8,1352080616,1352094308,3,7,13692
51166785@N06,2274,1,1352070890,1352073982,5,7,3092
51166785@N06,2274,4,1352081231,1352085331,7,7,4100
51166785@N06,2274,13,1352089672,1352089705,3,7,33
51166785@N06,2274,10,1352077228,1352077311,2,7,83
51166785@N06,2274,2,1352087490,1352094736,8,7,7246
51166785@N06,2275,5,1444514509,1444517024,3,2,2515
51166785@N06,2275,4,1444526943,1444526943,1,2,0
51186242@N00,2276,13,1418523767,1418523767,1,1,0
51267780@N00,2277,11,1224049668,1224049668,1,10,0
51267780@N00,2277,13,1224025873,1224030355,22,10,4482
51267780@N00,2277,4,1224030768,1224030768,1,10,0
51267780@N00,2277,10,1224018559,1224018582,2,10,23
51267780@N00,2277,6,1224030879,1224050313,5,10,19434
51267780@N00,2277,2,1224050057,1224050057,1,10,0
51267780@N00,2277,9,1224054056,1224055566,19,10,1510
51267780@N00,2277,1,1224019055,1224048323,18,10,29268
51267780@N00,2277,8,1224020128,1224051072,12,10,30944
51267780@N00,2277,5,1224019289,1224019500,5,10,211
51313971@N08,2278,5,1443666817,1443666817,1,1,0
51437422@N03,2279,4,1427933414,1427933414,1,2,0
51437422@N03,2279,2,1427946606,1427946606,1,2,0
51437422@N03,2280,1,1428026918,1428027767,4,1,849
51437422@N03,2281,8,1429822756,1429822756,1,1,0
51437422@N03,2282,2,1429878188,1429878188,1,1,0
51479343@N00,2283,8,1272453514,1272453517,2,1,3
51547237@N00,2284,9,1253438841,1253439597,2,1,756
51547237@N00,2285,8,1291853648,1291853652,2,2,4
51547237@N00,2285,6,1291880673,1291880673,1,2,0
51547237@N00,2286,13,1412731831,1412731831,1,1,0
51547237@N00,2287,1,1412814026,1412814026,1,1,0
51692964@N05,2288,5,1232552739,1232552739,1,2,0
51692964@N05,2288,8,1232556626,1232561365,2,2,4739
51692964@N05,2289,5,1236951679,1236951679,1,1,0
51746064@N07,2290,10,1362815129,1362815131,2,2,2
51746064@N07,2290,4,1362811873,1362811875,2,2,2
51746586@N06,2291,2,1281449417,1281449417,1,2,0
51746586@N06,2291,4,1281419907,1281436615,18,2,16708
51746586@N06,2292,10,1281840790,1281840790,1,3,0
51746586@N06,2292,5,1281835891,1281835891,1,3,0
51746586@N06,2292,2,1281843259,1281843306,2,3,47
51746586@N06,2293,4,1282356351,1282356351,1,1,0
51746586@N06,2294,1,1312425907,1312425948,2,5,41
51746586@N06,2294,5,1312421374,1312421374,1,5,0
51746586@N06,2294,8,1312420227,1312434216,5,5,13989
51746586@N06,2294,6,1312426602,1312430021,6,5,3419
51746586@N06,2294,4,1312419008,1312434329,31,5,15321
51746586@N06,2295,8,1312951130,1312951137,2,4,7
51746586@N06,2295,10,1312956208,1312957500,28,4,1292
51746586@N06,2295,5,1312954383,1312954383,1,4,0
51746586@N06,2295,13,1312940127,1312940171,2,4,44
51746586@N06,2296,1,1313283024,1313286446,10,7,3422
51746586@N06,2296,10,1313282666,1313299089,3,7,16423
51746586@N06,2296,5,1313284326,1313286151,3,7,1825
51746586@N06,2296,2,1313286613,1313286716,2,7,103
51746586@N06,2296,8,1313286563,1313286563,1,7,0
51746586@N06,2296,6,1313291258,1313291258,1,7,0
51746586@N06,2296,4,1313295990,1313299019,3,7,3029
51746586@N06,2297,7,1343892741,1343892741,1,6,0
51746586@N06,2297,1,1343867942,1343877178,10,6,9236
51746586@N06,2297,5,1343865719,1343880638,14,6,14919
51746586@N06,2297,2,1343884830,1343884830,1,6,0
51746586@N06,2297,8,1343865536,1343882642,19,6,17106
51746586@N06,2297,6,1343887114,1343887114,1,6,0
51746586@N06,2298,1,1343956299,1343956299,1,2,0
51746586@N06,2298,8,1343956568,1343956568,1,2,0
51746586@N06,2299,7,1344826634,1344828220,2,5,1586
51746586@N06,2299,1,1344834443,1344835208,3,5,765
51746586@N06,2299,12,1344828112,1344828112,1,5,0
51746586@N06,2299,13,1344822036,1344823564,4,5,1528
51746586@N06,2299,11,1344828122,1344828122,1,5,0
51791370@N03,2300,1,1300063397,1300063397,1,1,0
51791370@N03,2301,12,1300167309,1300168546,4,1,1237
51826494@N06,2302,4,1451521556,1451521556,1,1,0
51826494@N06,2303,4,1451596399,1451596399,1,1,0
51981360@N07,2304,4,1349927467,1349927467,1,1,0
52066610@N03,2305,8,1394696092,1394696092,1,2,0
52066610@N03,2305,4,1394671544,1394695745,3,2,24201
52082189@N03,2306,8,1328014800,1328014800,1,1,0
52168854@N00,2307,5,1348288715,1348288715,1,1,0
52168854@N00,2308,6,1348471157,1348471157,1,2,0
52168854@N00,2308,13,1348471825,1348490796,12,2,18971
52192784@N08,2309,11,1389849343,1389849343,1,4,0
52192784@N08,2309,1,1389853356,1389853490,4,4,134
52192784@N08,2309,6,1389833050,1389833735,8,4,685
52192784@N08,2309,2,1389848550,1389848550,1,4,0
52195956@N03,2310,13,1383089701,1383116162,11,1,26461
52195956@N03,2311,7,1425603074,1425603313,2,1,239
52226961@N04,2312,13,1376707023,1376707023,1,1,0
52226961@N04,2313,8,1391860302,1391860302,1,1,0
52254014@N00,2314,4,1277527828,1277527828,1,1,0
52254014@N00,2315,1,1292058593,1292058593,1,2,0
52254014@N00,2315,4,1292059628,1292059628,1,2,0
52254014@N00,2316,1,1306049039,1306049039,1,1,0
52254014@N00,2317,6,1322645671,1322645671,1,1,0
52254014@N00,2318,1,1324681889,1324681889,1,1,0
52254014@N00,2319,8,1339324026,1339324026,1,1,0
52254014@N00,2320,1,1356208773,1356209414,2,2,641
52254014@N00,2320,6,1356210652,1356211454,2,2,802
52399740@N05,2321,13,1395723216,1395723219,2,3,3
52399740@N05,2321,2,1395725797,1395725797,1,3,0
52399740@N05,2321,1,1395725936,1395727212,4,3,1276
52458519@N07,2322,4,1251001834,1251001834,1,2,0
52458519@N07,2322,5,1250982270,1250983967,2,2,1697
52504278@N00,2323,6,1332835748,1332835748,1,1,0
52574631@N00,2324,11,1323156016,1323156016,1,6,0
52574631@N00,2324,8,1323156092,1323173095,2,6,17003
52574631@N00,2324,6,1323159703,1323161707,14,6,2004
52574631@N00,2324,1,1323127289,1323162967,75,6,35678
52574631@N00,2324,12,1323150467,1323152280,3,6,1813
52574631@N00,2324,5,1323147048,1323147048,1,6,0
52574631@N00,2325,13,1455339000,1455339000,1,5,0
52574631@N00,2325,10,1455328110,1455328110,1,5,0
52574631@N00,2325,8,1455329585,1455329612,2,5,27
52574631@N00,2325,2,1455340341,1455341875,3,5,1534
52574631@N00,2325,12,1455334323,1455334323,1,5,0
52574631@N00,2326,13,1455846989,1455847080,3,9,91
52574631@N00,2326,11,1455862023,1455862023,1,9,0
52574631@N00,2326,10,1455838597,1455838597,1,9,0
52574631@N00,2326,7,1455855096,1455862179,3,9,7083
52574631@N00,2326,4,1455848749,1455860285,8,9,11536
52574631@N00,2326,6,1455860481,1455861339,2,9,858
52574631@N00,2326,2,1455853126,1455861728,3,9,8602
52574631@N00,2326,1,1455839242,1455839738,8,9,496
52574631@N00,2326,8,1455853730,1455853730,1,9,0
52627430@N00,2327,6,1220239645,1220239773,3,1,128
52636686@N07,2328,12,1390171799,1390194956,7,12,23157
52636686@N07,2328,8,1390187402,1390211383,30,12,23981
52636686@N07,2328,9,1390206703,1390208233,44,12,1530
52636686@N07,2328,4,1390181357,1390187290,3,12,5933
52636686@N07,2328,7,1390191778,1390192193,3,12,415
52636686@N07,2328,1,1390165211,1390211535,46,12,46324
52636686@N07,2328,2,1390168801,1390196925,14,12,28124
52636686@N07,2328,13,1390165691,1390205154,27,12,39463
52636686@N07,2328,11,1390169226,1390170457,26,12,1231
52636686@N07,2328,5,1390172427,1390209420,11,12,36993
52636686@N07,2328,6,1390165824,1390181170,35,12,15346
52636686@N07,2328,10,1390163836,1390212063,10,12,48227
52666614@N06,2329,6,1408336191,1408336191,1,2,0
52666614@N06,2329,13,1408334769,1408334769,1,2,0
52758053@N07,2330,8,1335404608,1335404608,1,1,0
52758053@N07,2331,5,1375482576,1375482576,1,3,0
52758053@N07,2331,7,1375481338,1375481338,1,3,0
52758053@N07,2331,1,1375483175,1375483175,1,3,0
52758053@N07,2332,9,1375960251,1375960251,1,2,0
52758053@N07,2332,10,1375960771,1375960771,1,2,0
52786697@N00,2333,6,1239604481,1239604481,1,1,0
52793155@N07,2334,6,1291294813,1291295650,2,1,837
52793155@N07,2335,6,1357373222,1357373222,1,2,0
52793155@N07,2335,8,1357371491,1357371491,1,2,0
52793155@N07,2336,7,1385875690,1385875690,1,2,0
52793155@N07,2336,13,1385870143,1385871479,2,2,1336
52793155@N07,2337,1,1391936269,1391936269,1,2,0
52793155@N07,2337,2,1391931704,1391931704,1,2,0
52793155@N07,2338,1,1416095390,1416095390,1,1,0
52872213@N04,2339,3,1307113866,1307113866,1,1,0
52976240@N00,2340,6,1354969010,1354969093,2,1,83
52982457@N00,2341,2,1278370618,1278401577,171,1,30959
52999052@N08,2342,8,1278806751,1278809112,2,1,2361
53024970@N07,2343,6,1321602178,1321602178,1,1,0
53024970@N07,2344,5,1330331682,1330331682,1,1,0
53024970@N07,2345,5,1338104726,1338104726,1,1,0
53034361@N00,2346,12,1463143536,1463143536,1,2,0
53034361@N00,2346,2,1463143025,1463146639,2,2,3614
53034361@N00,2347,1,1463214540,1463219400,2,3,4860
53034361@N00,2347,12,1463218936,1463218936,1,3,0
53034361@N00,2347,8,1463208190,1463219406,3,3,11216
53034361@N00,2348,4,1463471870,1463474729,2,1,2859
53046881@N07,2349,6,1389755108,1389755108,1,4,0
53046881@N07,2349,1,1389768863,1389768863,1,4,0
53046881@N07,2349,5,1389740880,1389740880,1,4,0
53046881@N07,2349,2,1389762533,1389762533,1,4,0
53157520@N07,2350,8,1285830542,1285830542,1,1,0
53199533@N07,2351,12,1268830837,1268830837,1,7,0
53199533@N07,2351,5,1268830812,1268830834,8,7,22
53199533@N07,2351,4,1268830816,1268830816,1,7,0
53199533@N07,2351,9,1268830801,1268830811,11,7,10
53199533@N07,2351,1,1268830836,1268830836,1,7,0
53199533@N07,2351,8,1268830800,1268830827,4,7,27
53199533@N07,2351,10,1268830833,1268830833,1,7,0
53325263@N07,2352,2,1301006899,1301007064,3,1,165
53325263@N07,2353,1,1301092223,1301092223,1,2,0
53325263@N07,2353,6,1301101598,1301109216,45,2,7618
53407359@N00,2354,6,1417594924,1417595046,2,1,122
53407359@N00,2355,6,1417833542,1417835333,4,3,1791
53407359@N00,2355,8,1417816573,1417816573,1,3,0
53407359@N00,2355,12,1417823621,1417823621,1,3,0
53407359@N00,2356,5,1417935234,1417947462,3,2,12228
53407359@N00,2356,2,1417950090,1417950096,2,2,6
53488242@N04,2357,5,1334217385,1334217385,1,2,0
53488242@N04,2357,1,1334218858,1334218858,1,2,0
53516741@N04,2358,4,1319373873,1319373873,1,2,0
53516741@N04,2358,9,1319365496,1319365744,2,2,248
53516741@N04,2359,1,1354665277,1354665277,1,1,0
53516741@N04,2360,13,1355026855,1355026855,1,2,0
53516741@N04,2360,6,1355031476,1355050512,2,2,19036
53516741@N04,2361,8,1413706788,1413707464,2,1,676
53613159@N04,2362,8,1319271646,1319271646,1,2,0
53613159@N04,2362,6,1319268849,1319268849,1,2,0
53613159@N04,2363,5,1319414533,1319414533,1,1,0
53770108@N03,2364,4,1364361231,1364361231,1,1,0
53797701@N07,2365,5,1407327322,1407327322,1,1,0
53821866@N05,2366,1,1470741063,1470741063,1,1,0
53980976@N07,2367,1,1372830776,1372830826,3,1,50
54049616@N06,2368,1,1317204593,1317204646,2,1,53
54114021@N06,2369,4,1332907645,1332907645,1,2,0
54114021@N06,2369,6,1332907636,1332907636,1,2,0
54193979@N06,2370,8,1251727200,1251727200,1,1,0
54250081@N05,2371,13,1369950567,1369957200,5,5,6633
54250081@N05,2371,2,1369965474,1369965474,1,5,0
54250081@N05,2371,1,1369960699,1369962975,9,5,2276
54250081@N05,2371,6,1369952384,1369952663,2,5,279
54250081@N05,2371,4,1369952611,1369962394,2,5,9783
54364530@N08,2372,10,1354578100,1354578437,3,5,337
54364530@N08,2372,6,1354581896,1354584508,27,5,2612
54364530@N08,2372,5,1354578188,1354586938,14,5,8750
54364530@N08,2372,2,1354581528,1354581753,4,5,225
54364530@N08,2372,1,1354577644,1354581397,11,5,3753
54364530@N08,2373,2,1386890220,1386890929,6,1,709
54364530@N08,2374,4,1448940122,1448940122,1,1,0
54364530@N08,2375,3,1449272486,1449272486,1,1,0
54409902@N00,2376,1,1228992013,1228992013,1,1,0
54433880@N05,2377,7,1382588184,1382588184,1,1,0
54507847@N06,2378,4,1413855800,1413856078,3,1,278
54612194@N05,2379,5,1364626055,1364626055,1,1,0
54679799@N03,2380,5,1370384025,1370384025,1,1,0
54679799@N03,2381,13,1463904801,1463904801,1,5,0
54679799@N03,2381,2,1463883512,1463883512,1,5,0
54679799@N03,2381,10,1463870242,1463870242,1,5,0
54679799@N03,2381,4,1463882305,1463882729,3,5,424
54679799@N03,2381,8,1463872081,1463899442,3,5,27361
54804105@N07,2382,6,1291544331,1291544331,1,1,0
54821630@N00,2383,8,1190245640,1190272904,44,1,27264
54831087@N00,2384,1,1287038361,1287038386,3,1,25
54845704@N05,2385,13,1298162404,1298162404,1,7,0
54845704@N05,2385,1,1298172529,1298194770,5,7,22241
54845704@N05,2385,6,1298178893,1298187250,13,7,8357
54845704@N05,2385,2,1298173403,1298194135,21,7,20732
54845704@N05,2385,8,1298173098,1298173098,1,7,0
54845704@N05,2385,4,1298158458,1298180496,3,7,22038
54845704@N05,2385,9,1298187995,1298188738,5,7,743
54855264@N00,2386,6,1371339640,1371339640,1,2,0
54855264@N00,2386,12,1371349322,1371349322,1,2,0
54865141@N03,2387,5,1452768495,1452768495,1,1,0
54902025@N00,2388,8,1227319590,1227319590,1,1,0
54902025@N00,2389,5,1286701637,1286701637,1,1,0
54902025@N00,2390,4,1328922529,1328922529,1,1,0
54902025@N00,2391,4,1329105063,1329105063,1,2,0
54902025@N00,2391,6,1329104642,1329104642,1,2,0
54902025@N00,2392,8,1357805275,1357805275,1,1,0
54902025@N00,2393,1,1379507378,1379507530,4,1,152
54962750@N05,2394,13,1336463926,1336463926,1,1,0
54968643@N02,2395,6,1357194317,1357194332,2,1,15
55029145@N00,2396,1,1256109702,1256109702,1,1,0
55104105@N00,2397,13,1350804271,1350804271,1,1,0
55143107@N00,2398,1,1224032130,1224032477,5,2,347
55143107@N00,2398,6,1224038942,1224038942,1,2,0
55191318@N04,2399,1,1287052904,1287052905,2,1,1
55217458@N00,2400,5,1352492958,1352494584,2,1,1626
55217458@N00,2401,4,1352710659,1352710659,1,1,0
55217458@N00,2402,5,1389401860,1389404956,2,1,3096
55266776@N00,2403,2,1266360666,1266363643,2,1,2977
55314293@N00,2404,8,1398143954,1398143954,1,1,0
55455788@N00,2405,13,1194159588,1194159588,1,2,0
55455788@N00,2405,9,1194177413,1194177852,4,2,439
55455788@N00,2406,6,1197793374,1197794037,15,1,663
55455788@N00,2407,6,1228639701,1228642127,15,1,2426
55455788@N00,2408,6,1228728014,1228728014,1,1,0
55455788@N00,2409,13,1258290905,1258290905,1,1,0
55455788@N00,2410,2,1284873678,1284873678,1,2,0
55455788@N00,2410,8,1284865864,1284886790,2,2,20926
55455788@N00,2411,8,1296774717,1296774717,1,1,0
55569174@N00,2412,6,1349419149,1349419158,2,1,9
55569174@N00,2413,6,1349486019,1349502895,2,1,16876
55615740@N00,2414,5,1404439169,1404440544,5,1,1375
55615740@N00,2415,8,1413613139,1413613139,1,5,0
55615740@N00,2415,11,1413611377,1413611456,3,5,79
55615740@N00,2415,7,1413611388,1413611388,1,5,0
55615740@N00,2415,2,1413613622,1413613622,1,5,0
55615740@N00,2415,13,1413616330,1413616330,1,5,0
55639505@N05,2416,6,1288325576,1288326181,2,1,605
55639632@N03,2417,8,1343187252,1343187252,1,2,0
55639632@N03,2417,1,1343203027,1343203027,1,2,0
55651863@N06,2418,5,1329527282,1329527306,2,1,24
55891979@N03,2419,13,1295326929,1295326929,1,1,0
55894487@N00,2420,9,1351845297,1351846776,5,2,1479
55894487@N00,2420,13,1351835258,1351835258,1,2,0
55986062@N03,2421,5,1371166761,1371166761,1,1,0
55991777@N00,2422,6,1433458326,1433458326,1,3,0
55991777@N00,2422,8,1433455368,1433455368,1,3,0
55991777@N00,2422,10,1433453647,1433453647,1,3,0
56027706@N00,2423,8,1235783497,1235783497,1,1,0
56027706@N00,2424,6,1268450898,1268451114,2,2,216
56027706@N00,2424,4,1268450665,1268450665,1,2,0
56040377@N07,2425,6,1412305465,1412305465,1,4,0
56040377@N07,2425,8,1412301437,1412301437,1,4,0
56040377@N07,2425,4,1412301566,1412301566,1,4,0
56040377@N07,2425,1,1412300784,1412300793,2,4,9
56068273@N06,2426,4,1359692737,1359692737,1,1,0
56068273@N06,2427,4,1359747539,1359757439,3,1,9900
56176110@N04,2428,1,1307955544,1307958297,2,1,2753
56176110@N04,2429,8,1308221706,1308221706,1,2,0
56176110@N04,2429,5,1308220930,1308220930,1,2,0
56221910@N03,2430,13,1439241549,1439241549,1,3,0
56221910@N03,2430,4,1439249344,1439249344,1,3,0
56221910@N03,2430,8,1439270584,1439270584,1,3,0
56223610@N07,2431,10,1335934546,1335938939,3,2,4393
56223610@N07,2431,13,1335941642,1335941642,1,2,0
56223610@N07,2432,9,1335975373,1335976057,5,1,684
56223610@N07,2433,7,1390617914,1390617914,1,1,0
56281521@N00,2434,8,1338854641,1338894687,16,1,40046
56281521@N00,2435,8,1437525362,1437561614,30,1,36252
56416261@N00,2436,2,1306114387,1306114387,1,7,0
56416261@N00,2436,6,1306126465,1306130858,2,7,4393
56416261@N00,2436,13,1306133262,1306133262,1,7,0
56416261@N00,2436,1,1306129283,1306137565,6,7,8282
56416261@N00,2436,5,1306134120,1306135436,2,7,1316
56416261@N00,2436,4,1306117994,1306124063,4,7,6069
56416261@N00,2436,8,1306112096,1306129199,3,7,17103
56596283@N04,2437,9,1313229097,1313229347,4,1,250
56615362@N05,2438,8,1288473500,1288473500,1,1,0
56615362@N05,2439,8,1288517752,1288517752,1,1,0
56625532@N04,2440,5,1404762400,1404762400,1,1,0
56922122@N03,2441,8,1249217129,1249217129,1,1,0
56922122@N03,2442,8,1304686979,1304686979,2,1,0
56952792@N00,2443,6,1198198800,1198198800,1,1,0
56955635@N00,2444,6,1392618409,1392618409,1,1,0
56972276@N06,2445,1,1311405089,1311405089,1,1,0
56996539@N00,2446,6,1225513363,1225526817,3,1,13454
56996539@N00,2447,10,1225710002,1225710002,1,2,0
56996539@N00,2447,11,1225711052,1225715245,6,2,4193
56998983@N00,2448,1,1270481855,1270491006,5,1,9151
57073634@N00,2449,4,1435229177,1435229177,1,2,0
57073634@N00,2449,5,1435226914,1435226914,1,2,0
57104916@N04,2450,3,1310908108,1310908108,1,1,0
57169261@N06,2451,5,1369955586,1369959746,58,1,4160
57169261@N06,2452,5,1370001917,1370001920,2,1,3
57169261@N06,2453,6,1385871606,1385881350,34,1,9744
57169261@N06,2454,5,1412427751,1412436937,2,1,9186
57169261@N06,2455,6,1419752152,1419752152,1,1,0
57245945@N03,2456,5,1292647160,1292647160,1,1,0
57268629@N00,2457,5,1388725303,1388727132,3,2,1829
57268629@N00,2457,13,1388733439,1388733439,1,2,0
57268629@N00,2458,6,1388895112,1388905459,3,4,10347
57268629@N00,2458,11,1388904330,1388904739,3,4,409
57268629@N00,2458,2,1388905101,1388905101,1,4,0
57268629@N00,2458,7,1388904877,1388905033,4,4,156
57269504@N03,2459,5,1262084712,1262084712,1,1,0
57269504@N03,2460,6,1262118729,1262118729,1,1,0
57311596@N05,2461,6,1321835746,1321835769,2,2,23
57311596@N05,2461,5,1321831943,1321831943,1,2,0
57428183@N00,2462,8,1194743017,1194768932,9,1,25915
57434805@N03,2463,1,1373722000,1373722000,1,5,0
57434805@N03,2463,8,1373725233,1373725233,1,5,0
57434805@N03,2463,10,1373728380,1373728380,1,5,0
57434805@N03,2463,2,1373732508,1373732508,1,5,0
57434805@N03,2463,5,1373713450,1373722033,2,5,8583
57453992@N04,2464,4,1259819653,1259819653,1,1,0
57498635@N02,2465,12,1370823475,1370823475,1,1,0
57501091@N00,2466,8,1212393857,1212393857,1,1,0
57507580@N00,2467,4,1336393510,1336393510,1,2,0
57507580@N00,2467,3,1336394344,1336394344,1,2,0
57507580@N00,2468,4,1336552233,1336552233,1,1,0
57507580@N00,2469,8,1336869235,1336869268,3,1,33
57516324@N03,2470,5,1428369360,1428369360,1,1,0
57657053@N00,2471,1,1212282920,1212282920,1,2,0
57657053@N00,2471,6,1212288122,1212288674,2,2,552
57657053@N00,2472,6,1233453016,1233453016,1,1,0
57657053@N00,2473,8,1241222532,1241222532,1,1,0
57669645@N03,2474,1,1408791129,1408796118,3,2,4989
57669645@N03,2474,6,1408801325,1408819768,4,2,18443
57799803@N02,2475,4,1446263287,1446263287,1,1,0
57809043@N00,2476,8,1294299071,1294299071,1,1,0
57812277@N05,2477,8,1343003011,1343003011,1,1,0
57812277@N05,2478,8,1343640087,1343640087,1,1,0
57813403@N07,2479,10,1355536624,1355536624,1,9,0
57813403@N07,2479,2,1355559729,1355560104,2,9,375
57813403@N07,2479,6,1355547078,1355556226,11,9,9148
57813403@N07,2479,1,1355523504,1355560496,4,9,36992
57813403@N07,2479,4,1355528184,1355556866,7,9,28682
57813403@N07,2479,5,1355541916,1355541916,1,9,0
57813403@N07,2479,12,1355524959,1355539568,5,9,14609
57813403@N07,2479,8,1355529153,1355529327,2,9,174
57813403@N07,2479,7,1355514030,1355514030,1,9,0
57835821@N00,2480,1,1327650415,1327650718,8,4,303
57835821@N00,2480,8,1327648291,1327648291,1,4,0
57835821@N00,2480,4,1327641083,1327641092,2,4,9
57835821@N00,2480,2,1327647673,1327647709,3,4,36
57835821@N00,2481,6,1368321168,1368327135,19,5,5967
57835821@N00,2481,12,1368338076,1368338127,3,5,51
57835821@N00,2481,8,1368330140,1368332261,5,5,2121
57835821@N00,2481,2,1368339701,1368339701,1,5,0
57835821@N00,2481,7,1368338630,1368338921,6,5,291
57837862@N06,2482,1,1302084537,1302084537,1,1,0
57915028@N00,2483,2,1357445226,1357445226,1,3,0
57915028@N00,2483,6,1357440717,1357446857,2,3,6140
57915028@N00,2483,13,1357423094,1357423094,1,3,0
57915028@N00,2484,1,1357924572,1357924572,1,2,0
57915028@N00,2484,9,1357926094,1357926932,6,2,838
57959349@N00,2485,6,1328949031,1328949031,1,1,0
58013444@N04,2486,2,1288930189,1288930189,1,1,0
58013444@N04,2487,6,1293183767,1293183803,2,1,36
58013444@N04,2488,10,1405076778,1405076778,1,1,0
58019767@N00,2489,8,1329338334,1329338334,1,3,0
58019767@N00,2489,5,1329339063,1329339063,1,3,0
58019767@N00,2489,13,1329350060,1329350060,1,3,0
58114283@N00,2490,1,1201999911,1202014402,4,2,14491
58114283@N00,2490,6,1202001435,1202001435,1,2,0
58228008@N00,2491,8,1385354339,1385354339,1,6,0
58228008@N00,2491,7,1385349775,1385349871,4,6,96
58228008@N00,2491,4,1385356703,1385356710,2,6,7
58228008@N00,2491,13,1385337326,1385337351,2,6,25
58228008@N00,2491,6,1385359761,1385359790,2,6,29
58228008@N00,2491,12,1385349503,1385349730,3,6,227
58479263@N00,2492,1,1351070798,1351070798,1,2,0
58479263@N00,2492,5,1351043191,1351043191,1,2,0
58600691@N08,2493,8,1401517125,1401517125,1,1,0
58602712@N04,2494,10,1295573135,1295573135,1,1,0
58755999@N05,2495,6,1400637409,1400637530,4,1,121
58769150@N04,2496,10,1322438877,1322438877,1,2,0
58769150@N04,2496,13,1322442096,1322442096,1,2,0
58828455@N00,2497,8,1224628380,1224659304,31,1,30924
58867684@N00,2498,10,1224652173,1224652173,1,2,0
58867684@N00,2498,6,1224656612,1224656679,3,2,67
58887120@N00,2499,4,1330152453,1330152453,1,2,0
58887120@N00,2499,13,1330152629,1330152629,1,2,0
58991728@N00,2500,4,1260852621,1260852621,1,1,0
59071486@N00,2501,5,1338017906,1338017906,1,1,0
59071486@N00,2502,5,1355629675,1355629675,1,3,0
59071486@N00,2502,6,1355644321,1355646936,3,3,2615
59071486@N00,2502,4,1355639709,1355639709,1,3,0
59071486@N00,2503,5,1377423483,1377423483,1,1,0
59071486@N00,2504,6,1416989322,1416989322,1,1,0
59162053@N00,2505,4,1433059770,1433059770,1,1,0
59171457@N00,2506,7,1329628839,1329628839,1,2,0
59171457@N00,2506,9,1329638680,1329639896,2,2,1216
59288549@N02,2507,8,1347402877,1347409812,2,2,6935
59288549@N02,2507,13,1347417113,1347417301,2,2,188
59288549@N02,2508,10,1347666078,1347666078,1,1,0
59361155@N07,2509,8,1334278694,1334278694,1,2,0
59361155@N07,2509,10,1334276790,1334276790,1,2,0
59390981@N04,2510,8,1309853603,1309853603,1,1,0
59411532@N02,2511,6,1299526991,1299526991,1,3,0
59411532@N02,2511,4,1299526384,1299526384,1,3,0
59411532@N02,2511,12,1299527704,1299527704,1,3,0
59471679@N04,2512,6,1414736982,1414736982,1,2,0
59471679@N04,2512,1,1414738593,1414738593,1,2,0
59471679@N04,2513,6,1415784756,1415784756,1,1,0
59471679@N04,2514,8,1466585049,1466585049,1,1,0
59471679@N04,2515,9,1468926826,1468927411,2,1,585
59513859@N00,2516,8,1316675913,1316675913,1,3,0
59513859@N00,2516,10,1316669301,1316669301,1,3,0
59513859@N00,2516,1,1316669664,1316679347,4,3,9683
59643697@N00,2517,6,1387092428,1387094328,19,1,1900
59658856@N03,2518,8,1352346293,1352346293,1,5,0
59658856@N03,2518,12,1352350812,1352350812,1,5,0
59658856@N03,2518,1,1352343209,1352343209,1,5,0
59658856@N03,2518,4,1352346711,1352346711,1,5,0
59658856@N03,2518,13,1352331844,1352331930,2,5,86
59662848@N00,2519,6,1444978887,1444978889,2,2,2
59662848@N00,2519,4,1444977652,1444977653,2,2,1
59669438@N05,2520,5,1311490789,1311490789,1,3,0
59669438@N05,2520,8,1311490148,1311490148,1,3,0
59669438@N05,2520,1,1311493465,1311493465,1,3,0
59676428@N04,2521,8,1318290459,1318290459,1,1,0
59682384@N03,2522,10,1378787769,1378787769,1,1,0
59888795@N03,2523,6,1253237430,1253237430,1,1,0
59888795@N03,2524,12,1309921908,1309921908,1,6,0
59888795@N03,2524,11,1309930793,1309930793,1,6,0
59888795@N03,2524,8,1309928649,1309928649,1,6,0
59888795@N03,2524,3,1309922625,1309922625,1,6,0
59888795@N03,2524,7,1309930840,1309930840,1,6,0
59888795@N03,2524,1,1309928649,1309928649,1,6,0
59888795@N03,2525,8,1379320498,1379320498,1,3,0
59888795@N03,2525,5,1379299466,1379299466,1,3,0
59888795@N03,2525,2,1379288310,1379289993,2,3,1683
59888795@N03,2526,4,1379464509,1379464509,1,1,0
59888866@N00,2527,8,1216942484,1216942484,1,2,0
59888866@N00,2527,1,1216930509,1216936718,19,2,6209
59888866@N00,2528,8,1231822315,1231822986,5,1,671
59888866@N00,2529,8,1317372000,1317372000,1,1,0
59888866@N00,2530,8,1328658586,1328658586,1,1,0
59888866@N00,2531,5,1377308188,1377308188,1,1,0
59888866@N00,2532,12,1377509307,1377509307,1,1,0
59888866@N00,2533,4,1379075028,1379075028,1,1,0
59888866@N00,2534,9,1381834603,1381834603,1,1,0
59888866@N00,2535,12,1383568004,1383568004,1,1,0
59888866@N00,2536,6,1383894076,1383895135,2,1,1059
59888866@N00,2537,1,1393656015,1393656046,2,1,31
59920313@N07,2538,8,1451382214,1451382214,1,1,0
59983818@N06,2539,13,1310000018,1310000018,1,1,0
59983818@N06,2540,13,1366502609,1366505156,7,5,2547
59983818@N06,2540,6,1366512451,1366513257,4,5,806
59983818@N06,2540,4,1366501484,1366502664,5,5,1180
59983818@N06,2540,5,1366510054,1366510054,1,5,0
59983818@N06,2540,1,1366509128,1366509511,4,5,383
59983818@N06,2541,11,1366613743,1366614220,4,5,477
59983818@N06,2541,9,1366623186,1366624336,6,5,1150
59983818@N06,2541,4,1366620128,1366627427,2,5,7299
59983818@N06,2541,8,1366616896,1366617658,7,5,762
59983818@N06,2541,1,1366592610,1366629191,8,5,36581
60016896@N06,2542,10,1321055987,1321090373,2,5,34386
60016896@N06,2542,4,1321068996,1321068996,1,5,0
60016896@N06,2542,1,1321059732,1321068717,2,5,8985
60016896@N06,2542,8,1321056327,1321088720,22,5,32393
60016896@N06,2542,5,1321068574,1321068574,1,5,0
60054626@N00,2543,5,1245821067,1245824009,8,4,2942
60054626@N00,2543,1,1245825900,1245827501,2,4,1601
60054626@N00,2543,8,1245817779,1245820132,8,4,2353
60054626@N00,2543,10,1245820741,1245829907,10,4,9166
60054626@N00,2544,5,1245977841,1245977895,2,3,54
60054626@N00,2544,8,1245991669,1246001177,8,3,9508
60054626@N00,2544,2,1245992194,1245997811,16,3,5617
60054626@N00,2545,5,1246269146,1246273946,6,2,4800
60054626@N00,2545,1,1246269480,1246269545,3,2,65
60054626@N00,2546,2,1431932593,1431935013,2,1,2420
60054626@N00,2547,5,1431997724,1432021195,10,3,23471
60054626@N00,2547,8,1432024679,1432024728,5,3,49
60054626@N00,2547,2,1432000852,1432020352,22,3,19500
60082453@N05,2548,4,1428883388,1428883388,1,7,0
60082453@N05,2548,9,1428926663,1428928055,6,7,1392
60082453@N05,2548,12,1428899957,1428899957,1,7,0
60082453@N05,2548,8,1428889995,1428889995,1,7,0
60082453@N05,2548,1,1428882691,1428909427,4,7,26736
60082453@N05,2548,10,1428902189,1428902706,2,7,517
60082453@N05,2548,13,1428896939,1428898458,5,7,1519
60082453@N05,2549,4,1447372251,1447378452,2,2,6201
60082453@N05,2549,6,1447399020,1447400082,6,2,1062
60223140@N04,2550,8,1345601830,1345601830,1,3,0
60223140@N04,2550,3,1345610936,1345611294,6,3,358
60223140@N04,2550,4,1345596232,1345607363,4,3,11131
60309882@N00,2551,1,1244374833,1244374833,1,1,0
60385541@N00,2552,13,1380985604,1380985604,1,1,0
60385541@N00,2553,1,1381044927,1381044927,1,2,0
60385541@N00,2553,2,1381053925,1381053925,1,2,0
60385541@N00,2554,5,1412436475,1412438011,3,2,1536
60385541@N00,2554,8,1412433085,1412433114,2,2,29
60481456@N00,2555,4,1387394594,1387394594,1,1,0
60481456@N00,2556,4,1387478331,1387478331,1,2,0
60481456@N00,2556,5,1387478482,1387478482,1,2,0
60504322@N04,2557,9,1317391200,1317391200,51,1,0
60504322@N04,2558,9,1372230228,1372237907,18,2,7679
60504322@N04,2558,8,1372215680,1372247732,70,2,32052
60588258@N00,2559,1,1279609561,1279609561,1,2,0
60588258@N00,2559,5,1279611223,1279611715,2,2,492
60611201@N02,2560,5,1347983076,1347983076,1,1,0
60611201@N02,2561,8,1348301292,1348301292,1,1,0
60705140@N02,2562,8,1301613966,1301630907,18,1,16941
60719438@N05,2563,6,1196589691,1196589778,2,1,87
60792472@N00,2564,12,1455009715,1455009715,1,1,0
60897658@N00,2565,10,1210906824,1210907132,2,3,308
60897658@N00,2565,2,1210895259,1210898754,2,3,3495
60897658@N00,2565,4,1210891475,1210893005,3,3,1530
61083754@N04,2566,8,1199256446,1199258473,2,1,2027
61083754@N04,2567,4,1199670682,1199670682,1,2,0
61083754@N04,2567,5,1199658137,1199661903,2,2,3766
61083754@N04,2568,6,1253240104,1253240119,2,4,15
61083754@N04,2568,8,1253269140,1253269180,4,4,40
61083754@N04,2568,5,1253258448,1253258488,2,4,40
61083754@N04,2568,2,1253237570,1253239819,6,4,2249
61083754@N04,2569,6,1253324219,1253326722,4,2,2503
61083754@N04,2569,2,1253319205,1253321826,21,2,2621
61182627@N06,2570,1,1304172000,1304172000,3,1,0
61186593@N07,2571,6,1307755456,1307755456,1,1,0
61198674@N00,2572,5,1311118812,1311120364,3,6,1552
61198674@N00,2572,6,1311143331,1311143331,1,6,0
61198674@N00,2572,10,1311144601,1311144654,2,6,53
61198674@N00,2572,13,1311117735,1311117760,2,6,25
61198674@N00,2572,4,1311116824,1311134595,8,6,17771
61198674@N00,2572,8,1311124151,1311124151,1,6,0
61198674@N00,2573,12,1311240176,1311240176,1,1,0
61198674@N00,2574,5,1311377706,1311378062,3,4,356
61198674@N00,2574,2,1311377110,1311377110,1,4,0
61198674@N00,2574,4,1311374639,1311374639,1,4,0
61198674@N00,2574,11,1311377105,1311377105,1,4,0
61198674@N00,2575,10,1311412885,1311412885,1,1,0
61261095@N02,2576,1,1318481996,1318481996,1,8,0
61261095@N02,2576,3,1318480977,1318480977,1,8,0
61261095@N02,2576,4,1318481140,1318481140,1,8,0
61261095@N02,2576,10,1318482137,1318482137,1,8,0
61261095@N02,2576,5,1318482177,1318482941,9,8,764
61261095@N02,2576,6,1318480697,1318480697,1,8,0
61261095@N02,2576,13,1318481401,1318481443,2,8,42
61261095@N02,2576,8,1318481770,1318481770,1,8,0
61261095@N02,2577,9,1331637469,1331637957,2,1,488
61261095@N02,2578,2,1334144741,1334144741,1,3,0
61261095@N02,2578,5,1334142209,1334142209,1,3,0
61261095@N02,2578,8,1334145260,1334145944,2,3,684
61285553@N00,2579,1,1196562063,1196598439,2,7,36376
61285553@N00,2579,4,1196578299,1196579223,4,7,924
61285553@N00,2579,10,1196560310,1196560349,4,7,39
61285553@N00,2579,8,1196586053,1196586053,1,7,0
61285553@N00,2579,6,1196574453,1196584761,14,7,10308
61285553@N00,2579,13,1196562531,1196582358,26,7,19827
61285553@N00,2579,5,1196594160,1196598152,2,7,3992
61308976@N04,2580,11,1320192839,1320192839,1,1,0
61338634@N04,2581,10,1456180061,1456180061,1,2,0
61338634@N04,2581,1,1456180542,1456180542,1,2,0
61403222@N03,2582,1,1431393904,1431393904,1,1,0
61581248@N04,2583,2,1388620387,1388620520,2,2,133
61581248@N04,2583,12,1388620700,1388620925,2,2,225
61581248@N04,2584,10,1388702476,1388702476,1,1,0
61644290@N00,2585,5,1193894710,1193894710,1,1,0
61644290@N00,2586,7,1258071222,1258071222,1,1,0
61644290@N00,2587,1,1325797666,1325797666,1,1,0
61756292@N00,2588,4,1358577396,1358577396,1,1,0
61827589@N06,2589,9,1368350126,1368350126,1,2,0
61827589@N06,2589,5,1368344516,1368344516,1,2,0
61897832@N00,2590,8,1260445853,1260521347,65,1,75494
61897832@N00,2591,8,1292192223,1292229027,49,1,36804
61897832@N00,2592,8,1293458417,1293458421,5,1,4
61905010@N03,2593,8,1411096635,1411096635,1,2,0
61905010@N03,2593,10,1411098056,1411098056,1,2,0
61990140@N04,2594,13,1353621515,1353621515,1,2,0
61990140@N04,2594,5,1353621808,1353621808,1,2,0
62065836@N00,2595,10,1457413249,1457413249,1,1,0
62102776@N02,2596,4,1376298088,1376298088,1,1,0
62122462@N00,2597,6,1347431822,1347431822,1,1,0
62147041@N08,2598,12,1454214523,1454214523,1,1,0
62205900@N00,2599,8,1268887626,1268887682,3,2,56
62205900@N00,2599,6,1268887971,1268889826,12,2,1855
62208823@N00,2600,6,1291534963,1291534963,1,1,0
62208823@N00,2601,6,1354956692,1354956692,1,1,0
62213164@N00,2602,1,1188723773,1188724159,2,5,386
62213164@N00,2602,9,1188728819,1188730298,8,5,1479
62213164@N00,2602,5,1188730376,1188730376,1,5,0
62213164@N00,2602,8,1188724309,1188727525,4,5,3216
62213164@N00,2602,10,1188723215,1188723215,1,5,0
62221880@N00,2603,1,1307560347,1307560400,2,1,53
62221880@N00,2604,1,1307603188,1307605580,2,2,2392
62221880@N00,2604,4,1307593683,1307597032,3,2,3349
62221880@N00,2605,8,1307634466,1307646479,2,1,12013
62221880@N00,2606,13,1308971035,1308971035,1,1,0
62236593@N04,2607,12,1416981122,1416981122,1,2,0
62236593@N04,2607,4,1416976408,1416976408,1,2,0
62256889@N05,2608,11,1305873505,1305873505,1,1,0
62256889@N05,2609,3,1305932616,1305932616,1,2,0
62256889@N05,2609,6,1305937109,1305937109,1,2,0
62256889@N05,2610,9,1358667210,1358668430,3,1,1220
62372928@N03,2611,10,1368975644,1368975644,1,1,0
62486370@N00,2612,1,1191480447,1191480604,2,3,157
62486370@N00,2612,10,1191480723,1191480863,2,3,140
62486370@N00,2612,3,1191480079,1191480079,1,3,0
62486370@N00,2613,1,1192441646,1192441646,1,1,0
62486370@N00,2614,7,1288590781,1288590833,2,2,52
62486370@N00,2614,2,1288599460,1288599460,1,2,0
62547617@N04,2615,13,1322385292,1322385990,4,1,698
62595633@N06,2616,2,1370565878,1370594111,14,10,28233
62595633@N06,2616,8,1370560001,1370565217,5,10,5216
62595633@N06,2616,1,1370559823,1370605627,10,10,45804
62595633@N06,2616,6,1370568948,1370589003,5,10,20055
62595633@N06,2616,10,1370581254,1370582639,4,10,1385
62595633@N06,2616,4,1370569008,1370588785,3,10,19777
62595633@N06,2616,9,1370602994,1370604455,13,10,1461
62595633@N06,2616,11,1370594661,1370594661,1,10,0
62595633@N06,2616,13,1370572366,1370575303,4,10,2937
62595633@N06,2616,5,1370562442,1370605925,20,10,43483
62595633@N06,2617,5,1370879012,1370879012,1,1,0
62624768@N02,2618,8,1189828565,1189828565,1,1,0
62624768@N02,2619,8,1352532395,1352532395,1,2,0
62624768@N02,2619,6,1352532520,1352533536,5,2,1016
62667441@N00,2620,4,1224637971,1224637971,1,1,0
62683562@N07,2621,8,1361164599,1361170503,44,4,5904
62683562@N07,2621,7,1361143793,1361166077,4,4,22284
62683562@N07,2621,1,1361170694,1361170694,1,4,0
62683562@N07,2621,11,1361144206,1361164130,2,4,19924
62704710@N03,2622,2,1362780698,1362780698,1,1,0
62705831@N05,2623,6,1290584247,1290584247,1,1,0
62772368@N00,2624,1,1441586833,1441617414,3,4,30581
62772368@N00,2624,4,1441599748,1441600172,2,4,424
62772368@N00,2624,9,1441590721,1441623197,4,4,32476
62772368@N00,2624,8,1441597346,1441597346,1,4,0
62783804@N05,2625,13,1358476402,1358476402,1,1,0
62950363@N05,2626,1,1349004589,1349004765,4,1,176
62950363@N05,2627,11,1349047439,1349047446,2,2,7
62950363@N05,2627,1,1349049031,1349049036,3,2,5
63026829@N08,2628,2,1421834285,1421834285,1,3,0
63026829@N08,2628,6,1421834242,1421834242,1,3,0
63026829@N08,2628,5,1421834254,1421834254,1,3,0
63084736@N00,2629,13,1437794421,1437794421,1,2,0
63084736@N00,2629,4,1437803936,1437804294,2,2,358
63084736@N00,2630,5,1438414028,1438414028,1,1,0
63202442@N00,2631,8,1189418669,1189418669,1,2,0
63202442@N00,2631,7,1189417468,1189417468,1,2,0
63202442@N00,2632,13,1201304801,1201304801,1,1,0
63202442@N00,2633,5,1201513585,1201513585,1,1,0
63202442@N00,2634,10,1201757821,1201757821,1,1,0
63202442@N00,2635,8,1220850188,1220867336,2,2,17148
63202442@N00,2635,1,1220850237,1220850799,2,2,562
63202442@N00,2636,6,1221289161,1221289253,2,3,92
63202442@N00,2636,1,1221286814,1221286814,1,3,0
63202442@N00,2636,5,1221283806,1221284238,2,3,432
63202442@N00,2637,5,1264892147,1264892147,1,1,0
63202442@N00,2638,8,1265096112,1265096296,2,5,184
63202442@N00,2638,1,1265091282,1265095245,2,5,3963
63202442@N00,2638,4,1265087964,1265087964,1,5,0
63202442@N00,2638,5,1265093369,1265093369,1,5,0
63202442@N00,2638,3,1265088071,1265088071,1,5,0
63202442@N00,2639,6,1291534150,1291534150,1,1,0
63202442@N00,2640,1,1301256607,1301256607,1,1,0
63202442@N00,2641,1,1301358966,1301358966,1,1,0
63202442@N00,2642,5,1317197049,1317197049,1,1,0
63211078@N00,2643,1,1245620950,1245620950,1,2,0
63211078@N00,2643,8,1245627460,1245627460,1,2,0
63211078@N00,2644,7,1245842057,1245842057,1,1,0
63257911@N00,2645,1,1212795637,1212795637,1,5,0
63257911@N00,2645,2,1212808445,1212810720,9,5,2275
63257911@N00,2645,5,1212794158,1212797362,4,5,3204
63257911@N00,2645,4,1212803641,1212803718,4,5,77
63257911@N00,2645,8,1212795597,1212808393,4,5,12796
63257911@N00,2646,6,1229124600,1229129373,2,4,4773
63257911@N00,2646,2,1229127474,1229127474,1,4,0
63257911@N00,2646,10,1229123116,1229123116,1,4,0
63257911@N00,2646,8,1229134305,1229138904,7,4,4599
63257911@N00,2647,6,1277424037,1277424053,3,11,16
63257911@N00,2647,1,1277417229,1277418747,3,11,1518
63257911@N00,2647,2,1277417878,1277417936,2,11,58
63257911@N00,2647,10,1277430611,1277433602,2,11,2991
63257911@N00,2647,3,1277422171,1277422171,1,11,0
63257911@N00,2647,12,1277426812,1277431866,7,11,5054
63257911@N00,2647,7,1277427546,1277427546,1,11,0
63257911@N00,2647,11,1277440229,1277440949,8,11,720
63257911@N00,2647,4,1277418315,1277420329,5,11,2014
63257911@N00,2647,13,1277420395,1277420395,1,11,0
63257911@N00,2647,8,1277417415,1277435592,5,11,18177
63257911@N00,2648,2,1316939909,1316940657,5,3,748
63257911@N00,2648,10,1316935602,1316935602,1,3,0
63257911@N00,2648,4,1316936261,1316936626,4,3,365
63265130@N03,2649,4,1416452017,1416460721,28,6,8704
63265130@N03,2649,10,1416445657,1416445657,1,6,0
63265130@N03,2649,6,1416457079,1416458986,24,6,1907
63265130@N03,2649,12,1416447308,1416451688,9,6,4380
63265130@N03,2649,1,1416447066,1416447072,3,6,6
63265130@N03,2649,7,1416447277,1416449127,8,6,1850
63287267@N00,2650,11,1332921422,1332921422,1,1,0
63287402@N00,2651,6,1214976234,1214976234,1,1,0
63287402@N00,2652,6,1289201427,1289205263,2,2,3836
63287402@N00,2652,5,1289208342,1289208342,1,2,0
63287402@N00,2653,6,1304384612,1304384612,1,1,0
63287402@N00,2654,13,1305123860,1305123860,1,1,0
63287402@N00,2655,6,1305285535,1305285535,1,1,0
63330642@N06,2656,5,1374980753,1374982065,3,1,1312
63330642@N06,2657,5,1377932161,1377932161,1,1,0
63330642@N06,2658,13,1381012888,1381012888,1,1,0
63330642@N06,2659,5,1383364455,1383364455,1,3,0
63330642@N06,2659,8,1383358507,1383358574,2,3,67
63330642@N06,2659,4,1383360303,1383360329,2,3,26
63330642@N06,2660,2,1385261760,1385261760,1,1,0
63330642@N06,2661,4,1392440754,1392440754,1,1,0
63330642@N06,2662,5,1392952101,1392953977,2,1,1876
63330642@N06,2663,2,1393736369,1393736427,2,2,58
63330642@N06,2663,5,1393730111,1393730111,1,2,0
63330642@N06,2664,6,1419044444,1419044444,1,1,0
63497676@N06,2665,5,1205678089,1205678089,1,1,0
63513545@N00,2666,5,1380178556,1380179078,2,7,522
63513545@N00,2666,4,1380165210,1380168203,4,7,2993
63513545@N00,2666,6,1380162371,1380173298,6,7,10927
63513545@N00,2666,2,1380157061,1380159690,9,7,2629
63513545@N00,2666,8,1380171784,1380171899,2,7,115
63513545@N00,2666,10,1380156316,1380156316,1,7,0
63513545@N00,2666,1,1380156561,1380156561,1,7,0
63513545@N00,2667,6,1380346913,1380346913,1,1,0
63513545@N00,2668,2,1415321648,1415325481,10,1,3833
63664617@N04,2669,8,1303076473,1303122105,16,1,45632
63812709@N02,2670,10,1306402999,1306402999,1,1,0
63812709@N02,2671,6,1306576604,1306576604,1,2,0
63812709@N02,2671,9,1306572505,1306572505,1,2,0
63812709@N02,2672,6,1306806475,1306806475,1,3,0
63812709@N02,2672,4,1306811042,1306811050,2,3,8
63812709@N02,2672,10,1306800713,1306800949,2,3,236
63952466@N03,2673,4,1334563501,1334563501,1,2,0
63952466@N03,2673,5,1334560362,1334560649,3,2,287
63999590@N00,2674,8,1238796632,1238796632,1,1,0
64034302@N02,2675,13,1319455884,1319455884,1,1,0
64076251@N02,2676,4,1402182357,1402182443,2,5,86
64076251@N02,2676,2,1402195613,1402196438,2,5,825
64076251@N02,2676,5,1402178304,1402178304,1,5,0
64076251@N02,2676,6,1402204837,1402204900,2,5,63
64076251@N02,2676,8,1402186149,1402197133,2,5,10984
64102362@N06,2677,4,1349598920,1349598920,1,3,0
64102362@N06,2677,6,1349602130,1349602130,1,3,0
64102362@N06,2677,2,1349604654,1349604654,1,3,0
64102362@N06,2678,10,1393491016,1393491213,2,1,197
64171510@N00,2679,7,1247029174,1247029334,2,5,160
64171510@N00,2679,4,1247024463,1247031753,2,5,7290
64171510@N00,2679,5,1247035710,1247037199,2,5,1489
64171510@N00,2679,6,1247031570,1247031570,1,5,0
64171510@N00,2679,8,1247025212,1247029050,3,5,3838
64220937@N02,2680,8,1322615951,1322626309,2,1,10358
64342403@N02,2681,11,1292134969,1292134969,1,1,0
64406224@N07,2682,9,1372332324,1372332364,2,1,40
64440833@N05,2683,1,1303867552,1303867574,3,2,22
64440833@N05,2683,5,1303870739,1303871316,2,2,577
64440833@N05,2684,1,1313234616,1313234698,6,1,82
64440833@N05,2685,6,1387776500,1387782913,61,1,6413
64465885@N03,2686,1,1268022123,1268022123,1,3,0
64465885@N03,2686,8,1268022054,1268022054,1,3,0
64465885@N03,2686,2,1268029040,1268030628,2,3,1588
64465885@N03,2687,12,1421221057,1421221459,7,1,402
64466278@N03,2688,8,1332667194,1332667405,2,3,211
64466278@N03,2688,6,1332667218,1332667395,3,3,177
64466278@N03,2688,1,1332667418,1332667418,1,3,0
64478148@N07,2689,5,1338595922,1338597243,3,4,1321
64478148@N07,2689,6,1338602836,1338612915,5,4,10079
64478148@N07,2689,11,1338598861,1338599302,10,4,441
64478148@N07,2689,7,1338599440,1338599448,3,4,8
64478148@N07,2690,7,1351408501,1351408571,7,2,70
64478148@N07,2690,12,1351408361,1351408693,14,2,332
64478148@N07,2691,8,1368767487,1368783694,51,3,16207
64478148@N07,2691,1,1368772929,1368772929,1,3,0
64478148@N07,2691,5,1368757961,1368763543,21,3,5582
64478148@N07,2692,8,1379059358,1379066163,12,3,6805
64478148@N07,2692,1,1379065119,1379067580,3,3,2461
64478148@N07,2692,13,1379067081,1379067081,1,3,0
64478148@N07,2693,4,1384070756,1384070756,1,2,0
64478148@N07,2693,6,1384069520,1384071352,47,2,1832
64478148@N07,2694,6,1384238512,1384238512,1,1,0
64478148@N07,2695,8,1400202052,1400226298,12,5,24246
64478148@N07,2695,1,1400200925,1400237552,80,5,36627
64478148@N07,2695,4,1400213758,1400213758,1,5,0
64478148@N07,2695,6,1400189112,1400189150,3,5,38
64478148@N07,2695,2,1400206311,1400206479,4,5,168
64478148@N07,2696,8,1404519418,1404558190,18,4,38772
64478148@N07,2696,6,1404529480,1404529964,2,4,484
64478148@N07,2696,1,1404516540,1404557832,9,4,41292
64478148@N07,2696,13,1404519621,1404519704,4,4,83
64478148@N07,2697,8,1406415022,1406415806,5,2,784
64478148@N07,2697,6,1406414821,1406415624,3,2,803
64478148@N07,2698,4,1460007672,1460008174,6,1,502
64531190@N05,2699,9,1360226141,1360226141,1,1,0
64542402@N07,2700,3,1355474012,1355474012,1,10,0
64542402@N07,2700,5,1355442097,1355465251,4,10,23154
64542402@N07,2700,9,1355475813,1355477193,7,10,1380
64542402@N07,2700,7,1355462741,1355463026,2,10,285
64542402@N07,2700,6,1355447343,1355472360,11,10,25017
64542402@N07,2700,2,1355470800,1355470800,1,10,0
64542402@N07,2700,1,1355438568,1355440406,3,10,1838
64542402@N07,2700,13,1355454432,1355455861,4,10,1429
64542402@N07,2700,8,1355438683,1355458872,2,10,20189
64542402@N07,2700,10,1355444375,1355446450,5,10,2075
64561762@N00,2701,13,1271732828,1271749371,10,1,16543
64574649@N00,2702,5,1308969022,1308969022,1,1,0
64592191@N00,2703,8,1197883640,1197883661,2,1,21
64604717@N03,2704,2,1330155623,1330155623,1,1,0
64654599@N00,2705,4,1327020673,1327020673,1,4,0
64654599@N00,2705,6,1327014785,1327014809,2,4,24
64654599@N00,2705,13,1327020532,1327020635,7,4,103
64654599@N00,2705,1,1327033362,1327033622,4,4,260
64669762@N02,2706,5,1351412341,1351412341,1,1,0
64779594@N00,2707,10,1201323296,1201323296,1,1,0
64779594@N00,2708,5,1377389121,1377390013,5,1,892
64779594@N00,2709,6,1394934504,1394934504,1,1,0
64779594@N00,2710,4,1449730283,1449730283,1,2,0
64779594@N00,2710,6,1449730194,1449730194,1,2,0
64779594@N00,2711,12,1454208290,1454208352,3,2,62
64779594@N00,2711,5,1454204176,1454206332,5,2,2156
64779594@N00,2712,10,1466803386,1466803386,1,1,0
64807684@N07,2713,1,1387412467,1387412467,1,1,0
64834051@N00,2714,12,1421621846,1421665419,3,8,43573
64834051@N00,2714,6,1421636516,1421647512,2,8,10996
64834051@N00,2714,8,1421651470,1421659176,2,8,7706
64834051@N00,2714,13,1421619798,1421624951,2,8,5153
64834051@N00,2714,2,1421642221,1421643270,3,8,1049
64834051@N00,2714,1,1421629500,1421640624,3,8,11124
64834051@N00,2714,4,1421647901,1421647901,1,8,0
64834051@N00,2714,5,1421632600,1421632680,3,8,80
64834051@N00,2715,12,1421710256,1421710256,1,1,0
64834051@N00,2716,2,1438590021,1438590021,1,4,0
64834051@N00,2716,1,1438586819,1438586819,1,4,0
64834051@N00,2716,4,1438558966,1438595325,6,4,36359
64834051@N00,2716,5,1438566401,1438566401,1,4,0
64991808@N02,2717,7,1316856703,1316856703,1,1,0
65013125@N06,2718,1,1372289867,1372289867,1,3,0
65013125@N06,2718,5,1372290019,1372290097,2,3,78
65013125@N06,2718,10,1372289100,1372289100,1,3,0
65061709@N00,2719,4,1468800094,1468800094,1,1,0
65103228@N02,2720,7,1409881881,1409881881,1,1,0
65103228@N02,2721,7,1409916348,1409916348,1,1,0
65103228@N02,2722,7,1410184481,1410184481,1,1,0
65103228@N02,2723,7,1431080502,1431080502,1,1,0
65103228@N02,2724,7,1431300525,1431300525,1,1,0
65103228@N02,2725,7,1449742278,1449742278,1,1,0
65105672@N00,2726,6,1379139018,1379139018,1,2,0
65105672@N00,2726,12,1379123403,1379123403,1,2,0
65105672@N00,2727,9,1443263005,1443263005,1,2,0
65105672@N00,2727,11,1443247532,1443247570,2,2,38
65105672@N00,2728,4,1443569905,1443584627,2,5,14722
65105672@N00,2728,6,1443580159,1443580560,2,5,401
65105672@N00,2728,8,1443568508,1443589424,6,5,20916
65105672@N00,2728,1,1443587683,1443587683,1,5,0
65105672@N00,2728,13,1443586866,1443586866,1,5,0
65105672@N00,2729,8,1460595979,1460598206,3,1,2227
65105672@N00,2730,9,1460635340,1460636572,2,1,1232
65159120@N05,2731,10,1230067285,1230067285,2,1,0
65159120@N05,2732,6,1323497199,1323497199,1,1,0
65223931@N00,2733,5,1387837288,1387837288,1,4,0
65223931@N00,2733,4,1387841899,1387854691,2,4,12792
65223931@N00,2733,6,1387872090,1387873359,5,4,1269
65223931@N00,2733,1,1387844203,1387844203,1,4,0
65228321@N00,2734,4,1448446372,1448446372,1,1,0
65367128@N00,2735,8,1198390411,1198390411,1,2,0
65367128@N00,2735,6,1198390926,1198393601,9,2,2675
65367128@N00,2736,8,1211509019,1211509019,1,2,0
65367128@N00,2736,2,1211513615,1211516181,40,2,2566
65367128@N00,2737,12,1261189909,1261189909,1,1,0
65367128@N00,2738,1,1330400653,1330400653,1,1,0
65429168@N00,2739,6,1198269213,1198269261,2,2,48
65429168@N00,2739,8,1198263411,1198263565,3,2,154
65435894@N02,2740,1,1339641432,1339641432,1,1,0
65547015@N00,2741,9,1389343944,1389354944,3,7,11000
65547015@N00,2741,10,1389341386,1389341386,1,7,0
65547015@N00,2741,13,1389349305,1389349305,1,7,0
65547015@N00,2741,4,1389318300,1389331206,6,7,12906
65547015@N00,2741,1,1389333843,1389334823,2,7,980
65547015@N00,2741,8,1389316141,1389316141,1,7,0
65547015@N00,2741,5,1389342141,1389342141,2,7,0
65778609@N03,2742,6,1408407530,1408407584,2,3,54
65778609@N03,2742,5,1408408596,1408408596,1,3,0
65778609@N03,2742,13,1408414020,1408414020,1,3,0
65785294@N07,2743,11,1359966201,1359966201,1,2,0
65785294@N07,2743,7,1359961197,1359961197,1,2,0
65825924@N03,2744,1,1395654379,1395654686,2,1,307
65825924@N03,2745,8,1418805723,1418805723,1,2,0
65825924@N03,2745,6,1418807607,1418807607,1,2,0
65825924@N03,2746,1,1425979911,1425979911,1,3,0
65825924@N03,2746,13,1425976179,1425976179,1,3,0
65825924@N03,2746,6,1425978460,1425978460,1,3,0
65825924@N03,2747,12,1440468971,1440489936,3,4,20965
65825924@N03,2747,1,1440470356,1440470356,1,4,0
65825924@N03,2747,13,1440498471,1440498471,1,4,0
65825924@N03,2747,11,1440460271,1440460271,1,4,0
65825924@N03,2748,8,1458027335,1458027335,1,3,0
65825924@N03,2748,1,1458034705,1458034705,1,3,0
65825924@N03,2748,4,1458025659,1458025659,1,3,0
65825924@N03,2749,10,1458380540,1458380540,1,1,0
65856564@N08,2750,5,1386029137,1386029137,1,1,0
65976254@N05,2751,8,1323416944,1323416944,1,1,0
65987396@N00,2752,1,1308470437,1308470437,1,2,0
65987396@N00,2752,8,1308449221,1308450295,4,2,1074
66231302@N00,2753,6,1280459907,1280459907,1,1,0
66242944@N03,2754,4,1254479953,1254479953,1,1,0
66372647@N06,2755,13,1470825801,1470825801,1,1,0
66408130@N07,2756,10,1418949398,1418949398,1,1,0
66506437@N08,2757,2,1315613711,1315613711,1,1,0
66718423@N03,2758,8,1229914374,1229914374,1,2,0
66718423@N03,2758,5,1229912604,1229916273,4,2,3669
66718423@N03,2759,8,1230388948,1230389014,3,3,66
66718423@N03,2759,6,1230398804,1230403382,15,3,4578
66718423@N03,2759,5,1230390900,1230390900,1,3,0
66718423@N03,2760,5,1230862646,1230863463,3,1,817
66718423@N03,2761,5,1287543805,1287544803,3,1,998
66718423@N03,2762,1,1287922685,1287922721,3,3,36
66718423@N03,2762,5,1287922923,1287928350,7,3,5427
66718423@N03,2762,8,1287931141,1287931162,2,3,21
66718423@N03,2763,5,1287976874,1287981660,10,2,4786
66718423@N03,2763,8,1287979185,1287985357,5,2,6172
66749627@N00,2764,1,1469875426,1469875426,1,2,0
66749627@N00,2764,5,1469875002,1469875002,1,2,0
66749627@N00,2765,12,1469928040,1469928040,1,1,0
66884161@N05,2766,1,1353128116,1353128116,1,1,0
67037430@N06,2767,13,1385972854,1385973501,2,2,647
67037430@N06,2767,6,1385970105,1385975729,25,2,5624
67043514@N00,2768,5,1354071845,1354071845,1,1,0
67056982@N00,2769,11,1277353914,1277353914,1,5,0
67056982@N00,2769,13,1277343520,1277344256,4,5,736
67056982@N00,2769,1,1277346955,1277348070,5,5,1115
67056982@N00,2769,6,1277356919,1277357841,4,5,922
67056982@N00,2769,8,1277353948,1277353948,1,5,0
67093054@N00,2770,1,1324462950,1324462950,1,2,0
67093054@N00,2770,5,1324459128,1324459128,1,2,0
67123974@N05,2771,13,1361569542,1361569542,1,1,0
67214151@N00,2772,7,1399333958,1399350391,12,1,16433
67214151@N00,2773,7,1411258963,1411275265,9,1,16302
67214151@N00,2774,7,1417337162,1417339694,14,1,2532
67214151@N00,2775,7,1423379891,1423384429,6,1,4538
67237167@N03,2776,8,1388295372,1388295372,1,5,0
67237167@N03,2776,6,1388314570,1388314570,1,5,0
67237167@N03,2776,1,1388296970,1388299028,14,5,2058
67237167@N03,2776,12,1388295457,1388295609,6,5,152
67237167@N03,2776,9,1388319490,1388319520,2,5,30
67246822@N00,2777,6,1323817506,1323817506,1,4,0
67246822@N00,2777,13,1323826510,1323826510,1,4,0
67246822@N00,2777,11,1323829430,1323830050,8,4,620
67246822@N00,2777,5,1323837164,1323837164,1,4,0
67298936@N05,2778,8,1333955038,1333955038,1,1,0
67298936@N05,2779,8,1346732539,1346732539,1,1,0
67298936@N05,2780,8,1377860429,1377861106,2,1,677
67299437@N06,2781,4,1432883995,1432884010,2,1,15
67299437@N06,2782,13,1433050592,1433051639,4,4,1047
67299437@N06,2782,12,1433051721,1433051757,2,4,36
67299437@N06,2782,3,1433039677,1433039805,2,4,128
67299437@N06,2782,5,1433042883,1433049263,7,4,6380
67299437@N06,2783,4,1433215517,1433215628,3,1,111
67299437@N06,2784,4,1433397878,1433397945,4,1,67
67299437@N06,2785,4,1433542990,1433543198,2,1,208
67489881@N07,2786,12,1318597926,1318597926,1,2,0
67489881@N07,2786,13,1318585576,1318585576,1,2,0
67527549@N00,2787,7,1294114717,1294115036,12,1,319
67621043@N00,2788,6,1337122986,1337122986,1,2,0
67621043@N00,2788,5,1337123955,1337123955,1,2,0
67621043@N00,2789,11,1337722486,1337722486,1,1,0
67621043@N00,2790,7,1426585485,1426585485,1,1,0
67621043@N00,2791,1,1431047043,1431047043,1,1,0
67737010@N08,2792,1,1471169407,1471170398,2,1,991
68010648@N07,2793,6,1343450564,1343450607,2,6,43
68010648@N07,2793,5,1343436032,1343436056,2,6,24
68010648@N07,2793,1,1343435239,1343436221,3,6,982
68010648@N07,2793,13,1343443737,1343449964,3,6,6227
68010648@N07,2793,10,1343436021,1343436021,1,6,0
68010648@N07,2793,8,1343436533,1343436533,1,6,0
68010648@N07,2794,1,1343528480,1343528480,1,2,0
68010648@N07,2794,8,1343526640,1343526640,1,2,0
68010648@N07,2795,6,1343572865,1343572865,1,1,0
68067047@N00,2796,5,1428428589,1428428589,1,1,0
68169569@N07,2797,1,1244094456,1244094456,1,1,0
68174416@N00,2798,8,1304492923,1304492923,1,1,0
68235353@N00,2799,6,1328517470,1328518084,2,1,614
68311601@N00,2800,13,1245429950,1245429950,1,3,0
68311601@N00,2800,6,1245426297,1245426297,1,3,0
68311601@N00,2800,8,1245426626,1245428500,2,3,1874
68350381@N03,2801,5,1369961669,1369962479,2,3,810
68350381@N03,2801,8,1369973408,1369973408,1,3,0
68350381@N03,2801,4,1369969549,1369969549,1,3,0
68559301@N00,2802,1,1335947862,1335948043,2,1,181
68559301@N00,2803,13,1374473985,1374473985,1,1,0
68577094@N06,2804,12,1352618008,1352624482,2,1,6474
68577094@N06,2805,1,1357129766,1357129766,1,1,0
68647410@N05,2806,10,1310175368,1310175368,1,1,0
68821991@N03,2807,5,1438647585,1438647585,1,1,0
68821991@N03,2808,4,1438681833,1438681833,1,1,0
68997488@N00,2809,5,1451111905,1451111905,1,1,0
68998347@N00,2810,1,1396951647,1396951660,2,3,13
68998347@N00,2810,9,1396954007,1396954814,11,3,807
68998347@N00,2810,5,1396951755,1396952080,2,3,325
69108709@N07,2811,8,1325915470,1325915470,1,3,0
69108709@N07,2811,4,1325915876,1325915876,1,3,0
69108709@N07,2811,7,1325930252,1325930754,2,3,502
69108709@N07,2812,1,1326971117,1326971120,24,3,3
69108709@N07,2812,8,1326981862,1326981862,1,3,0
69108709@N07,2812,6,1326971120,1326971120,1,3,0
69108709@N07,2813,6,1333380267,1333382656,3,2,2389
69108709@N07,2813,5,1333364358,1333364862,4,2,504
69108709@N07,2814,1,1333418753,1333422792,2,3,4039
69108709@N07,2814,6,1333419662,1333419662,1,3,0
69108709@N07,2814,5,1333422951,1333423041,2,3,90
69108709@N07,2815,6,1333952311,1333952512,3,1,201
69116795@N00,2816,2,1285811375,1285844077,35,1,32702
69121654@N00,2817,12,1265684461,1265684931,4,1,470
69121654@N00,2818,7,1268640673,1268640673,1,1,0
69161765@N08,2819,5,1352188838,1352191020,2,3,2182
69161765@N08,2819,9,1352191775,1352191780,2,3,5
69161765@N08,2819,10,1352188818,1352188818,1,3,0
69161765@N08,2820,2,1352242050,1352242537,2,3,487
69161765@N08,2820,1,1352238487,1352238487,1,3,0
69161765@N08,2820,4,1352239236,1352239722,5,3,486
69206063@N00,2821,5,1307814452,1307814452,1,4,0
69206063@N00,2821,8,1307841947,1307841947,1,4,0
69206063@N00,2821,3,1307820749,1307820749,1,4,0
69206063@N00,2821,6,1307844448,1307844448,1,4,0
69206063@N00,2822,3,1307938817,1307940338,4,1,1521
69206229@N03,2823,8,1319850717,1319850739,4,1,22
69219361@N05,2824,2,1371425235,1371426043,5,1,808
69256737@N00,2825,8,1310775616,1310775616,1,1,0
69256737@N00,2826,8,1310809119,1310809119,1,1,0
69256737@N00,2827,8,1311235381,1311242809,3,1,7428
69271250@N00,2828,12,1448593920,1448593920,1,4,0
69271250@N00,2828,10,1448607114,1448607114,1,4,0
69271250@N00,2828,6,1448611029,1448611499,6,4,470
69271250@N00,2828,4,1448604700,1448604707,5,4,7
69301930@N03,2829,6,1315799158,1315799158,1,2,0
69301930@N03,2829,9,1315824650,1315824874,3,2,224
69343619@N08,2830,5,1371248536,1371248536,1,1,0
69389488@N00,2831,10,1226268607,1226294260,149,1,25653
69393458@N02,2832,6,1403755583,1403755583,1,1,0
69416229@N00,2833,9,1248083292,1248084573,2,1,1281
69574134@N00,2834,5,1221031591,1221031591,1,1,0
69574134@N00,2835,1,1346229028,1346238097,4,9,9069
69574134@N00,2835,10,1346221263,1346226945,4,9,5682
69574134@N00,2835,5,1346222647,1346229063,18,9,6416
69574134@N00,2835,9,1346252078,1346252709,4,9,631
69574134@N00,2835,6,1346240279,1346240506,5,9,227
69574134@N00,2835,11,1346227405,1346232493,10,9,5088
69574134@N00,2835,13,1346241494,1346242089,4,9,595
69574134@N00,2835,4,1346242939,1346242995,2,9,56
69574134@N00,2835,2,1346231063,1346231935,2,9,872
69591415@N02,2836,6,1309042905,1309042905,1,1,0
69689125@N02,2837,4,1395967933,1395967933,1,1,0
69781071@N00,2838,1,1299536209,1299580720,27,1,44511
69872692@N07,2839,4,1332312106,1332312106,1,1,0
69872692@N07,2840,6,1352531827,1352531827,1,1,0
69872692@N07,2841,1,1380243303,1380243303,1,1,0
69880349@N08,2842,12,1449071734,1449071930,2,1,196
69883003@N00,2843,5,1348611463,1348612052,2,1,589
69883003@N00,2844,11,1431826430,1431826430,1,1,0
69926337@N00,2845,6,1288077133,1288077133,1,1,0
69987114@N00,2846,12,1197598940,1197598940,1,1,0
69987114@N00,2847,11,1230192623,1230192623,1,1,0
69990708@N04,2848,9,1232675371,1232675371,1,1,0
69990708@N04,2849,9,1259586000,1259586000,1,1,0
70084804@N00,2850,2,1349165941,1349165941,1,1,0
70084804@N00,2851,6,1349483040,1349486858,2,1,3818
70626136@N00,2852,4,1348659646,1348659646,1,1,0
70862502@N00,2853,4,1330691200,1330691200,1,1,0
70862502@N00,2854,9,1330878546,1330878546,1,1,0
70862502@N00,2855,2,1331349630,1331349630,1,1,0
70862502@N00,2856,5,1358250414,1358250414,1,1,0
70862502@N00,2857,6,1384229057,1384229057,1,2,0
70862502@N00,2857,4,1384232157,1384232157,1,2,0
70862502@N00,2858,1,1384322820,1384322820,1,1,0
70926999@N00,2859,5,1406343937,1406348341,3,1,4404
70926999@N00,2860,11,1406687723,1406687723,1,7,0
70926999@N00,2860,3,1406695484,1406695529,5,7,45
70926999@N00,2860,8,1406693695,1406693695,1,7,0
70926999@N00,2860,7,1406687125,1406687125,1,7,0
70926999@N00,2860,2,1406691739,1406691739,1,7,0
70926999@N00,2860,5,1406688120,1406689091,6,7,971
70926999@N00,2860,6,1406694482,1406699608,3,7,5126
70928085@N00,2861,5,1224024850,1224026190,4,5,1340
70928085@N00,2861,13,1224031610,1224036229,5,5,4619
70928085@N00,2861,11,1224037388,1224037388,1,5,0
70928085@N00,2861,1,1224059009,1224059009,1,5,0
70928085@N00,2861,8,1224037351,1224038932,4,5,1581
70944869@N00,2862,9,1423984884,1423988735,3,1,3851
70944869@N00,2863,6,1429586928,1429586928,1,2,0
70944869@N00,2863,8,1429595914,1429595914,1,2,0
71121295@N00,2864,8,1362960713,1362960713,1,1,0
71128153@N00,2865,8,1369386390,1369386392,2,2,2
71128153@N00,2865,1,1369386543,1369386543,1,2,0
7128421@N05,2866,1,1457031361,1457031361,1,1,0
71307440@N00,2867,6,1401410839,1401410862,2,1,23
71307440@N00,2868,4,1401442708,1401442708,1,1,0
71369646@N00,2869,2,1382778659,1382778659,1,2,0
71369646@N00,2869,6,1382780946,1382780946,1,2,0
7151738@N03,2870,6,1353137235,1353137235,1,1,0
7151738@N03,2871,11,1393282256,1393297649,10,2,15393
7151738@N03,2871,13,1393299101,1393299101,1,2,0
7151738@N03,2872,2,1396668161,1396668169,2,2,8
7151738@N03,2872,13,1396671942,1396671948,2,2,6
7151738@N03,2873,13,1415486233,1415501056,3,4,14823
7151738@N03,2873,10,1415513293,1415513293,1,4,0
7151738@N03,2873,1,1415511505,1415512946,4,4,1441
7151738@N03,2873,4,1415487663,1415503780,20,4,16117
7151738@N03,2874,12,1421536140,1421542097,4,2,5957
7151738@N03,2874,8,1421536516,1421536516,1,2,0
71854985@N00,2875,1,1332556362,1332556387,3,1,25
71922377@N00,2876,1,1372998009,1372998009,1,1,0
71922377@N00,2877,6,1387599159,1387599159,1,1,0
71922377@N00,2878,2,1409526898,1409531726,2,1,4828
7195717@N05,2879,4,1294716187,1294716187,1,1,0
71965292@N00,2880,7,1213140401,1213140658,72,1,257
7200488@N08,2881,8,1195594700,1195594700,1,1,0
7206981@N03,2882,8,1244937631,1244937631,1,4,0
7206981@N03,2882,1,1244937569,1244937569,1,4,0
7206981@N03,2882,5,1244936682,1244936682,1,4,0
7206981@N03,2882,10,1244935991,1244935991,1,4,0
72126458@N00,2883,5,1311125431,1311125437,2,3,6
72126458@N00,2883,6,1311146309,1311148385,7,3,2076
72126458@N00,2883,10,1311141713,1311142998,75,3,1285
72143850@N00,2884,5,1336040603,1336040603,1,1,0
72324747@N00,2885,1,1287401795,1287401795,1,1,0
72324747@N00,2886,8,1287803574,1287803574,1,1,0
72324747@N00,2887,4,1288081056,1288081056,1,1,0
7239561@N06,2888,8,1230717605,1230732483,4,1,14878
7256184@N02,2889,12,1228955854,1228962994,12,2,7140
7256184@N02,2889,6,1228971280,1228975875,5,2,4595
7256454@N05,2890,12,1214364752,1214365926,23,2,1174
7256454@N05,2890,6,1214386481,1214386481,1,2,0
7256454@N05,2891,2,1214616827,1214620051,10,2,3224
7256454@N05,2891,8,1214621792,1214621796,2,2,4
7256454@N05,2892,12,1214708857,1214715254,43,6,6397
7256454@N05,2892,2,1214711341,1214711511,13,6,170
7256454@N05,2892,10,1214718903,1214718917,5,6,14
7256454@N05,2892,1,1214716453,1214716577,6,6,124
7256454@N05,2892,8,1214710836,1214715985,28,6,5149
7256454@N05,2892,4,1214710233,1214712142,25,6,1909
7256454@N05,2893,6,1245032252,1245032388,5,1,136
7256454@N05,2894,12,1310085231,1310085231,1,3,0
7256454@N05,2894,6,1310088442,1310089120,9,3,678
7256454@N05,2894,8,1310085057,1310085057,1,3,0
72589879@N00,2895,5,1348921249,1348922389,8,1,1140
72670227@N06,2896,5,1429327476,1429344723,29,4,17247
72670227@N06,2896,4,1429333943,1429334613,23,4,670
72670227@N06,2896,10,1429346125,1429346125,1,4,0
72670227@N06,2896,13,1429321724,1429325651,30,4,3927
72685908@N00,2897,5,1380184047,1380184047,1,2,0
72685908@N00,2897,2,1380183792,1380183792,1,2,0
72776097@N00,2898,8,1206133393,1206133401,2,1,8
72844756@N00,2899,5,1250022902,1250022902,1,1,0
72844756@N00,2900,8,1250069465,1250069465,1,1,0
7286287@N03,2901,6,1341820364,1341820364,1,5,0
7286287@N03,2901,5,1341819159,1341824657,2,5,5498
7286287@N03,2901,8,1341809789,1341809789,1,5,0
7286287@N03,2901,4,1341813178,1341820282,3,5,7104
7286287@N03,2901,7,1341809676,1341809676,1,5,0
7287512@N02,2902,12,1270704520,1270709252,7,4,4732
7287512@N02,2902,6,1270723263,1270723263,1,4,0
7287512@N02,2902,7,1270708210,1270708210,1,4,0
7287512@N02,2902,1,1270724895,1270724895,1,4,0
72915363@N00,2903,1,1206950390,1206950390,1,1,0
73055057@N00,2904,8,1323407954,1323411703,8,1,3749
7305851@N07,2905,4,1353811190,1353811190,1,1,0
73105116@N00,2906,5,1273783038,1273783491,2,2,453
73105116@N00,2906,1,1273782646,1273782646,1,2,0
73114641@N00,2907,5,1425715048,1425719384,5,1,4336
7311921@N08,2908,8,1189223731,1189232206,9,1,8475
7311921@N08,2909,8,1189287130,1189287130,1,1,0
73234653@N00,2910,11,1373675146,1373704944,9,1,29798
73265016@N00,2911,6,1207867884,1207869804,4,1,1920
73427821@N00,2912,7,1257818412,1257818445,8,2,33
73427821@N00,2912,1,1257831227,1257831259,4,2,32
73427821@N00,2913,8,1332608916,1332609050,6,4,134
73427821@N00,2913,7,1332595046,1332595921,9,4,875
73427821@N00,2913,4,1332607890,1332608674,25,4,784
73427821@N00,2913,6,1332589790,1332606967,46,4,17177
73427821@N00,2914,8,1345860803,1345871566,23,4,10763
73427821@N00,2914,1,1345852875,1345882986,24,4,30111
73427821@N00,2914,12,1345887604,1345887605,2,4,1
73427821@N00,2914,4,1345866655,1345866952,3,4,297
73427821@N00,2915,6,1353034874,1353034933,5,1,59
73427821@N00,2916,5,1369329798,1369329934,9,2,136
73427821@N00,2916,1,1369314649,1369315615,6,2,966
73427821@N00,2917,5,1369976178,1369978316,9,2,2138
73427821@N00,2917,4,1369974048,1369974054,3,2,6
73451901@N00,2918,8,1350974139,1350974369,2,4,230
73451901@N00,2918,1,1350954266,1350956843,2,4,2577
73451901@N00,2918,5,1350955086,1350956322,2,4,1236
73451901@N00,2918,6,1350964465,1350964465,1,4,0
73451901@N00,2919,6,1351146546,1351146546,1,2,0
73451901@N00,2919,5,1351146658,1351146658,1,2,0
73451901@N00,2920,2,1358032591,1358032591,1,1,0
7349370@N04,2921,6,1242105453,1242105453,1,7,0
7349370@N04,2921,10,1242090155,1242093508,22,7,3353
7349370@N04,2921,1,1242089664,1242112888,8,7,23224
7349370@N04,2921,8,1242094225,1242112530,7,7,18305
7349370@N04,2921,5,1242089831,1242091686,7,7,1855
7349370@N04,2921,7,1242097797,1242098275,8,7,478
7349370@N04,2921,2,1242094425,1242095308,4,7,883
7349370@N04,2922,8,1260750738,1260750738,1,2,0
7349370@N04,2922,12,1260755452,1260755452,1,2,0
7356139@N05,2923,5,1362531100,1362531100,1,1,0
7357708@N03,2924,8,1319639783,1319639783,1,1,0
73596184@N00,2925,6,1299290707,1299290742,3,2,35
73596184@N00,2925,13,1299284754,1299284754,1,2,0
73596184@N00,2926,5,1299900500,1299900500,1,1,0
7366969@N02,2927,1,1336083622,1336128524,69,1,44902
7366969@N02,2928,13,1336867224,1336887510,51,1,20286
7366969@N02,2929,8,1391648353,1391675866,110,2,27513
7366969@N02,2929,9,1391673019,1391673019,1,2,0
7366969@N02,2930,10,1392281787,1392281925,2,4,138
7366969@N02,2930,8,1392281173,1392281183,2,4,10
7366969@N02,2930,1,1392281254,1392281258,2,4,4
7366969@N02,2930,9,1392278431,1392280035,14,4,1604
7366969@N02,2931,10,1392348735,1392350519,13,1,1784
7367216@N05,2932,4,1218796986,1218796986,1,1,0
7367216@N05,2933,4,1218859708,1218859708,1,1,0
7367216@N05,2934,5,1218932191,1218932191,1,2,0
7367216@N05,2934,4,1218935018,1218935018,1,2,0
7367216@N05,2935,12,1239060658,1239067080,2,1,6422
7367216@N05,2936,2,1341653009,1341654563,3,1,1554
7367216@N05,2937,13,1348709056,1348710111,4,1,1055
7367216@N05,2938,8,1348921839,1348931061,4,1,9222
73719225@N00,2939,5,1379821286,1379821286,1,1,0
7372061@N07,2940,13,1286532879,1286542173,25,1,9294
73783753@N00,2941,11,1275200685,1275200699,2,1,14
73799444@N00,2942,5,1198036005,1198036060,2,3,55
73799444@N00,2942,9,1198047382,1198047382,1,3,0
73799444@N00,2942,1,1198052432,1198052432,1,3,0
7397135@N04,2943,8,1327550814,1327550814,1,1,0
74025099@N03,2944,1,1387602743,1387602833,2,2,90
74025099@N03,2944,7,1387602914,1387602914,1,2,0
74081331@N00,2945,6,1400916502,1400916502,1,1,0
74089168@N00,2946,9,1382426176,1382426176,1,1,0
74089168@N00,2947,4,1447829788,1447829788,1,1,0
74101007@N00,2948,2,1190096783,1190112923,79,1,16140
7416177@N04,2949,13,1293656938,1293693579,19,1,36641
7416177@N04,2950,13,1293947832,1293948220,2,1,388
74246558@N00,2951,4,1468214583,1468214583,1,1,0
74289372@N00,2952,6,1318985324,1318985324,1,4,0
74289372@N00,2952,5,1318994168,1318995427,4,4,1259
74289372@N00,2952,8,1318988819,1318988819,1,4,0
74289372@N00,2952,4,1318980129,1318983346,2,4,3217
74366817@N06,2953,5,1389941426,1389941708,2,2,282
74366817@N06,2953,6,1389936680,1389936680,1,2,0
74366817@N06,2954,8,1400395717,1400395717,1,1,0
74366817@N06,2955,5,1402021773,1402021773,1,1,0
74372164@N04,2956,11,1352416708,1352416708,1,1,0
74417388@N08,2957,13,1382235128,1382235128,1,1,0
74461555@N05,2958,10,1330756555,1330756651,2,2,96
74461555@N05,2958,2,1330756631,1330756631,1,2,0
74461555@N05,2959,8,1336172455,1336174554,3,2,2099
74461555@N05,2959,4,1336170501,1336170501,1,2,0
74461555@N05,2960,8,1336258531,1336293127,6,1,34596
74461555@N05,2961,1,1338632550,1338633123,4,3,573
74461555@N05,2961,4,1338587607,1338589135,2,3,1528
74461555@N05,2961,8,1338587142,1338633469,3,3,46327
74461555@N05,2962,10,1338686061,1338686061,1,1,0
74461555@N05,2963,6,1375442084,1375442084,1,4,0
74461555@N05,2963,1,1375440443,1375441506,3,4,1063
74461555@N05,2963,4,1375441925,1375441925,1,4,0
74461555@N05,2963,5,1375441008,1375441008,1,4,0
74461555@N05,2964,6,1417416836,1417418730,4,2,1894
74461555@N05,2964,12,1417420816,1417420816,1,2,0
74689807@N03,2965,6,1393211542,1393211542,1,1,0
74712199@N00,2966,6,1334890479,1334890479,1,1,0
74741442@N08,2967,8,1450440288,1450440288,1,1,0
74754977@N03,2968,8,1468995424,1468995424,1,1,0
74822965@N00,2969,4,1370652109,1370661651,4,1,9542
74865359@N00,2970,2,1386837604,1386838009,3,1,405
74865359@N00,2971,8,1386894639,1386894639,1,3,0
74865359@N00,2971,1,1386893875,1386893875,1,3,0
74865359@N00,2971,5,1386892705,1386892800,2,3,95
74865359@N00,2972,1,1391590134,1391590134,1,2,0
74865359@N00,2972,9,1391588575,1391589360,5,2,785
74878854@N00,2973,2,1337326115,1337326115,1,1,0
74939715@N05,2974,5,1364892450,1364892450,1,1,0
74985978@N00,2975,3,1353192069,1353192069,1,1,0
75091505@N00,2976,13,1347875988,1347875988,1,1,0
75132636@N00,2977,8,1228107025,1228127559,19,1,20534
75338025@N07,2978,2,1383636614,1383636614,1,8,0
75338025@N07,2978,1,1383616822,1383616946,5,8,124
75338025@N07,2978,5,1383617052,1383618493,5,8,1441
75338025@N07,2978,4,1383624478,1383624491,2,8,13
75338025@N07,2978,13,1383628261,1383628278,4,8,17
75338025@N07,2978,8,1383636115,1383636191,3,8,76
75338025@N07,2978,10,1383616623,1383634459,16,8,17836
75338025@N07,2978,6,1383620951,1383636900,5,8,15949
75421381@N00,2979,4,1223365328,1223365328,1,1,0
75555566@N05,2980,11,1349398935,1349407148,11,1,8213
75601845@N06,2981,7,1209105142,1209107387,12,1,2245
75601845@N06,2982,7,1209533898,1209547139,11,1,13241
75601845@N06,2983,7,1209896605,1209902171,45,1,5566
75601845@N06,2984,7,1210247156,1210247696,6,1,540
75601845@N06,2985,7,1283837474,1283859802,441,1,22328
75601845@N06,2986,7,1284283252,1284290826,3,1,7574
75601845@N06,2987,7,1322992269,1323011640,226,1,19371
75601845@N06,2988,7,1323437073,1323441505,52,1,4432
75601845@N06,2989,7,1323684201,1323689554,67,1,5353
75637646@N07,2990,4,1423369204,1423369204,1,2,0
75637646@N07,2990,6,1423358664,1423358664,1,2,0
7573710@N02,2991,1,1231628798,1231628798,1,1,0
7573710@N02,2992,5,1232272238,1232273382,10,1,1144
75990687@N05,2993,5,1454191715,1454191720,2,3,5
75990687@N05,2993,7,1454201086,1454201086,1,3,0
75990687@N05,2993,9,1454195157,1454195232,4,3,75
76024515@N07,2994,8,1316318795,1316331948,2,1,13153
76024515@N07,2995,5,1347946570,1347946570,1,2,0
76024515@N07,2995,13,1347934886,1347934886,1,2,0
76024515@N07,2996,6,1348114367,1348114367,1,2,0
76024515@N07,2996,9,1348129778,1348129778,1,2,0
76032222@N00,2997,10,1223940156,1223940263,2,1,107
7612058@N04,2998,5,1254165433,1254165433,1,3,0
7612058@N04,2998,1,1254160284,1254160292,2,3,8
7612058@N04,2998,11,1254165018,1254165018,1,3,0
7612058@N04,2999,8,1254399553,1254399553,1,2,0
7612058@N04,2999,1,1254411619,1254411619,1,2,0
76131376@N03,3000,1,1361058670,1361058670,1,4,0
76131376@N03,3000,5,1361066410,1361066482,3,4,72
76131376@N03,3000,8,1361064712,1361064712,1,4,0
76131376@N03,3000,6,1361074494,1361074494,1,4,0
76151808@N00,3001,10,1234481431,1234481431,1,7,0
76151808@N00,3001,1,1234486266,1234488451,2,7,2185
76151808@N00,3001,11,1234483088,1234484021,5,7,933
76151808@N00,3001,6,1234498467,1234500884,5,7,2417
76151808@N00,3001,8,1234485776,1234491980,3,7,6204
76151808@N00,3001,9,1234514875,1234516563,2,7,1688
76151808@N00,3001,4,1234501825,1234501825,1,7,0
76151808@N00,3002,10,1234763960,1234763960,1,5,0
76151808@N00,3002,7,1234745129,1234745129,1,5,0
76151808@N00,3002,11,1234741043,1234746855,4,5,5812
76151808@N00,3002,5,1234766836,1234766990,3,5,154
76151808@N00,3002,4,1234752142,1234752142,1,5,0
76151808@N00,3003,1,1266025105,1266036803,3,7,11698
76151808@N00,3003,11,1266029008,1266029008,1,7,0
76151808@N00,3003,6,1266042379,1266042379,1,7,0
76151808@N00,3003,8,1266036007,1266036007,1,7,0
76151808@N00,3003,4,1266043078,1266043078,1,7,0
76151808@N00,3003,3,1266043092,1266043092,1,7,0
76151808@N00,3003,7,1266044163,1266046322,4,7,2159
76151808@N00,3004,10,1266308509,1266308509,1,8,0
76151808@N00,3004,1,1266299519,1266308367,3,8,8848
76151808@N00,3004,5,1266309781,1266309781,1,8,0
76151808@N00,3004,11,1266282196,1266282196,1,8,0
76151808@N00,3004,6,1266287720,1266291644,5,8,3924
76151808@N00,3004,8,1266296478,1266298180,4,8,1702
76151808@N00,3004,9,1266311114,1266312335,3,8,1221
76151808@N00,3004,7,1266307881,1266307881,1,8,0
76151808@N00,3005,1,1266452148,1266459722,3,3,7574
76151808@N00,3005,6,1266454942,1266455065,2,3,123
76151808@N00,3005,4,1266455490,1266455490,1,3,0
76151808@N00,3006,1,1297904725,1297928651,4,3,23926
76151808@N00,3006,6,1297917039,1297922952,4,3,5913
76151808@N00,3006,2,1297898209,1297898209,1,3,0
76151808@N00,3007,1,1298518142,1298522196,2,1,4054
76151808@N00,3008,13,1345687339,1345687339,1,3,0
76151808@N00,3008,2,1345693029,1345693029,1,3,0
76151808@N00,3008,3,1345688576,1345688576,1,3,0
76151808@N00,3009,8,1361502472,1361502472,1,1,0
76151808@N00,3010,2,1388395435,1388395435,1,2,0
76151808@N00,3010,6,1388393973,1388393973,1,2,0
76151808@N00,3011,2,1424226404,1424226404,1,3,0
76151808@N00,3011,1,1424230382,1424230390,3,3,8
76151808@N00,3011,13,1424236739,1424236739,1,3,0
76151808@N00,3012,6,1424583203,1424583590,2,1,387
76151808@N00,3013,6,1451376298,1451376934,2,1,636
76152450@N07,3014,1,1280900708,1280900708,1,1,0
76235804@N08,3015,3,1355982411,1355982411,1,1,0
76235804@N08,3016,8,1356072699,1356072699,1,2,0
76235804@N08,3016,2,1356072197,1356072197,1,2,0
7635377@N05,3017,5,1221293016,1221293346,8,1,330
76430348@N02,3018,2,1338093703,1338096345,7,2,2642
76430348@N02,3018,6,1338100252,1338100252,1,2,0
7664041@N07,3019,8,1391405053,1391415331,10,1,10278
7664041@N07,3020,8,1391474636,1391492793,11,1,18157
76663697@N00,3021,6,1212562338,1212566102,9,4,3764
76663697@N00,3021,4,1212562056,1212562056,1,4,0
76663697@N00,3021,13,1212558143,1212559064,3,4,921
76663697@N00,3021,8,1212561641,1212567926,2,4,6285
76665138@N00,3022,8,1263349529,1263349529,1,1,0
76665138@N00,3023,2,1274404551,1274404551,1,1,0
76665138@N00,3024,12,1326162727,1326163836,4,7,1109
76665138@N00,3024,3,1326153446,1326153457,2,7,11
76665138@N00,3024,5,1326160710,1326160710,1,7,0
76665138@N00,3024,4,1326152306,1326153091,2,7,785
76665138@N00,3024,8,1326165393,1326165624,3,7,231
76665138@N00,3024,6,1326154756,1326155958,3,7,1202
76665138@N00,3024,2,1326157165,1326158014,4,7,849
76665138@N00,3025,12,1326434810,1326437623,5,4,2813
76665138@N00,3025,10,1326438242,1326438242,1,4,0
76665138@N00,3025,6,1326432621,1326433795,3,4,1174
76665138@N00,3025,4,1326429092,1326429405,3,4,313
76665138@N00,3026,12,1326497448,1326498594,2,2,1146
76665138@N00,3026,4,1326494725,1326499161,2,2,4436
76692421@N02,3027,4,1355677882,1355677882,1,1,0
76704164@N00,3028,9,1371648268,1371648268,1,3,0
76704164@N00,3028,6,1371640354,1371640354,1,3,0
76704164@N00,3028,5,1371620618,1371622998,2,3,2380
76704164@N00,3029,12,1371697060,1371697060,1,1,0
76730958@N07,3030,13,1365035819,1365035819,1,1,0
76730958@N07,3031,1,1365297219,1365297219,1,4,0
76730958@N07,3031,4,1365290356,1365290356,1,4,0
76730958@N07,3031,5,1365303270,1365303270,1,4,0
76730958@N07,3031,13,1365288416,1365288416,1,4,0
76766156@N06,3032,4,1359874457,1359886888,5,10,12431
76766156@N06,3032,8,1359872813,1359903291,6,10,30478
76766156@N06,3032,6,1359875623,1359894000,5,10,18377
76766156@N06,3032,2,1359877454,1359881200,4,10,3746
76766156@N06,3032,13,1359885552,1359886714,13,10,1162
76766156@N06,3032,12,1359877652,1359885147,11,10,7495
76766156@N06,3032,5,1359871142,1359872312,4,10,1170
76766156@N06,3032,10,1359869726,1359897664,4,10,27938
76766156@N06,3032,9,1359900324,1359901838,15,10,1514
76766156@N06,3032,1,1359887227,1359887242,2,10,15
76766156@N06,3033,5,1390906441,1390906441,1,2,0
76766156@N06,3033,1,1390907019,1390907143,7,2,124
7677428@N07,3034,4,1350799601,1350799601,1,3,0
7677428@N07,3034,13,1350799707,1350799707,1,3,0
7677428@N07,3034,8,1350799672,1350799672,1,3,0
76954449@N08,3035,5,1368577265,1368577265,1,1,0
7717393@N02,3036,11,1264004482,1264004482,1,1,0
77179348@N00,3037,1,1342079126,1342089721,6,11,10595
77179348@N00,3037,13,1342091706,1342091816,2,11,110
77179348@N00,3037,5,1342079320,1342093680,13,11,14360
77179348@N00,3037,11,1342089970,1342089970,1,11,0
77179348@N00,3037,7,1342081542,1342084076,13,11,2534
77179348@N00,3037,6,1342090283,1342091385,7,11,1102
77179348@N00,3037,8,1342080191,1342082878,19,11,2687
77179348@N00,3037,12,1342083638,1342083822,6,11,184
77179348@N00,3037,4,1342091488,1342091488,1,11,0
77179348@N00,3037,9,1342094823,1342097816,15,11,2993
77179348@N00,3037,10,1342078755,1342094498,3,11,15743
77179348@N00,3038,1,1342254002,1342254006,2,6,4
77179348@N00,3038,7,1342252511,1342253784,12,6,1273
77179348@N00,3038,11,1342246373,1342246373,1,6,0
77179348@N00,3038,12,1342253787,1342253787,1,6,0
77179348@N00,3038,8,1342246377,1342246377,1,6,0
77179348@N00,3038,2,1342246433,1342251257,6,6,4824
77179348@N00,3039,1,1442566843,1442566900,6,4,57
77179348@N00,3039,5,1442566998,1442568601,14,4,1603
77179348@N00,3039,9,1442568927,1442572473,60,4,3546
77179348@N00,3039,10,1442566571,1442572688,10,4,6117
77179348@N00,3040,11,1442642833,1442642833,1,9,0
77179348@N00,3040,10,1442635663,1442635665,2,9,2
77179348@N00,3040,8,1442640177,1442642869,31,9,2692
77179348@N00,3040,4,1442633113,1442652349,37,9,19236
77179348@N00,3040,1,1442632887,1442638327,6,9,5440
77179348@N00,3040,6,1442642219,1442659990,53,9,17771
77179348@N00,3040,13,1442633043,1442653728,45,9,20685
77179348@N00,3040,5,1442635724,1442636792,14,9,1068
77179348@N00,3040,2,1442641896,1442654826,30,9,12930
77395664@N00,3041,13,1412432793,1412432804,2,7,11
77395664@N00,3041,5,1412441114,1412441156,2,7,42
77395664@N00,3041,1,1412438095,1412438534,6,7,439
77395664@N00,3041,4,1412435348,1412436033,2,7,685
77395664@N00,3041,2,1412436293,1412436812,3,7,519
77395664@N00,3041,8,1412438107,1412438427,2,7,320
77395664@N00,3041,6,1412436122,1412436122,1,7,0
77437178@N00,3042,7,1273200941,1273200941,1,2,0
77437178@N00,3042,8,1273183020,1273202157,3,2,19137
77437178@N00,3043,8,1346380334,1346380334,1,1,0
77437178@N00,3044,8,1346466489,1346466489,1,1,0
77463997@N03,3045,13,1355093491,1355093491,1,1,0
77463997@N03,3046,4,1358140392,1358140392,1,1,0
77463997@N03,3047,8,1367548986,1367548986,1,1,0
77463997@N03,3048,4,1386040765,1386040765,1,1,0
77463997@N03,3049,4,1388456716,1388456716,1,1,0
77463997@N03,3050,4,1388546186,1388546186,1,1,0
77463997@N03,3051,13,1394104324,1394104324,1,1,0
77463997@N03,3052,8,1406933793,1406933793,1,1,0
77463997@N03,3053,8,1420549519,1420549519,1,1,0
77463997@N03,3054,1,1425109229,1425109229,1,1,0
77463997@N03,3055,12,1425898554,1425898554,1,1,0
77463997@N03,3056,10,1440724571,1440724571,1,1,0
77463997@N03,3057,10,1441368936,1441368936,1,1,0
77463997@N03,3058,8,1442527643,1442527643,1,1,0
77463997@N03,3059,6,1446885152,1446885152,1,1,0
77463997@N03,3060,6,1447233127,1447233127,1,1,0
77463997@N03,3061,6,1447668137,1447668137,1,1,0
77463997@N03,3062,10,1449203278,1449203278,1,1,0
77463997@N03,3063,8,1453415851,1453415851,1,1,0
77463997@N03,3064,10,1454014840,1454014840,1,1,0
77463997@N03,3065,10,1458255437,1458255437,1,1,0
77463997@N03,3066,6,1459372979,1459372979,1,1,0
77463997@N03,3067,4,1459784490,1459784490,1,1,0
77463997@N03,3068,4,1459990068,1459990068,1,1,0
77503031@N00,3069,8,1261672153,1261672869,21,3,716
77503031@N00,3069,6,1261672612,1261672612,1,3,0
77503031@N00,3069,2,1261672145,1261672911,3,3,766
77545914@N00,3070,6,1268014566,1268045147,6,5,30581
77545914@N00,3070,2,1268033748,1268036844,7,5,3096
77545914@N00,3070,1,1268010950,1268010950,1,5,0
77545914@N00,3070,4,1268016494,1268016494,1,5,0
77545914@N00,3070,5,1268010520,1268027391,5,5,16871
77573771@N00,3071,4,1230253621,1230253621,1,1,0
77692940@N00,3072,2,1367544719,1367544724,2,1,5
7772172@N02,3073,8,1298689781,1298706940,32,1,17159
77744839@N00,3074,5,1389679894,1389679894,1,6,0
77744839@N00,3074,13,1389676108,1389688268,7,6,12160
77744839@N00,3074,7,1389683852,1389683852,1,6,0
77744839@N00,3074,12,1389683304,1389683304,1,6,0
77744839@N00,3074,2,1389684192,1389684411,2,6,219
77744839@N00,3074,4,1389678075,1389678075,1,6,0
77744839@N00,3075,8,1389739866,1389739866,1,4,0
77744839@N00,3075,11,1389742326,1389742326,1,4,0
77744839@N00,3075,6,1389744769,1389756832,2,4,12063
77744839@N00,3075,5,1389737583,1389738008,2,4,425
7776897@N02,3076,8,1223164185,1223192856,21,1,28671
7776897@N02,3077,8,1223254766,1223255233,3,1,467
7784444@N07,3078,8,1253427752,1253442807,152,1,15055
7784444@N07,3079,8,1284418242,1284455872,301,1,37630
7784444@N07,3080,8,1299366686,1299403267,163,1,36581
7784444@N07,3081,8,1307142269,1307167289,108,1,25020
7784444@N07,3082,8,1376695662,1376702062,40,1,6400
77932199@N07,3083,10,1341022488,1341025844,20,2,3356
77932199@N07,3083,8,1341031235,1341033424,29,2,2189
77932199@N07,3084,1,1341401034,1341401958,5,2,924
77932199@N07,3084,6,1341395120,1341395120,1,2,0
77932199@N07,3085,1,1356267241,1356267241,1,1,0
77932199@N07,3086,5,1374373927,1374373927,1,1,0
77987119@N08,3087,4,1327297283,1327297283,1,2,0
77987119@N08,3087,8,1327292600,1327292962,7,2,362
78027754@N00,3088,2,1361590805,1361590805,1,1,0
78027754@N00,3089,1,1361702952,1361702952,1,1,0
7804123@N08,3090,2,1410244304,1410244304,1,2,0
7804123@N08,3090,4,1410267683,1410267683,1,2,0
78089576@N06,3091,6,1333250233,1333250233,1,1,0
78132024@N00,3092,6,1389320926,1389320926,1,1,0
78262954@N05,3093,8,1364857756,1364894826,42,1,37070
78299922@N08,3094,8,1281573293,1281573293,1,2,0
78299922@N08,3094,5,1281569422,1281569422,1,2,0
7830943@N03,3095,6,1381643136,1381643136,1,4,0
7830943@N03,3095,11,1381640124,1381640124,1,4,0
7830943@N03,3095,4,1381637289,1381639938,2,4,2649
7830943@N03,3095,8,1381643911,1381643911,1,4,0
78345092@N07,3096,5,1372748220,1372751575,2,4,3355
78345092@N07,3096,1,1372748348,1372748348,1,4,0
78345092@N07,3096,4,1372735276,1372735276,1,4,0
78345092@N07,3096,13,1372745633,1372745633,1,4,0
78364960@N04,3097,9,1338202830,1338203935,2,3,1105
78364960@N04,3097,8,1338172445,1338172649,2,3,204
78364960@N04,3097,12,1338179126,1338179443,3,3,317
78364960@N04,3098,12,1343731236,1343731236,1,1,0
78364960@N04,3099,8,1344492636,1344493008,3,1,372
78364960@N04,3100,13,1353121293,1353122828,4,1,1535
78364960@N04,3101,8,1354252722,1354252794,2,2,72
78364960@N04,3101,11,1354251167,1354251811,2,2,644
78364960@N04,3102,6,1354956506,1354956506,1,1,0
78364960@N04,3103,12,1361153282,1361153282,1,1,0
78364960@N04,3104,7,1368257936,1368257936,1,3,0
78364960@N04,3104,8,1368259918,1368260326,3,3,408
78364960@N04,3104,5,1368262704,1368263422,4,3,718
78364960@N04,3105,7,1369998546,1369998546,1,5,0
78364960@N04,3105,13,1369986247,1369986247,1,5,0
78364960@N04,3105,4,1369986568,1369986568,1,5,0
78364960@N04,3105,5,1369999452,1369999452,1,5,0
78364960@N04,3105,1,1369991781,1369991781,1,5,0
78364960@N04,3106,4,1374146609,1374146609,1,6,0
78364960@N04,3106,8,1374144315,1374152783,4,6,8468
78364960@N04,3106,5,1374149994,1374150136,2,6,142
78364960@N04,3106,1,1374153587,1374153587,1,6,0
78364960@N04,3106,2,1374153116,1374153116,1,6,0
78364960@N04,3106,6,1374146868,1374146868,1,6,0
78364960@N04,3107,8,1379082245,1379082245,1,4,0
78364960@N04,3107,13,1379079286,1379079286,1,4,0
78364960@N04,3107,1,1379076858,1379077433,2,4,575
78364960@N04,3107,11,1379062296,1379062296,1,4,0
78364960@N04,3108,9,1381825879,1381825879,1,1,0
78364960@N04,3109,8,1382225278,1382246377,4,3,21099
78364960@N04,3109,13,1382237128,1382238322,5,3,1194
78364960@N04,3109,2,1382225505,1382225599,2,3,94
78364960@N04,3110,1,1386300868,1386306727,5,2,5859
78364960@N04,3110,5,1386303418,1386303418,1,2,0
78364960@N04,3111,9,1397386138,1397386138,1,1,0
78364960@N04,3112,1,1398908477,1398935091,5,2,26614
78364960@N04,3112,8,1398918141,1398918141,1,2,0
78364960@N04,3113,6,1404615437,1404622789,5,1,7352
78364960@N04,3114,9,1414917174,1414918374,2,2,1200
78364960@N04,3114,6,1414913241,1414913241,1,2,0
78364960@N04,3115,6,1432894365,1432894365,1,2,0
78364960@N04,3115,13,1432880299,1432880299,1,2,0
78364960@N04,3116,1,1434282907,1434282907,1,2,0
78364960@N04,3116,9,1434286235,1434286235,1,2,0
78364960@N04,3117,10,1435146786,1435146786,1,1,0
78364960@N04,3118,6,1449216878,1449217378,2,2,500
78364960@N04,3118,7,1449213778,1449213778,1,2,0
78364960@N04,3119,6,1450866911,1450866911,1,1,0
78364960@N04,3120,8,1461396182,1461410411,8,2,14229
78364960@N04,3120,7,1461406175,1461406342,5,2,167
78364960@N04,3121,5,1463184534,1463184534,1,1,0
78364960@N04,3122,13,1466250850,1466250850,1,1,0
78427651@N00,3123,4,1356828982,1356828982,1,1,0
7843077@N06,3124,4,1275087078,1275087078,1,1,0
7843077@N06,3125,4,1275178728,1275183609,3,1,4881
7849988@N04,3126,2,1428979451,1428979451,1,1,0
7849988@N04,3127,3,1466480464,1466480464,1,5,0
7849988@N04,3127,12,1466472777,1466473673,2,5,896
7849988@N04,3127,5,1466479546,1466479553,2,5,7
7849988@N04,3127,6,1466501943,1466508103,11,5,6160
7849988@N04,3127,4,1466480443,1466480443,1,5,0
78562800@N05,3128,4,1362528629,1362528629,1,1,0
78569471@N00,3129,8,1214455654,1214456536,11,3,882
78569471@N00,3129,1,1214449964,1214449992,4,3,28
78569471@N00,3129,11,1214457560,1214457560,1,3,0
78779574@N00,3130,8,1335943490,1335953622,4,7,10132
78779574@N00,3130,9,1335954541,1335958097,79,7,3556
78779574@N00,3130,6,1335948857,1335953264,9,7,4407
78779574@N00,3130,4,1335921294,1335921294,1,7,0
78779574@N00,3130,1,1335926117,1335959806,17,7,33689
78779574@N00,3130,2,1335944705,1335948025,5,7,3320
78779574@N00,3130,11,1335921603,1335921603,1,7,0
7886635@N06,3131,6,1425249760,1425254077,4,2,4317
7886635@N06,3131,10,1425277892,1425280115,12,2,2223
79023626@N00,3132,6,1298170420,1298170420,1,1,0
79023626@N00,3133,4,1305800661,1305800661,1,1,0
79023626@N00,3134,8,1305851854,1305851854,1,2,0
79023626@N00,3134,13,1305838146,1305852648,2,2,14502
79023626@N00,3135,6,1316853097,1316853303,2,1,206
79023626@N00,3136,2,1335400199,1335400199,1,1,0
79023626@N00,3137,8,1345801681,1345801681,1,1,0
79023626@N00,3138,12,1354770985,1354770985,1,2,0
79023626@N00,3138,2,1354753053,1354753053,1,2,0
79023626@N00,3139,1,1356153857,1356153857,1,2,0
79023626@N00,3139,12,1356151636,1356151636,1,2,0
79092915@N00,3140,5,1280556350,1280556350,1,2,0
79092915@N00,3140,8,1280561121,1280561121,1,2,0
79121533@N00,3141,13,1388899485,1388899485,1,1,0
79128990@N00,3142,4,1405858275,1405858275,1,1,0
7915108@N06,3143,4,1295831793,1295831793,1,1,0
79169260@N00,3144,6,1292657384,1292657384,1,1,0
7917124@N07,3145,4,1458017818,1458018095,12,4,277
7917124@N07,3145,8,1458025320,1458033394,4,4,8074
7917124@N07,3145,1,1458038040,1458038050,2,4,10
7917124@N07,3145,7,1458027992,1458028583,7,4,591
79172203@N00,3146,11,1291596469,1291597423,19,9,954
79172203@N00,3146,2,1291583212,1291600626,7,9,17414
79172203@N00,3146,4,1291586391,1291611003,3,9,24612
79172203@N00,3146,13,1291586276,1291594156,5,9,7880
79172203@N00,3146,10,1291581318,1291581334,2,9,16
79172203@N00,3146,1,1291583798,1291583908,2,9,110
79172203@N00,3146,5,1291585710,1291585710,1,9,0
79172203@N00,3146,6,1291586661,1291621596,39,9,34935
79172203@N00,3146,8,1291586135,1291605790,5,9,19655
79172203@N00,3147,2,1291940844,1291941441,4,6,597
79172203@N00,3147,10,1291937692,1291938979,10,6,1287
79172203@N00,3147,1,1291931956,1291931956,1,6,0
79172203@N00,3147,5,1291930003,1291931216,3,6,1213
79172203@N00,3147,12,1291932022,1291934961,3,6,2939
79172203@N00,3147,7,1291933330,1291933330,1,6,0
79172203@N00,3148,1,1399258386,1399258386,1,3,0
79172203@N00,3148,5,1399245015,1399245015,1,3,0
79172203@N00,3148,8,1399248651,1399248929,2,3,278
79344793@N02,3149,7,1330933285,1330933285,1,2,0
79344793@N02,3149,8,1330917381,1330917381,1,2,0
79366282@N00,3150,12,1385947564,1385947564,1,1,0
79399703@N00,3151,4,1367188744,1367188744,1,1,0
79433444@N07,3152,6,1354805998,1354806201,3,1,203
7945637@N07,3153,6,1217817728,1217817728,1,1,0
7945637@N07,3154,12,1240723769,1240724330,2,1,561
7945637@N07,3155,6,1261387242,1261391949,3,1,4707
7945637@N07,3156,8,1262506467,1262506467,1,2,0
7945637@N07,3156,6,1262501480,1262502713,2,2,1233
7945637@N07,3157,6,1288952844,1288952844,1,1,0
7945637@N07,3158,8,1305936980,1305936980,1,1,0
7945637@N07,3159,8,1305970674,1305970674,1,1,0
7945637@N07,3160,8,1326964463,1326964463,1,1,0
7945637@N07,3161,6,1419593640,1419593640,1,1,0
7945637@N07,3162,6,1446724185,1446724185,1,1,0
79478905@N04,3163,6,1458458555,1458458555,1,1,0
79541517@N00,3164,8,1378119159,1378119159,1,1,0
7955606@N05,3165,13,1217402418,1217402418,1,1,0
79577915@N00,3166,12,1290323043,1290323043,1,3,0
79577915@N00,3166,1,1290315579,1290315579,1,3,0
79577915@N00,3166,9,1290326074,1290326074,1,3,0
7973770@N05,3167,4,1218085794,1218088855,5,3,3061
7973770@N05,3167,1,1218083725,1218084004,6,3,279
7973770@N05,3167,6,1218102608,1218105078,4,3,2470
79761301@N00,3168,8,1287672220,1287673587,16,2,1367
79761301@N00,3168,5,1287670426,1287671759,13,2,1333
79761301@N00,3169,12,1287997951,1287997951,1,5,0
79761301@N00,3169,6,1287996465,1287997348,7,5,883
79761301@N00,3169,5,1287998592,1288008708,42,5,10116
79761301@N00,3169,4,1287996304,1287996360,7,5,56
79761301@N00,3169,8,1287996114,1287997660,2,5,1546
79761301@N00,3170,13,1402031517,1402031517,1,6,0
79761301@N00,3170,6,1402016827,1402016831,2,6,4
79761301@N00,3170,5,1402025035,1402041647,12,6,16612
79761301@N00,3170,8,1402015443,1402016545,7,6,1102
79761301@N00,3170,11,1402020913,1402021567,7,6,654
79761301@N00,3170,1,1402031640,1402043833,34,6,12193
79939076@N02,3171,12,1342251993,1342252201,3,9,208
79939076@N02,3171,13,1342225094,1342239419,6,9,14325
79939076@N02,3171,4,1342225450,1342234914,7,9,9464
79939076@N02,3171,8,1342228665,1342259233,4,9,30568
79939076@N02,3171,7,1342228498,1342228498,1,9,0
79939076@N02,3171,6,1342233003,1342234621,14,9,1618
79939076@N02,3171,9,1342261232,1342265231,22,9,3999
79939076@N02,3171,5,1342227867,1342227973,3,9,106
79939076@N02,3171,1,1342224887,1342259249,11,9,34362
79959485@N00,3172,12,1219049033,1219049064,3,4,31
79959485@N00,3172,6,1219046725,1219046725,1,4,0
79959485@N00,3172,8,1219051768,1219052278,13,4,510
79959485@N00,3172,1,1219054767,1219054767,1,4,0
79959485@N00,3173,6,1219277014,1219277028,2,1,14
79959485@N00,3174,6,1331798321,1331802514,14,7,4193
79959485@N00,3174,8,1331794237,1331804348,4,7,10111
79959485@N00,3174,4,1331796248,1331796756,5,7,508
79959485@N00,3174,7,1331804404,1331804404,1,7,0
79959485@N00,3174,1,1331807033,1331809417,11,7,2384
79959485@N00,3174,2,1331794727,1331795640,8,7,913
79959485@N00,3174,5,1331807298,1331809148,24,7,1850
79959485@N00,3175,11,1331856060,1331856467,17,7,407
79959485@N00,3175,6,1331859326,1331859608,8,7,282
79959485@N00,3175,7,1331853933,1331853971,3,7,38
79959485@N00,3175,1,1331853835,1331853947,3,7,112
79959485@N00,3175,10,1331853394,1331853790,2,7,396
79959485@N00,3175,4,1331859735,1331859735,1,7,0
79959485@N00,3175,13,1331859853,1331859895,2,7,42
79959485@N00,3176,10,1332034456,1332034464,2,3,8
79959485@N00,3176,5,1332034841,1332045874,22,3,11033
79959485@N00,3176,13,1332042016,1332042030,2,3,14
80075211@N06,3177,4,1289800176,1289804991,2,1,4815
80081080@N00,3178,9,1445596659,1445596659,1,2,0
80081080@N00,3178,4,1445585113,1445585113,1,2,0
80084904@N00,3179,5,1200866117,1200866117,1,3,0
80084904@N00,3179,13,1200866118,1200866119,2,3,1
80084904@N00,3179,6,1200866121,1200866154,11,3,33
80084904@N00,3180,9,1227027780,1227037962,18,1,10182
8021465@N08,3181,1,1254384089,1254384089,1,1,0
8021465@N08,3182,13,1262599487,1262604611,2,1,5124
8021465@N08,3183,13,1262904689,1262910866,3,1,6177
8021465@N08,3184,8,1266957227,1266957227,1,1,0
8021465@N08,3185,2,1267848716,1267848716,1,3,0
8021465@N08,3185,8,1267824500,1267846012,5,3,21512
8021465@N08,3185,6,1267838232,1267838232,1,3,0
8021465@N08,3186,11,1288664618,1288664618,1,1,0
8021465@N08,3187,10,1309994612,1309994612,1,1,0
8021465@N08,3188,1,1337333313,1337333313,1,1,0
80304458@N00,3189,8,1419374068,1419374084,2,3,16
80304458@N00,3189,6,1419383234,1419383234,1,3,0
80304458@N00,3189,2,1419374445,1419374445,1,3,0
80341011@N00,3190,13,1416121825,1416121825,1,1,0
80435580@N03,3191,1,1348306109,1348306109,1,1,0
8054352@N06,3192,5,1355147493,1355147493,1,1,0
8054352@N06,3193,9,1361594107,1361594107,1,1,0
8054352@N06,3194,5,1365310997,1365310997,1,1,0
8054352@N06,3195,4,1381537491,1381537491,1,1,0
8054352@N06,3196,9,1390884196,1390884196,1,1,0
80558292@N00,3197,8,1379059945,1379059945,1,1,0
80558292@N00,3198,12,1382504977,1382504977,1,2,0
80558292@N00,3198,6,1382512971,1382512971,1,2,0
80612606@N00,3199,4,1262331109,1262331109,1,2,0
80612606@N00,3199,6,1262331118,1262331131,3,2,13
80612606@N00,3200,2,1283576398,1283576953,2,1,555
80612606@N00,3201,2,1298673170,1298673170,1,1,0
80612606@N00,3202,4,1307706033,1307706053,2,1,20
8066628@N02,3203,7,1189924443,1189957146,84,1,32703
8066628@N02,3204,7,1190103510,1190103510,1,1,0
8066628@N02,3205,7,1230631541,1230631541,1,1,0
8066628@N02,3206,7,1230886064,1230911555,45,1,25491
8066628@N02,3207,7,1231399201,1231412924,3,1,13723
8066628@N02,3208,7,1343068502,1343068561,10,1,59
8068421@N07,3209,13,1200888208,1200888208,1,1,0
8068421@N07,3210,8,1209989788,1209993646,2,2,3858
8068421@N07,3210,5,1209988933,1209988933,1,2,0
8068421@N07,3211,6,1287475975,1287478147,4,1,2172
8068421@N07,3212,6,1295765400,1295765400,1,1,0
8068421@N07,3213,6,1296106823,1296106823,1,2,0
8068421@N07,3213,1,1296112198,1296123569,3,2,11371
8068774@N05,3214,11,1213240155,1213240155,1,1,0
8068835@N04,3215,1,1333789802,1333801708,69,5,11906
8068835@N04,3215,5,1333790011,1333797647,28,5,7636
8068835@N04,3215,10,1333789287,1333792669,17,5,3382
8068835@N04,3215,9,1333794621,1333796514,40,5,1893
8068835@N04,3215,2,1333799590,1333801453,46,5,1863
8068835@N04,3216,5,1333868428,1333870086,19,4,1658
8068835@N04,3216,10,1333856574,1333871601,76,4,15027
8068835@N04,3216,4,1333877397,1333877464,7,4,67
8068835@N04,3216,13,1333877584,1333877585,2,4,1
8068835@N04,3217,1,1409275023,1409288669,13,6,13646
8068835@N04,3217,6,1409282749,1409285355,30,6,2606
8068835@N04,3217,2,1409279705,1409280803,13,6,1098
8068835@N04,3217,4,1409283466,1409283467,4,6,1
8068835@N04,3217,13,1409283139,1409283167,8,6,28
8068835@N04,3217,11,1409285709,1409285709,3,6,0
80730316@N05,3218,5,1421824212,1421829644,4,2,5432
80730316@N05,3218,4,1421813295,1421813295,1,2,0
8074702@N06,3219,4,1371717625,1371717722,2,1,97
80775532@N06,3220,8,1442723461,1442724848,2,4,1387
80775532@N06,3220,1,1442722632,1442725274,2,4,2642
80775532@N06,3220,10,1442729477,1442729477,1,4,0
80775532@N06,3220,5,1442726754,1442726754,1,4,0
80847103@N00,3221,12,1356407046,1356407926,4,2,880
80847103@N00,3221,7,1356406888,1356407972,17,2,1084
80847103@N00,3222,8,1356499856,1356499856,1,1,0
8089996@N06,3223,13,1459674712,1459676070,5,3,1358
8089996@N06,3223,2,1459656582,1459658784,2,3,2202
8089996@N06,3223,1,1459663244,1459676778,6,3,13534
8094673@N04,3224,8,1279162615,1279162615,1,1,0
8095506@N07,3225,8,1285729721,1285755200,82,1,25479
8095506@N07,3226,12,1286248338,1286273820,47,1,25482
80994469@N00,3227,4,1267609350,1267609350,1,1,0
8110876@N06,3228,8,1200794624,1200810585,35,1,15961
8110876@N06,3229,8,1238282389,1238288497,6,1,6108
8110876@N06,3230,8,1239169576,1239169787,4,1,211
81118954@N00,3231,5,1418868490,1418868490,1,1,0
8124939@N07,3232,12,1200102727,1200110539,2,3,7812
8124939@N07,3232,1,1200100360,1200100413,3,3,53
8124939@N07,3232,5,1200113865,1200113865,1,3,0
81291546@N02,3233,5,1358042113,1358042113,1,1,0
81291546@N02,3234,6,1382237213,1382237213,1,1,0
81292745@N00,3235,1,1305245986,1305245986,1,1,0
8129384@N04,3236,6,1355121449,1355122798,4,1,1349
81322238@N00,3237,6,1274269474,1274269482,2,4,8
81322238@N00,3237,1,1274270557,1274270565,2,4,8
81322238@N00,3237,10,1274270747,1274270747,1,4,0
81322238@N00,3237,9,1274272121,1274273795,6,4,1674
81322238@N00,3238,6,1274430764,1274430796,3,7,32
81322238@N00,3238,1,1274399565,1274407314,2,7,7749
81322238@N00,3238,13,1274428952,1274428991,9,7,39
81322238@N00,3238,8,1274402465,1274407222,359,7,4757
81322238@N00,3238,4,1274429310,1274429374,3,7,64
81322238@N00,3238,2,1274402154,1274441094,5,7,38940
81322238@N00,3238,10,1274422085,1274424353,14,7,2268
81699626@N00,3239,4,1447664629,1447664629,1,1,0
81704292@N02,3240,1,1327065285,1327065285,1,1,0
81713706@N05,3241,2,1399253699,1399253705,4,1,6
81713774@N03,3242,12,1445912537,1445912537,1,1,0
8177037@N06,3243,13,1339364364,1339380841,12,1,16477
8177037@N06,3244,13,1371934239,1371959417,53,1,25178
81810968@N02,3245,6,1342308937,1342308937,1,1,0
81834077@N00,3246,8,1214018690,1214047260,20,1,28570
81855582@N00,3247,1,1255123750,1255128094,4,4,4344
81855582@N00,3247,5,1255124729,1255127760,7,4,3031
81855582@N00,3247,2,1255132394,1255141458,3,4,9064
81855582@N00,3247,6,1255132997,1255133038,2,4,41
81932021@N00,3248,5,1229894834,1229934437,11,1,39603
82031849@N00,3249,6,1356767642,1356768200,7,2,558
82031849@N00,3249,8,1356767033,1356767033,1,2,0
82031849@N00,3250,6,1357289073,1357289823,12,1,750
82211889@N00,3251,2,1326603515,1326603515,1,2,0
82211889@N00,3251,4,1326594472,1326599824,13,2,5352
82211889@N00,3252,1,1459033447,1459033457,3,5,10
82211889@N00,3252,12,1459036178,1459037114,6,5,936
82211889@N00,3252,2,1459039137,1459039137,1,5,0
82211889@N00,3252,8,1459033606,1459033814,9,5,208
82211889@N00,3252,4,1459042280,1459042664,3,5,384
82211889@N00,3253,7,1459219871,1459219889,2,4,18
82211889@N00,3253,9,1459241666,1459244693,4,4,3027
82211889@N00,3253,2,1459219362,1459219362,1,4,0
82211889@N00,3253,6,1459207377,1459207385,2,4,8
82211889@N00,3254,2,1459474321,1459474799,2,2,478
82211889@N00,3254,4,1459478112,1459478114,2,2,2
82335642@N00,3255,7,1258863914,1258866034,9,4,2120
82335642@N00,3255,1,1258863239,1258868284,6,4,5045
82335642@N00,3255,8,1258857710,1258868078,15,4,10368
82335642@N00,3255,10,1258863057,1258863057,1,4,0
82418556@N00,3256,4,1358142857,1358142857,1,4,0
82418556@N00,3256,6,1358147562,1358147562,1,4,0
82418556@N00,3256,9,1358139937,1358139937,1,4,0
82418556@N00,3256,5,1358139862,1358150358,4,4,10496
82418556@N00,3257,8,1380927382,1380927382,1,2,0
82418556@N00,3257,1,1380927822,1380927822,1,2,0
82418556@N00,3258,8,1380982783,1380982783,1,1,0
82418556@N00,3259,8,1399158587,1399158587,1,4,0
82418556@N00,3259,4,1399157662,1399175478,4,4,17816
82418556@N00,3259,5,1399169898,1399169898,1,4,0
82418556@N00,3259,1,1399155359,1399155359,1,4,0
82541612@N00,3260,4,1395198295,1395198295,1,3,0
82541612@N00,3260,5,1395193249,1395193249,1,3,0
82541612@N00,3260,8,1395189298,1395189298,1,3,0
82624704@N00,3261,6,1273980452,1273982558,12,3,2106
82624704@N00,3261,1,1273987878,1273989060,16,3,1182
82624704@N00,3261,2,1273973062,1274003394,15,3,30332
8270001@N04,3262,8,1269450053,1269461232,4,1,11179
82746306@N00,3263,8,1248262142,1248262142,1,1,0
82936946@N00,3264,5,1281744053,1281744053,2,2,0
82936946@N00,3264,1,1281763289,1281763289,1,2,0
83035350@N06,3265,8,1362694508,1362694508,1,2,0
83035350@N06,3265,13,1362707788,1362707788,1,2,0
83083483@N04,3266,4,1432287919,1432287919,1,1,0
83083483@N04,3267,4,1432400893,1432400893,1,1,0
83088992@N06,3268,4,1366051238,1366051282,2,2,44
83088992@N06,3268,6,1366051536,1366051536,1,2,0
83092888@N03,3269,8,1380108799,1380108799,1,1,0
83106697@N00,3270,1,1225320263,1225337418,2,3,17155
83106697@N00,3270,5,1225323146,1225338398,3,3,15252
83106697@N00,3270,2,1225330142,1225334646,4,3,4504
83106697@N00,3271,6,1354859449,1354859449,1,1,0
8311873@N03,3272,6,1348037228,1348037228,1,4,0
8311873@N03,3272,8,1348036859,1348037581,2,4,722
8311873@N03,3272,2,1348037127,1348037127,1,4,0
8311873@N03,3272,5,1348037414,1348037414,1,4,0
8311873@N03,3273,5,1352852684,1352852764,2,1,80
8311873@N03,3274,8,1359342151,1359342151,1,1,0
8311873@N03,3275,5,1370762053,1370762053,1,1,0
8311873@N03,3276,13,1420452730,1420452730,1,1,0
8311873@N03,3277,5,1423463888,1423463888,1,1,0
83133472@N05,3278,13,1347627309,1347627309,1,1,0
83133472@N05,3279,4,1347671030,1347671030,1,1,0
83133472@N05,3280,4,1366550267,1366550267,1,1,0
83133472@N05,3281,4,1369313001,1369313001,1,1,0
83133472@N05,3282,4,1369400795,1369400795,1,2,0
83133472@N05,3282,12,1369403482,1369403482,1,2,0
83133472@N05,3283,2,1370759272,1370759272,1,1,0
83133472@N05,3284,12,1371258397,1371258397,1,1,0
83133472@N05,3285,6,1374312096,1374312096,1,1,0
83133472@N05,3286,4,1374838882,1374838882,1,1,0
83167112@N06,3287,6,1416295823,1416295823,1,1,0
83206670@N05,3288,8,1314239115,1314268057,66,1,28942
83206670@N05,3289,1,1314315691,1314315691,1,3,0
83206670@N05,3289,8,1314321172,1314321190,2,3,18
83206670@N05,3289,2,1314325269,1314325273,2,3,4
8326174@N06,3290,5,1381828422,1381828422,1,1,0
8328546@N03,3291,6,1208946888,1208946888,1,4,0
8328546@N03,3291,3,1208946908,1208946908,1,4,0
8328546@N03,3291,1,1208946886,1208947310,4,4,424
8328546@N03,3291,8,1208945281,1208946882,2,4,1601
8328546@N03,3292,1,1209026705,1209028523,4,1,1818
83286805@N00,3293,5,1320653394,1320653394,1,2,0
83286805@N00,3293,1,1320638478,1320643956,2,2,5478
83286805@N00,3294,6,1320814179,1320814179,1,2,0
83286805@N00,3294,8,1320807995,1320807995,1,2,0
8330434@N05,3295,6,1358231643,1358231666,2,1,23
8342736@N06,3296,6,1275355572,1275355572,1,1,0
8358539@N02,3297,5,1331807230,1331807230,1,1,0
8358539@N02,3298,2,1370136639,1370136639,1,1,0
83657528@N00,3299,2,1300229792,1300246547,2,3,16755
83657528@N00,3299,12,1300249785,1300249835,2,3,50
83657528@N00,3299,5,1300258143,1300258143,1,3,0
83794242@N07,3300,4,1435641043,1435641043,1,1,0
83825280@N06,3301,12,1353072728,1353072728,1,1,0
83848625@N00,3302,5,1432090430,1432090430,1,7,0
83848625@N00,3302,1,1432096199,1432096199,1,7,0
83848625@N00,3302,11,1432088007,1432088007,1,7,0
83848625@N00,3302,6,1432087116,1432087670,2,7,554
83848625@N00,3302,10,1432090448,1432090448,1,7,0
83848625@N00,3302,13,1432092865,1432092865,1,7,0
83848625@N00,3302,8,1432091499,1432091499,1,7,0
83848625@N00,3303,12,1456287462,1456287462,1,6,0
83848625@N00,3303,4,1456284666,1456284666,1,6,0
83848625@N00,3303,5,1456280002,1456280002,1,6,0
83848625@N00,3303,1,1456303229,1456303229,1,6,0
83848625@N00,3303,8,1456282559,1456282559,1,6,0
83848625@N00,3303,6,1456293999,1456293999,1,6,0
83848625@N00,3304,2,1456382606,1456382606,1,3,0
83848625@N00,3304,4,1456389357,1456390003,2,3,646
83848625@N00,3304,8,1456377998,1456391154,3,3,13156
83935707@N00,3305,1,1240537876,1240538290,2,4,414
83935707@N00,3305,4,1240532900,1240533063,5,4,163
83935707@N00,3305,5,1240537213,1240537449,3,4,236
83935707@N00,3305,10,1240528854,1240528854,1,4,0
84013956@N00,3306,6,1325154006,1325171986,2,1,17980
84057763@N00,3307,1,1453166680,1453166680,1,1,0
8405842@N02,3308,6,1412471030,1412471030,1,1,0
8405842@N02,3309,8,1412675431,1412675431,1,2,0
8405842@N02,3309,2,1412673328,1412673328,1,2,0
84108876@N00,3310,13,1210901626,1210901626,1,1,0
84132551@N00,3311,13,1439806123,1439806123,1,1,0
84132551@N00,3312,13,1442476039,1442476039,1,1,0
84168064@N02,3313,4,1445748002,1445748002,1,2,0
84168064@N02,3313,13,1445747721,1445747721,1,2,0
84169004@N00,3314,2,1228353900,1228354320,4,1,420
84169004@N00,3315,4,1386304091,1386304091,1,1,0
84221632@N00,3316,2,1359603485,1359603942,2,1,457
84227486@N02,3317,1,1354787568,1354787568,1,3,0
84227486@N02,3317,4,1354782373,1354782378,2,3,5
84227486@N02,3317,6,1354779989,1354786758,3,3,6769
84227486@N02,3318,8,1366078553,1366078553,1,3,0
84227486@N02,3318,6,1366070509,1366070509,1,3,0
84227486@N02,3318,7,1366077352,1366077361,2,3,9
84296061@N04,3319,8,1360628683,1360628914,2,1,231
84489335@N04,3320,7,1346400342,1346400342,1,1,0
84531937@N00,3321,6,1309466602,1309466602,1,2,0
84531937@N00,3321,1,1309494868,1309494868,1,2,0
8459320@N03,3322,2,1246847260,1246847275,2,1,15
84643106@N00,3323,6,1261992973,1261993885,6,1,912
84643106@N00,3324,6,1262255156,1262255156,1,1,0
84697271@N00,3325,8,1294466497,1294466501,2,4,4
84697271@N00,3325,2,1294466196,1294466196,1,4,0
84697271@N00,3325,1,1294466507,1294466507,1,4,0
84697271@N00,3325,6,1294461120,1294461120,1,4,0
84697271@N00,3326,13,1294701943,1294701943,1,4,0
84697271@N00,3326,8,1294703455,1294703455,1,4,0
84697271@N00,3326,4,1294702220,1294702250,2,4,30
84697271@N00,3326,6,1294702451,1294702931,2,4,480
84765974@N00,3327,12,1464692908,1464692908,1,1,0
84824340@N07,3328,5,1409993470,1409994036,2,4,566
84824340@N07,3328,8,1409996697,1409996697,1,4,0
84824340@N07,3328,7,1409996225,1409996225,1,4,0
84824340@N07,3328,1,1409991379,1409995976,2,4,4597
84861343@N00,3329,8,1370562665,1370568740,7,2,6075
84861343@N00,3329,6,1370560992,1370560992,1,2,0
85095974@N05,3330,4,1374370324,1374370331,6,1,7
85095974@N05,3331,4,1374487402,1374492093,7,2,4691
85095974@N05,3331,6,1374487416,1374487416,1,2,0
85095974@N05,3332,1,1402091216,1402106112,25,2,14896
85095974@N05,3332,2,1402094366,1402094554,2,2,188
85095974@N05,3333,8,1402670137,1402670137,1,1,0
85095974@N05,3334,1,1434157420,1434158667,39,3,1247
85095974@N05,3334,10,1434169308,1434180052,16,3,10744
85095974@N05,3334,8,1434158909,1434159013,17,3,104
85095974@N05,3335,4,1434682513,1434682513,1,2,0
85095974@N05,3335,1,1434684803,1434685025,12,2,222
85095974@N05,3336,1,1470556831,1470556831,1,5,0
85095974@N05,3336,13,1470563917,1470563932,2,5,15
85095974@N05,3336,10,1470556507,1470556507,1,5,0
85095974@N05,3336,12,1470557004,1470557670,13,5,666
85095974@N05,3336,8,1470558792,1470559221,6,5,429
85095974@N05,3337,4,1470637846,1470638943,5,6,1097
85095974@N05,3337,7,1470619555,1470619906,17,6,351
85095974@N05,3337,1,1470609988,1470609988,1,6,0
85095974@N05,3337,12,1470611447,1470611447,1,6,0
85095974@N05,3337,2,1470621138,1470621601,14,6,463
85095974@N05,3337,8,1470618277,1470618502,10,6,225
85116518@N06,3338,10,1376005136,1376005147,2,1,11
85121305@N08,3339,1,1441098235,1441098299,5,2,64
85121305@N08,3339,5,1441074232,1441082251,3,2,8019
85121963@N00,3340,8,1320724582,1320743821,11,1,19239
85148660@N00,3341,4,1362184980,1362187252,4,1,2272
8526919@N08,3342,5,1461410210,1461410210,1,1,0
85281436@N03,3343,5,1362740395,1362740395,1,1,0
85288320@N00,3344,10,1312174553,1312174553,1,4,0
85288320@N00,3344,13,1312160651,1312162598,3,4,1947
85288320@N00,3344,5,1312173426,1312173426,1,4,0
85288320@N00,3344,4,1312164714,1312164714,1,4,0
85288320@N00,3345,5,1312341413,1312345100,11,3,3687
85288320@N00,3345,8,1312336678,1312337152,2,3,474
85288320@N00,3345,4,1312335266,1312336763,2,3,1497
85509341@N00,3346,2,1392876587,1392876587,1,2,0
85509341@N00,3346,7,1392874832,1392874832,1,2,0
85542262@N00,3347,13,1280986839,1280986839,1,2,0
85542262@N00,3347,6,1280973226,1280973226,1,2,0
85543411@N08,3348,5,1381530057,1381530057,1,1,0
85543411@N08,3349,13,1420509761,1420509761,1,1,0
85566955@N00,3350,2,1379466303,1379466303,1,1,0
8562768@N07,3351,6,1351212589,1351212589,1,2,0
8562768@N07,3351,1,1351216178,1351216178,1,2,0
85631149@N00,3352,2,1393373194,1393373194,1,3,0
85631149@N00,3352,1,1393398010,1393403308,3,3,5298
85631149@N00,3352,6,1393376689,1393376689,1,3,0
85632208@N03,3353,7,1329417006,1329417006,1,2,0
85632208@N03,3353,6,1329409988,1329409988,1,2,0
85644119@N00,3354,1,1198793116,1198793116,1,2,0
85644119@N00,3354,8,1198790948,1198799808,2,2,8860
85644119@N00,3355,6,1198829923,1198831255,3,2,1332
85644119@N00,3355,1,1198834822,1198836484,4,2,1662
85644119@N00,3356,6,1212974497,1212974497,1,4,0
85644119@N00,3356,1,1212963106,1212963106,1,4,0
85644119@N00,3356,8,1212963106,1212979461,13,4,16355
85644119@N00,3356,5,1212963835,1212964119,2,4,284
85644119@N00,3357,10,1228865463,1228865463,1,1,0
85644119@N00,3358,4,1262124883,1262131036,2,8,6153
85644119@N00,3358,6,1262126889,1262166181,3,8,39292
85644119@N00,3358,2,1262122199,1262139286,3,8,17087
85644119@N00,3358,11,1262154870,1262154870,1,8,0
85644119@N00,3358,8,1262131068,1262157715,3,8,26647
85644119@N00,3358,10,1262131461,1262131461,1,8,0
85644119@N00,3358,5,1262123764,1262147983,2,8,24219
85644119@N00,3358,1,1262120273,1262157627,6,8,37354
85644119@N00,3359,4,1324414782,1324445369,3,7,30587
85644119@N00,3359,6,1324440500,1324455713,4,7,15213
85644119@N00,3359,13,1324415371,1324419645,2,7,4274
85644119@N00,3359,1,1324410786,1324447530,4,7,36744
85644119@N00,3359,8,1324414505,1324438654,6,7,24149
85644119@N00,3359,10,1324431718,1324457193,2,7,25475
85644119@N00,3359,5,1324431848,1324431929,2,7,81
8567292@N04,3360,7,1229719041,1229719099,6,1,58
8567292@N04,3361,7,1229813197,1229848501,39,1,35304
8567292@N04,3362,7,1230015798,1230019711,9,1,3913
8567292@N04,3363,1,1441525107,1441525107,1,3,0
8567292@N04,3363,4,1441498455,1441498681,3,3,226
8567292@N04,3363,2,1441504683,1441510722,14,3,6039
85688704@N07,3364,1,1312447553,1312447553,1,1,0
85744958@N00,3365,1,1235991269,1235993472,3,1,2203
85744958@N00,3366,1,1286078557,1286078695,2,1,138
85744958@N00,3367,9,1305648508,1305649937,13,1,1429
85744958@N00,3368,1,1305780461,1305783618,3,1,3157
85744958@N00,3369,1,1318954238,1318964821,8,1,10583
85744958@N00,3370,10,1328055376,1328066235,3,1,10859
85744958@N00,3371,10,1353661352,1353661352,1,2,0
85744958@N00,3371,1,1353661010,1353661010,1,2,0
8576764@N02,3372,6,1409562477,1409563088,9,4,611
8576764@N02,3372,2,1409544369,1409545168,6,4,799
8576764@N02,3372,1,1409543529,1409543531,2,4,2
8576764@N02,3372,4,1409563637,1409563637,1,4,0
8576764@N02,3373,4,1409909583,1409909583,1,1,0
85813749@N00,3374,7,1418773551,1418773551,1,4,0
85813749@N00,3374,4,1418777132,1418788809,2,4,11677
85813749@N00,3374,6,1418786429,1418810193,3,4,23764
85813749@N00,3374,9,1418805224,1418805224,1,4,0
85843151@N00,3375,8,1359976853,1359976853,1,7,0
85843151@N00,3375,9,1359965097,1359965097,1,7,0
85843151@N00,3375,5,1359961384,1359961384,1,7,0
85843151@N00,3375,13,1359946217,1359950958,5,7,4741
85843151@N00,3375,10,1359959939,1359960141,2,7,202
85843151@N00,3375,4,1359931718,1359948695,5,7,16977
85843151@N00,3375,6,1359935628,1359935628,1,7,0
85855667@N00,3376,12,1309475152,1309475152,1,5,0
85855667@N00,3376,13,1309485723,1309485802,2,5,79
85855667@N00,3376,8,1309475219,1309475219,1,5,0
85855667@N00,3376,4,1309479738,1309479774,2,5,36
85855667@N00,3376,1,1309474109,1309474109,1,5,0
85856616@N05,3377,6,1353932666,1353933124,6,1,458
85859494@N02,3378,2,1369908563,1369908563,1,2,0
85859494@N02,3378,5,1369910622,1369910644,3,2,22
85859494@N02,3379,6,1370048007,1370052196,4,5,4189
85859494@N02,3379,1,1370035907,1370042880,10,5,6973
85859494@N02,3379,11,1370043802,1370043802,1,5,0
85859494@N02,3379,5,1370038218,1370038641,9,5,423
85859494@N02,3379,4,1370056284,1370056291,2,5,7
85863433@N04,3380,11,1323746123,1323746123,1,1,0
85864407@N08,3381,5,1384672896,1384674538,3,3,1642
85864407@N08,3381,6,1384677318,1384683496,2,3,6178
85864407@N08,3381,8,1384659382,1384659382,1,3,0
85912588@N00,3382,6,1353568528,1353568528,1,1,0
8592217@N08,3383,8,1237792802,1237792802,1,3,0
8592217@N08,3383,4,1237793312,1237793312,1,3,0
8592217@N08,3383,7,1237790180,1237790180,1,3,0
8599745@N08,3384,13,1210765768,1210766228,5,1,460
86001309@N00,3385,1,1336049303,1336066052,19,1,16749
86061580@N00,3386,4,1291005616,1291007251,9,1,1635
86111910@N03,3387,5,1348281138,1348281138,1,3,0
86111910@N03,3387,6,1348287406,1348287406,1,3,0
86111910@N03,3387,11,1348298173,1348298173,1,3,0
86171175@N08,3388,6,1404717374,1404717374,1,3,0
86171175@N08,3388,1,1404708333,1404708333,1,3,0
86171175@N08,3388,5,1404707174,1404707174,1,3,0
86177168@N03,3389,4,1282008113,1282008113,1,1,0
86235456@N07,3390,6,1452749365,1452749365,1,1,0
86278660@N00,3391,9,1386227468,1386230238,40,1,2770
8638605@N02,3392,8,1275625251,1275626236,5,5,985
8638605@N02,3392,4,1275631899,1275643713,106,5,11814
8638605@N02,3392,10,1275623899,1275624058,3,5,159
8638605@N02,3392,1,1275624262,1275624341,5,5,79
8638605@N02,3392,5,1275644088,1275645055,12,5,967
8638605@N02,3393,2,1275783287,1275784758,6,8,1471
8638605@N02,3393,13,1275788633,1275789343,45,8,710
8638605@N02,3393,6,1275781783,1275790528,21,8,8745
8638605@N02,3393,1,1275780422,1275780422,1,8,0
8638605@N02,3393,3,1275792187,1275793008,2,8,821
8638605@N02,3393,4,1275781666,1275792024,34,8,10358
8638605@N02,3393,10,1275775298,1275778199,10,8,2901
8638605@N02,3393,5,1275778315,1275778837,4,8,522
8638605@N02,3394,2,1275968718,1275969032,3,6,314
8638605@N02,3394,13,1275966581,1275966581,1,6,0
8638605@N02,3394,12,1275970373,1275970677,2,6,304
8638605@N02,3394,4,1275967060,1275967502,3,6,442
8638605@N02,3394,1,1275965911,1275965911,1,6,0
8638605@N02,3394,5,1275971313,1275972053,3,6,740
8642045@N04,3395,5,1421542401,1421542401,1,1,0
8642045@N04,3396,5,1421584860,1421584860,1,1,0
86434226@N00,3397,4,1360475366,1360475728,3,1,362
86459399@N00,3398,5,1255332539,1255332539,1,1,0
86459399@N00,3399,1,1275221364,1275221364,1,2,0
86459399@N00,3399,9,1275218215,1275220690,5,2,2475
86459399@N00,3400,6,1291878151,1291878764,4,1,613
86459399@N00,3401,2,1318815944,1318815944,1,3,0
86459399@N00,3401,4,1318820497,1318821825,3,3,1328
86459399@N00,3401,8,1318819338,1318819338,1,3,0
86459399@N00,3402,5,1319110099,1319110127,3,3,28
86459399@N00,3402,8,1319101916,1319102295,3,3,379
86459399@N00,3402,1,1319101625,1319101632,2,3,7
86482004@N00,3403,12,1337500907,1337500916,2,5,9
86482004@N00,3403,4,1337491374,1337494789,4,5,3415
86482004@N00,3403,5,1337503948,1337503948,1,5,0
86482004@N00,3403,8,1337498830,1337498830,1,5,0
86482004@N00,3403,13,1337487464,1337491114,4,5,3650
86507020@N00,3404,1,1245710151,1245713788,7,1,3637
86562986@N00,3405,10,1230671907,1230671907,1,3,0
86562986@N00,3405,8,1230673608,1230683002,6,3,9394
86562986@N00,3405,2,1230677126,1230680582,3,3,3456
86562986@N00,3406,6,1230713252,1230713252,1,1,0
86643038@N07,3407,2,1400216236,1400216236,1,1,0
86701646@N00,3408,4,1292650888,1292650888,1,1,0
86719158@N00,3409,6,1299288039,1299288043,2,1,4
86864767@N00,3410,8,1205178522,1205178522,1,2,0
86864767@N00,3410,5,1205178596,1205178596,1,2,0
86864767@N00,3411,1,1205345189,1205345189,1,1,0
86985744@N00,3412,4,1376698117,1376698117,1,1,0
87049901@N00,3413,2,1317283767,1317283767,1,1,0
87195182@N04,3414,8,1356576331,1356576331,1,1,0
87261736@N00,3415,6,1443228617,1443228617,1,2,0
87261736@N00,3415,1,1443225010,1443225010,1,2,0
8729032@N06,3416,5,1224633962,1224633962,1,2,0
8729032@N06,3416,10,1224629967,1224629967,1,2,0
8729032@N06,3417,4,1224822441,1224822524,4,2,83
8729032@N06,3417,1,1224825727,1224825727,1,2,0
8729032@N06,3418,12,1283338132,1283340045,2,1,1913
8729032@N06,3419,2,1288048595,1288049774,5,2,1179
8729032@N06,3419,8,1288042154,1288047756,87,2,5602
8729032@N06,3420,8,1373166719,1373167060,8,4,341
8729032@N06,3420,3,1373162145,1373162266,5,4,121
8729032@N06,3420,5,1373155133,1373155133,1,4,0
8729032@N06,3420,2,1373156044,1373156044,1,4,0
8729032@N06,3421,7,1387237428,1387237428,1,9,0
8729032@N06,3421,8,1387262557,1387270602,24,9,8045
8729032@N06,3421,10,1387271075,1387271084,2,9,9
8729032@N06,3421,3,1387250228,1387250228,1,9,0
8729032@N06,3421,12,1387235426,1387269936,29,9,34510
8729032@N06,3421,5,1387238620,1387242323,6,9,3703
8729032@N06,3421,2,1387250767,1387253297,6,9,2530
8729032@N06,3421,6,1387253126,1387267220,16,9,14094
8729032@N06,3421,4,1387249410,1387250238,8,9,828
8729032@N06,3422,11,1417990355,1418011806,36,9,21451
8729032@N06,3422,10,1417990378,1417991301,6,9,923
8729032@N06,3422,7,1417996282,1418011942,4,9,15660
8729032@N06,3422,5,1418002875,1418003088,5,9,213
8729032@N06,3422,12,1418003034,1418006718,9,9,3684
8729032@N06,3422,1,1418002622,1418002759,15,9,137
8729032@N06,3422,2,1417993396,1418009533,11,9,16137
8729032@N06,3422,8,1418004968,1418016135,27,9,11167
8729032@N06,3422,4,1417994100,1418007363,149,9,13263
8729032@N06,3423,5,1429752192,1429752192,1,1,0
8729032@N06,3424,8,1458288749,1458288750,2,4,1
8729032@N06,3424,10,1458284292,1458284292,1,4,0
8729032@N06,3424,7,1458288750,1458288750,1,4,0
8729032@N06,3424,12,1458284291,1458284291,1,4,0
8730186@N03,3425,7,1427922862,1427951494,20,1,28632
8730186@N03,3426,7,1428022224,1428027426,4,1,5202
87415005@N02,3427,12,1417674369,1417674509,2,5,140
87415005@N02,3427,7,1417674376,1417674376,1,5,0
87415005@N02,3427,2,1417665513,1417665513,1,5,0
87415005@N02,3427,6,1417682057,1417683129,9,5,1072
87415005@N02,3427,1,1417667240,1417667240,1,5,0
8744270@N03,3428,8,1204762459,1204769058,2,1,6599
8744270@N03,3429,8,1204953303,1204962044,3,1,8741
87506761@N00,3430,4,1336137217,1336141570,8,1,4353
87507703@N04,3431,1,1356560461,1356572454,16,8,11993
87507703@N04,3431,4,1356569516,1356569948,6,8,432
87507703@N04,3431,8,1356563195,1356563195,1,8,0
87507703@N04,3431,5,1356560985,1356565159,3,8,4174
87507703@N04,3431,6,1356570010,1356571003,16,8,993
87507703@N04,3431,12,1356562959,1356562959,1,8,0
87507703@N04,3431,2,1356571625,1356571694,2,8,69
87507703@N04,3431,13,1356569109,1356569109,1,8,0
87635169@N02,3432,6,1449218023,1449219905,12,1,1882
87723016@N00,3433,4,1379561565,1379561941,2,1,376
87725423@N06,3434,5,1373614150,1373631031,3,3,16881
87725423@N06,3434,8,1373618897,1373618897,1,3,0
87725423@N06,3434,1,1373612401,1373619398,2,3,6997
8773866@N07,3435,6,1229126142,1229126142,1,2,0
8773866@N07,3435,5,1229122966,1229122966,1,2,0
8773866@N07,3436,1,1287200141,1287200141,1,1,0
87854506@N04,3437,4,1355569706,1355569869,6,4,163
87854506@N04,3437,5,1355559575,1355559575,1,4,0
87854506@N04,3437,6,1355561080,1355561747,9,4,667
87854506@N04,3437,1,1355559835,1355560098,3,4,263
87854506@N04,3438,5,1363502841,1363502841,1,1,0
87881467@N08,3439,1,1359557321,1359567957,64,1,10636
87881467@N08,3440,1,1361857063,1361857282,2,1,219
87881467@N08,3441,1,1361928150,1361930851,7,1,2701
87881467@N08,3442,1,1362440052,1362441131,6,1,1079
87898971@N03,3443,6,1449271573,1449271573,1,1,0
87942779@N00,3444,6,1202560735,1202560735,1,1,0
87953089@N04,3445,8,1390025402,1390025402,1,7,0
87953089@N04,3445,1,1389997724,1389997805,3,7,81
87953089@N04,3445,9,1390033534,1390033537,2,7,3
87953089@N04,3445,5,1389997910,1390001490,9,7,3580
87953089@N04,3445,12,1390025949,1390026770,4,7,821
87953089@N04,3445,4,1390002518,1390002632,2,7,114
87953089@N04,3445,6,1390009502,1390017335,5,7,7833
87953089@N04,3446,8,1390533096,1390533096,1,1,0
87993502@N03,3447,2,1357572863,1357572863,1,1,0
8803306@N02,3448,1,1227313655,1227313655,1,1,0
8803306@N02,3449,4,1240705301,1240705301,1,1,0
8803306@N02,3450,2,1244860838,1244860838,1,6,0
8803306@N02,3450,4,1244846396,1244846396,1,6,0
8803306@N02,3450,10,1244843889,1244843889,1,6,0
8803306@N02,3450,6,1244859615,1244860476,2,6,861
8803306@N02,3450,8,1244846378,1244867426,10,6,21048
8803306@N02,3450,12,1244851285,1244851285,1,6,0
88078923@N04,3451,13,1415939256,1415941316,3,4,2060
88078923@N04,3451,5,1415933185,1415933190,3,4,5
88078923@N04,3451,2,1415920919,1415920931,4,4,12
88078923@N04,3451,12,1415938659,1415938666,5,4,7
8807897@N04,3452,1,1193020290,1193020290,1,1,0
88097009@N07,3453,5,1418535451,1418535451,1,1,0
88101388@N07,3454,1,1355704294,1355705622,48,2,1328
88101388@N07,3454,8,1355698853,1355699688,21,2,835
88158593@N00,3455,8,1305876928,1305876928,1,1,0
88158593@N00,3456,5,1334295146,1334295146,1,1,0
88264442@N00,3457,1,1321426135,1321426135,1,1,0
88322185@N00,3458,6,1195636230,1195636479,3,2,249
88322185@N00,3458,5,1195626818,1195626818,1,2,0
88322185@N00,3459,8,1195710906,1195710906,1,1,0
88322185@N00,3460,8,1195953179,1195953179,1,1,0
88322185@N00,3461,5,1323091014,1323091357,30,1,343
88322185@N00,3462,5,1468454853,1468471282,59,1,16429
8838492@N05,3463,10,1198285744,1198285744,1,8,0
8838492@N05,3463,8,1198286540,1198307883,10,8,21343
8838492@N05,3463,1,1198286133,1198311525,25,8,25392
8838492@N05,3463,7,1198296873,1198297092,7,8,219
8838492@N05,3463,12,1198296838,1198296963,5,8,125
8838492@N05,3463,9,1198315571,1198315589,2,8,18
8838492@N05,3463,4,1198287404,1198300644,9,8,13240
8838492@N05,3463,6,1198300987,1198303392,3,8,2405
88479439@N03,3464,6,1350722154,1350722343,5,3,189
88479439@N03,3464,9,1350731649,1350731649,1,3,0
88479439@N03,3464,10,1350702821,1350705836,6,3,3015
88488885@N00,3465,6,1274259178,1274259178,1,1,0
88504071@N00,3466,2,1211603499,1211617805,2,1,14306
8854930@N07,3467,6,1417858912,1417859301,2,1,389
88653431@N00,3468,9,1338368623,1338368623,1,2,0
88653431@N00,3468,4,1338356683,1338356683,1,2,0
88711965@N00,3469,12,1380508210,1380508210,1,3,0
88711965@N00,3469,2,1380515889,1380515889,1,3,0
88711965@N00,3469,4,1380497262,1380497262,1,3,0
88740729@N02,3470,6,1470627666,1470627666,1,1,0
88785574@N00,3471,5,1340334077,1340334077,1,1,0
88859710@N03,3472,1,1379049345,1379049345,1,1,0
88859710@N03,3473,1,1384476385,1384476385,1,1,0
88959316@N00,3474,1,1193490000,1193490000,1,1,0
88959316@N00,3475,8,1193544931,1193545286,2,1,355
88984016@N00,3476,8,1253406554,1253406554,1,1,0
88984016@N00,3477,6,1348867099,1348867099,1,2,0
88984016@N00,3477,4,1348868057,1348868057,1,2,0
88984016@N00,3478,1,1349269944,1349269944,1,1,0
88994581@N00,3479,5,1351229803,1351229803,1,2,0
88994581@N00,3479,4,1351227824,1351227824,1,2,0
89014556@N00,3480,7,1202977551,1202979422,2,1,1871
89014556@N00,3481,7,1203050304,1203050304,1,1,0
89072528@N00,3482,2,1243247949,1243247949,1,2,0
89072528@N00,3482,1,1243226450,1243226450,1,2,0
89138020@N00,3483,6,1241481118,1241489320,20,9,8202
89138020@N00,3483,8,1241479870,1241513071,10,9,33201
89138020@N00,3483,13,1241499471,1241506184,22,9,6713
89138020@N00,3483,12,1241496936,1241497311,4,9,375
89138020@N00,3483,3,1241489726,1241511565,8,9,21839
89138020@N00,3483,4,1241480225,1241501834,3,9,21609
89138020@N00,3483,2,1241486716,1241494960,16,9,8244
89138020@N00,3483,10,1241479360,1241479470,2,9,110
89138020@N00,3483,11,1241509266,1241510258,2,9,992
89138020@N00,3484,6,1241829957,1241829957,1,5,0
89138020@N00,3484,12,1241830435,1241831928,8,5,1493
89138020@N00,3484,4,1241824780,1241824780,1,5,0
89138020@N00,3484,2,1241828364,1241829719,10,5,1355
89138020@N00,3484,7,1241826382,1241826382,1,5,0
8927252@N06,3485,8,1319325026,1319354379,10,1,29353
8927252@N06,3486,8,1325409453,1325410823,5,1,1370
8927252@N06,3487,8,1355636448,1355646993,9,1,10545
89334444@N08,3488,4,1392000524,1392000524,1,2,0
89334444@N08,3488,11,1392014216,1392014216,1,2,0
89388234@N00,3489,6,1371868804,1371868804,1,4,0
89388234@N00,3489,8,1371858010,1371858010,1,4,0
89388234@N00,3489,4,1371866167,1371868188,2,4,2021
89388234@N00,3489,2,1371869142,1371877213,3,4,8071
89451823@N08,3490,1,1378943001,1378943001,2,3,0
89451823@N08,3490,6,1378947587,1378947587,1,3,0
89451823@N08,3490,5,1378943113,1378943113,1,3,0
89455189@N05,3491,5,1396931731,1396931731,1,1,0
8949620@N08,3492,6,1209811321,1209811321,1,2,0
8949620@N08,3492,2,1209828853,1209828853,1,2,0
8949620@N08,3493,2,1209861327,1209861841,3,2,514
8949620@N08,3493,13,1209861723,1209861762,2,2,39
8949620@N08,3494,2,1209897967,1209905544,2,2,7577
8949620@N08,3494,6,1209898433,1209898433,1,2,0
8949620@N08,3495,8,1243945819,1243945819,1,2,0
8949620@N08,3495,10,1243928189,1243946165,12,2,17976
8951720@N04,3496,5,1304315047,1304315156,3,1,109
89522530@N00,3497,12,1332038885,1332042257,6,10,3372
89522530@N00,3497,7,1332036939,1332037292,3,10,353
89522530@N00,3497,13,1332048316,1332049681,9,10,1365
89522530@N00,3497,1,1332044107,1332044107,1,10,0
89522530@N00,3497,11,1332020870,1332020870,1,10,0
89522530@N00,3497,3,1332032412,1332032412,1,10,0
89522530@N00,3497,6,1332026844,1332034856,11,10,8012
89522530@N00,3497,8,1332044147,1332045625,9,10,1478
89522530@N00,3497,4,1332021306,1332023282,5,10,1976
89522530@N00,3497,2,1332023817,1332046319,9,10,22502
89573469@N03,3498,7,1367648257,1367648257,1,1,0
89658123@N07,3499,9,1359707249,1359707249,1,1,0
8980678@N03,3500,8,1190771688,1190775168,4,1,3480
8980678@N03,3501,8,1213503358,1213503509,2,1,151
8980678@N03,3502,8,1229501221,1229503496,8,1,2275
8980678@N03,3503,1,1236733629,1236733629,1,2,0
8980678@N03,3503,8,1236726105,1236726105,1,2,0
8980678@N03,3504,8,1268279657,1268279657,1,1,0
8980678@N03,3505,8,1279196350,1279196350,1,1,0
8980678@N03,3506,8,1284079786,1284081288,3,1,1502
8980678@N03,3507,8,1290071934,1290075355,6,1,3421
8980678@N03,3508,7,1294963069,1294963069,1,3,0
8980678@N03,3508,8,1294963323,1294963323,1,3,0
8980678@N03,3508,11,1294962927,1294962927,1,3,0
8980678@N03,3509,8,1308277032,1308277868,3,1,836
8980678@N03,3510,13,1379071694,1379074005,5,2,2311
8980678@N03,3510,1,1379060147,1379077648,2,2,17501
8980678@N03,3511,6,1384157537,1384159214,3,1,1677
8980678@N03,3512,6,1418458235,1418459461,3,1,1226
89938050@N07,3513,1,1350356682,1350356698,2,1,16
90008840@N00,3514,4,1370749060,1370749060,1,2,0
90008840@N00,3514,6,1370745190,1370750687,2,2,5497
90008840@N00,3515,6,1417854409,1417855484,4,1,1075
90008840@N00,3516,4,1444436591,1444436591,1,1,0
90008840@N00,3517,12,1462587683,1462593772,2,1,6089
90067442@N03,3518,5,1376773545,1376773545,1,1,0
90123960@N00,3519,4,1227159101,1227173790,6,6,14689
90123960@N00,3519,13,1227173876,1227177725,4,6,3849
90123960@N00,3519,1,1227169528,1227169607,5,6,79
90123960@N00,3519,6,1227160063,1227168357,13,6,8294
90123960@N00,3519,5,1227168720,1227172061,6,6,3341
90123960@N00,3519,8,1227168533,1227180259,3,6,11726
90123960@N00,3520,6,1295416924,1295416924,1,4,0
90123960@N00,3520,8,1295417634,1295417634,1,4,0
90123960@N00,3520,13,1295418034,1295418034,1,4,0
90123960@N00,3520,1,1295406851,1295419519,2,4,12668
90184981@N00,3521,1,1354350180,1354350180,1,1,0
9026784@N08,3522,6,1356768732,1356768732,1,1,0
90315279@N00,3523,5,1369007089,1369007089,1,6,0
90315279@N00,3523,6,1369015660,1369022265,6,6,6605
90315279@N00,3523,2,1369026135,1369040306,5,6,14171
90315279@N00,3523,4,1369021143,1369025052,6,6,3909
90315279@N00,3523,10,1369004774,1369041885,5,6,37111
90315279@N00,3523,1,1369006051,1369006051,2,6,0
90315279@N00,3524,6,1443494565,1443494565,1,1,0
90347114@N05,3525,12,1397175523,1397175523,1,4,0
90347114@N05,3525,13,1397178039,1397178039,1,4,0
90347114@N05,3525,11,1397175742,1397175771,3,4,29
90347114@N05,3525,8,1397175161,1397175185,3,4,24
9036688@N06,3526,10,1317184895,1317188486,14,3,3591
9036688@N06,3526,2,1317184853,1317191623,7,3,6770
9036688@N06,3526,6,1317203312,1317203312,1,3,0
9046670@N05,3527,1,1409467408,1409467408,1,1,0
90468007@N00,3528,1,1202906966,1202906966,1,1,0
90496636@N05,3529,12,1424668115,1424668115,1,1,0
9053157@N02,3530,10,1340848819,1340848819,1,2,0
9053157@N02,3530,5,1340848828,1340848828,1,2,0
9053157@N02,3531,12,1341130304,1341130313,2,1,9
9053157@N02,3532,4,1342155327,1342155327,1,2,0
9053157@N02,3532,6,1342155339,1342155339,1,2,0
9053157@N02,3533,6,1342433708,1342433708,1,1,0
90533800@N00,3534,6,1329617419,1329617419,1,2,0
90533800@N00,3534,1,1329616111,1329624916,3,2,8805
90642923@N00,3535,5,1193439603,1193439629,2,2,26
90642923@N00,3535,6,1193447780,1193447780,1,2,0
90642923@N00,3536,2,1199672906,1199673115,2,2,209
90642923@N00,3536,4,1199681128,1199681128,1,2,0
90642923@N00,3537,1,1205465806,1205468863,2,2,3057
90642923@N00,3537,6,1205472981,1205472981,1,2,0
90642923@N00,3538,2,1212115581,1212117046,7,4,1465
90642923@N00,3538,11,1212115533,1212115533,1,4,0
90642923@N00,3538,12,1212115426,1212115426,1,4,0
90642923@N00,3538,6,1212117482,1212117482,1,4,0
90642923@N00,3539,6,1222826750,1222831901,5,1,5151
90642923@N00,3540,6,1231903230,1231903230,1,2,0
90642923@N00,3540,2,1231916652,1231917724,2,2,1072
90642923@N00,3541,4,1244876033,1244876455,2,4,422
90642923@N00,3541,6,1244870934,1244870934,1,4,0
90642923@N00,3541,2,1244867224,1244867224,1,4,0
90642923@N00,3541,13,1244866692,1244866692,1,4,0
9070451@N03,3542,13,1400728673,1400728673,1,1,0
90727225@N00,3543,8,1245457710,1245495696,10,1,37986
90728477@N00,3544,2,1369439563,1369439563,1,4,0
90728477@N00,3544,5,1369436260,1369457388,3,4,21128
90728477@N00,3544,4,1369441549,1369441836,2,4,287
90728477@N00,3544,8,1369440222,1369440222,1,4,0
90844305@N00,3545,2,1215575896,1215575896,1,1,0
91045059@N02,3546,1,1358115783,1358151135,120,3,35352
91045059@N02,3546,13,1358122627,1358122627,2,3,0
91045059@N02,3546,6,1358121117,1358121688,4,3,571
91087719@N08,3547,6,1416833650,1416833650,1,1,0
91087719@N08,3548,6,1449309527,1449309527,1,1,0
91092205@N07,3549,5,1368068707,1368070848,29,3,2141
91092205@N07,3549,4,1368072644,1368072645,4,3,1
91092205@N07,3549,1,1368061136,1368099365,27,3,38229
91110029@N02,3550,5,1389685849,1389685849,1,1,0
91110029@N02,3551,8,1412557092,1412557092,1,1,0
91110029@N02,3552,1,1414619265,1414619265,1,1,0
91132397@N08,3553,6,1417501724,1417504237,2,2,2513
91132397@N08,3553,12,1417498960,1417498960,1,2,0
91144647@N06,3554,4,1333874027,1333874027,1,1,0
91144647@N06,3555,6,1334134833,1334134861,2,1,28
91144647@N06,3556,8,1355611034,1355611034,1,1,0
91207697@N08,3557,8,1413444197,1413444197,1,3,0
91207697@N08,3557,9,1413449903,1413449903,1,3,0
91207697@N08,3557,7,1413442745,1413442745,1,3,0
91207697@N08,3558,6,1413851157,1413853750,3,1,2593
91207697@N08,3559,4,1414196728,1414196737,2,1,9
91207697@N08,3560,8,1423377587,1423377587,1,1,0
91220827@N02,3561,6,1377040834,1377040834,1,1,0
91227690@N08,3562,7,1459836682,1459836682,1,2,0
91227690@N08,3562,12,1459836255,1459836588,10,2,333
91227690@N08,3563,5,1460352025,1460352800,4,3,775
91227690@N08,3563,1,1460349778,1460349778,1,3,0
91227690@N08,3563,4,1460354236,1460354628,9,3,392
91227690@N08,3564,2,1460701572,1460701769,2,3,197
91227690@N08,3564,5,1460697780,1460698429,7,3,649
91227690@N08,3564,8,1460699471,1460701188,10,3,1717
91227690@N08,3565,5,1461129981,1461129981,1,1,0
91227690@N08,3566,1,1461559592,1461559592,1,2,0
91227690@N08,3566,5,1461561680,1461562840,3,2,1160
91315857@N02,3567,5,1377202862,1377202862,1,1,0
91315857@N02,3568,9,1378191334,1378191334,1,1,0
91315857@N02,3569,8,1440280107,1440280130,2,3,23
91315857@N02,3569,4,1440282584,1440286358,2,3,3774
91315857@N02,3569,1,1440275042,1440275042,1,3,0
91363409@N07,3570,5,1416003408,1416007810,2,2,4402
91363409@N07,3570,2,1416016389,1416016389,1,2,0
91372718@N04,3571,1,1374487963,1374487985,2,6,22
91372718@N04,3571,8,1374458740,1374458740,1,6,0
91372718@N04,3571,10,1374498846,1374498873,2,6,27
91372718@N04,3571,9,1374497603,1374497603,1,6,0
91372718@N04,3571,2,1374464597,1374464597,1,6,0
91372718@N04,3571,13,1374463335,1374463404,2,6,69
91372718@N04,3572,4,1374658303,1374658303,1,3,0
91372718@N04,3572,5,1374659798,1374667894,3,3,8096
91372718@N04,3572,10,1374652951,1374652951,1,3,0
91380511@N05,3573,6,1321693932,1321693932,1,1,0
91407288@N07,3574,1,1352100189,1352100209,3,6,20
91407288@N07,3574,11,1352081862,1352081862,1,6,0
91407288@N07,3574,6,1352089937,1352089937,1,6,0
91407288@N07,3574,5,1352074735,1352079911,4,6,5176
91407288@N07,3574,4,1352103167,1352103536,9,6,369
91407288@N07,3574,10,1352066288,1352066288,1,6,0
91407288@N07,3575,5,1352443435,1352443435,1,1,0
91409399@N07,3576,4,1379741788,1379745329,2,3,3541
91409399@N07,3576,1,1379751893,1379751917,2,3,24
91409399@N07,3576,8,1379747465,1379747476,2,3,11
91409399@N07,3577,5,1379827358,1379827358,1,3,0
91409399@N07,3577,13,1379821756,1379823212,3,3,1456
91409399@N07,3577,6,1379811800,1379811800,1,3,0
91435349@N03,3578,6,1381383114,1381383114,1,1,0
91501015@N07,3579,6,1356419850,1356419850,1,1,0
91511594@N02,3580,4,1385375457,1385376641,2,2,1184
91511594@N02,3580,2,1385380065,1385380065,1,2,0
91511594@N02,3581,2,1385445083,1385445083,1,1,0
91569514@N05,3582,1,1432683158,1432684641,5,1,1483
91569514@N05,3583,12,1433302676,1433302781,3,2,105
91569514@N05,3583,13,1433302111,1433302111,1,2,0
9161595@N03,3584,1,1329354534,1329376293,2,7,21759
9161595@N03,3584,2,1329373498,1329373498,1,7,0
9161595@N03,3584,13,1329352839,1329354263,3,7,1424
9161595@N03,3584,12,1329358196,1329358307,2,7,111
9161595@N03,3584,8,1329346930,1329350065,12,7,3135
9161595@N03,3584,6,1329362111,1329365624,9,7,3513
9161595@N03,3584,11,1329366450,1329368539,3,7,2089
91619162@N06,3585,13,1360380131,1360380131,1,1,0
91621746@N00,3586,9,1330250191,1330250210,4,4,19
91621746@N00,3586,10,1330230505,1330230505,1,4,0
91621746@N00,3586,13,1330235012,1330235132,7,4,120
91621746@N00,3586,4,1330235443,1330235481,4,4,38
91678850@N02,3587,6,1355301479,1355301562,2,1,83
91694685@N00,3588,7,1220953406,1220954094,3,2,688
91694685@N00,3588,8,1220954641,1220954641,1,2,0
91694685@N00,3589,2,1221004672,1221005606,6,1,934
9176927@N08,3590,4,1225864392,1225864440,3,2,48
9176927@N08,3590,1,1225858935,1225859003,3,2,68
9176927@N08,3591,1,1239237651,1239237656,2,3,5
9176927@N08,3591,6,1239242001,1239242001,1,3,0
9176927@N08,3591,11,1239240060,1239240060,1,3,0
91831221@N00,3592,1,1326497911,1326497911,1,1,0
91859523@N00,3593,1,1303706037,1303711773,2,4,5736
91859523@N00,3593,6,1303709760,1303709760,1,4,0
91859523@N00,3593,13,1303706257,1303706257,1,4,0
91859523@N00,3593,4,1303709143,1303709143,1,4,0
91894661@N02,3594,1,1366516686,1366516686,1,1,0
9191162@N05,3595,2,1225500177,1225500183,2,1,6
9197147@N03,3596,8,1400212387,1400212387,1,1,0
9197147@N03,3597,2,1400295152,1400295152,1,1,0
92005509@N02,3598,8,1464144216,1464144216,1,1,0
92008781@N05,3599,1,1354672980,1354672980,1,1,0
92026547@N05,3600,5,1411551936,1411552968,6,2,1032
92026547@N05,3600,1,1411550746,1411550746,1,2,0
92026547@N05,3601,5,1417862121,1417862419,2,2,298
92026547@N05,3601,8,1417862984,1417863192,2,2,208
92098172@N03,3602,8,1357870847,1357870847,1,2,0
92098172@N03,3602,5,1357857343,1357859081,2,2,1738
9213713@N02,3603,5,1387935713,1387935713,1,1,0
92238955@N06,3604,7,1354067756,1354091733,3,1,23977
92248782@N00,3605,8,1381233678,1381233678,1,1,0
9228491@N06,3606,6,1267312196,1267312196,1,6,0
9228491@N06,3606,10,1267305749,1267334866,20,6,29117
9228491@N06,3606,1,1267307256,1267335737,5,6,28481
9228491@N06,3606,5,1267320590,1267335485,5,6,14895
9228491@N06,3606,12,1267319061,1267319093,3,6,32
9228491@N06,3606,2,1267314816,1267314816,1,6,0
9228491@N06,3607,1,1267566755,1267578861,7,7,12106
9228491@N06,3607,2,1267567563,1267590897,6,7,23334
9228491@N06,3607,4,1267570774,1267570774,1,7,0
9228491@N06,3607,10,1267566739,1267566739,1,7,0
9228491@N06,3607,6,1267568442,1267568793,6,7,351
9228491@N06,3607,12,1267573312,1267573474,15,7,162
9228491@N06,3607,8,1267567230,1267574011,4,7,6781
9228491@N06,3608,9,1267696512,1267696796,5,11,284
9228491@N06,3608,11,1267682406,1267685454,5,11,3048
9228491@N06,3608,7,1267682624,1267682624,1,11,0
9228491@N06,3608,10,1267690999,1267691571,4,11,572
9228491@N06,3608,2,1267677109,1267685832,5,11,8723
9228491@N06,3608,1,1267676836,1267683240,8,11,6404
9228491@N06,3608,4,1267683791,1267685026,3,11,1235
9228491@N06,3608,6,1267681785,1267685104,9,11,3319
9228491@N06,3608,12,1267685554,1267685589,2,11,35
9228491@N06,3608,13,1267679081,1267686939,8,11,7858
9228491@N06,3608,8,1267682207,1267690393,16,11,8186
9228491@N06,3609,2,1268090257,1268105656,32,1,15399
9228491@N06,3610,1,1323644199,1323644256,2,1,57
9228491@N06,3611,6,1323756965,1323756965,1,3,0
9228491@N06,3611,9,1323767561,1323768591,3,3,1030
9228491@N06,3611,8,1323752602,1323753492,2,3,890
9228491@N06,3612,8,1329534021,1329534021,1,1,0
9230719@N05,3613,6,1291447905,1291448454,3,2,549
9230719@N05,3613,11,1291450617,1291450617,1,2,0
92375998@N05,3614,1,1370071597,1370071597,1,1,0
92504072@N06,3615,13,1291416261,1291431377,3,1,15116
92505486@N00,3616,8,1289380996,1289380996,2,2,0
92505486@N00,3616,6,1289379294,1289379934,2,2,640
92517428@N00,3617,10,1287320400,1287320400,24,1,0
92533979@N00,3618,10,1359868699,1359868879,4,4,180
92533979@N00,3618,8,1359874745,1359874745,1,4,0
92533979@N00,3618,9,1359880069,1359880069,1,4,0
92533979@N00,3618,4,1359853680,1359870897,3,4,17217
92589815@N02,3619,8,1366776901,1366798897,11,1,21996
9261503@N08,3620,1,1434245632,1434245730,7,2,98
9261503@N08,3620,8,1434248625,1434248625,2,2,0
92622262@N08,3621,9,1370690814,1370690908,7,1,94
92622262@N08,3622,4,1378543008,1378543055,5,3,47
92622262@N08,3622,5,1378532918,1378541471,4,3,8553
92622262@N08,3622,6,1378544463,1378544638,2,3,175
92622262@N08,3623,4,1392443453,1392443453,1,3,0
92622262@N08,3623,5,1392452044,1392452044,1,3,0
92622262@N08,3623,6,1392443377,1392443402,2,3,25
92622262@N08,3624,4,1401004109,1401004109,1,2,0
92622262@N08,3624,2,1400997297,1400999137,2,2,1840
92622262@N08,3625,6,1418454869,1418454869,2,1,0
9290765@N06,3626,7,1222221927,1222223893,8,2,1966
9290765@N06,3626,5,1222226504,1222226517,3,2,13
9292159@N06,3627,10,1449657597,1449657597,1,2,0
9292159@N06,3627,1,1449658066,1449658066,1,2,0
9292159@N06,3628,13,1449730121,1449730348,2,8,227
9292159@N06,3628,8,1449729530,1449733780,3,8,4250
9292159@N06,3628,7,1449731959,1449731959,1,8,0
9292159@N06,3628,10,1449738471,1449738482,2,8,11
9292159@N06,3628,5,1449738597,1449738597,1,8,0
9292159@N06,3628,12,1449733155,1449733620,5,8,465
9292159@N06,3628,6,1449730601,1449740692,10,8,10091
9292159@N06,3628,4,1449734703,1449734703,1,8,0
92931591@N05,3629,9,1440919316,1440919316,1,1,0
93003498@N05,3630,1,1331882111,1331882124,3,1,13
93003498@N05,3631,7,1367470402,1367470473,3,1,71
93074386@N00,3632,9,1444987879,1444987879,1,1,0
93081598@N05,3633,1,1365496364,1365496457,4,2,93
93081598@N05,3633,5,1365498605,1365498605,1,2,0
93117900@N03,3634,4,1383108991,1383108991,1,1,0
93150071@N06,3635,8,1363832547,1363832547,1,1,0
93283041@N00,3636,5,1217925264,1217925264,1,1,0
93283041@N00,3637,7,1229464832,1229464856,7,8,24
93283041@N00,3637,8,1229464850,1229464898,10,8,48
93283041@N00,3637,12,1229464878,1229464878,1,8,0
93283041@N00,3637,13,1229464823,1229464824,2,8,1
93283041@N00,3637,10,1229464844,1229464907,14,8,63
93283041@N00,3637,1,1229464800,1229464906,17,8,106
93283041@N00,3637,5,1229464843,1229464843,1,8,0
93283041@N00,3637,6,1229464802,1229464896,34,8,94
93283041@N00,3638,11,1279073014,1279074244,21,1,1230
93283041@N00,3639,10,1289097010,1289097054,2,3,44
93283041@N00,3639,9,1289112979,1289112986,2,3,7
93283041@N00,3639,6,1289101865,1289101880,2,3,15
93283041@N00,3640,6,1292482813,1292485354,16,1,2541
9329633@N04,3641,2,1354244096,1354244096,1,1,0
93334382@N02,3642,5,1392499041,1392499455,3,1,414
93371661@N08,3643,1,1360361977,1360361977,1,1,0
93461622@N00,3644,9,1445595462,1445595462,1,2,0
93461622@N00,3644,4,1445583010,1445583010,1,2,0
93480471@N06,3645,8,1362002069,1362011498,72,1,9429
93480471@N06,3646,8,1362113079,1362123906,39,1,10827
93503884@N03,3647,2,1351325488,1351325488,1,2,0
93503884@N03,3647,8,1351323969,1351324047,2,2,78
93514520@N02,3648,6,1357028842,1357028842,1,1,0
93538524@N06,3649,4,1374550124,1374551622,4,4,1498
93538524@N06,3649,1,1374540965,1374542715,3,4,1750
93538524@N06,3649,10,1374539053,1374539053,1,4,0
93538524@N06,3649,6,1374546093,1374557048,29,4,10955
93586926@N05,3650,4,1410204608,1410204608,1,2,0
93586926@N05,3650,5,1410204573,1410204573,1,2,0
93629101@N05,3651,10,1430600451,1430653735,14,13,53284
93629101@N05,3651,12,1430619835,1430622686,20,13,2851
93629101@N05,3651,5,1430653618,1430654400,7,13,782
93629101@N05,3651,4,1430634121,1430636923,5,13,2802
93629101@N05,3651,7,1430620403,1430623992,38,13,3589
93629101@N05,3651,13,1430618610,1430618648,4,13,38
93629101@N05,3651,3,1430634109,1430634109,1,13,0
93629101@N05,3651,8,1430616929,1430640809,24,13,23880
93629101@N05,3651,11,1430623057,1430623652,41,13,595
93629101@N05,3651,2,1430618133,1430644796,70,13,26663
93629101@N05,3651,6,1430618789,1430634670,22,13,15881
93629101@N05,3651,9,1430621591,1430653266,50,13,31675
93629101@N05,3651,1,1430637192,1430655987,14,13,18795
93743574@N08,3652,4,1416951484,1416951624,10,3,140
93743574@N08,3652,2,1416976566,1416976566,2,3,0
93743574@N08,3652,6,1416954168,1416954168,1,3,0
93857621@N00,3653,6,1387956435,1387956435,1,1,0
93890245@N05,3654,13,1377168598,1377168598,1,2,0
93890245@N05,3654,5,1377172030,1377172030,1,2,0
9426620@N06,3655,4,1213912126,1213912275,6,3,149
9426620@N06,3655,1,1213919553,1213919553,1,3,0
9426620@N06,3655,8,1213914718,1213914775,4,3,57
9426620@N06,3656,8,1213966810,1213966810,1,1,0
94335186@N07,3657,1,1427920969,1427921274,2,1,305
94378868@N00,3658,6,1361266308,1361266308,1,2,0
94378868@N00,3658,5,1361266231,1361266231,1,2,0
94436430@N00,3659,7,1360276591,1360276591,1,1,0
94529757@N00,3660,1,1256006934,1256006934,1,1,0
9456601@N03,3661,13,1308469030,1308470400,4,3,1370
9456601@N03,3661,1,1308441934,1308441934,1,3,0
9456601@N03,3661,4,1308458057,1308458057,1,3,0
9459831@N04,3662,6,1288492946,1288492946,1,1,0
94608875@N00,3663,1,1215479321,1215489200,11,1,9879
94608875@N00,3664,1,1215561189,1215561189,1,1,0
94608875@N00,3665,1,1215650714,1215658633,31,1,7919
94608875@N00,3666,6,1291267854,1291278516,15,1,10662
9461342@N03,3667,2,1397195919,1397195919,1,1,0
9461342@N03,3668,6,1460012776,1460012776,1,1,0
94687753@N00,3669,8,1372374103,1372374103,1,2,0
94687753@N00,3669,2,1372377541,1372377541,1,2,0
94697173@N00,3670,4,1432936953,1432940120,29,4,3167
94697173@N00,3670,2,1432951738,1432951738,1,4,0
94697173@N00,3670,8,1432943838,1432946978,24,4,3140
94697173@N00,3670,6,1432937474,1432937474,1,4,0
94697173@N00,3671,4,1443574770,1443574788,4,9,18
94697173@N00,3671,7,1443572289,1443572421,8,9,132
94697173@N00,3671,2,1443572715,1443573700,2,9,985
94697173@N00,3671,13,1443568751,1443568814,5,9,63
94697173@N00,3671,11,1443571724,1443572281,13,9,557
94697173@N00,3671,8,1443568890,1443576640,4,9,7750
94697173@N00,3671,12,1443571585,1443571585,1,9,0
94697173@N00,3671,6,1443574203,1443574756,46,9,553
94697173@N00,3671,1,1443568631,1443571502,9,9,2871
94697173@N00,3672,12,1454647799,1454649951,24,1,2152
94921086@N08,3673,5,1384383067,1384383067,1,1,0
95095552@N02,3674,12,1399104606,1399104606,1,3,0
95095552@N02,3674,8,1399076817,1399076817,2,3,0
95095552@N02,3674,2,1399115727,1399115727,2,3,0
95095552@N02,3675,4,1399230208,1399258696,3,1,28488
95225007@N00,3676,2,1383961187,1383961187,1,1,0
95258067@N00,3677,2,1386825863,1386825863,1,9,0
95258067@N00,3677,13,1386812188,1386812188,1,9,0
95258067@N00,3677,5,1386836094,1386837970,3,9,1876
95258067@N00,3677,11,1386825657,1386825657,1,9,0
95258067@N00,3677,8,1386821386,1386832551,3,9,11165
95258067@N00,3677,10,1386841334,1386841334,1,9,0
95258067@N00,3677,9,1386839139,1386839160,2,9,21
95258067@N00,3677,6,1386807961,1386835274,13,9,27313
95258067@N00,3677,7,1386832232,1386832232,1,9,0
95258067@N00,3678,8,1386889394,1386889575,2,3,181
95258067@N00,3678,11,1386889278,1386889278,1,3,0
95258067@N00,3678,10,1386890816,1386890816,1,3,0
95341382@N05,3679,9,1438511174,1438511174,1,1,0
95341382@N05,3680,2,1443262057,1443262087,2,1,30
95356654@N00,3681,8,1223469300,1223469300,1,1,0
95356654@N00,3682,4,1327886408,1327886408,1,1,0
95356654@N00,3683,9,1390205936,1390210396,21,1,4460
95400328@N03,3684,13,1371506890,1371506890,1,2,0
95400328@N03,3684,2,1371511664,1371511664,1,2,0
95400328@N03,3685,9,1371547482,1371547482,1,1,0
95413039@N00,3686,8,1198279887,1198307969,86,1,28082
9549670@N05,3687,1,1467842410,1467848082,21,9,5672
9549670@N05,3687,5,1467846694,1467846805,2,9,111
9549670@N05,3687,2,1467845149,1467845202,3,9,53
9549670@N05,3687,7,1467845432,1467845919,4,9,487
9549670@N05,3687,12,1467845479,1467845492,4,9,13
9549670@N05,3687,13,1467842637,1467842777,2,9,140
9549670@N05,3687,8,1467844829,1467847381,18,9,2552
9549670@N05,3687,6,1467843021,1467844662,12,9,1641
9549670@N05,3687,4,1467842961,1467844643,4,9,1682
95532183@N07,3688,6,1451802694,1451802694,1,1,0
95532183@N07,3689,12,1452582024,1452582024,1,1,0
95555269@N00,3690,12,1385253583,1385254819,2,4,1236
95555269@N00,3690,1,1385256950,1385259030,2,4,2080
95555269@N00,3690,6,1385270437,1385290662,10,4,20225
95555269@N00,3690,9,1385276147,1385276147,1,4,0
95559818@N00,3691,1,1190686249,1190686597,3,1,348
95559818@N00,3692,1,1333446480,1333446480,1,2,0
95559818@N00,3692,4,1333442529,1333442529,1,2,0
95572727@N00,3693,5,1310175368,1310175368,1,1,0
95608654@N04,3694,1,1363835351,1363848424,3,4,13073
95608654@N04,3694,4,1363842892,1363842892,1,4,0
95608654@N04,3694,6,1363840969,1363842708,3,4,1739
95608654@N04,3694,5,1363846468,1363846468,1,4,0
95615577@N07,3695,7,1379578266,1379616933,150,1,38667
95653839@N03,3696,5,1416540042,1416540042,1,1,0
95694198@N00,3697,5,1363124667,1363137464,4,3,12797
95694198@N00,3697,3,1363130611,1363130611,1,3,0
95694198@N00,3697,13,1363133989,1363135468,5,3,1479
95778894@N00,3698,6,1457243548,1457243548,1,4,0
95778894@N00,3698,7,1457255685,1457255685,1,4,0
95778894@N00,3698,8,1457233861,1457233861,1,4,0
95778894@N00,3698,12,1457256246,1457256246,1,4,0
95786139@N05,3699,2,1342412035,1342412035,1,1,0
95839603@N02,3700,6,1395873382,1395893465,6,10,20083
95839603@N02,3700,2,1395872913,1395886248,7,10,13335
95839603@N02,3700,9,1395914158,1395914158,1,10,0
95839603@N02,3700,7,1395903822,1395903822,1,10,0
95839603@N02,3700,1,1395910236,1395910310,2,10,74
95839603@N02,3700,10,1395871551,1395911220,3,10,39669
95839603@N02,3700,8,1395872198,1395890284,7,10,18086
95839603@N02,3700,13,1395896940,1395898642,2,10,1702
95839603@N02,3700,4,1395901589,1395901589,1,10,0
95839603@N02,3700,12,1395874451,1395878893,4,10,4442
95928504@N03,3701,1,1428295003,1428295003,1,2,0
95928504@N03,3701,5,1428295649,1428295649,1,2,0
95979850@N00,3702,12,1237094513,1237126207,5,1,31694
96062950@N02,3703,6,1386200595,1386228398,6,5,27803
96062950@N02,3703,2,1386228975,1386230314,2,5,1339
96062950@N02,3703,13,1386220231,1386220231,1,5,0
96062950@N02,3703,5,1386204498,1386204515,2,5,17
96062950@N02,3703,8,1386199991,1386216834,4,5,16843
96062950@N02,3704,10,1386461003,1386464970,2,4,3967
96062950@N02,3704,11,1386460737,1386460737,1,4,0
96062950@N02,3704,7,1386460781,1386460781,1,4,0
96062950@N02,3704,9,1386461146,1386461146,1,4,0
96074685@N04,3705,13,1373964743,1373971595,14,4,6852
96074685@N04,3705,4,1373964341,1373964455,51,4,114
96074685@N04,3705,2,1373941195,1373953829,16,4,12634
96074685@N04,3705,1,1373965230,1373971218,6,4,5988
96074685@N04,3706,6,1374127764,1374132743,3,1,4979
96077153@N00,3707,6,1291541287,1291543196,2,1,1909
96077153@N00,3708,10,1322440332,1322440332,1,1,0
96077153@N00,3709,9,1337940878,1337940878,1,2,0
96077153@N00,3709,10,1337923437,1337923437,1,2,0
96084178@N00,3710,1,1257823273,1257834992,4,1,11719
96084178@N00,3711,6,1395476810,1395476851,3,1,41
96110416@N06,3712,1,1374191048,1374221415,3,3,30367
96110416@N06,3712,6,1374220906,1374220906,1,3,0
96110416@N06,3712,12,1374195271,1374195278,2,3,7
96110416@N06,3713,6,1375163118,1375163118,1,1,0
9611843@N04,3714,7,1265844084,1265844084,1,1,0
9611843@N04,3715,11,1295311953,1295311953,1,1,0
9611843@N04,3716,1,1317340395,1317340395,1,1,0
9611843@N04,3717,8,1350258933,1350258933,1,1,0
96139953@N06,3718,10,1448680658,1448681016,17,3,358
96139953@N06,3718,6,1448686138,1448686138,1,3,0
96139953@N06,3718,7,1448695531,1448695531,1,3,0
9621505@N08,3719,5,1411165787,1411165787,1,1,0
96244139@N03,3720,7,1280202606,1280233997,13,1,31391
96269557@N00,3721,6,1245806887,1245807659,6,2,772
96269557@N00,3721,2,1245807225,1245807661,4,2,436
96274088@N05,3722,8,1356238053,1356238053,1,5,0
96274088@N05,3722,5,1356217128,1356217128,1,5,0
96274088@N05,3722,9,1356249804,1356249804,1,5,0
96274088@N05,3722,6,1356226956,1356252440,13,5,25484
96274088@N05,3722,1,1356217007,1356217007,1,5,0
96274088@N05,3723,11,1356388761,1356388761,1,3,0
96274088@N05,3723,6,1356389319,1356389319,1,3,0
96274088@N05,3723,4,1356386730,1356386730,1,3,0
96306402@N08,3724,5,1370325119,1370325119,1,1,0
96312503@N08,3725,10,1373123293,1373123293,1,1,0
96312503@N08,3726,10,1382265956,1382265956,1,1,0
96312503@N08,3727,4,1398912442,1398940658,2,2,28216
96312503@N08,3727,1,1398947742,1398947742,1,2,0
96312503@N08,3728,6,1400928391,1400928391,1,1,0
96312503@N08,3729,1,1400974586,1400974586,1,1,0
96312503@N08,3730,7,1401189653,1401189653,1,1,0
9639902@N04,3731,8,1222901624,1222901624,1,1,0
9639902@N04,3732,8,1240467091,1240474301,2,2,7210
9639902@N04,3732,11,1240481122,1240481122,1,2,0
96430093@N05,3733,13,1369976696,1369976696,1,1,0
96430093@N05,3734,1,1373006274,1373006274,1,2,0
96430093@N05,3734,4,1372995949,1372996688,2,2,739
96430093@N05,3735,1,1382221186,1382222165,2,2,979
96430093@N05,3735,8,1382235260,1382235260,1,2,0
96430093@N05,3736,5,1382918841,1382918841,1,1,0
96430093@N05,3737,12,1391382053,1391392976,2,2,10923
96430093@N05,3737,1,1391384616,1391393399,6,2,8783
96430093@N05,3738,1,1395188959,1395191277,3,1,2318
96430093@N05,3739,1,1395451073,1395461091,3,1,10018
96430093@N05,3740,4,1395521863,1395521863,1,1,0
96430093@N05,3741,1,1401521593,1401521593,1,1,0
96430093@N05,3742,1,1425341290,1425341290,1,1,0
96430093@N05,3743,1,1426884716,1426884716,1,1,0
96430093@N05,3744,1,1453940661,1453940661,1,1,0
9644199@N02,3745,8,1214913750,1214914532,10,1,782
9644199@N02,3746,1,1310001607,1310001607,1,1,0
9644199@N02,3747,4,1325061512,1325061512,1,1,0
9644199@N02,3748,5,1331620699,1331620699,1,1,0
96466494@N00,3749,4,1471598392,1471598392,1,1,0
96525092@N00,3750,1,1254385609,1254385609,1,3,0
96525092@N00,3750,10,1254369658,1254369658,1,3,0
96525092@N00,3750,8,1254384618,1254389453,3,3,4835
96525092@N00,3751,8,1257261291,1257261291,1,1,0
96525092@N00,3752,8,1262951913,1262951913,1,1,0
96525092@N00,3753,2,1267827940,1267827940,1,2,0
96525092@N00,3753,8,1267829141,1267830902,2,2,1761
9653109@N04,3754,12,1252315984,1252315984,1,3,0
9653109@N04,3754,5,1252316095,1252316492,4,3,397
9653109@N04,3754,10,1252310441,1252310441,1,3,0
9653109@N04,3755,11,1252581207,1252581207,1,2,0
9653109@N04,3755,13,1252571586,1252571586,1,2,0
9653109@N04,3756,11,1285578592,1285578592,1,3,0
9653109@N04,3756,5,1285576404,1285584356,2,3,7952
9653109@N04,3756,4,1285580623,1285580623,1,3,0
96545872@N00,3757,4,1356243187,1356243187,1,1,0
96548081@N07,3758,2,1460342374,1460342374,1,1,0
96581740@N03,3759,11,1442565237,1442565237,1,5,0
96581740@N03,3759,1,1442545424,1442548143,7,5,2719
96581740@N03,3759,2,1442564736,1442564740,2,5,4
96581740@N03,3759,12,1442559121,1442560418,13,5,1297
96581740@N03,3759,8,1442539915,1442548179,14,5,8264
96634395@N05,3760,5,1392176619,1392176619,1,1,0
96634395@N05,3761,11,1394357185,1394357863,2,2,678
96634395@N05,3761,4,1394355029,1394355029,1,2,0
96637966@N00,3762,4,1402063028,1402063028,1,1,0
9664341@N05,3763,2,1215131208,1215134133,3,4,2925
9664341@N05,3763,6,1215140150,1215140150,1,4,0
9664341@N05,3763,7,1215129419,1215129419,1,4,0
9664341@N05,3763,8,1215146274,1215146518,4,4,244
9664341@N05,3764,2,1215214641,1215216791,2,2,2150
9664341@N05,3764,12,1215217847,1215217847,1,2,0
9664341@N05,3765,8,1215653927,1215653927,1,1,0
96678288@N02,3766,8,1370579649,1370579656,4,1,7
96678288@N02,3767,6,1384317722,1384319328,2,1,1606
96678288@N02,3768,10,1385530739,1385546653,8,3,15914
96678288@N02,3768,2,1385533140,1385533198,2,3,58
96678288@N02,3768,9,1385541083,1385544359,10,3,3276
96678288@N02,3769,6,1388825509,1388833779,46,2,8270
96678288@N02,3769,4,1388833484,1388833484,1,2,0
96678288@N02,3770,6,1448694791,1448717127,2,1,22336
96678288@N02,3771,12,1449924470,1449924775,3,2,305
96678288@N02,3771,6,1449916279,1449916279,1,2,0
96678288@N02,3772,5,1451020068,1451020068,1,2,0
96678288@N02,3772,6,1451026752,1451034509,3,2,7757
96678288@N02,3773,4,1451121166,1451121166,1,1,0
96678288@N02,3774,5,1451442024,1451442024,1,1,0
96678288@N02,3775,6,1451704571,1451739224,9,1,34653
96678288@N02,3776,6,1451814413,1451814413,1,1,0
96678288@N02,3777,6,1451992824,1451992824,1,1,0
96678288@N02,3778,6,1452302468,1452320819,5,1,18351
96678288@N02,3779,12,1455511610,1455511610,1,2,0
96678288@N02,3779,8,1455524372,1455524938,2,2,566
96678288@N02,3780,8,1455569342,1455569342,1,1,0
96678288@N02,3781,2,1457936016,1457936016,1,4,0
96678288@N02,3781,8,1457944988,1457944988,1,4,0
96678288@N02,3781,4,1457940297,1457945933,4,4,5636
96678288@N02,3781,6,1457933674,1457939174,3,4,5500
96678288@N02,3782,2,1458789090,1458789090,1,2,0
96678288@N02,3782,8,1458813110,1458813318,2,2,208
96678288@N02,3783,6,1459143044,1459204999,33,1,61955
96678288@N02,3784,8,1460963471,1460968471,2,4,5000
96678288@N02,3784,5,1460962155,1460978008,2,4,15853
96678288@N02,3784,9,1460966697,1460974740,5,4,8043
96678288@N02,3784,6,1460975035,1460975035,1,4,0
96678288@N02,3785,4,1462177955,1462177955,1,1,0
96678288@N02,3786,4,1465887760,1465887760,1,1,0
96678288@N02,3787,2,1466495638,1466495638,1,3,0
96678288@N02,3787,4,1466499796,1466499796,1,3,0
96678288@N02,3787,10,1466475864,1466512609,5,3,36745
96678288@N02,3788,8,1467104576,1467104801,2,1,225
96678288@N02,3789,8,1468315455,1468339541,4,1,24086
96678288@N02,3790,5,1469512141,1469527361,3,5,15220
96678288@N02,3790,8,1469505147,1469528129,4,5,22982
96678288@N02,3790,7,1469513619,1469513619,1,5,0
96678288@N02,3790,6,1469514349,1469514349,1,5,0
96678288@N02,3790,2,1469518365,1469518365,1,5,0
96739093@N00,3791,2,1279275032,1279275032,1,1,0
96744221@N05,3792,2,1370694292,1370694292,1,2,0
96744221@N05,3792,4,1370694123,1370694123,1,2,0
96818288@N03,3793,1,1202121738,1202121738,1,1,0
96846534@N05,3794,2,1363660143,1363660143,1,2,0
96846534@N05,3794,8,1363650332,1363650332,1,2,0
96905971@N05,3795,1,1370658111,1370658111,1,2,0
96905971@N05,3795,10,1370654320,1370663927,2,2,9607
96934975@N05,3796,2,1370404697,1370404697,1,1,0
97023479@N08,3797,6,1444181549,1444186064,3,5,4515
97023479@N08,3797,9,1444209767,1444209966,2,5,199
97023479@N08,3797,5,1444169618,1444178509,2,5,8891
97023479@N08,3797,8,1444173421,1444173421,1,5,0
97023479@N08,3797,10,1444176425,1444176425,1,5,0
9710088@N06,3798,6,1298725544,1298725544,1,1,0
97174119@N07,3799,4,1405488847,1405488847,1,1,0
97174119@N07,3800,5,1405812951,1405812951,1,1,0
97267319@N00,3801,8,1365671373,1365671373,1,5,0
97267319@N00,3801,4,1365642743,1365667086,5,5,24343
97267319@N00,3801,2,1365654301,1365672527,3,5,18226
97267319@N00,3801,13,1365644512,1365644535,2,5,23
97267319@N00,3801,6,1365647499,1365650709,5,5,3210
97316886@N04,3802,6,1452470520,1452470520,1,2,0
97316886@N04,3802,10,1452468705,1452468705,1,2,0
97408089@N00,3803,4,1362963470,1362963470,2,1,0
97413516@N00,3804,8,1287101839,1287101839,1,1,0
97472023@N04,3805,1,1414041918,1414041918,1,2,0
97472023@N04,3805,2,1414034231,1414034231,1,2,0
97477255@N00,3806,6,1359865012,1359866148,10,1,1136
97489023@N00,3807,11,1322967681,1322967681,1,3,0
97489023@N00,3807,5,1322953795,1322954063,2,3,268
97489023@N00,3807,6,1322961012,1322965132,2,3,4120
97550352@N08,3808,6,1387609066,1387609066,1,1,0
97621779@N03,3809,7,1339319028,1339319028,1,1,0
97639305@N00,3810,1,1300103040,1300103252,3,1,212
97721343@N08,3811,6,1420107989,1420108453,3,2,464
97721343@N08,3811,1,1420109124,1420109348,3,2,224
97818848@N05,3812,12,1435566131,1435566131,1,1,0
97818848@N05,3813,13,1453531249,1453531249,1,1,0
97838235@N00,3814,13,1381110797,1381110797,1,4,0
97838235@N00,3814,12,1381128311,1381128311,1,4,0
97838235@N00,3814,4,1381120008,1381120775,3,4,767
97838235@N00,3814,5,1381102245,1381102245,1,4,0
97864553@N00,3815,11,1306359366,1306393553,63,1,34187
97864553@N00,3816,11,1306446894,1306446894,1,1,0
97885855@N04,3817,6,1376366294,1376366294,1,1,0
9790304@N07,3818,10,1363913283,1363913825,3,3,542
9790304@N07,3818,5,1363903219,1363903219,1,3,0
9790304@N07,3818,3,1363908500,1363909424,3,3,924
97904625@N05,3819,2,1373170302,1373170315,2,1,13
97956153@N08,3820,8,1363391204,1363391204,1,1,0
98109106@N00,3821,8,1246601148,1246601148,1,3,0
98109106@N00,3821,13,1246603691,1246613406,9,3,9715
98109106@N00,3821,4,1246606395,1246608454,3,3,2059
98109106@N00,3822,8,1246705027,1246723539,18,1,18512
98109106@N00,3823,6,1247213075,1247213075,1,4,0
98109106@N00,3823,7,1247218619,1247219167,3,4,548
98109106@N00,3823,1,1247219124,1247219124,1,4,0
98109106@N00,3823,4,1247214020,1247214760,4,4,740
9813050@N08,3824,6,1257042486,1257042713,13,9,227
9813050@N08,3824,7,1257034806,1257042302,11,9,7496
9813050@N08,3824,9,1257057634,1257063068,45,9,5434
9813050@N08,3824,2,1257035265,1257042287,48,9,7022
9813050@N08,3824,3,1257042991,1257043205,13,9,214
9813050@N08,3824,8,1257031541,1257072946,2,9,41405
9813050@N08,3824,10,1257031720,1257031782,2,9,62
9813050@N08,3824,1,1257034785,1257057496,9,9,22711
9813050@N08,3824,5,1257031671,1257034493,6,9,2822
9813050@N08,3825,6,1257217168,1257217189,2,3,21
9813050@N08,3825,13,1257217488,1257219403,71,3,1915
9813050@N08,3825,3,1257212819,1257212852,3,3,33
9813050@N08,3826,11,1257558536,1257558556,4,1,20
98223232@N00,3827,5,1255559199,1255559217,3,4,18
98223232@N00,3827,13,1255570642,1255573242,21,4,2600
98223232@N00,3827,6,1255580224,1255580975,9,4,751
98223232@N00,3827,8,1255558625,1255558629,2,4,4
98297562@N04,3828,8,1395212269,1395212269,1,2,0
98297562@N04,3828,1,1395202918,1395202918,1,2,0
98297562@N04,3829,8,1395391409,1395391409,1,3,0
98297562@N04,3829,4,1395388476,1395388485,2,3,9
98297562@N04,3829,2,1395383176,1395383176,1,3,0
98317956@N00,3830,8,1337724812,1337724812,1,3,0
98317956@N00,3830,13,1337745932,1337746488,23,3,556
98317956@N00,3830,6,1337734936,1337755304,5,3,20368
98317956@N00,3831,6,1338171572,1338171878,2,1,306
98387918@N07,3832,6,1417245788,1417248083,4,1,2295
98474523@N00,3833,1,1323038954,1323069539,37,1,30585
9858951@N03,3834,11,1274254743,1274254787,6,2,44
9858951@N03,3834,8,1274254724,1274254797,3,2,73
9860213@N08,3835,2,1343093717,1343095907,5,1,2190
9860213@N08,3836,7,1447894799,1447894799,1,2,0
9860213@N08,3836,5,1447893369,1447893369,1,2,0
9860213@N08,3837,5,1448005196,1448005196,1,1,0
98655096@N05,3838,7,1373080029,1373080057,7,3,28
98655096@N05,3838,12,1373080069,1373080072,3,3,3
98655096@N05,3838,10,1373091811,1373091825,3,3,14
98672908@N07,3839,6,1451445076,1451445084,2,3,8
98672908@N07,3839,4,1451435244,1451446957,9,3,11713
98672908@N07,3839,5,1451424934,1451424934,1,3,0
9881590@N03,3840,10,1380090584,1380090584,1,1,0
98889314@N02,3841,5,1403764601,1403766207,24,4,1606
98889314@N02,3841,8,1403766698,1403767067,8,4,369
98889314@N02,3841,1,1403764448,1403769573,24,4,5125
98889314@N02,3841,10,1403764324,1403764598,3,4,274
9907136@N02,3842,1,1252103018,1252103018,1,1,0
9907136@N02,3843,10,1333594321,1333594590,2,1,269
99119735@N06,3844,8,1382840337,1382840337,1,1,0
99119735@N06,3845,4,1382922881,1382926600,2,7,3719
99119735@N06,3845,6,1382919226,1382919226,1,7,0
99119735@N06,3845,7,1382943448,1382943487,5,7,39
99119735@N06,3845,11,1382917115,1382943417,22,7,26302
99119735@N06,3845,9,1382948159,1382950623,3,7,2464
99119735@N06,3845,13,1382923318,1382923318,1,7,0
99119735@N06,3845,2,1382944130,1382944291,3,7,161
99199321@N07,3846,6,1420933183,1420933183,1,1,0
99219204@N00,3847,4,1359181337,1359185884,3,3,4547
99219204@N00,3847,5,1359157853,1359159562,2,3,1709
99219204@N00,3847,6,1359175281,1359175281,1,3,0
9938245@N08,3848,1,1246312106,1246312106,1,1,0
99385068@N00,3849,1,1383353575,1383356864,10,1,3289
99422834@N05,3850,10,1331508330,1331521671,3,2,13341
99422834@N05,3850,1,1331525801,1331525951,3,2,150
99471343@N00,3851,8,1366157309,1366158890,2,5,1581
99471343@N00,3851,12,1366162176,1366181037,4,5,18861
99471343@N00,3851,7,1366160018,1366173414,2,5,13396
99471343@N00,3851,2,1366154734,1366188101,10,5,33367
99471343@N00,3851,6,1366158382,1366167312,6,5,8930
99503665@N00,3852,2,1356316252,1356316252,1,3,0
99503665@N00,3852,4,1356327367,1356327367,1,3,0
99503665@N00,3852,8,1356318727,1356318727,1,3,0
99544917@N00,3853,5,1406415546,1406430465,4,2,14919
99544917@N00,3853,8,1406430246,1406430930,2,2,684
99619919@N05,3854,1,1362288610,1362288610,1,2,0
99619919@N05,3854,2,1362290745,1362290745,1,2,0
9977376@N05,3855,12,1382231426,1382231426,1,1,0
99876261@N00,3856,1,1212882505,1212905051,284,1,22546
99929871@N00,3857,4,1294444664,1294444664,1,1,0
99948019@N00,3858,4,1386059683,1386059683,1,1,0
