userID,trajID,poiID,startTime,endTime,#photo,trajLen,poiDuration
100049423@N05,1,11,1376565773,1376565773,1,1,0
100063617@N06,2,11,1451012071,1451016962,2,1,4891
10008488@N07,3,17,1354153386,1354153386,1,1,0
10008488@N07,4,5,1354580494,1354580494,1,1,0
100214981@N03,5,11,1374451523,1374469888,145,1,18365
100214981@N03,6,11,1378167118,1378167118,1,1,0
100354657@N04,7,11,1363604909,1363604909,1,1,0
100363554@N07,8,11,1462850364,1462850364,1,1,0
100436193@N03,9,14,1419464468,1419464468,1,2,0
100436193@N03,9,4,1419466160,1419466160,1,2,0
100448554@N06,10,10,1371363018,1371363018,1,1,0
100459519@N02,11,15,1462770945,1462770945,1,2,0
100459519@N02,11,13,1462765469,1462765469,1,2,0
100459519@N02,12,2,1462941587,1462941587,1,1,0
10048675@N02,13,10,1233348588,1233348635,3,1,47
10048675@N02,14,13,1233531829,1233541814,9,3,9985
10048675@N02,14,8,1233528573,1233528655,2,3,82
10048675@N02,14,10,1233531817,1233545934,5,3,14117
10048675@N02,15,1,1234142295,1234142295,1,2,0
10048675@N02,15,10,1234144700,1234144700,1,2,0
10048675@N02,16,13,1234327057,1234337851,15,4,10794
10048675@N02,16,8,1234314519,1234324562,2,4,10043
10048675@N02,16,10,1234331502,1234331666,2,4,164
10048675@N02,16,6,1234316806,1234316806,1,4,0
10048675@N02,17,1,1234506689,1234511269,11,4,4580
10048675@N02,17,13,1234504968,1234505016,3,4,48
10048675@N02,17,9,1234508181,1234509657,4,4,1476
10048675@N02,17,11,1234513275,1234513285,2,4,10
100506822@N02,18,17,1387861379,1387861385,2,3,6
100506822@N02,18,15,1387860460,1387860498,2,3,38
100506822@N02,18,11,1387872225,1387881579,11,3,9354
100506822@N02,19,6,1388056931,1388056967,2,1,36
100523630@N04,20,13,1384847821,1384847960,2,2,139
100523630@N04,20,8,1384851704,1384851704,1,2,0
100524190@N04,21,8,1389855575,1389855575,1,1,0
10061441@N03,22,11,1229533072,1229533072,1,1,0
10061441@N03,23,13,1229627071,1229627071,1,1,0
100620414@N03,24,1,1461718283,1461718293,3,8,10
100620414@N03,24,17,1461724932,1461727442,10,8,2510
100620414@N03,24,13,1461723839,1461724519,5,8,680
100620414@N03,24,11,1461712118,1461713895,8,8,1777
100620414@N03,24,5,1461719152,1461729236,14,8,10084
100620414@N03,24,10,1461727727,1461727828,7,8,101
100620414@N03,24,8,1461719960,1461720581,7,8,621
100620414@N03,24,15,1461724800,1461727057,10,8,2257
100657680@N02,25,5,1395530058,1395530058,1,1,0
10068791@N08,26,11,1251425652,1251425652,1,2,0
10068791@N08,26,14,1251430414,1251430414,1,2,0
100692786@N04,27,11,1377225508,1377225508,1,1,0
100692786@N04,28,11,1394244306,1394244306,1,1,0
100692786@N04,29,17,1394928488,1394928488,1,1,0
100692786@N04,30,11,1400360079,1400360079,1,1,0
10076246@N06,31,11,1209662791,1209662791,1,1,0
100775193@N08,32,2,1389753952,1389753952,1,1,0
100775237@N03,33,11,1311389608,1311389608,1,1,0
100775237@N03,34,3,1341064800,1341064800,1,2,0
100775237@N03,34,11,1341064800,1341064800,2,2,0
100775237@N03,35,11,1372600800,1372600800,1,2,0
100775237@N03,35,14,1372600800,1372600800,1,2,0
100775237@N03,36,11,1405653257,1405654036,4,4,779
100775237@N03,36,4,1405645010,1405645010,1,4,0
100775237@N03,36,14,1405644303,1405644328,4,4,25
100775237@N03,36,3,1405644476,1405644615,7,4,139
100822654@N07,37,13,1400647105,1400647105,1,1,0
100822654@N07,38,4,1400733548,1400733548,1,2,0
100822654@N07,38,5,1400708131,1400732340,4,2,24209
100822654@N07,39,13,1400956813,1400956813,1,1,0
10084809@N04,40,11,1459820341,1459832742,2,1,12401
100948027@N07,41,8,1315281409,1315283279,6,2,1870
100948027@N07,41,13,1315296132,1315296132,1,2,0
101102803@N06,42,8,1344318648,1344318648,1,1,0
101118128@N08,43,17,1446957626,1446957626,1,1,0
101195207@N02,44,11,1467023380,1467023439,3,1,59
10128570@N04,45,17,1218858723,1218858748,3,3,25
10128570@N04,45,10,1218862691,1218864746,5,3,2055
10128570@N04,45,8,1218879135,1218879229,4,3,94
101355546@N05,46,5,1433557433,1433557433,1,1,0
101445497@N05,47,11,1222265010,1222272332,2,1,7322
101445497@N05,48,11,1316519128,1316519128,1,2,0
101445497@N05,48,9,1316493033,1316493033,1,2,0
101445497@N05,49,11,1316658792,1316658792,1,2,0
101445497@N05,49,9,1316662683,1316662683,1,2,0
101445497@N05,50,5,1353127016,1353127016,1,1,0
101445497@N05,51,1,1369545567,1369545567,1,2,0
101445497@N05,51,13,1369536010,1369536010,1,2,0
101445497@N05,52,5,1380793304,1380793304,1,4,0
101445497@N05,52,8,1380790923,1380792357,2,4,1434
101445497@N05,52,17,1380775831,1380775831,1,4,0
101445497@N05,52,9,1380770999,1380771671,2,4,672
101445497@N05,53,10,1380876245,1380876245,1,2,0
101445497@N05,53,9,1380883314,1380883314,1,2,0
101445497@N05,54,15,1389337291,1389337291,1,2,0
101445497@N05,54,3,1389334716,1389334716,1,2,0
101445497@N05,55,5,1433301323,1433306075,2,3,4752
101445497@N05,55,11,1433294694,1433294694,1,3,0
101445497@N05,55,13,1433319502,1433319502,1,3,0
101445497@N05,56,8,1452224936,1452224936,1,4,0
101445497@N05,56,11,1452234523,1452234943,2,4,420
101445497@N05,56,16,1452230529,1452230529,1,4,0
101445497@N05,56,4,1452220565,1452220565,1,4,0
101473404@N07,57,11,1388726894,1388751001,3,2,24107
101473404@N07,57,8,1388728274,1388728274,1,2,0
101473404@N07,58,10,1453642338,1453644329,5,5,1991
101473404@N07,58,17,1453642608,1453642608,1,5,0
101473404@N07,58,13,1453643037,1453643551,3,5,514
101473404@N07,58,15,1453638922,1453644137,3,5,5215
101473404@N07,58,11,1453636986,1453638875,4,5,1889
10148198@N00,59,11,1388902220,1388902220,1,1,0
101503011@N06,60,7,1443751173,1443751173,1,3,0
101503011@N06,60,11,1443759456,1443759456,1,3,0
101503011@N06,60,2,1443749161,1443751225,3,3,2064
10156308@N03,61,15,1418971435,1418971435,1,2,0
10156308@N03,61,1,1418988089,1418988089,3,2,0
10156308@N03,62,4,1419034591,1419034591,1,1,0
10175710@N03,63,11,1374103345,1374103345,1,2,0
10175710@N03,63,8,1374121822,1374131986,2,2,10164
10182842@N08,64,11,1215141337,1215141724,3,1,387
10183029@N00,65,11,1326782023,1326782023,1,1,0
10183029@N00,66,11,1326836472,1326881565,152,1,45093
101924327@N08,67,11,1416397007,1416397007,1,1,0
102284959@N03,68,11,1380404414,1380404444,2,1,30
102284959@N03,69,6,1398447381,1398447381,1,1,0
102284959@N03,70,11,1443166515,1443166515,1,1,0
102284959@N03,71,11,1443703316,1443719661,4,2,16345
102284959@N03,71,8,1443717629,1443717739,2,2,110
102284959@N03,72,11,1450759509,1450759509,1,1,0
10245322@N05,73,11,1197675088,1197675088,1,1,0
10245322@N05,74,8,1197780519,1197780519,1,1,0
10259875@N03,75,11,1204290000,1204290000,1,2,0
10259875@N03,75,13,1204290000,1204290000,1,2,0
10259875@N03,76,15,1206233100,1206233100,1,1,0
10259875@N03,77,2,1231387716,1231387716,1,3,0
10259875@N03,77,10,1231370678,1231410052,3,3,39374
10259875@N03,77,11,1231389573,1231411174,2,3,21601
10259875@N03,78,11,1262515088,1262515220,3,1,132
10259875@N03,79,8,1262667656,1262667656,1,5,0
10259875@N03,79,11,1262645553,1262648189,3,5,2636
10259875@N03,79,13,1262675473,1262675473,1,5,0
10259875@N03,79,5,1262664288,1262664288,1,5,0
10259875@N03,79,4,1262646033,1262646844,4,5,811
10259875@N03,80,15,1274004836,1274005061,2,7,225
10259875@N03,80,5,1273991643,1273991643,1,7,0
10259875@N03,80,13,1274003541,1274004783,9,7,1242
10259875@N03,80,10,1273993136,1273993136,1,7,0
10259875@N03,80,8,1273993418,1273993803,2,7,385
10259875@N03,80,17,1274004978,1274004978,1,7,0
10259875@N03,80,11,1274009773,1274009773,1,7,0
10259875@N03,81,15,1303112790,1303112790,1,5,0
10259875@N03,81,10,1303113199,1303113199,1,5,0
10259875@N03,81,13,1303122517,1303122850,5,5,333
10259875@N03,81,17,1303112963,1303112963,1,5,0
10259875@N03,81,11,1303094675,1303114627,2,5,19952
10259875@N03,82,15,1364629884,1364629957,2,6,73
10259875@N03,82,5,1364624998,1364624998,1,6,0
10259875@N03,82,13,1364628066,1364629676,10,6,1610
10259875@N03,82,10,1364630926,1364634563,6,6,3637
10259875@N03,82,17,1364630157,1364630227,2,6,70
10259875@N03,82,11,1364611881,1364621387,3,6,9506
10259875@N03,83,15,1392517870,1392517870,1,6,0
10259875@N03,83,7,1392535756,1392535756,1,6,0
10259875@N03,83,13,1392519630,1392519630,1,6,0
10259875@N03,83,10,1392516289,1392516289,1,6,0
10259875@N03,83,2,1392534568,1392534568,1,6,0
10259875@N03,83,11,1392540659,1392540659,1,6,0
10259875@N03,84,8,1392714201,1392714201,1,2,0
10259875@N03,84,13,1392719629,1392719629,1,2,0
10259875@N03,85,9,1428557045,1428557045,1,6,0
10259875@N03,85,5,1428572272,1428572534,2,6,262
10259875@N03,85,13,1428567477,1428568299,3,6,822
10259875@N03,85,10,1428565637,1428565637,1,6,0
10259875@N03,85,17,1428564519,1428564519,1,6,0
10259875@N03,85,11,1428546335,1428546335,1,6,0
10287709@N08,86,11,1257338639,1257338639,1,2,0
10287709@N08,86,1,1257343412,1257343412,1,2,0
10287709@N08,87,7,1257517115,1257517115,1,1,0
10295241@N02,88,8,1236491899,1236491899,1,3,0
10295241@N02,88,4,1236468059,1236468059,1,3,0
10295241@N02,88,11,1236501116,1236501337,2,3,221
10295241@N02,89,11,1371891137,1371891137,1,1,0
103400918@N03,90,10,1370300958,1370300958,1,1,0
103400918@N03,91,10,1370331016,1370331023,2,1,7
103482436@N07,92,11,1441365828,1441365828,1,1,0
10350193@N07,93,8,1212197769,1212197769,1,2,0
10350193@N07,93,5,1212195910,1212195910,1,2,0
10350193@N07,94,11,1260669109,1260683870,5,1,14761
10350193@N07,95,9,1289019298,1289019298,1,1,0
10350193@N07,96,8,1301100472,1301100472,1,2,0
10350193@N07,96,17,1301106879,1301106911,2,2,32
10350193@N07,97,11,1419510997,1419511051,2,1,54
10360498@N02,98,11,1335576555,1335586767,2,1,10212
10360498@N02,99,11,1335629511,1335629967,3,1,456
10360498@N02,100,11,1336117977,1336117977,1,1,0
103662148@N03,101,11,1426763940,1426763940,1,1,0
103845490@N03,102,11,1380870929,1380870929,1,1,0
103845490@N03,103,11,1387339284,1387339284,1,1,0
103845490@N03,104,11,1391495082,1391495082,1,2,0
103845490@N03,104,17,1391498262,1391498262,1,2,0
104009266@N06,105,5,1352357123,1352357123,1,1,0
10403093@N06,106,13,1353463415,1353463441,2,3,26
10403093@N06,106,11,1353454131,1353454269,6,3,138
10403093@N06,106,10,1353468946,1353471989,2,3,3043
10414404@N08,107,3,1405829092,1405829092,1,3,0
10414404@N08,107,5,1405844241,1405844241,1,3,0
10414404@N08,107,8,1405840203,1405840203,1,3,0
104152796@N05,108,11,1423272410,1423272410,1,1,0
104468853@N05,109,8,1432800117,1432800117,1,1,0
10474978@N05,110,2,1308990910,1308990910,1,1,0
10485077@N06,111,7,1202774520,1202774520,1,1,0
10500812@N04,112,11,1326445023,1326445023,1,2,0
10500812@N04,112,5,1326450908,1326450908,1,2,0
105156445@N06,113,2,1408583271,1408583271,1,7,0
105156445@N06,113,5,1408587985,1408588039,3,7,54
105156445@N06,113,15,1408585546,1408585575,3,7,29
105156445@N06,113,10,1408584852,1408584852,1,7,0
105156445@N06,113,11,1408581103,1408589211,2,7,8108
105156445@N06,113,17,1408585469,1408585469,1,7,0
105156445@N06,113,13,1408585695,1408585695,1,7,0
10529536@N05,114,4,1298947486,1298947486,1,4,0
10529536@N05,114,8,1298957499,1298957499,1,4,0
10529536@N05,114,17,1298944638,1298944638,1,4,0
10529536@N05,114,13,1298964960,1298964960,1,4,0
10529536@N05,115,5,1299210988,1299210988,1,1,0
105380744@N04,116,11,1382004508,1382004584,4,2,76
105380744@N04,116,3,1381996929,1381996929,1,2,0
10546731@N07,117,2,1311416748,1311416769,2,1,21
10570686@N02,118,11,1268540991,1268551365,2,1,10374
10570686@N02,119,11,1268685740,1268689241,2,1,3501
10572043@N03,120,11,1305352674,1305352674,1,1,0
105763347@N06,121,8,1357111902,1357111902,1,1,0
105916543@N07,122,11,1453080137,1453080137,1,1,0
106025342@N02,123,8,1372401090,1372401090,1,1,0
106045902@N02,124,11,1366243452,1366243452,1,3,0
106045902@N02,124,17,1366259701,1366259889,2,3,188
106045902@N02,124,10,1366256299,1366256299,1,3,0
106112977@N06,125,6,1441655288,1441655288,1,1,0
10617321@N00,126,11,1464513492,1464513492,1,1,0
106475835@N05,127,11,1361536912,1361536912,1,1,0
106475835@N05,128,11,1361623987,1361626776,3,1,2789
106475835@N05,129,11,1365155303,1365158588,2,1,3285
106475835@N05,130,11,1372425960,1372427853,2,1,1893
106475835@N05,131,11,1382437124,1382476835,18,1,39711
10655470@N06,132,11,1324594061,1324633120,15,1,39059
10670886@N08,133,4,1397697184,1397697184,1,1,0
10692931@N08,134,12,1229648321,1229648427,3,2,106
10692931@N08,134,11,1229640732,1229642671,7,2,1939
106980455@N06,135,8,1383372686,1383372686,1,1,0
107084948@N08,136,11,1383790060,1383824042,58,1,33982
10764262@N06,137,12,1359597279,1359597611,3,1,332
10774763@N05,138,5,1251953805,1251965226,9,10,11421
10774763@N05,138,4,1251962266,1251962266,1,10,0
10774763@N05,138,2,1251961261,1251961339,3,10,78
10774763@N05,138,7,1251959744,1251959988,5,10,244
10774763@N05,138,9,1251956791,1251958011,8,10,1220
10774763@N05,138,1,1251955527,1251956618,9,10,1091
10774763@N05,138,16,1251958134,1251958223,2,10,89
10774763@N05,138,17,1251962647,1251962678,2,10,31
10774763@N05,138,15,1251962763,1251962885,5,10,122
10774763@N05,138,11,1251952995,1251959460,7,10,6465
108140637@N08,139,15,1375335740,1375335830,3,6,90
108140637@N08,139,11,1375330783,1375332368,20,6,1585
108140637@N08,139,6,1375338128,1375338400,8,6,272
108140637@N08,139,10,1375333669,1375335135,5,6,1466
108140637@N08,139,17,1375335387,1375336150,11,6,763
108140637@N08,139,13,1375336269,1375337631,2,6,1362
108207234@N02,140,16,1426205370,1426205462,3,1,92
108207234@N02,141,11,1426389848,1426389848,1,1,0
108207234@N02,142,6,1464380841,1464380841,1,1,0
108207234@N02,143,11,1464409819,1464409819,1,1,0
108231769@N08,144,10,1396858102,1396858102,1,5,0
108231769@N08,144,17,1396857097,1396857114,2,5,17
108231769@N08,144,11,1396839694,1396839694,1,5,0
108231769@N08,144,8,1396850959,1396850983,2,5,24
108231769@N08,144,13,1396856465,1396856819,7,5,354
10857883@N05,145,10,1270772023,1270772085,2,2,62
10857883@N05,145,11,1270786318,1270786370,2,2,52
10858077@N00,146,17,1207188738,1207188738,1,1,0
108592555@N04,147,8,1400245865,1400245865,1,2,0
108592555@N04,147,11,1400245860,1400245860,1,2,0
10893867@N03,148,11,1211000057,1211000664,28,1,607
108942230@N03,149,5,1395646307,1395646307,1,1,0
10899502@N05,150,7,1256093920,1256093927,42,1,7
10899502@N05,151,6,1271818767,1271818767,1,2,0
10899502@N05,151,11,1271818758,1271818769,8,2,11
10901345@N05,152,2,1446619714,1446619714,1,1,0
10905622@N03,153,11,1189150559,1189150559,1,1,0
10925918@N03,154,17,1362523354,1362523354,1,2,0
10925918@N03,154,13,1362522701,1362522701,1,2,0
10925918@N03,155,8,1362612947,1362618301,2,2,5354
10925918@N03,155,15,1362634933,1362634933,1,2,0
109554486@N07,156,15,1384401571,1384401703,2,5,132
109554486@N07,156,2,1384395099,1384395099,1,5,0
109554486@N07,156,4,1384400326,1384400326,1,5,0
109554486@N07,156,8,1384407784,1384417460,9,5,9676
109554486@N07,156,11,1384425169,1384425178,2,5,9
10967865@N04,157,6,1352544446,1352544446,1,1,0
10983978@N03,158,15,1215163643,1215163643,1,5,0
10983978@N03,158,6,1215164386,1215170888,13,5,6502
10983978@N03,158,17,1215163387,1215163387,1,5,0
10983978@N03,158,5,1215175185,1215175185,1,5,0
10983978@N03,158,8,1215174577,1215174896,2,5,319
10983978@N03,159,3,1217230841,1217230841,1,1,0
10983978@N03,160,11,1217665282,1217665282,1,1,0
10983978@N03,161,16,1218789711,1218789711,1,2,0
10983978@N03,161,1,1218791307,1218791568,2,2,261
10983978@N03,162,16,1222587402,1222587714,2,2,312
10983978@N03,162,9,1222588105,1222588384,3,2,279
10983978@N03,163,17,1226152939,1226152939,1,1,0
10983978@N03,164,6,1229333036,1229333036,1,1,0
10983978@N03,165,11,1234935143,1234935143,1,1,0
10983978@N03,166,11,1235036716,1235036716,1,2,0
10983978@N03,166,2,1235036449,1235036449,1,2,0
10983978@N03,167,4,1239278162,1239278162,1,1,0
10983978@N03,168,8,1240102856,1240102856,1,1,0
10983978@N03,169,6,1246709530,1246709697,2,1,167
10983978@N03,170,6,1246770145,1246770301,2,1,156
10983978@N03,171,10,1250556806,1250556806,1,5,0
10983978@N03,171,6,1250556285,1250557667,7,5,1382
10983978@N03,171,5,1250582560,1250582560,1,5,0
10983978@N03,171,8,1250582627,1250582627,1,5,0
10983978@N03,171,11,1250583240,1250583302,2,5,62
10983978@N03,172,4,1252413201,1252413201,1,1,0
10983978@N03,173,11,1260930699,1260930699,1,1,0
10983978@N03,174,10,1261802440,1261802440,1,1,0
10983978@N03,175,15,1286630356,1286630356,1,2,0
10983978@N03,175,8,1286630095,1286630729,2,2,634
10983978@N03,176,16,1291504643,1291504643,1,1,0
10983978@N03,177,4,1313157600,1313157600,2,4,0
10983978@N03,177,15,1313157600,1313157600,3,4,0
10983978@N03,177,17,1313157600,1313157600,3,4,0
10983978@N03,177,11,1313157600,1313157600,1,4,0
10983978@N03,178,17,1313326360,1313326360,1,1,0
10983978@N03,179,1,1333790417,1333800812,7,3,10395
10983978@N03,179,6,1333792424,1333792424,1,3,0
10983978@N03,179,8,1333794076,1333794076,1,3,0
10983978@N03,180,6,1333878989,1333878989,1,2,0
10983978@N03,180,1,1333879860,1333879860,1,2,0
10983978@N03,181,6,1334325600,1334325600,14,1,0
10983978@N03,182,6,1334495010,1334495010,1,1,0
10989907@N07,183,9,1386053288,1386053288,1,8,0
10989907@N07,183,13,1386053438,1386053646,3,8,208
10989907@N07,183,11,1386028568,1386031947,3,8,3379
10989907@N07,183,15,1386021256,1386021256,1,8,0
10989907@N07,183,16,1386028747,1386028747,1,8,0
10989907@N07,183,4,1386053113,1386053141,2,8,28
10989907@N07,183,2,1386049216,1386052982,4,8,3766
10989907@N07,183,3,1386045966,1386053032,4,8,7066
10989907@N07,184,13,1386139143,1386143221,11,2,4078
10989907@N07,184,17,1386157420,1386157420,1,2,0
10989907@N07,185,11,1386199117,1386199165,2,2,48
10989907@N07,185,17,1386196217,1386196246,2,2,29
10989907@N07,186,13,1386312501,1386312501,1,4,0
10989907@N07,186,8,1386299311,1386299311,1,4,0
10989907@N07,186,15,1386289000,1386312855,3,4,23855
10989907@N07,186,17,1386310585,1386312117,2,4,1532
109920749@N03,187,1,1334729699,1334729699,1,1,0
11011638@N02,188,11,1400900100,1400908628,4,1,8528
110166673@N02,189,2,1385430436,1385434149,30,5,3713
110166673@N02,189,15,1385447347,1385447371,9,5,24
110166673@N02,189,5,1385451439,1385451464,12,5,25
110166673@N02,189,11,1385421072,1385421087,6,5,15
110166673@N02,189,9,1385438980,1385438980,3,5,0
110166673@N02,190,1,1385610860,1385610960,10,1,100
11017709@N07,191,11,1318648391,1318648391,1,1,0
110223705@N07,192,1,1463700297,1463701321,3,4,1024
110223705@N07,192,11,1463699667,1463743121,3,4,43454
110223705@N07,192,8,1463732310,1463732868,4,4,558
110223705@N07,192,4,1463713456,1463713456,1,4,0
11041171@N06,193,8,1302405002,1302405002,1,3,0
11041171@N06,193,2,1302393689,1302393689,1,3,0
11041171@N06,193,11,1302389629,1302389629,1,3,0
11041171@N06,194,14,1321136966,1321136966,1,1,0
11054536@N00,195,16,1209080140,1209080140,1,4,0
11054536@N00,195,1,1209079942,1209079942,1,4,0
11054536@N00,195,10,1209094374,1209096598,2,4,2224
11054536@N00,195,11,1209085196,1209085935,3,4,739
110806683@N02,196,11,1387941133,1387941133,1,1,0
11102586@N00,197,1,1283642934,1283642973,2,6,39
11102586@N00,197,9,1283644454,1283646210,6,6,1756
11102586@N00,197,11,1283646941,1283648821,3,6,1880
11102586@N00,197,5,1283649700,1283650303,9,6,603
11102586@N00,197,14,1283641401,1283641401,1,6,0
11102586@N00,197,2,1283641552,1283642705,3,6,1153
111107017@N08,198,4,1384126128,1384126128,1,2,0
111107017@N08,198,11,1384125216,1384125216,1,2,0
111107017@N08,199,16,1386407394,1386407394,1,1,0
11136034@N06,200,11,1242741773,1242769491,58,1,27718
11136034@N06,201,11,1243048893,1243066644,51,1,17751
11145342@N04,202,8,1212898219,1212899953,4,1,1734
11145342@N04,203,8,1272021567,1272021567,1,1,0
11149127@N05,204,17,1300234816,1300234816,1,2,0
11149127@N05,204,1,1300223858,1300223858,1,2,0
11154831@N06,205,11,1193899491,1193899491,1,2,0
11154831@N06,205,13,1193885232,1193885232,1,2,0
11158788@N00,206,5,1210386284,1210386284,1,1,0
11158788@N00,207,13,1225533201,1225533201,1,1,0
111603867@N06,208,11,1390533708,1390533708,1,2,0
111603867@N06,208,9,1390537932,1390538331,5,2,399
11171054@N04,209,11,1440154604,1440154604,1,2,0
11171054@N04,209,7,1440154599,1440154601,2,2,2
11191102@N07,210,11,1379498437,1379511482,3,1,13045
111991502@N02,211,16,1385991329,1385991329,1,1,0
11199582@N03,212,8,1329182238,1329182343,2,3,105
11199582@N03,212,13,1329207171,1329207171,1,3,0
11199582@N03,212,4,1329191216,1329191216,1,3,0
112023512@N04,213,11,1382438036,1382438036,1,1,0
112045904@N02,214,4,1388743711,1388743711,1,2,0
112045904@N02,214,11,1388750955,1388750955,1,2,0
112162011@N02,215,11,1387606442,1387617425,2,1,10983
112283958@N06,216,1,1377924609,1377933130,27,1,8521
11230735@N07,217,15,1194175845,1194175845,1,2,0
11230735@N07,217,10,1194176054,1194176054,1,2,0
11230735@N07,218,16,1219469124,1219469124,1,1,0
11240815@N03,219,11,1366975384,1366975384,1,1,0
11260538@N06,220,6,1348791029,1348794939,3,2,3910
11260538@N06,220,10,1348791592,1348791592,1,2,0
11260538@N06,221,9,1348876338,1348876338,1,1,0
11260538@N06,222,6,1352613389,1352613389,1,1,0
11260538@N06,223,11,1355650271,1355650271,1,1,0
112709393@N04,224,8,1365203035,1365203035,1,1,0
112734542@N02,225,11,1396762877,1396765623,2,2,2746
112734542@N02,225,17,1396777941,1396777941,2,2,0
11279883@N00,226,5,1233973339,1233973391,4,1,52
11279883@N00,227,3,1390781187,1390781187,1,1,0
11284904@N02,228,17,1348312003,1348312003,1,1,0
11292395@N05,229,11,1218910539,1218910539,1,1,0
112941383@N05,230,11,1436521835,1436521835,1,1,0
112985786@N07,231,5,1353802868,1353802868,1,1,0
113040137@N08,232,11,1461499539,1461499539,1,1,0
113086034@N04,233,10,1394427325,1394427325,1,1,0
113086034@N04,234,10,1458265704,1458265704,1,1,0
113086034@N04,235,10,1458824420,1458824420,1,2,0
113086034@N04,235,5,1458822511,1458822511,1,2,0
11342926@N04,236,15,1318665902,1318665902,1,1,0
11355999@N08,237,11,1374443421,1374443421,1,3,0
11355999@N08,237,13,1374454935,1374454935,1,3,0
11355999@N08,237,8,1374467709,1374467709,1,3,0
11355999@N08,238,2,1374575544,1374575544,1,2,0
11355999@N08,238,11,1374569398,1374571424,2,2,2026
11355999@N08,239,11,1374825576,1374825576,1,1,0
11374644@N06,240,13,1368589826,1368589826,1,1,0
11374644@N06,241,8,1412841323,1412841323,1,2,0
11374644@N06,241,17,1412848057,1412849522,13,2,1465
113875683@N02,242,4,1378083991,1378083991,1,1,0
11429691@N03,243,9,1299925810,1299925810,1,2,0
11429691@N03,243,15,1299925819,1299925819,1,2,0
114343416@N06,244,11,1378019214,1378019214,1,1,0
11438118@N00,245,13,1188464235,1188468949,6,2,4714
11438118@N00,245,11,1188457863,1188457863,1,2,0
11438118@N00,246,9,1189066184,1189067202,8,1,1018
11438118@N00,247,1,1189730376,1189754750,20,5,24374
11438118@N00,247,16,1189750665,1189752705,5,5,2040
11438118@N00,247,4,1189746788,1189746788,1,5,0
11438118@N00,247,11,1189735157,1189735157,1,5,0
11438118@N00,247,6,1189754960,1189754960,1,5,0
11438118@N00,248,11,1190871240,1190871741,8,1,501
11438118@N00,249,13,1191220322,1191220322,1,1,0
11438118@N00,250,13,1191740859,1191743736,3,3,2877
11438118@N00,250,16,1191732260,1191732357,3,3,97
11438118@N00,250,9,1191730367,1191732200,4,3,1833
11438118@N00,251,11,1193385174,1193385685,2,1,511
11438118@N00,252,1,1196395141,1196395141,1,3,0
11438118@N00,252,13,1196390743,1196399994,2,3,9251
11438118@N00,252,5,1196397797,1196398208,4,3,411
11438118@N00,253,11,1197587860,1197587971,5,1,111
11438118@N00,254,11,1197969440,1197969472,2,1,32
11438118@N00,255,11,1207887521,1207887521,1,1,0
11438118@N00,256,11,1222324272,1222339309,14,5,15037
11438118@N00,256,8,1222333894,1222337334,52,5,3440
11438118@N00,256,15,1222326033,1222326231,5,5,198
11438118@N00,256,13,1222326387,1222326397,2,5,10
11438118@N00,256,5,1222338096,1222338346,3,5,250
11438118@N00,257,11,1222930715,1222938896,14,6,8181
11438118@N00,257,10,1222936436,1222936436,1,6,0
11438118@N00,257,17,1222936286,1222936286,1,6,0
11438118@N00,257,13,1222934521,1222935532,2,6,1011
11438118@N00,257,5,1222930332,1222938434,2,6,8102
11438118@N00,257,16,1222928003,1222928003,1,6,0
11438118@N00,258,13,1223797324,1223797324,1,1,0
11438118@N00,259,13,1223967583,1223967583,1,2,0
11438118@N00,259,5,1223961393,1223961408,2,2,15
11438118@N00,260,13,1224917737,1224917737,1,3,0
11438118@N00,260,10,1224918072,1224918089,3,3,17
11438118@N00,260,6,1224918271,1224918285,2,3,14
11438118@N00,261,6,1224987253,1224987253,1,1,0
11438118@N00,262,11,1244728827,1244728827,1,1,0
11438118@N00,263,3,1250296400,1250296400,1,4,0
11438118@N00,263,12,1250291407,1250291407,1,4,0
11438118@N00,263,2,1250299825,1250299825,1,4,0
11438118@N00,263,11,1250291839,1250306240,8,4,14401
11438118@N00,264,11,1254117877,1254125517,4,2,7640
11438118@N00,264,6,1254120368,1254123992,16,2,3624
11438118@N00,265,17,1255423918,1255427985,11,1,4067
11439401@N07,266,8,1232463560,1232463560,1,1,0
11441631@N00,267,2,1348619290,1348619290,1,4,0
11441631@N00,267,11,1348604510,1348604510,1,4,0
11441631@N00,267,17,1348630079,1348630079,1,4,0
11441631@N00,267,13,1348633061,1348633346,2,4,285
11441631@N00,268,11,1348824242,1348824242,1,3,0
11441631@N00,268,10,1348819815,1348821810,2,3,1995
11441631@N00,268,6,1348823738,1348823738,1,3,0
114434902@N04,269,3,1401074437,1401074443,2,1,6
114677615@N06,270,11,1350018679,1350018679,1,1,0
11479795@N00,271,1,1191213440,1191213440,1,2,0
11479795@N00,271,9,1191218365,1191218365,1,2,0
11479795@N00,272,17,1191305083,1191305083,1,2,0
11479795@N00,272,5,1191297600,1191297600,1,2,0
11493860@N02,273,8,1317864491,1317864866,4,2,375
11493860@N02,273,11,1317886596,1317886596,1,2,0
11504889@N06,274,11,1446286100,1446286100,1,4,0
11504889@N06,274,13,1446259625,1446259976,9,4,351
11504889@N06,274,8,1446274374,1446277080,23,4,2706
11504889@N06,274,15,1446257491,1446257498,2,4,7
115400338@N03,275,17,1401104535,1401104535,1,6,0
115400338@N03,275,10,1401104631,1401104631,1,6,0
115400338@N03,275,13,1401103935,1401103935,1,6,0
115400338@N03,275,8,1401100625,1401100804,4,6,179
115400338@N03,275,11,1401105103,1401105245,2,6,142
115400338@N03,275,15,1401104064,1401104238,2,6,174
11541209@N06,276,5,1193908419,1193908419,1,1,0
11541209@N06,277,17,1250035079,1250035079,1,5,0
11541209@N06,277,5,1250050681,1250050681,1,5,0
11541209@N06,277,13,1250035753,1250040672,3,5,4919
11541209@N06,277,11,1250028259,1250028259,1,5,0
11541209@N06,277,10,1250032402,1250032402,1,5,0
11541209@N06,278,8,1250233387,1250234331,2,2,944
11541209@N06,278,6,1250237680,1250237775,3,2,95
11581147@N06,279,9,1432788517,1432788517,1,2,0
11581147@N06,279,11,1432776587,1432777084,3,2,497
116066345@N06,280,11,1401747449,1401747449,1,1,0
116112674@N02,281,10,1461614030,1461614106,2,6,76
116112674@N02,281,9,1461597118,1461597118,1,6,0
116112674@N02,281,8,1461620091,1461622656,13,6,2565
116112674@N02,281,13,1461623341,1461624210,3,6,869
116112674@N02,281,16,1461594448,1461594495,2,6,47
116112674@N02,281,6,1461623246,1461623246,1,6,0
11654579@N07,282,11,1361484929,1361484929,1,4,0
11654579@N07,282,9,1361487067,1361487305,2,4,238
11654579@N07,282,17,1361494432,1361494432,1,4,0
11654579@N07,282,13,1361496612,1361496612,1,4,0
11654579@N07,283,11,1393658937,1393658937,1,1,0
116801007@N03,284,10,1392518158,1392518468,2,1,310
11724486@N02,285,1,1384835738,1384837056,3,3,1318
11724486@N02,285,17,1384850908,1384850912,2,3,4
11724486@N02,285,11,1384833698,1384833698,1,3,0
117386007@N08,286,1,1323937433,1323937433,1,1,0
117386007@N08,287,5,1368700334,1368700334,1,2,0
117386007@N08,287,11,1368682461,1368682488,2,2,27
11752574@N06,288,4,1194754212,1194754212,1,1,0
11752574@N06,289,11,1259625022,1259625132,2,1,110
11752574@N06,290,11,1348122530,1348122530,1,1,0
11771947@N03,291,11,1205888400,1205888442,43,1,42
11774512@N05,292,8,1298237484,1298248779,25,4,11295
11774512@N05,292,13,1298255589,1298255601,2,4,12
11774512@N05,292,5,1298236218,1298237150,8,4,932
11774512@N05,292,10,1298261004,1298283780,3,4,22776
11785705@N02,293,14,1291610999,1291610999,1,3,0
11785705@N02,293,8,1291626786,1291626786,1,3,0
11785705@N02,293,2,1291614339,1291614339,1,3,0
117898742@N02,294,11,1394412616,1394412626,2,1,10
118160923@N04,295,11,1392159830,1392162689,5,2,2859
118160923@N04,295,5,1392180475,1392180475,1,2,0
11825945@N00,296,5,1378433451,1378433451,1,1,0
11825945@N00,297,11,1385846907,1385848464,8,1,1557
11825945@N00,298,5,1389650945,1389650945,1,1,0
11825945@N00,299,10,1389981011,1389981011,1,1,0
11825945@N00,300,13,1390168476,1390168476,1,1,0
11831873@N00,301,7,1286097347,1286114864,16,1,17517
11874382@N02,302,11,1275560722,1275560722,1,2,0
11874382@N02,302,2,1275546041,1275546041,1,2,0
11928454@N04,303,17,1244280371,1244280415,2,10,44
11928454@N04,303,10,1244277614,1244280257,12,10,2643
11928454@N04,303,11,1244287922,1244287922,1,10,0
11928454@N04,303,15,1244280723,1244281607,11,10,884
11928454@N04,303,2,1244270031,1244273866,3,10,3835
11928454@N04,303,4,1244275640,1244277094,3,10,1454
11928454@N04,303,14,1244274208,1244274868,4,10,660
11928454@N04,303,13,1244281775,1244284219,8,10,2444
11928454@N04,303,12,1244270912,1244273374,5,10,2462
11928454@N04,303,3,1244274987,1244275106,4,10,119
11928454@N04,304,1,1244508160,1244508160,1,5,0
11928454@N04,304,5,1244515165,1244519698,13,5,4533
11928454@N04,304,9,1244505650,1244505668,3,5,18
11928454@N04,304,16,1244510752,1244510752,1,5,0
11928454@N04,304,8,1244521189,1244524319,14,5,3130
11928454@N04,305,10,1244769350,1244769457,3,4,107
11928454@N04,305,15,1244769779,1244770172,2,4,393
11928454@N04,305,11,1244767488,1244767488,1,4,0
11928454@N04,305,13,1244771031,1244773540,4,4,2509
11935368@N00,306,6,1292147150,1292147150,1,3,0
11935368@N00,306,8,1292134002,1292134002,1,3,0
11935368@N00,306,5,1292141955,1292141955,1,3,0
11935368@N00,307,11,1292457958,1292457958,1,6,0
11935368@N00,307,3,1292447266,1292447266,1,6,0
11935368@N00,307,16,1292462165,1292462165,1,6,0
11935368@N00,307,8,1292473180,1292473192,2,6,12
11935368@N00,307,9,1292451674,1292452600,2,6,926
11935368@N00,307,2,1292456487,1292456487,1,6,0
11935368@N00,308,10,1292833850,1292833850,1,3,0
11935368@N00,308,13,1292833812,1292833812,1,3,0
11935368@N00,308,17,1292833859,1292833859,1,3,0
119422749@N03,309,2,1395134394,1395134420,2,2,26
119422749@N03,309,11,1395116159,1395116225,6,2,66
119422749@N03,310,4,1395209320,1395209320,1,1,0
119435566@N06,311,11,1457238907,1457238907,1,1,0
119796978@N03,312,8,1393301126,1393303368,2,1,2242
119796978@N03,313,10,1393455158,1393455159,2,1,1
119796978@N03,314,13,1393641742,1393641742,1,1,0
119908732@N04,315,11,1408337388,1408337388,1,1,0
119955613@N07,316,11,1444641033,1444641033,1,1,0
12004667@N02,317,10,1294278711,1294278711,1,3,0
12004667@N02,317,13,1294282850,1294282850,1,3,0
12004667@N02,317,15,1294282507,1294282507,1,3,0
120115443@N02,318,2,1371709051,1371709051,1,2,0
120115443@N02,318,11,1371710060,1371710060,1,2,0
120147674@N05,319,1,1395466806,1395467602,2,1,796
120147674@N05,320,11,1396037268,1396038542,2,1,1274
120210303@N04,321,11,1394624358,1394624358,1,1,0
12036424@N04,322,6,1305612962,1305613043,2,4,81
12036424@N04,322,1,1305590233,1305590402,4,4,169
12036424@N04,322,5,1305602682,1305602682,1,4,0
12036424@N04,322,12,1305619086,1305619086,1,4,0
12044368@N04,323,10,1395268643,1395268643,1,1,0
120533378@N03,324,2,1443053158,1443053158,1,3,0
120533378@N03,324,5,1443073283,1443073301,2,3,18
120533378@N03,324,1,1443057432,1443057432,1,3,0
120533378@N03,325,1,1443397450,1443400648,4,2,3198
120533378@N03,325,10,1443406433,1443408282,5,2,1849
12059076@N05,326,11,1188908971,1188908971,1,1,0
12071396@N00,327,11,1368949846,1368949846,1,1,0
120756153@N05,328,5,1307765690,1307765690,1,1,0
12083014@N05,329,9,1222228539,1222228539,1,6,0
12083014@N05,329,17,1222213706,1222218751,2,6,5045
12083014@N05,329,3,1222240899,1222240899,1,6,0
12083014@N05,329,2,1222216482,1222216482,1,6,0
12083014@N05,329,4,1222214162,1222214162,1,6,0
12083014@N05,329,5,1222255025,1222255025,1,6,0
12083014@N05,330,11,1253495576,1253495576,1,2,0
12083014@N05,330,10,1253496465,1253496636,3,2,171
12088605@N08,331,1,1301131001,1301131001,1,1,0
12088724@N02,332,5,1211164931,1211164931,1,4,0
12088724@N02,332,16,1211166599,1211166599,1,4,0
12088724@N02,332,1,1211180749,1211180749,1,4,0
12088724@N02,332,11,1211182536,1211182536,1,4,0
12130680@N05,333,13,1407052487,1407052651,4,6,164
12130680@N05,333,17,1407052997,1407053053,3,6,56
12130680@N05,333,2,1407043296,1407044502,12,6,1206
12130680@N05,333,11,1407045168,1407056354,2,6,11186
12130680@N05,333,5,1407053509,1407055118,10,6,1609
12130680@N05,333,8,1407047318,1407047441,7,6,123
121354827@N08,334,2,1370586433,1370586443,3,1,10
12149318@N07,335,11,1229910762,1229910762,1,1,0
121499845@N05,336,8,1404276677,1404276677,1,5,0
121499845@N05,336,5,1404297641,1404297641,1,5,0
121499845@N05,336,10,1404286442,1404286442,1,5,0
121499845@N05,336,13,1404288567,1404288567,1,5,0
121499845@N05,336,11,1404268132,1404268132,1,5,0
121499845@N05,337,8,1427880746,1427880746,1,3,0
121499845@N05,337,5,1427881110,1427881110,1,3,0
121499845@N05,337,13,1427877381,1427877396,2,3,15
121655138@N03,338,3,1395647317,1395647317,1,2,0
121655138@N03,338,11,1395644077,1395644077,1,2,0
121861619@N03,339,11,1423518520,1423523640,3,9,5120
121861619@N03,339,13,1423529903,1423548611,8,9,18708
121861619@N03,339,8,1423528209,1423528367,3,9,158
121861619@N03,339,5,1423527800,1423560769,12,9,32969
121861619@N03,339,2,1423523911,1423524718,3,9,807
121861619@N03,339,17,1423531264,1423547733,15,9,16469
121861619@N03,339,6,1423533319,1423533319,1,9,0
121861619@N03,339,10,1423537208,1423547859,12,9,10651
121861619@N03,339,15,1423531166,1423536736,6,9,5570
12186997@N00,340,11,1356729006,1356729006,1,1,0
12197785@N03,341,8,1246159064,1246159064,1,1,0
12197785@N03,342,5,1246499983,1246499983,1,1,0
12197785@N03,343,11,1259635232,1259635232,1,4,0
12197785@N03,343,7,1259627599,1259627599,1,4,0
12197785@N03,343,2,1259628506,1259628506,1,4,0
12197785@N03,343,6,1259655582,1259655582,1,4,0
12197785@N03,344,11,1288086123,1288086365,2,2,242
12197785@N03,344,16,1288074338,1288074338,1,2,0
12199307@N08,345,10,1241839606,1241840018,3,6,412
12199307@N08,345,2,1241839531,1241839531,1,6,0
12199307@N08,345,11,1241830297,1241868646,7,6,38349
12199307@N08,345,15,1241843148,1241843148,1,6,0
12199307@N08,345,5,1241854845,1241865898,4,6,11053
12199307@N08,345,13,1241843329,1241844049,3,6,720
12205233@N02,346,11,1227426500,1227426500,1,1,0
12238277@N04,347,5,1311649345,1311649345,1,3,0
12238277@N04,347,3,1311641179,1311648227,21,3,7048
12238277@N04,347,11,1311636036,1311636036,1,3,0
12247055@N00,348,11,1461284945,1461284945,1,1,0
122575123@N04,349,11,1393727009,1393727009,1,1,0
12261016@N00,350,3,1329951049,1329951049,1,1,0
12261016@N00,351,11,1329989463,1329989555,2,1,92
12277777@N04,352,11,1311309027,1311330832,4,2,21805
12277777@N04,352,17,1311312341,1311327391,5,2,15050
122876725@N05,353,11,1406153497,1406192508,9,7,39011
122876725@N05,353,3,1406160416,1406160416,1,7,0
122876725@N05,353,9,1406157714,1406157886,15,7,172
122876725@N05,353,1,1406153820,1406157145,5,7,3325
122876725@N05,353,8,1406166821,1406171488,10,7,4667
122876725@N05,353,7,1406160365,1406160464,6,7,99
122876725@N05,353,5,1406168577,1406168726,2,7,149
122876725@N05,354,13,1406871990,1406871990,1,7,0
122876725@N05,354,11,1406888434,1406888687,6,7,253
122876725@N05,354,7,1406848743,1406848750,2,7,7
122876725@N05,354,5,1406886855,1406888056,32,7,1201
122876725@N05,354,15,1406875734,1406881453,10,7,5719
122876725@N05,354,17,1406875917,1406882164,18,7,6247
122876725@N05,354,10,1406875924,1406882307,8,7,6383
122876725@N05,355,11,1407540952,1407540952,1,6,0
122876725@N05,355,16,1407548989,1407548995,3,6,6
122876725@N05,355,4,1407560661,1407560769,11,6,108
122876725@N05,355,9,1407546844,1407546853,2,6,9
122876725@N05,355,7,1407541153,1407541181,6,6,28
122876725@N05,355,8,1407552897,1407552897,1,6,0
123157079@N03,356,10,1397193527,1397193527,1,1,0
12381123@N06,357,11,1324250645,1324254353,9,2,3708
12381123@N06,357,9,1324252329,1324252812,6,2,483
124313309@N04,358,11,1402536132,1402553884,3,1,17752
124370052@N08,359,17,1396846199,1396846199,1,1,0
12440183@N04,360,2,1346122358,1346123190,6,1,832
124439338@N05,361,16,1426899930,1426899930,1,1,0
12445726@N06,362,16,1335577524,1335577524,1,1,0
12445963@N00,363,8,1412662626,1412662746,3,5,120
12445963@N00,363,7,1412652903,1412652903,1,5,0
12445963@N00,363,11,1412650173,1412650173,1,5,0
12445963@N00,363,12,1412659456,1412659456,1,5,0
12445963@N00,363,4,1412660377,1412660377,1,5,0
12456985@N00,364,11,1396839103,1396839103,1,1,0
124601595@N06,365,11,1398502222,1398513203,2,2,10981
124601595@N06,365,15,1398506326,1398506446,6,2,120
124601595@N06,366,15,1398644781,1398677396,22,1,32615
124897697@N02,367,8,1427595066,1427596055,3,7,989
124897697@N02,367,13,1427603314,1427603840,3,7,526
124897697@N02,367,5,1427590805,1427593401,6,7,2596
124897697@N02,367,9,1427584043,1427584043,1,7,0
124897697@N02,367,15,1427603983,1427604532,2,7,549
124897697@N02,367,11,1427581162,1427608108,2,7,26946
124897697@N02,367,10,1427605052,1427605052,1,7,0
124948917@N04,368,11,1433504213,1433504213,1,3,0
124948917@N04,368,8,1433477787,1433477792,2,3,5
124948917@N04,368,1,1433495287,1433495287,1,3,0
12508217@N08,369,10,1189308889,1189314289,4,2,5400
12508217@N08,369,15,1189315053,1189315053,1,2,0
12508217@N08,370,11,1193554576,1193554576,1,1,0
12508217@N08,371,9,1193825845,1193825921,2,1,76
12508217@N08,372,13,1194151473,1194151473,1,1,0
12508217@N08,373,11,1198905368,1198905368,1,1,0
12508217@N08,374,13,1221618474,1221626035,3,2,7561
12508217@N08,374,15,1221626921,1221627755,3,2,834
12508217@N08,375,13,1222952381,1222952381,1,3,0
12508217@N08,375,17,1222952169,1222952169,1,3,0
12508217@N08,375,15,1222951559,1222952094,3,3,535
12508217@N08,376,11,1264227687,1264227699,2,1,12
12508217@N08,377,9,1318722198,1318725755,13,6,3557
12508217@N08,377,11,1318717969,1318721600,36,6,3631
12508217@N08,377,3,1318727857,1318729645,4,6,1788
12508217@N08,377,7,1318727716,1318727716,1,6,0
12508217@N08,377,5,1318734116,1318734232,8,6,116
12508217@N08,377,16,1318726128,1318726487,2,6,359
12508217@N08,378,9,1332478252,1332478615,2,4,363
12508217@N08,378,4,1332485976,1332485976,1,4,0
12508217@N08,378,11,1332476529,1332476629,2,4,100
12508217@N08,378,16,1332479468,1332479577,6,4,109
12508217@N08,379,13,1335695965,1335695969,3,5,4
12508217@N08,379,17,1335678340,1335697155,9,5,18815
12508217@N08,379,5,1335680779,1335682679,5,5,1900
12508217@N08,379,10,1335678706,1335679373,6,5,667
12508217@N08,379,8,1335685401,1335686696,9,5,1295
12508217@N08,380,5,1348786785,1348786808,2,1,23
12508217@N08,381,1,1349607007,1349613798,16,1,6791
12508217@N08,382,6,1349991661,1349994957,35,1,3296
12508217@N08,383,11,1357952296,1357952296,1,1,0
12508217@N08,384,8,1367747831,1367752048,27,2,4217
12508217@N08,384,11,1367753952,1367753952,1,2,0
12508217@N08,385,11,1384006649,1384014218,11,1,7569
12508217@N08,386,11,1384060114,1384060157,2,3,43
12508217@N08,386,6,1384065069,1384066918,43,3,1849
12508217@N08,386,13,1384062806,1384062895,8,3,89
12577376@N04,387,15,1352696177,1352696177,1,1,0
125837856@N05,388,8,1404261751,1404265280,29,2,3529
125837856@N05,388,1,1404267400,1404293421,20,2,26021
12586305@N04,389,11,1266720039,1266720039,1,4,0
12586305@N04,389,8,1266723367,1266723461,3,4,94
12586305@N04,389,13,1266726620,1266726620,1,4,0
12586305@N04,389,17,1266728615,1266728615,1,4,0
125863683@N08,390,11,1417778638,1417778638,1,1,0
125863683@N08,391,11,1417921213,1417921213,1,1,0
12592520@N03,392,9,1230697193,1230697266,2,3,73
12592520@N03,392,11,1230683722,1230699041,2,3,15319
12592520@N03,392,17,1230703111,1230703111,1,3,0
12650001@N08,393,11,1388536511,1388536511,1,1,0
126527286@N03,394,10,1288596462,1288596539,2,3,77
126527286@N03,394,9,1288576819,1288576819,2,3,0
126527286@N03,394,16,1288577203,1288577203,1,3,0
12658090@N00,395,11,1358334589,1358334589,1,1,0
12658090@N00,396,11,1358414290,1358442605,3,1,28315
12658090@N00,397,5,1358526033,1358526033,1,2,0
12658090@N00,397,11,1358527058,1358527058,1,2,0
12658090@N00,398,5,1358571156,1358571156,1,1,0
12658090@N00,399,5,1400856234,1400856234,1,1,0
12659736@N02,400,11,1210068466,1210068525,3,4,59
12659736@N02,400,9,1210049841,1210050457,5,4,616
12659736@N02,400,8,1210063625,1210064004,18,4,379
12659736@N02,400,1,1210049742,1210049742,1,4,0
126647792@N06,401,11,1453243262,1453243262,1,1,0
126776752@N03,402,3,1422077559,1422077559,1,1,0
126776752@N03,403,3,1437197643,1437197643,1,1,0
127015663@N02,404,1,1415326419,1415328292,2,5,1873
127015663@N02,404,10,1415343645,1415344311,4,5,666
127015663@N02,404,13,1415342214,1415342214,1,5,0
127015663@N02,404,11,1415320729,1415320729,1,5,0
127015663@N02,404,8,1415337515,1415337515,1,5,0
12711998@N00,405,11,1424674939,1424674939,1,1,0
127278883@N08,406,1,1439532377,1439532766,11,4,389
127278883@N08,406,4,1439522383,1439522430,8,4,47
127278883@N08,406,2,1439524498,1439530325,13,4,5827
127278883@N08,406,9,1439535369,1439535371,3,4,2
127278883@N08,407,13,1439619184,1439619188,2,3,4
127278883@N08,407,1,1439625681,1439625687,3,3,6
127278883@N08,407,5,1439625651,1439625852,4,3,201
12738795@N00,408,11,1231586974,1231586974,1,1,0
12738795@N00,409,15,1231673387,1231673387,1,2,0
12738795@N00,409,11,1231673382,1231673382,1,2,0
12742129@N00,410,11,1300510088,1300510088,1,1,0
12742129@N00,411,11,1300580348,1300580348,1,1,0
127429516@N03,412,6,1426137504,1426141306,5,5,3802
127429516@N03,412,17,1426136510,1426136522,2,5,12
127429516@N03,412,11,1426111779,1426154010,2,5,42231
127429516@N03,412,8,1426143753,1426144086,2,5,333
127429516@N03,412,13,1426137058,1426139962,2,5,2904
127484878@N05,413,8,1442471409,1442471409,1,1,0
127484878@N05,414,8,1467842392,1467842392,1,1,0
127662106@N04,415,17,1413543736,1413543779,2,1,43
127662106@N04,416,6,1414736037,1414748073,20,1,12036
127662106@N04,417,16,1416639005,1416639034,3,2,29
127662106@N04,417,11,1416644868,1416644868,1,2,0
127662106@N04,418,17,1423390132,1423390344,77,2,212
127662106@N04,418,11,1423385181,1423385841,13,2,660
127662106@N04,419,4,1425187096,1425187105,2,3,9
127662106@N04,419,2,1425186150,1425186528,13,3,378
127662106@N04,419,11,1425179686,1425179831,7,3,145
127662106@N04,420,10,1426122893,1426122893,1,2,0
127662106@N04,420,11,1426134542,1426134542,1,2,0
127662106@N04,421,11,1457490202,1457490241,4,1,39
127662106@N04,422,4,1464664939,1464664939,1,3,0
127662106@N04,422,7,1464664541,1464664885,5,3,344
127662106@N04,422,3,1464664515,1464667761,8,3,3246
127662106@N04,423,7,1466145439,1466145444,2,1,5
127662106@N04,424,10,1467634025,1467634656,24,1,631
127810693@N08,425,11,1259146338,1259164061,2,1,17723
12784818@N04,426,10,1465094090,1465094130,2,11,40
12784818@N04,426,1,1465090577,1465091703,5,11,1126
12784818@N04,426,5,1465104115,1465125528,5,11,21413
12784818@N04,426,2,1465114870,1465115680,3,11,810
12784818@N04,426,17,1465094471,1465098293,3,11,3822
12784818@N04,426,8,1465103374,1465122510,5,11,19136
12784818@N04,426,4,1465093426,1465093426,1,11,0
12784818@N04,426,13,1465099412,1465099505,3,11,93
12784818@N04,426,11,1465086191,1465127404,11,11,41213
12784818@N04,426,15,1465098416,1465098951,7,11,535
12784818@N04,426,9,1465088058,1465089310,4,11,1252
12786525@N08,427,13,1188608967,1188609987,2,2,1020
12786525@N08,427,5,1188632478,1188632478,1,2,0
12786525@N08,428,15,1211125875,1211125875,1,1,0
127885330@N05,429,11,1334489085,1334489085,1,1,0
127991665@N08,430,11,1241691976,1241691976,1,1,0
128025409@N08,431,8,1409931270,1409932707,2,1,1437
128210777@N08,432,2,1383434961,1383434961,1,1,0
12834171@N06,433,11,1192399636,1192400062,3,1,426
128509080@N04,434,14,1409421573,1409421573,1,1,0
128509080@N04,435,11,1417352400,1417363000,2,1,10600
128509080@N04,436,11,1417626676,1417626923,2,1,247
128509080@N04,437,11,1417670327,1417670482,2,1,155
128526407@N07,438,5,1415734125,1415734125,1,2,0
128526407@N07,438,3,1415734040,1415734040,1,2,0
128526407@N07,439,2,1416246811,1416246811,1,1,0
128526407@N07,440,17,1416510401,1416510401,1,2,0
128526407@N07,440,4,1416509964,1416509964,1,2,0
128526407@N07,441,3,1416771421,1416771421,1,1,0
128526407@N07,442,11,1417146468,1417146468,1,1,0
128526407@N07,443,8,1417546230,1417546230,1,1,0
128526407@N07,444,2,1417577685,1417577685,1,1,0
128526407@N07,445,8,1417648024,1417648024,1,1,0
128959272@N04,446,11,1421457321,1421459416,2,1,2095
129418129@N03,447,5,1385965275,1385965275,1,1,0
129438227@N06,448,13,1414841129,1414841129,1,1,0
129438227@N06,449,5,1431165225,1431165225,1,1,0
129438227@N06,450,13,1456914828,1456914828,1,1,0
129451096@N08,451,5,1426209921,1426226560,8,1,16639
129451096@N08,452,16,1426670605,1426670605,2,1,0
129451096@N08,453,16,1426811310,1426811310,1,1,0
129455250@N03,454,11,1438601921,1438601921,1,1,0
129455250@N03,455,11,1438827535,1438827535,1,1,0
12962494@N00,456,11,1443692617,1443692617,1,1,0
12980856@N06,457,15,1389262365,1389262401,2,1,36
12982579@N00,458,15,1339745768,1339748431,2,7,2663
12982579@N00,458,11,1339740490,1339741063,3,7,573
12982579@N00,458,8,1339744125,1339744495,6,7,370
12982579@N00,458,5,1339743869,1339743919,2,7,50
12982579@N00,458,16,1339741252,1339741252,1,7,0
12982579@N00,458,10,1339748436,1339748781,3,7,345
12982579@N00,458,17,1339745786,1339747531,5,7,1745
12989776@N03,459,15,1291189966,1291189966,1,1,0
12989776@N03,460,5,1318385617,1318385617,1,1,0
130069612@N06,461,4,1433135296,1433135296,1,1,0
130069612@N06,462,11,1433588124,1433588124,1,1,0
130069612@N06,463,13,1463283089,1463283089,1,1,0
130069612@N06,464,11,1463567586,1463567586,1,1,0
130069612@N06,465,13,1463614468,1463614618,2,1,150
130069612@N06,466,9,1463786907,1463786907,1,3,0
130069612@N06,466,4,1463784662,1463784662,1,3,0
130069612@N06,466,16,1463788716,1463788716,1,3,0
130127205@N04,467,17,1456279383,1456279675,7,4,292
130127205@N04,467,10,1456279030,1456279030,1,4,0
130127205@N04,467,2,1456276469,1456276511,3,4,42
130127205@N04,467,13,1456280923,1456280998,4,4,75
13032456@N05,468,5,1381901706,1381901756,2,2,50
13032456@N05,468,11,1381916275,1381916294,2,2,19
13032456@N05,469,10,1382070375,1382070375,1,4,0
13032456@N05,469,17,1382072647,1382072647,1,4,0
13032456@N05,469,13,1382067677,1382067677,1,4,0
13032456@N05,469,11,1382047742,1382047742,1,4,0
130361105@N07,470,5,1406154852,1406154852,1,2,0
130361105@N07,470,17,1406179297,1406179297,1,2,0
13051628@N00,471,5,1299119055,1299136045,4,1,16990
130809171@N06,472,11,1428728148,1428728148,1,1,0
130895783@N02,473,15,1424782800,1424782800,1,1,0
131018110@N07,474,2,1439601045,1439601209,2,2,164
131018110@N07,474,8,1439611997,1439612813,4,2,816
131150099@N04,475,15,1426229742,1426229742,1,2,0
131150099@N04,475,8,1426224413,1426224413,1,2,0
13116303@N03,476,8,1331016907,1331016907,1,1,0
131213971@N07,477,3,1440295202,1440295202,1,1,0
13137063@N05,478,10,1370142041,1370142120,2,3,79
13137063@N05,478,11,1370139641,1370140018,4,3,377
13137063@N05,478,13,1370145742,1370145980,4,3,238
131412080@N05,479,8,1450688694,1450690930,2,15,2236
131412080@N05,479,3,1450655835,1450656243,4,15,408
131412080@N05,479,1,1450657436,1450671602,8,15,14166
131412080@N05,479,10,1450693875,1450693900,3,15,25
131412080@N05,479,12,1450686410,1450686429,2,15,19
131412080@N05,479,5,1450688455,1450688455,1,15,0
131412080@N05,479,2,1450671295,1450687361,29,15,16066
131412080@N05,479,7,1450655801,1450671561,3,15,15760
131412080@N05,479,4,1450684101,1450686069,9,15,1968
131412080@N05,479,14,1450656060,1450656060,1,15,0
131412080@N05,479,16,1450659121,1450660631,4,15,1510
131412080@N05,479,9,1450657343,1450657358,2,15,15
131412080@N05,479,13,1450693452,1450693529,2,15,77
131412080@N05,479,17,1450693668,1450693688,2,15,20
131412080@N05,479,11,1450650601,1450683487,8,15,32886
13156986@N08,480,8,1391952497,1391952589,4,1,92
13156986@N08,481,8,1391988074,1391988074,1,1,0
131849702@N06,482,7,1436063067,1436063067,1,3,0
131849702@N06,482,11,1436055902,1436055969,5,3,67
131849702@N06,482,1,1436056480,1436057363,2,3,883
13191676@N07,483,3,1243778400,1243778400,1,2,0
13191676@N07,483,11,1243778400,1243778400,1,2,0
131918782@N02,484,8,1422504326,1422504326,1,1,0
131918782@N02,485,4,1442201086,1442201088,2,1,2
132097980@N07,486,8,1457663980,1457663980,1,4,0
132097980@N07,486,17,1457668632,1457668632,1,4,0
132097980@N07,486,10,1457668733,1457668733,1,4,0
132097980@N07,486,5,1457663706,1457663706,1,4,0
132132547@N04,487,16,1428111912,1428111933,2,1,21
132132547@N04,488,8,1428545795,1428545799,2,1,4
13230685@N08,489,13,1359009304,1359011328,19,3,2024
13230685@N08,489,8,1359004176,1359004309,5,3,133
13230685@N08,489,5,1359002164,1359017193,5,3,15029
13230685@N08,490,11,1359440777,1359440777,1,1,0
132357461@N07,491,5,1405223685,1405223685,1,1,0
13259518@N00,492,4,1245124358,1245126556,3,3,2198
13259518@N00,492,11,1245105962,1245105962,1,3,0
13259518@N00,492,2,1245120708,1245120708,1,3,0
13259518@N00,493,8,1245472025,1245473499,3,3,1474
13259518@N00,493,5,1245471681,1245471681,1,3,0
13259518@N00,493,11,1245458709,1245489214,2,3,30505
13271166@N06,494,11,1401881347,1401881347,1,1,0
132959156@N02,495,11,1433845944,1433845944,1,1,0
132959156@N02,496,13,1439891317,1439891317,1,1,0
132959156@N02,497,11,1443780015,1443780015,1,1,0
13310991@N04,498,11,1188803803,1188811465,9,1,7662
133471560@N03,499,11,1442226420,1442227867,2,1,1447
13353749@N06,500,11,1195797792,1195797792,1,1,0
13355109@N08,501,5,1363826102,1363826102,1,2,0
13355109@N08,501,8,1363834923,1363834923,1,2,0
133557193@N03,502,11,1433983183,1433983183,1,1,0
13359849@N00,503,11,1383605169,1383627017,2,1,21848
13359849@N00,504,11,1383861288,1383861288,1,1,0
13359849@N00,505,11,1389480311,1389480311,1,1,0
13359849@N00,506,11,1424552780,1424553548,5,1,768
13444787@N08,507,5,1303278106,1303278112,2,1,6
134814033@N03,508,3,1451959880,1451959888,3,5,8
134814033@N03,508,12,1451953384,1451953384,1,5,0
134814033@N03,508,11,1451956609,1451956609,1,5,0
134814033@N03,508,5,1451986712,1451986712,2,5,0
134814033@N03,508,15,1451981038,1451988760,6,5,7722
134944545@N04,509,15,1419747160,1419747160,1,1,0
135084898@N08,510,2,1424302644,1424304221,12,1,1577
13516406@N00,511,2,1367126607,1367126607,1,5,0
13516406@N00,511,9,1367124808,1367124808,1,5,0
13516406@N00,511,5,1367138550,1367138550,1,5,0
13516406@N00,511,12,1367128809,1367128809,1,5,0
13516406@N00,511,15,1367132410,1367132913,4,5,503
135322752@N06,512,11,1440348416,1440348416,1,1,0
13533794@N00,513,14,1212774671,1212804637,8,11,29966
13533794@N00,513,4,1212792041,1212821460,14,11,29419
13533794@N00,513,15,1212779558,1212779558,1,11,0
13533794@N00,513,10,1212779337,1212779384,3,11,47
13533794@N00,513,17,1212779394,1212779507,5,11,113
13533794@N00,513,11,1212773595,1212806435,20,11,32840
13533794@N00,513,16,1212791580,1212791580,1,11,0
13533794@N00,513,3,1212775867,1212805244,22,11,29377
13533794@N00,513,13,1212779608,1212779641,4,11,33
13533794@N00,513,1,1212787889,1212820319,17,11,32430
13533794@N00,513,9,1212785982,1212814834,12,11,28852
13559836@N03,514,8,1321090843,1321090866,2,3,23
13559836@N03,514,17,1321068009,1321068009,1,3,0
13559836@N03,514,15,1321068733,1321068733,1,3,0
13559836@N03,515,6,1436609199,1436609199,1,1,0
13604385@N00,516,11,1352498250,1352498250,1,1,0
13604385@N00,517,11,1352543359,1352543359,1,1,0
13613904@N05,518,1,1211435227,1211435674,5,1,447
13636518@N05,519,6,1300208506,1300208506,1,1,0
13644648@N03,520,8,1254021522,1254021522,1,2,0
13644648@N03,520,14,1254021534,1254021534,1,2,0
13644648@N03,521,9,1254659304,1254659304,1,3,0
13644648@N03,521,11,1254659322,1254659322,1,3,0
13644648@N03,521,8,1254659288,1254659288,1,3,0
13644648@N03,522,13,1287809064,1287809064,1,9,0
13644648@N03,522,11,1287809637,1287809637,1,9,0
13644648@N03,522,10,1287809052,1287809634,5,9,582
13644648@N03,522,8,1287809059,1287809067,4,9,8
13644648@N03,522,1,1287809631,1287809633,2,9,2
13644648@N03,522,4,1287809048,1287809049,2,9,1
13644648@N03,522,5,1287809625,1287809636,2,9,11
13644648@N03,522,15,1287809627,1287809627,1,9,0
13644648@N03,522,2,1287809050,1287809635,4,9,585
13696688@N02,523,1,1322436395,1322436395,1,1,0
13703871@N00,524,11,1320655410,1320655410,1,1,0
13725122@N02,525,8,1368848318,1368848318,1,3,0
13725122@N02,525,13,1368838992,1368838992,1,3,0
13725122@N02,525,11,1368835712,1368835712,1,3,0
13772877@N00,526,11,1398943669,1398946201,3,1,2532
13775066@N00,527,11,1382827840,1382856472,13,1,28632
137778335@N08,528,6,1413810000,1413810000,2,1,0
137778335@N08,529,6,1414933200,1414933200,1,1,0
137778335@N08,530,6,1415397956,1415397956,1,1,0
137778335@N08,531,6,1447365970,1447365970,1,1,0
13813159@N00,532,2,1353795123,1353795123,1,5,0
13813159@N00,532,15,1353802926,1353802926,1,5,0
13813159@N00,532,13,1353803095,1353803095,1,5,0
13813159@N00,532,11,1353820920,1353821068,2,5,148
13813159@N00,532,10,1353801572,1353801572,1,5,0
13818837@N05,533,11,1308719075,1308719075,1,2,0
13818837@N05,533,8,1308721640,1308721640,1,2,0
13818837@N05,534,11,1308797978,1308797978,1,1,0
13844015@N07,535,11,1367051671,1367051671,1,1,0
13844015@N07,536,11,1367200942,1367200942,1,1,0
13880897@N06,537,11,1361003867,1361004248,5,1,381
13885531@N00,538,8,1225859741,1225859765,2,3,24
13885531@N00,538,11,1225861959,1225862563,2,3,604
13885531@N00,538,10,1225852862,1225852862,1,3,0
13901020@N02,539,10,1190405472,1190405534,2,2,62
13901020@N02,539,5,1190405420,1190405420,1,2,0
13901020@N02,540,13,1193641985,1193641985,1,2,0
13901020@N02,540,4,1193641710,1193641710,1,2,0
139081931@N05,541,11,1408712683,1408712683,1,2,0
139081931@N05,541,13,1408686733,1408686733,1,2,0
139081931@N05,542,6,1409310532,1409310532,1,1,0
139081931@N05,543,11,1409627514,1409627530,2,1,16
13913844@N00,544,11,1343018965,1343028358,16,1,9393
139205459@N03,545,13,1464582676,1464582708,2,2,32
139205459@N03,545,17,1464582951,1464582965,2,2,14
13929738@N04,546,8,1195190519,1195190519,1,2,0
13929738@N04,546,11,1195198512,1195198512,1,2,0
13929738@N04,547,10,1195344871,1195344871,1,1,0
13933131@N08,548,11,1316838300,1316853446,7,3,15146
13933131@N08,548,13,1316851378,1316852623,14,3,1245
13933131@N08,548,16,1316839976,1316840026,2,3,50
13933131@N08,549,3,1381784300,1381784300,1,3,0
13933131@N08,549,11,1381797183,1381818564,19,3,21381
13933131@N08,549,2,1381784265,1381784265,1,3,0
13933131@N08,550,15,1393736655,1393739013,4,2,2358
13933131@N08,550,1,1393725743,1393726453,3,2,710
13959240@N08,551,4,1346114903,1346114903,1,1,0
13959240@N08,552,6,1346147151,1346147151,1,1,0
13959240@N08,553,6,1346321487,1346321505,2,1,18
14013358@N06,554,8,1228547157,1228547157,1,1,0
14013358@N06,555,5,1339810754,1339824504,2,7,13750
14013358@N06,555,11,1339841631,1339841738,3,7,107
14013358@N06,555,15,1339817932,1339818582,3,7,650
14013358@N06,555,10,1339809172,1339820552,3,7,11380
14013358@N06,555,8,1339811080,1339812054,6,7,974
14013358@N06,555,17,1339809538,1339809650,2,7,112
14013358@N06,555,3,1339814749,1339814749,1,7,0
14013358@N06,556,11,1351382538,1351385646,11,1,3108
14022320@N00,557,15,1314680627,1314680627,1,1,0
14130502@N07,558,15,1310173467,1310173467,1,2,0
14130502@N07,558,17,1310173589,1310173648,2,2,59
14135751@N07,559,9,1398393043,1398393043,1,3,0
14135751@N07,559,16,1398393070,1398393070,1,3,0
14135751@N07,559,1,1398393870,1398393924,3,3,54
14169447@N07,560,11,1375246463,1375246463,1,1,0
141774505@N07,561,5,1459305268,1459305452,10,2,184
141774505@N07,561,11,1459300131,1459327257,19,2,27126
141774505@N07,562,11,1459394267,1459394267,1,1,0
142375287@N03,563,15,1388380361,1388380361,1,1,0
14242488@N02,564,15,1193113096,1193113096,1,1,0
14242929@N02,565,9,1191397463,1191397463,1,1,0
14244677@N08,566,11,1404779524,1404779524,1,3,0
14244677@N08,566,6,1404752593,1404752593,1,3,0
14244677@N08,566,8,1404749666,1404749666,1,3,0
14246866@N05,567,7,1296965257,1296965257,1,4,0
14246866@N05,567,11,1296968113,1296968113,1,4,0
14246866@N05,567,4,1296962078,1296962087,2,4,9
14246866@N05,567,9,1296959589,1296959589,1,4,0
14261584@N00,568,1,1300057575,1300058590,2,2,1015
14261584@N00,568,17,1300056229,1300063792,3,2,7563
14275801@N04,569,11,1193521696,1193521696,1,1,0
14280234@N04,570,13,1317428691,1317428691,1,1,0
14319961@N08,571,11,1448881480,1448881480,1,1,0
14334279@N02,572,1,1420410718,1420411442,2,1,724
14344313@N05,573,2,1203982944,1203982944,1,1,0
14344313@N05,574,8,1204940140,1204940243,2,2,103
14344313@N05,574,2,1204940410,1204940410,1,2,0
14370802@N05,575,7,1386310298,1386310298,1,1,0
14370802@N05,576,11,1400310742,1400310742,1,1,0
14370802@N05,577,8,1401524957,1401524957,1,1,0
14370802@N05,578,8,1412402007,1412402007,1,1,0
14375907@N00,579,15,1326440603,1326454038,89,1,13435
14375907@N00,580,15,1326532611,1326538521,105,1,5910
14423128@N00,581,11,1274572653,1274572653,1,1,0
14428367@N00,582,10,1226635344,1226636067,16,2,723
14428367@N00,582,13,1226637157,1226637851,25,2,694
144474523@N02,583,7,1218102082,1218102082,1,1,0
144474523@N02,584,8,1246261000,1246261000,1,2,0
144474523@N02,584,13,1246251715,1246251715,1,2,0
14449931@N08,585,5,1378712119,1378712119,1,3,0
14449931@N08,585,11,1378707364,1378707364,1,3,0
14449931@N08,585,8,1378717878,1378717878,1,3,0
14449931@N08,586,11,1378954408,1378954814,2,1,406
14449931@N08,587,11,1400149296,1400149296,1,1,0
14449931@N08,588,2,1411004784,1411004784,1,1,0
14472753@N02,589,8,1335146169,1335146169,1,1,0
14472753@N02,590,17,1368835276,1368835276,1,1,0
14479515@N03,591,11,1199918908,1199962260,26,8,43352
14479515@N03,591,17,1199927032,1199954834,8,8,27802
14479515@N03,591,8,1199935311,1199961511,13,8,26200
14479515@N03,591,13,1199927683,1199945649,4,8,17966
14479515@N03,591,10,1199926578,1199953810,6,8,27232
14479515@N03,591,15,1199927503,1199954917,4,8,27414
14479515@N03,591,5,1199938585,1199961717,4,8,23132
14479515@N03,591,16,1199920279,1199920279,1,8,0
14479515@N03,592,11,1254185482,1254185486,7,1,4
14484378@N08,593,13,1221328905,1221328905,1,1,0
14487451@N00,594,11,1379149869,1379150681,3,1,812
14489732@N00,595,11,1275703664,1275703664,1,1,0
14489732@N00,596,11,1276081416,1276081416,1,1,0
14500034@N06,597,13,1388505366,1388505366,1,1,0
14504365@N00,598,11,1359156756,1359179524,7,4,22768
14504365@N00,598,2,1359161323,1359163218,4,4,1895
14504365@N00,598,4,1359164717,1359164790,4,4,73
14504365@N00,598,10,1359166673,1359166673,2,4,0
14541788@N06,599,1,1429462051,1429462051,1,1,0
14542870@N03,600,8,1264149001,1264149001,1,1,0
14561857@N02,601,11,1369269776,1369269776,1,1,0
14572041@N08,602,11,1448319140,1448319140,1,1,0
14572041@N08,603,11,1448353756,1448353756,1,1,0
14580956@N08,604,6,1273307538,1273309254,16,9,1716
14580956@N08,604,8,1273294404,1273295716,14,9,1312
14580956@N08,604,4,1273303213,1273303239,2,9,26
14580956@N08,604,12,1273300967,1273302570,8,9,1603
14580956@N08,604,11,1273279186,1273318768,8,9,39582
14580956@N08,604,17,1273318087,1273318087,1,9,0
14580956@N08,604,1,1273288972,1273299951,9,9,10979
14580956@N08,604,9,1273283103,1273287023,7,9,3920
14580956@N08,604,3,1273284595,1273284595,2,9,0
14617498@N00,605,6,1229077934,1229078981,5,3,1047
14617498@N00,605,3,1229056246,1229056246,1,3,0
14617498@N00,605,1,1229062745,1229064049,8,3,1304
14617498@N00,606,11,1297555604,1297555604,1,1,0
14625004@N00,607,8,1195371833,1195371854,2,3,21
14625004@N00,607,6,1195376993,1195376993,2,3,0
14625004@N00,607,11,1195361858,1195361864,2,3,6
14625004@N00,608,17,1195696324,1195696324,1,7,0
14625004@N00,608,8,1195708991,1195708991,1,7,0
14625004@N00,608,2,1195688365,1195690869,4,7,2504
14625004@N00,608,10,1195694465,1195695779,3,7,1314
14625004@N00,608,9,1195686894,1195686894,1,7,0
14625004@N00,608,13,1195701689,1195705452,8,7,3763
14625004@N00,608,3,1195693783,1195693843,2,7,60
14631943@N08,609,9,1190512320,1190512320,1,3,0
14631943@N08,609,4,1190512287,1190512287,1,3,0
14631943@N08,609,11,1190512311,1190512311,1,3,0
14639823@N05,610,8,1221976082,1221976082,1,1,0
14639823@N05,611,5,1235707847,1235707992,2,1,145
14639823@N05,612,7,1300674171,1300674171,1,2,0
14639823@N05,612,15,1300681442,1300681442,1,2,0
14769156@N08,613,6,1417954282,1417954519,19,1,237
14769156@N08,614,11,1433427815,1433427998,21,4,183
14769156@N08,614,12,1433427694,1433427694,1,4,0
14769156@N08,614,5,1433428063,1433428063,1,4,0
14769156@N08,614,8,1433428145,1433428161,3,4,16
14788107@N07,615,2,1420095958,1420095958,1,1,0
14845075@N00,616,11,1407389023,1407389612,3,4,589
14845075@N00,616,10,1407378740,1407378883,3,4,143
14845075@N00,616,9,1407380493,1407380569,2,4,76
14845075@N00,616,1,1407380487,1407405327,2,4,24840
14873749@N02,617,11,1309881057,1309881130,2,3,73
14873749@N02,617,6,1309875611,1309875638,2,3,27
14873749@N02,617,5,1309864953,1309864953,1,3,0
14877714@N00,618,11,1193460803,1193461209,2,2,406
14877714@N00,618,9,1193464761,1193464794,3,2,33
14898307@N00,619,11,1360299992,1360299992,1,1,0
14903923@N07,620,11,1241861190,1241861190,1,1,0
14903923@N07,621,11,1242961227,1242961563,3,1,336
14904592@N04,622,1,1292034869,1292034869,1,3,0
14904592@N04,622,2,1292025170,1292025170,1,3,0
14904592@N04,622,4,1292013986,1292014200,3,3,214
14915921@N00,623,8,1196566713,1196567001,7,8,288
14915921@N00,623,9,1196573612,1196574982,6,8,1370
14915921@N00,623,11,1196575349,1196587561,16,8,12212
14915921@N00,623,10,1196558877,1196560998,21,8,2121
14915921@N00,623,17,1196558580,1196558834,10,8,254
14915921@N00,623,5,1196568035,1196569238,5,8,1203
14915921@N00,623,13,1196558432,1196561935,4,8,3503
14915921@N00,623,1,1196569820,1196573004,5,8,3184
14934218@N03,624,10,1214903505,1214903505,1,2,0
14934218@N03,624,17,1214905134,1214905134,1,2,0
14934218@N03,625,15,1252062033,1252062033,1,3,0
14934218@N03,625,10,1252052658,1252056287,2,3,3629
14934218@N03,625,8,1252045682,1252048352,9,3,2670
15021432@N00,626,8,1190343113,1190343138,3,1,25
15021432@N00,627,8,1191134991,1191134991,1,4,0
15021432@N00,627,2,1191120835,1191120835,1,4,0
15021432@N00,627,4,1191122949,1191122949,1,4,0
15021432@N00,627,11,1191103320,1191103320,1,4,0
15021432@N00,628,10,1191219002,1191219257,2,1,255
15021432@N00,629,10,1192156954,1192156954,1,4,0
15021432@N00,629,15,1192164493,1192164493,1,4,0
15021432@N00,629,11,1192169443,1192169443,1,4,0
15021432@N00,629,4,1192146072,1192146072,1,4,0
15021432@N00,630,15,1209017267,1209017309,2,3,42
15021432@N00,630,11,1209007811,1209008239,3,3,428
15021432@N00,630,13,1209018885,1209018885,1,3,0
15021432@N00,631,10,1222486222,1222486285,2,1,63
15021432@N00,632,16,1225931829,1225932239,4,1,410
15021432@N00,633,13,1229821296,1229821407,2,1,111
15021432@N00,634,11,1234006550,1234006550,1,2,0
15021432@N00,634,17,1234001490,1234001795,6,2,305
15048974@N00,635,11,1452987235,1452987547,2,1,312
15048974@N00,636,11,1464942810,1464945331,5,1,2521
15048974@N00,637,11,1465168953,1465168953,1,1,0
15048974@N00,638,11,1465253031,1465253031,1,1,0
15079826@N00,639,5,1327735474,1327735474,1,1,0
15079826@N00,640,5,1386992350,1386992402,2,1,52
15079826@N00,641,13,1400913780,1400916948,3,2,3168
15079826@N00,641,5,1400930901,1400937388,8,2,6487
15265115@N06,642,17,1359276523,1359276753,5,3,230
15265115@N06,642,10,1359273472,1359273472,1,3,0
15265115@N06,642,11,1359272471,1359281105,6,3,8634
15268966@N00,643,11,1212557089,1212558317,2,1,1228
15403331@N00,644,11,1420376621,1420378690,2,1,2069
15409357@N07,645,11,1393573768,1393573768,1,1,0
15409357@N07,646,17,1431856330,1431856330,1,1,0
15429890@N08,647,1,1191233224,1191233224,1,1,0
15473418@N00,648,11,1212456796,1212456796,1,2,0
15473418@N00,648,2,1212458499,1212461141,3,2,2642
15473418@N00,649,15,1212564504,1212564504,1,6,0
15473418@N00,649,10,1212553914,1212555103,6,6,1189
15473418@N00,649,8,1212549163,1212549834,3,6,671
15473418@N00,649,5,1212551743,1212551778,3,6,35
15473418@N00,649,17,1212558205,1212558205,1,6,0
15473418@N00,649,13,1212558775,1212565945,10,6,7170
15473418@N00,650,14,1212895077,1212900756,3,7,5679
15473418@N00,650,12,1212897840,1212899370,3,7,1530
15473418@N00,650,9,1212886317,1212886564,2,7,247
15473418@N00,650,2,1212900239,1212900239,1,7,0
15473418@N00,650,7,1212888498,1212888498,1,7,0
15473418@N00,650,11,1212903014,1212903014,1,7,0
15473418@N00,650,16,1212883018,1212883018,1,7,0
15473418@N00,651,2,1215831618,1215831619,2,1,1
15473418@N00,652,11,1216035038,1216035038,1,1,0
15474023@N03,653,11,1396318127,1396343704,2,7,25577
15474023@N03,653,10,1396324083,1396324083,1,7,0
15474023@N03,653,8,1396336509,1396338943,7,7,2434
15474023@N03,653,17,1396326467,1396327699,3,7,1232
15474023@N03,653,5,1396342209,1396342209,1,7,0
15474023@N03,653,13,1396328594,1396329651,3,7,1057
15474023@N03,653,1,1396322778,1396322778,1,7,0
15510693@N08,654,8,1362288970,1362288970,1,2,0
15510693@N08,654,5,1362290671,1362290671,1,2,0
15518367@N03,655,11,1303383765,1303383765,1,2,0
15518367@N03,655,16,1303371297,1303371297,1,2,0
15525927@N04,656,11,1296271570,1296271570,1,1,0
15530177@N05,657,13,1418266648,1418267498,6,3,850
15530177@N05,657,10,1418266034,1418266543,10,3,509
15530177@N05,657,15,1418265642,1418265886,8,3,244
15531512@N00,658,11,1365378255,1365379484,10,1,1229
15531512@N00,659,17,1426492471,1426492488,2,2,17
15531512@N00,659,2,1426494344,1426494348,2,2,4
15531512@N00,660,5,1426576396,1426576414,2,2,18
15531512@N00,660,4,1426568635,1426568635,1,2,0
15533594@N00,661,11,1296946963,1296947763,2,2,800
15533594@N00,661,5,1296966276,1296966276,1,2,0
15545914@N00,662,11,1313127143,1313127143,1,1,0
15551876@N04,663,11,1376816099,1376816099,1,2,0
15551876@N04,663,13,1376812189,1376812189,1,2,0
15578904@N00,664,8,1381740547,1381740547,1,1,0
15605437@N08,665,3,1203601892,1203601892,1,9,0
15605437@N08,665,5,1203602033,1203602048,6,9,15
15605437@N08,665,4,1203601852,1203601854,2,9,2
15605437@N08,665,15,1203601969,1203601978,3,9,9
15605437@N08,665,6,1203601948,1203601953,3,9,5
15605437@N08,665,11,1203601858,1203601888,11,9,30
15605437@N08,665,12,1203601893,1203601908,6,9,15
15605437@N08,665,8,1203601984,1203601984,1,9,0
15605437@N08,665,13,1203601990,1203601990,1,9,0
15756745@N06,666,8,1335261878,1335261878,1,1,0
15790231@N02,667,13,1222418544,1222418544,1,6,0
15790231@N02,667,12,1222401601,1222401601,1,6,0
15790231@N02,667,2,1222393404,1222401661,22,6,8257
15790231@N02,667,14,1222414044,1222416774,18,6,2730
15790231@N02,667,11,1222393175,1222393175,1,6,0
15790231@N02,667,6,1222422027,1222422107,4,6,80
15802258@N04,668,11,1384035360,1384035360,1,1,0
15802258@N04,669,17,1384077748,1384078466,4,1,718
15802258@N04,670,11,1392446081,1392446081,1,1,0
15802258@N04,671,17,1417826774,1417826774,1,1,0
15802258@N04,672,11,1449361757,1449361757,1,1,0
15802258@N04,673,11,1460748513,1460748513,1,1,0
15823562@N00,674,11,1255577493,1255577493,1,1,0
15823562@N00,675,10,1255870124,1255872095,3,1,1971
15823562@N00,676,11,1275645564,1275645662,4,1,98
15834837@N08,677,4,1376456551,1376456564,2,1,13
15834837@N08,678,7,1381565610,1381565616,2,2,6
15834837@N08,678,11,1381558358,1381575622,9,2,17264
16088786@N03,679,11,1402986096,1402986096,1,1,0
16088786@N03,680,3,1403598568,1403598568,1,1,0
16093042@N00,681,10,1351559136,1351559136,1,4,0
16093042@N00,681,13,1351559428,1351559428,1,4,0
16093042@N00,681,11,1351559072,1351559072,1,4,0
16093042@N00,681,17,1351575210,1351578566,2,4,3356
16299212@N03,682,11,1232785138,1232785138,1,1,0
16299212@N03,683,11,1232839075,1232866077,2,1,27002
16355945@N00,684,4,1300175716,1300175716,1,1,0
16355945@N00,685,8,1323402960,1323402960,1,2,0
16355945@N00,685,5,1323403827,1323403827,1,2,0
16417121@N00,686,13,1452834085,1452834085,1,2,0
16417121@N00,686,11,1452848166,1452848166,1,2,0
16429538@N00,687,11,1246785183,1246785183,1,1,0
16429538@N00,688,15,1247041955,1247049071,12,2,7116
16429538@N00,688,11,1247051125,1247051125,1,2,0
16476321@N02,689,17,1333940199,1333940199,1,1,0
16605570@N08,690,12,1243409687,1243409687,1,2,0
16605570@N08,690,2,1243405801,1243405801,1,2,0
16644192@N02,691,6,1217340000,1217340000,2,1,0
16985502@N04,692,4,1292977784,1292977784,1,1,0
16985502@N04,693,11,1324008041,1324008041,1,1,0
16985502@N04,694,7,1324173150,1324173150,1,2,0
16985502@N04,694,3,1324173015,1324173015,1,2,0
16985502@N04,695,10,1324273935,1324273935,1,6,0
16985502@N04,695,6,1324276214,1324279056,2,6,2842
16985502@N04,695,5,1324274500,1324274500,1,6,0
16985502@N04,695,8,1324274688,1324274688,1,6,0
16985502@N04,695,13,1324273061,1324273300,2,6,239
16985502@N04,695,15,1324273829,1324273829,1,6,0
16985502@N04,696,6,1353829861,1353829861,1,2,0
16985502@N04,696,16,1353814973,1353840493,2,2,25520
16991061@N00,697,11,1211423722,1211442967,19,1,19245
16991061@N00,698,11,1211509790,1211509790,1,1,0
16994861@N08,699,17,1380694495,1380702179,3,4,7684
16994861@N08,699,11,1380692112,1380692112,1,4,0
16994861@N08,699,10,1380694412,1380694412,1,4,0
16994861@N08,699,13,1380699733,1380699733,1,4,0
16994861@N08,700,7,1380762206,1380762206,1,6,0
16994861@N08,700,16,1380758331,1380758419,3,6,88
16994861@N08,700,9,1380757835,1380761144,4,6,3309
16994861@N08,700,8,1380774162,1380774177,2,6,15
16994861@N08,700,5,1380770392,1380770392,1,6,0
16994861@N08,700,2,1380761349,1380761931,3,6,582
16994861@N08,701,11,1380805181,1380805410,4,1,229
17057923@N06,702,10,1311212521,1311217443,24,12,4922
17057923@N06,702,13,1311219240,1311221962,6,12,2722
17057923@N06,702,16,1311232171,1311232193,2,12,22
17057923@N06,702,17,1311216804,1311218714,3,12,1910
17057923@N06,702,15,1311218970,1311219158,4,12,188
17057923@N06,702,7,1311203161,1311239241,3,12,36080
17057923@N06,702,5,1311231645,1311246792,38,12,15147
17057923@N06,702,4,1311241277,1311241277,1,12,0
17057923@N06,702,11,1311202128,1311236924,7,12,34796
17057923@N06,702,3,1311238176,1311238538,32,12,362
17057923@N06,702,1,1311207025,1311232058,5,12,25033
17057923@N06,702,9,1311205284,1311205496,3,12,212
17057923@N06,703,5,1311545664,1311545828,4,5,164
17057923@N06,703,4,1311555905,1311555905,1,5,0
17057923@N06,703,11,1311540811,1311540811,1,5,0
17057923@N06,703,14,1311574726,1311576512,18,5,1786
17057923@N06,703,2,1311549808,1311553918,30,5,4110
17099253@N00,704,5,1350199975,1350199975,1,9,0
17099253@N00,704,2,1350176087,1350176172,2,9,85
17099253@N00,704,15,1350186609,1350186643,2,9,34
17099253@N00,704,13,1350188451,1350188451,1,9,0
17099253@N00,704,17,1350185731,1350185731,1,9,0
17099253@N00,704,12,1350176685,1350176685,1,9,0
17099253@N00,704,7,1350173516,1350173516,1,9,0
17099253@N00,704,10,1350184692,1350184695,2,9,3
17099253@N00,704,11,1350169218,1350210669,2,9,41451
17099253@N00,705,5,1350780571,1350802910,2,4,22339
17099253@N00,705,2,1350780343,1350780343,1,4,0
17099253@N00,705,10,1350780407,1350780415,2,4,8
17099253@N00,705,11,1350780299,1350780617,2,4,318
17145135@N00,706,13,1318563981,1318563981,1,6,0
17145135@N00,706,10,1318580398,1318580398,1,6,0
17145135@N00,706,5,1318550632,1318550632,1,6,0
17145135@N00,706,11,1318547580,1318571016,3,6,23436
17145135@N00,706,4,1318564067,1318564067,1,6,0
17145135@N00,706,8,1318553406,1318553406,1,6,0
17299643@N00,707,13,1301906027,1301906885,3,8,858
17299643@N00,707,8,1301900034,1301900688,4,8,654
17299643@N00,707,17,1301909811,1301909826,2,8,15
17299643@N00,707,16,1301889925,1301890122,2,8,197
17299643@N00,707,15,1301909410,1301909451,8,8,41
17299643@N00,707,11,1301885503,1301888670,6,8,3167
17299643@N00,707,5,1301896029,1301897839,9,8,1810
17299643@N00,707,1,1301891711,1301893002,2,8,1291
17328804@N05,708,11,1268823685,1268823685,1,1,0
17386110@N00,709,17,1373548256,1373548256,1,1,0
17539749@N00,710,3,1266644052,1266644052,1,1,0
17567960@N00,711,13,1322873283,1322873689,5,3,406
17567960@N00,711,11,1322885289,1322885289,1,3,0
17567960@N00,711,10,1322871649,1322871654,2,3,5
17599044@N08,712,17,1220262393,1220262393,1,1,0
17671095@N04,713,17,1244395091,1244395091,1,1,0
17725987@N00,714,11,1380298962,1380298962,1,1,0
17725987@N00,715,11,1387025971,1387025971,1,1,0
17754571@N02,716,11,1353051151,1353051151,1,3,0
17754571@N02,716,8,1353047906,1353047906,1,3,0
17754571@N02,716,5,1353048326,1353048326,1,3,0
17762186@N00,717,11,1325108818,1325108838,2,1,20
17883439@N08,718,5,1363855554,1363855554,1,1,0
18004163@N00,719,11,1336881855,1336881855,1,1,0
18081271@N00,720,11,1324281173,1324281173,1,1,0
18081271@N00,721,3,1324516809,1324516809,1,1,0
18158822@N06,722,14,1257110982,1257131483,93,1,20501
18214853@N00,723,4,1346214774,1346214774,1,4,0
18214853@N00,723,11,1346191910,1346236558,4,4,44648
18214853@N00,723,2,1346218810,1346218884,2,4,74
18214853@N00,723,10,1346216069,1346216069,1,4,0
18229944@N04,724,11,1272650104,1272650104,1,1,0
18229944@N04,725,4,1285947365,1285948770,2,1,1405
18334814@N00,726,11,1461109296,1461151765,3,3,42469
18334814@N00,726,10,1461115220,1461126984,2,3,11764
18334814@N00,726,13,1461150395,1461150395,1,3,0
18334814@N00,727,17,1461387644,1461387644,1,1,0
18427074@N00,728,11,1346803664,1346803664,1,1,0
18647653@N08,729,1,1376798941,1376798941,1,2,0
18647653@N08,729,4,1376810487,1376810501,4,2,14
18681277@N00,730,11,1410485028,1410486229,2,1,1201
18697834@N00,731,11,1321241581,1321241581,1,1,0
18703622@N06,732,3,1359593000,1359593052,3,4,52
18703622@N06,732,9,1359589427,1359608354,3,4,18927
18703622@N06,732,5,1359613281,1359613281,1,4,0
18703622@N06,732,11,1359583403,1359583403,1,4,0
18748204@N00,733,9,1401267581,1401271283,5,4,3702
18748204@N00,733,11,1401245140,1401246277,2,4,1137
18748204@N00,733,2,1401271673,1401272904,15,4,1231
18748204@N00,733,4,1401257307,1401260909,24,4,3602
18835181@N05,734,8,1232674637,1232674637,1,1,0
18835181@N05,735,4,1258081232,1258081232,1,2,0
18835181@N05,735,8,1258106340,1258106340,1,2,0
18928626@N00,736,11,1218094623,1218094623,1,1,0
19017254@N03,737,10,1394672586,1394672586,1,1,0
19026178@N00,738,8,1194923104,1194925495,5,9,2391
19026178@N00,738,12,1194934523,1194934523,1,9,0
19026178@N00,738,5,1194929162,1194929162,1,9,0
19026178@N00,738,10,1194912818,1194912944,4,9,126
19026178@N00,738,17,1194913094,1194913619,15,9,525
19026178@N00,738,9,1194911612,1194911612,1,9,0
19026178@N00,738,13,1194913919,1194914107,6,9,188
19026178@N00,738,15,1194913674,1194913720,3,9,46
19026178@N00,738,11,1194911012,1194911387,6,9,375
19262297@N03,739,8,1286611669,1286611669,1,1,0
19262297@N03,740,11,1368853052,1368853052,1,1,0
19356293@N08,741,6,1244103248,1244103248,1,1,0
19555551@N00,742,14,1197929808,1197929813,2,9,5
19555551@N00,742,15,1197956685,1197964957,4,9,8272
19555551@N00,742,10,1197958071,1197958071,1,9,0
19555551@N00,742,8,1197940416,1197941058,3,9,642
19555551@N00,742,13,1197951429,1197954785,3,9,3356
19555551@N00,742,12,1197935107,1197935107,1,9,0
19555551@N00,742,2,1197935098,1197935098,1,9,0
19555551@N00,742,11,1197928499,1197968349,3,9,39850
19555551@N00,742,5,1197937873,1197937873,1,9,0
19555551@N00,743,2,1276654140,1276654197,2,3,57
19555551@N00,743,11,1276687515,1276687515,1,3,0
19555551@N00,743,5,1276675178,1276675178,1,3,0
19594436@N00,744,3,1242690096,1242690435,26,1,339
19594436@N00,745,6,1242954902,1242991809,85,1,36907
19594436@N00,746,6,1244701366,1244701366,1,1,0
19594436@N00,747,6,1254031689,1254031689,1,1,0
19609393@N03,748,5,1303346604,1303346627,3,1,23
19653633@N03,749,13,1208904510,1208904510,1,1,0
19709423@N04,750,9,1387876206,1387876221,3,1,15
19762975@N06,751,10,1329721556,1329721556,1,2,0
19762975@N06,751,11,1329721928,1329721928,1,2,0
19800853@N07,752,2,1427140967,1427140967,1,1,0
19936517@N07,753,3,1386240949,1386240949,1,1,0
19951106@N03,754,11,1320028060,1320028060,3,1,0
19951106@N03,755,13,1320283305,1320283308,2,1,3
20008009@N05,756,11,1430807513,1430807513,1,2,0
20008009@N05,756,13,1430792019,1430792019,1,2,0
20035490@N00,757,9,1355397837,1355397837,1,1,0
20154444@N04,758,11,1300268790,1300268790,1,1,0
20154444@N04,759,1,1469262459,1469262459,1,3,0
20154444@N04,759,11,1469226488,1469226488,1,3,0
20154444@N04,759,4,1469248559,1469248559,1,3,0
20229609@N03,760,11,1341301898,1341301920,2,1,22
20278762@N00,761,11,1461771023,1461771023,1,1,0
20287222@N00,762,1,1289965414,1289966871,2,1,1457
20287222@N00,763,8,1290159166,1290159176,3,1,10
20319059@N06,764,8,1253610704,1253610704,1,1,0
20322483@N05,765,8,1198945365,1198957702,3,1,12337
20322483@N05,766,11,1204258691,1204258691,1,2,0
20322483@N05,766,8,1204255025,1204255025,1,2,0
20322483@N05,767,3,1204330281,1204330281,1,1,0
20322483@N05,768,11,1218428214,1218447793,4,2,19579
20322483@N05,768,10,1218449981,1218449981,1,2,0
20322483@N05,769,16,1218507444,1218507444,1,2,0
20322483@N05,769,4,1218506091,1218506091,1,2,0
20322483@N05,770,7,1218671932,1218671932,1,3,0
20322483@N05,770,9,1218669941,1218669941,1,3,0
20322483@N05,770,16,1218670179,1218670179,1,3,0
20322483@N05,771,11,1225411595,1225411607,2,1,12
20322483@N05,772,11,1225517632,1225518398,2,1,766
20342624@N00,773,9,1286068432,1286068432,1,5,0
20342624@N00,773,16,1286088513,1286088513,1,5,0
20342624@N00,773,11,1286070810,1286070810,1,5,0
20342624@N00,773,1,1286066798,1286066798,1,5,0
20342624@N00,773,8,1286076266,1286076266,1,5,0
20509582@N00,774,4,1304347773,1304347773,1,1,0
20544000@N00,775,11,1363132914,1363132914,1,1,0
20544648@N06,776,11,1284852313,1284852516,3,1,203
20544648@N06,777,13,1285150321,1285150362,2,4,41
20544648@N06,777,17,1285149989,1285150171,4,4,182
20544648@N06,777,15,1285150212,1285150212,1,4,0
20544648@N06,777,10,1285149884,1285149931,2,4,47
20544648@N06,778,8,1285293023,1285294543,7,2,1520
20544648@N06,778,5,1285294767,1285294767,1,2,0
20677928@N06,779,13,1236984912,1236984912,1,4,0
20677928@N06,779,11,1236951963,1236952807,2,4,844
20677928@N06,779,3,1236976443,1236976531,3,4,88
20677928@N06,779,10,1236983282,1236983307,2,4,25
20677928@N06,780,13,1239075556,1239075624,2,1,68
20683088@N03,781,11,1450916995,1450916995,1,1,0
20701570@N00,782,13,1319185019,1319185019,1,2,0
20701570@N00,782,15,1319185275,1319185275,1,2,0
20701570@N00,783,10,1348971864,1348971864,1,2,0
20701570@N00,783,4,1348965332,1348965332,1,2,0
20701570@N00,784,13,1379755429,1379755429,1,1,0
20701570@N00,785,12,1402198616,1402198616,1,3,0
20701570@N00,785,10,1402198626,1402198626,1,3,0
20701570@N00,785,7,1402198617,1402198617,1,3,0
20701570@N00,786,11,1450488702,1450488702,1,1,0
20704576@N04,787,11,1197954041,1197954156,2,1,115
20715134@N00,788,13,1237848126,1237848146,2,6,20
20715134@N00,788,9,1237836962,1237836962,1,6,0
20715134@N00,788,15,1237842140,1237842140,1,6,0
20715134@N00,788,1,1237853694,1237853694,1,6,0
20715134@N00,788,16,1237839519,1237839519,1,6,0
20715134@N00,788,11,1237836602,1237881763,3,6,45161
20725537@N04,789,6,1382394828,1382417905,8,1,23077
20727999@N06,790,10,1305018976,1305018976,1,6,0
20727999@N06,790,17,1305015925,1305016300,4,6,375
20727999@N06,790,2,1304981784,1304981784,1,6,0
20727999@N06,790,5,1305009504,1305010289,2,6,785
20727999@N06,790,8,1305010590,1305011090,5,6,500
20727999@N06,790,1,1304979522,1304979522,1,6,0
20727999@N06,791,1,1305153615,1305153615,1,5,0
20727999@N06,791,9,1305153623,1305153832,3,5,209
20727999@N06,791,11,1305152074,1305152074,1,5,0
20727999@N06,791,5,1305193038,1305193038,1,5,0
20727999@N06,791,8,1305179333,1305190779,4,5,11446
20742002@N00,792,11,1229767494,1229767494,1,1,0
20771338@N00,793,13,1222231839,1222231846,2,3,7
20771338@N00,793,11,1222232739,1222232890,4,3,151
20771338@N00,793,8,1222222731,1222232322,4,3,9591
20864470@N00,794,11,1333137878,1333137878,1,2,0
20864470@N00,794,9,1333113208,1333113208,1,2,0
20885794@N00,795,11,1467460420,1467460420,1,1,0
20895877@N04,796,8,1349070961,1349077366,3,3,6405
20895877@N04,796,13,1349063611,1349063611,1,3,0
20895877@N04,796,17,1349061907,1349061907,1,3,0
20925955@N03,797,1,1208662673,1208663120,4,1,447
20944525@N04,798,11,1369124033,1369124033,1,1,0
20961008@N08,799,11,1461489855,1461489855,1,1,0
21029801@N05,800,3,1241259466,1241259567,3,3,101
21029801@N05,800,11,1241230566,1241263911,3,3,33345
21029801@N05,800,4,1241259940,1241259940,1,3,0
21038859@N08,801,1,1209701182,1209701624,4,2,442
21038859@N08,801,12,1209687593,1209687593,1,2,0
21038859@N08,802,11,1209731738,1209731738,1,1,0
21038859@N08,803,11,1209969812,1209969816,2,2,4
21038859@N08,803,15,1209970679,1209970679,1,2,0
21100210@N05,804,11,1195640120,1195640120,1,1,0
21138471@N00,805,5,1224721138,1224721476,3,1,338
21138471@N00,806,11,1235873459,1235873459,1,1,0
21212744@N07,807,11,1199147625,1199147662,3,1,37
21212744@N07,808,8,1199232595,1199232695,6,1,100
21212744@N07,809,11,1199668030,1199668040,2,1,10
21212744@N07,810,13,1199948611,1199948795,5,4,184
21212744@N07,810,11,1199952215,1199952224,2,4,9
21212744@N07,810,17,1199948954,1199949008,4,4,54
21212744@N07,810,10,1199950405,1199950439,3,4,34
21228638@N00,811,8,1237705339,1237705339,1,2,0
21228638@N00,811,1,1237684875,1237684875,1,2,0
21228638@N00,812,6,1238111985,1238111985,1,1,0
21242385@N04,813,8,1367050603,1367050628,2,1,25
21242740@N00,814,4,1259293648,1259310620,4,1,16972
21242740@N00,815,4,1259388032,1259388032,1,1,0
21242740@N00,816,4,1263549442,1263549442,1,1,0
21242740@N00,817,4,1280471522,1280484980,2,1,13458
21254904@N02,818,5,1219655714,1219655714,1,2,0
21254904@N02,818,11,1219631142,1219658843,2,2,27701
21254904@N02,819,16,1219984724,1219984724,1,1,0
21299180@N02,820,13,1356305526,1356306856,3,1,1330
21299180@N02,821,13,1362282011,1362308516,30,1,26505
21299180@N02,822,13,1366451204,1366451204,3,2,0
21299180@N02,822,6,1366448371,1366449541,13,2,1170
21299180@N02,823,4,1366947432,1366955519,12,2,8087
21299180@N02,823,11,1366955541,1366955541,3,2,0
21301462@N02,824,16,1311498533,1311498533,1,4,0
21301462@N02,824,2,1311476501,1311479257,7,4,2756
21301462@N02,824,5,1311500997,1311501907,20,4,910
21301462@N02,824,11,1311472251,1311472251,1,4,0
21301462@N02,825,8,1311575554,1311575625,5,4,71
21301462@N02,825,17,1311582386,1311584612,4,4,2226
21301462@N02,825,10,1311582973,1311582973,1,4,0
21301462@N02,825,13,1311560433,1311561437,9,4,1004
21328392@N06,826,7,1311380958,1311380958,1,8,0
21328392@N06,826,17,1311404699,1311421498,5,8,16799
21328392@N06,826,10,1311405198,1311406859,3,8,1661
21328392@N06,826,13,1311401947,1311401947,1,8,0
21328392@N06,826,8,1311392842,1311392881,2,8,39
21328392@N06,826,4,1311384085,1311384085,1,8,0
21328392@N06,826,11,1311378384,1311378594,3,8,210
21328392@N06,826,5,1311390557,1311391576,3,8,1019
21369373@N00,827,10,1353652012,1353655529,4,1,3517
21377282@N00,828,10,1221348923,1221348923,1,1,0
21383026@N06,829,15,1247373311,1247373311,1,2,0
21383026@N06,829,17,1247373457,1247373457,1,2,0
21383026@N06,830,6,1249290388,1249296318,5,1,5930
21383026@N06,831,13,1255048859,1255049582,2,1,723
21383026@N06,832,13,1255740369,1255740369,1,1,0
21383026@N06,833,13,1285233588,1285233692,2,1,104
21383026@N06,834,6,1286952184,1286952184,1,1,0
21383026@N06,835,11,1288764071,1288765437,4,1,1366
21383026@N06,836,6,1289206359,1289210742,3,1,4383
21383026@N06,837,6,1289287251,1289297023,2,1,9772
21383026@N06,838,13,1293687846,1293687846,1,1,0
21383026@N06,839,5,1294902940,1294902940,1,2,0
21383026@N06,839,13,1294896931,1294896931,1,2,0
21383026@N06,840,15,1296788715,1296788715,1,1,0
21383026@N06,841,4,1298623907,1298623907,1,1,0
21383026@N06,842,13,1305017116,1305017116,1,2,0
21383026@N06,842,15,1305009226,1305009232,2,2,6
21383026@N06,843,8,1311247889,1311247889,1,2,0
21383026@N06,843,15,1311245041,1311245051,3,2,10
21383026@N06,844,13,1318486603,1318487962,4,1,1359
21407390@N00,845,10,1364033378,1364033378,1,1,0
21422300@N00,846,8,1198569649,1198569649,1,2,0
21422300@N00,846,11,1198573959,1198573959,1,2,0
21467315@N00,847,11,1376036828,1376037336,2,1,508
21472383@N03,848,8,1200547437,1200547437,1,2,0
21472383@N03,848,11,1200550646,1200550646,1,2,0
21482165@N05,849,10,1196641296,1196641298,2,1,2
21537772@N02,850,16,1196357149,1196357149,1,1,0
21591624@N00,851,11,1215989621,1215989987,2,2,366
21591624@N00,851,1,1215991000,1215991000,1,2,0
21591624@N00,852,8,1216030352,1216030352,1,1,0
21619670@N03,853,11,1196728870,1196729181,2,3,311
21619670@N03,853,17,1196745002,1196745002,1,3,0
21619670@N03,853,8,1196736950,1196736950,1,3,0
21619670@N03,854,15,1197091723,1197091736,2,2,13
21619670@N03,854,13,1197091934,1197092107,3,2,173
21637807@N07,855,9,1242450738,1242450738,1,2,0
21637807@N07,855,16,1242451073,1242451073,1,2,0
21641933@N00,856,5,1336286255,1336286255,1,1,0
21641933@N00,857,12,1377735981,1377735981,1,2,0
21641933@N00,857,2,1377738387,1377738387,1,2,0
21657144@N06,858,11,1204928355,1204965428,4,1,37073
21667128@N00,859,11,1293392027,1293424063,33,1,32036
21667128@N00,860,11,1293484838,1293509370,46,1,24532
21667128@N00,861,11,1293568556,1293585706,50,1,17150
21667128@N00,862,11,1293623676,1293687098,68,1,63422
21667128@N00,863,11,1293751937,1293751994,2,1,57
21667128@N00,864,11,1293786616,1293786616,1,2,0
21667128@N00,864,8,1293784300,1293785205,5,2,905
21675394@N03,865,11,1197115202,1197115202,1,1,0
21685693@N02,866,13,1195563955,1195566046,5,2,2091
21685693@N02,866,11,1195575393,1195575393,1,2,0
21685693@N02,867,1,1257049359,1257049367,2,1,8
21739162@N04,868,8,1253940172,1253941953,8,7,1781
21739162@N04,868,11,1253917885,1253927460,5,7,9575
21739162@N04,868,16,1253938405,1253938405,1,7,0
21739162@N04,868,9,1253918691,1253918691,1,7,0
21739162@N04,868,1,1253918526,1253938794,2,7,20268
21739162@N04,868,2,1253925001,1253925058,3,7,57
21739162@N04,868,13,1253946151,1253946439,2,7,288
21739162@N04,869,8,1302255187,1302255187,1,8,0
21739162@N04,869,11,1302216869,1302258555,4,8,41686
21739162@N04,869,16,1302223824,1302223824,1,8,0
21739162@N04,869,5,1302248557,1302248557,1,8,0
21739162@N04,869,2,1302225362,1302227617,4,8,2255
21739162@N04,869,17,1302229519,1302230953,2,8,1434
21739162@N04,869,10,1302228933,1302229159,3,8,226
21739162@N04,869,13,1302231287,1302233550,7,8,2263
21748548@N00,870,11,1420662906,1420662906,1,3,0
21748548@N00,870,8,1420661055,1420661093,4,3,38
21748548@N00,870,17,1420662351,1420662351,1,3,0
21748548@N00,871,15,1420781137,1420781137,1,7,0
21748548@N00,871,11,1420754440,1420754465,2,7,25
21748548@N00,871,8,1420746334,1420746350,2,7,16
21748548@N00,871,2,1420770653,1420771444,12,7,791
21748548@N00,871,17,1420784163,1420785563,2,7,1400
21748548@N00,871,14,1420774971,1420774980,2,7,9
21748548@N00,871,3,1420762715,1420775289,14,7,12574
21748548@N00,872,13,1420942130,1420942144,2,2,14
21748548@N00,872,17,1420941987,1420941988,2,2,1
21758755@N04,873,8,1194324407,1194324681,6,1,274
21768535@N06,874,11,1351641503,1351641503,1,3,0
21768535@N06,874,9,1351641739,1351641739,1,3,0
21768535@N06,874,13,1351652507,1351652507,1,3,0
21807174@N04,875,8,1309767164,1309767164,1,2,0
21807174@N04,875,5,1309754803,1309754803,1,2,0
21807174@N04,876,4,1310208661,1310208661,1,1,0
21851811@N04,877,2,1270111045,1270111045,1,1,0
21882182@N03,878,15,1347116625,1347116996,3,3,371
21882182@N03,878,17,1347116405,1347116405,1,3,0
21882182@N03,878,10,1347116187,1347116223,3,3,36
21933943@N02,879,11,1379397461,1379397461,1,1,0
21933943@N02,880,11,1379562813,1379562813,1,1,0
21960471@N06,881,10,1252903588,1252903588,1,1,0
21978090@N03,882,15,1323315036,1323315036,1,4,0
21978090@N03,882,2,1323312404,1323312404,1,4,0
21978090@N03,882,11,1323299729,1323299850,4,4,121
21978090@N03,882,17,1323313668,1323313735,2,4,67
22046456@N04,883,16,1279991781,1279991946,2,2,165
22046456@N04,883,1,1279987041,1279987041,1,2,0
22046456@N04,884,9,1289698266,1289698266,1,1,0
22055481@N04,885,13,1198467695,1198467695,1,2,0
22055481@N04,885,6,1198467696,1198467696,1,2,0
22058355@N06,886,11,1288750758,1288751510,2,2,752
22058355@N06,886,4,1288746850,1288749306,2,2,2456
22065354@N08,887,13,1291443327,1291444768,2,1,1441
22068918@N00,888,8,1237778464,1237779595,2,8,1131
22068918@N00,888,11,1237756372,1237783677,4,8,27305
22068918@N00,888,13,1237770034,1237770034,1,8,0
22068918@N00,888,1,1237761618,1237762503,7,8,885
22068918@N00,888,12,1237784493,1237784493,1,8,0
22068918@N00,888,4,1237789220,1237789228,2,8,8
22068918@N00,888,10,1237769312,1237769624,3,8,312
22068918@N00,888,5,1237779822,1237780556,5,8,734
22071371@N00,889,11,1232316678,1232316678,1,1,0
22092583@N05,890,11,1434799713,1434799713,1,1,0
22107206@N00,891,5,1369634957,1369634978,2,1,21
22119513@N00,892,8,1251083106,1251083106,1,1,0
22133066@N05,893,13,1382057764,1382057764,1,1,0
22151340@N02,894,11,1207822125,1207824785,2,1,2660
22151340@N02,895,4,1212302423,1212302423,1,2,0
22151340@N02,895,11,1212309654,1212309654,1,2,0
22151340@N02,896,11,1216547876,1216547876,1,1,0
22151340@N02,897,4,1217398951,1217398951,1,1,0
22158588@N00,898,11,1194656201,1194656201,1,1,0
22158588@N00,899,13,1201342004,1201342041,2,1,37
22158588@N00,900,5,1204366177,1204366177,1,1,0
22161498@N00,901,1,1195369990,1195369990,1,4,0
22161498@N00,901,17,1195368269,1195368269,1,4,0
22161498@N00,901,2,1195351017,1195357891,12,4,6874
22161498@N00,901,13,1195366857,1195367740,4,4,883
22162211@N07,902,11,1331481273,1331481273,1,1,0
22204656@N00,903,11,1447866375,1447866375,1,1,0
22207764@N06,904,9,1212302498,1212302983,3,1,485
22207764@N06,905,8,1220776143,1220776577,2,1,434
22207764@N06,906,2,1226643828,1226643828,1,1,0
22207764@N06,907,9,1243650872,1243650872,1,1,0
22207764@N06,908,11,1280549372,1280549372,1,6,0
22207764@N06,908,9,1280540133,1280540172,2,6,39
22207764@N06,908,16,1280540346,1280540346,1,6,0
22207764@N06,908,4,1280543273,1280543273,1,6,0
22207764@N06,908,5,1280547674,1280547674,1,6,0
22207764@N06,908,3,1280535065,1280535065,1,6,0
22207764@N06,909,8,1280716859,1280717380,3,1,521
22218920@N08,910,4,1260773156,1260773171,2,1,15
22218920@N08,911,2,1394414620,1394414669,4,3,49
22218920@N08,911,4,1394410288,1394434738,4,3,24450
22218920@N08,911,14,1394410553,1394431115,19,3,20562
22232518@N05,912,4,1305470353,1305470357,2,1,4
22232518@N05,913,4,1306503440,1306503458,4,1,18
22232518@N05,914,4,1306804086,1306804086,1,1,0
22232518@N05,915,4,1306887191,1306887191,1,1,0
22232518@N05,916,4,1312952602,1312952837,3,3,235
22232518@N05,916,10,1312954337,1312954337,1,3,0
22232518@N05,916,15,1312954656,1312955163,4,3,507
22232518@N05,917,4,1343543452,1343543490,14,1,38
22261589@N00,918,15,1194915990,1194915990,1,1,0
22261589@N00,919,5,1240828190,1240828190,1,1,0
22261589@N00,920,11,1292028930,1292028930,1,1,0
22261589@N00,921,8,1292388673,1292389719,3,3,1046
22261589@N00,921,17,1292382105,1292382105,1,3,0
22261589@N00,921,11,1292363833,1292399573,4,3,35740
22261589@N00,922,8,1292492977,1292494634,2,1,1657
22261589@N00,923,11,1296288951,1296288951,1,1,0
22261589@N00,924,1,1337127117,1337139536,2,1,12419
22261589@N00,925,8,1337486868,1337489714,3,3,2846
22261589@N00,925,11,1337469630,1337472096,2,3,2466
22261589@N00,925,9,1337504885,1337504905,2,3,20
22261589@N00,926,11,1341833852,1341833852,1,1,0
22261589@N00,927,9,1391161201,1391161201,1,1,0
22265703@N06,928,11,1246970422,1246970422,1,1,0
22273519@N07,929,11,1315884679,1315884679,1,2,0
22273519@N07,929,5,1315888225,1315888225,1,2,0
22311971@N04,930,2,1322393258,1322393258,1,2,0
22311971@N04,930,13,1322383573,1322383573,1,2,0
22316898@N07,931,7,1397779524,1397783342,3,1,3818
22316898@N07,932,7,1414801814,1414801814,1,1,0
22326950@N05,933,11,1199130486,1199130486,1,1,0
22326950@N05,934,3,1217656104,1217656436,14,1,332
22326950@N05,935,9,1217759349,1217759436,3,2,87
22326950@N05,935,11,1217759153,1217759153,1,2,0
22326950@N05,936,13,1217987856,1217988107,2,1,251
22351148@N02,937,9,1205995505,1205996743,2,1,1238
22375931@N03,938,10,1298587350,1298587539,3,1,189
22404194@N03,939,11,1370922425,1370922425,1,1,0
22423587@N03,940,8,1284811131,1284811131,1,1,0
22423587@N03,941,8,1297504459,1297504459,1,2,0
22423587@N03,941,3,1297501928,1297501928,1,2,0
22423587@N03,942,11,1299220996,1299220996,1,2,0
22423587@N03,942,17,1299221806,1299221806,1,2,0
22423587@N03,943,11,1301026997,1301026997,1,1,0
22423587@N03,944,1,1308468044,1308468044,1,1,0
22423587@N03,945,6,1319879649,1319879649,1,1,0
22423587@N03,946,15,1323503064,1323503064,1,1,0
22423587@N03,947,8,1323576424,1323576424,1,1,0
22423587@N03,948,13,1324785035,1324785035,1,1,0
22423587@N03,949,1,1412392173,1412392173,1,1,0
22446827@N02,950,11,1401152416,1401152416,1,1,0
22446827@N02,951,5,1401185103,1401185103,2,1,0
22462637@N00,952,11,1301636752,1301636752,1,1,0
22474934@N00,953,11,1382530175,1382530305,8,2,130
22474934@N00,953,5,1382521214,1382521246,4,2,32
22496843@N03,954,13,1207906506,1207906839,2,2,333
22496843@N03,954,1,1207890107,1207891039,4,2,932
22500161@N06,955,11,1332455321,1332455321,1,1,0
22575554@N05,956,13,1378788354,1378788354,1,1,0
22575554@N05,957,11,1410385710,1410385710,1,1,0
22585033@N00,958,11,1371768119,1371768119,1,1,0
22602665@N02,959,11,1358191083,1358220398,11,1,29315
22602665@N02,960,11,1358283502,1358311493,50,1,27991
22616926@N08,961,13,1198724752,1198724752,1,1,0
22618933@N08,962,16,1309842993,1309842993,1,1,0
22629506@N00,963,10,1222395227,1222403001,4,1,7774
22629506@N00,964,10,1222479665,1222479665,1,1,0
22659528@N06,965,2,1347412787,1347412787,1,2,0
22659528@N06,965,11,1347421712,1347437574,2,2,15862
22659528@N06,966,2,1348041637,1348041637,1,2,0
22659528@N06,966,11,1348054342,1348054342,1,2,0
22659528@N06,967,11,1348297411,1348297411,1,1,0
22659528@N06,968,2,1348397172,1348397172,1,1,0
22659528@N06,969,11,1402272824,1402272824,1,1,0
22659528@N06,970,13,1402479440,1402479440,1,1,0
22659528@N06,971,9,1403747105,1403747194,2,1,89
22659528@N06,972,13,1403865188,1403865188,1,1,0
22659528@N06,973,13,1404720538,1404720538,1,1,0
22659528@N06,974,13,1405246240,1405246240,1,2,0
22659528@N06,974,5,1405248283,1405248283,1,2,0
22659528@N06,975,4,1405760271,1405760271,1,1,0
22659528@N06,976,11,1407049645,1407049905,4,1,260
22659528@N06,977,11,1407209256,1407209256,1,1,0
22659528@N06,978,11,1407479421,1407483167,3,1,3746
22659528@N06,979,11,1409471582,1409471582,1,1,0
22687691@N02,980,10,1194244960,1194244960,1,1,0
22687691@N02,981,1,1209039696,1209040208,2,1,512
22687691@N02,982,16,1213011114,1213011114,1,1,0
22687691@N02,983,8,1225521498,1225521534,3,4,36
22687691@N02,983,16,1225517779,1225517779,1,4,0
22687691@N02,983,11,1225512006,1225513183,3,4,1177
22687691@N02,983,12,1225531349,1225531826,2,4,477
22687691@N02,984,11,1225846633,1225846633,1,1,0
22720103@N06,985,11,1346150611,1346150611,1,1,0
22720103@N06,986,8,1349010283,1349010284,3,1,1
22741934@N04,987,8,1347182018,1347187490,4,1,5472
22772553@N05,988,4,1213093046,1213093046,1,1,0
22786107@N06,989,16,1206927990,1206928006,2,1,16
22791773@N07,990,11,1280011494,1280011494,1,3,0
22791773@N07,990,7,1280015311,1280015311,1,3,0
22791773@N07,990,10,1280027815,1280027815,1,3,0
22802028@N08,991,4,1209729839,1209729839,1,3,0
22802028@N08,991,11,1209733017,1209733402,5,3,385
22802028@N08,991,2,1209725055,1209725064,2,3,9
22802028@N08,992,15,1209884680,1209887731,3,1,3051
22802028@N08,993,5,1209970862,1209974266,6,3,3404
22802028@N08,993,1,1209968096,1209968096,1,3,0
22802028@N08,993,11,1209960915,1209961144,3,3,229
22810906@N06,994,11,1324734341,1324734341,1,1,0
22854594@N07,995,11,1380162425,1380162425,1,2,0
22854594@N07,995,5,1380183302,1380183380,2,2,78
22866792@N00,996,17,1291612145,1291612145,1,5,0
22866792@N00,996,8,1291592318,1291592318,1,5,0
22866792@N00,996,5,1291590060,1291590427,5,5,367
22866792@N00,996,10,1291612347,1291612347,1,5,0
22866792@N00,996,13,1291610960,1291611297,2,5,337
22866792@N00,997,11,1291685430,1291699065,3,4,13635
22866792@N00,997,4,1291702990,1291702990,1,4,0
22866792@N00,997,12,1291690482,1291696548,2,4,6066
22866792@N00,997,2,1291696066,1291696092,2,4,26
22925214@N04,998,3,1419908713,1419908713,1,1,0
22937808@N04,999,10,1368226985,1368226985,1,1,0
22937808@N04,1000,8,1430826630,1430826630,1,2,0
22937808@N04,1000,11,1430829360,1430829360,1,2,0
22937808@N04,1001,11,1430962164,1430962164,1,1,0
22937808@N04,1002,11,1431002057,1431002057,1,1,0
22937808@N04,1003,8,1462265196,1462265196,1,1,0
22966062@N04,1004,15,1198562772,1198562775,2,2,3
22966062@N04,1004,11,1198547602,1198547609,2,2,7
22969152@N05,1005,11,1389579970,1389579970,1,1,0
23012921@N08,1006,11,1323837067,1323837067,1,1,0
23025449@N05,1007,8,1255837383,1255837383,1,3,0
23025449@N05,1007,17,1255861665,1255861665,1,3,0
23025449@N05,1007,11,1255821076,1255821076,1,3,0
23028801@N03,1008,8,1348912800,1348912800,1,2,0
23028801@N03,1008,11,1348898318,1348899937,2,2,1619
23028801@N03,1009,11,1349591631,1349591631,1,2,0
23028801@N03,1009,4,1349594474,1349598403,5,2,3929
23036992@N08,1010,11,1264926197,1264926197,1,3,0
23036992@N08,1010,13,1264927726,1264927726,1,3,0
23036992@N08,1010,10,1264928093,1264928306,3,3,213
23036992@N08,1011,10,1265159526,1265159526,1,2,0
23036992@N08,1011,9,1265155500,1265155500,1,2,0
23043254@N03,1012,17,1208062114,1208062114,1,2,0
23043254@N03,1012,9,1208048719,1208048719,1,2,0
23071450@N02,1013,10,1287962810,1287962810,1,1,0
23074913@N00,1014,5,1338431115,1338431115,1,1,0
23108813@N00,1015,16,1226230628,1226230628,1,2,0
23108813@N00,1015,2,1226226752,1226226755,2,2,3
23108813@N00,1016,14,1237680628,1237680628,1,1,0
23108813@N00,1017,14,1256634452,1256634452,1,1,0
23108813@N00,1018,17,1286600988,1286600988,1,1,0
23108813@N00,1019,10,1287020401,1287020401,1,1,0
23108813@N00,1020,5,1288322746,1288322746,1,1,0
23108813@N00,1021,17,1288925793,1288925793,1,1,0
23108813@N00,1022,12,1290834872,1290834872,1,1,0
23108813@N00,1023,11,1296812989,1296812989,1,1,0
23108813@N00,1024,14,1302919381,1302919381,1,1,0
23108813@N00,1025,11,1305241416,1305241416,1,1,0
23108813@N00,1026,9,1305959577,1305959577,1,1,0
23108813@N00,1027,11,1337312950,1337312950,1,1,0
23108813@N00,1028,11,1349571153,1349571153,1,1,0
23108813@N00,1029,1,1354695709,1354695709,1,1,0
23108813@N00,1030,11,1375851879,1375851879,1,1,0
23108813@N00,1031,17,1383364881,1383364881,1,1,0
23108813@N00,1032,7,1390007715,1390007715,1,1,0
23108813@N00,1033,13,1398940682,1398940682,1,1,0
23108813@N00,1034,4,1417771457,1417771457,1,1,0
23108813@N00,1035,4,1432503631,1432503631,1,1,0
23108813@N00,1036,6,1447310493,1447310493,1,1,0
23108813@N00,1037,11,1451115613,1451115613,1,1,0
23108813@N00,1038,11,1459247949,1459247949,1,1,0
23108813@N00,1039,11,1462848534,1462848534,1,1,0
23108813@N00,1040,17,1463116584,1463116584,1,1,0
23117061@N05,1041,8,1331373509,1331373509,2,1,0
23126267@N02,1042,3,1411100441,1411100441,1,1,0
23172783@N07,1043,15,1343377424,1343377424,1,2,0
23172783@N07,1043,13,1343377610,1343377610,1,2,0
23172783@N07,1044,15,1344131345,1344131461,2,1,116
23172783@N07,1045,11,1376042094,1376042094,1,3,0
23172783@N07,1045,5,1376046757,1376046757,1,3,0
23172783@N07,1045,3,1376044159,1376044159,1,3,0
23198304@N02,1046,13,1193276242,1193276242,1,1,0
23205379@N02,1047,11,1400973202,1401010141,2,3,36939
23205379@N02,1047,17,1400996196,1400996196,1,3,0
23205379@N02,1047,13,1400988603,1401001904,3,3,13301
23205379@N02,1048,13,1408850804,1408850804,1,1,0
23207003@N05,1049,15,1464322959,1464322959,1,7,0
23207003@N05,1049,11,1464312675,1464312751,4,7,76
23207003@N05,1049,1,1464333666,1464333666,1,7,0
23207003@N05,1049,10,1464317134,1464322495,4,7,5361
23207003@N05,1049,8,1464326303,1464329325,6,7,3022
23207003@N05,1049,13,1464323102,1464323180,2,7,78
23207003@N05,1049,17,1464317246,1464317488,5,7,242
23209784@N00,1050,5,1439094661,1439094661,1,1,0
23212779@N04,1051,11,1287908124,1287908124,1,2,0
23212779@N04,1051,3,1287904317,1287904317,1,2,0
23212779@N04,1052,4,1291782197,1291782197,1,1,0
23212779@N04,1053,4,1299055399,1299055399,1,3,0
23212779@N04,1053,11,1299059712,1299059930,2,3,218
23212779@N04,1053,8,1299057829,1299057829,1,3,0
23212779@N04,1054,1,1299125539,1299125539,1,1,0
23212779@N04,1055,11,1300712798,1300712798,1,1,0
23212779@N04,1056,11,1308666977,1308666977,1,1,0
23212779@N04,1057,4,1318564859,1318564859,1,1,0
23212779@N04,1058,11,1348946092,1348946092,1,1,0
23212779@N04,1059,8,1348996136,1348996136,1,1,0
23212779@N04,1060,12,1349043284,1349043284,1,1,0
23237004@N06,1061,6,1351311642,1351311642,1,1,0
23288611@N00,1062,8,1232249525,1232260403,2,1,10878
23304890@N00,1063,8,1283657799,1283657799,1,1,0
23319775@N04,1064,11,1394706939,1394706939,1,5,0
23319775@N04,1064,15,1394712492,1394712492,1,5,0
23319775@N04,1064,13,1394713545,1394713545,1,5,0
23319775@N04,1064,4,1394710640,1394710640,1,5,0
23319775@N04,1064,8,1394728018,1394728018,1,5,0
23322134@N02,1065,8,1192836526,1192836526,1,1,0
23322134@N02,1066,11,1201400770,1201400770,1,4,0
23322134@N02,1066,5,1201403182,1201403182,1,4,0
23322134@N02,1066,4,1201407705,1201407705,1,4,0
23322134@N02,1066,1,1201406170,1201406170,1,4,0
23322134@N02,1067,11,1213955010,1213955010,1,2,0
23322134@N02,1067,15,1213950896,1213950896,1,2,0
23322134@N02,1068,13,1226745095,1226745095,1,12,0
23322134@N02,1068,11,1226724325,1226746902,3,12,22577
23322134@N02,1068,5,1226737673,1226737673,1,12,0
23322134@N02,1068,10,1226745572,1226745572,1,12,0
23322134@N02,1068,3,1226700368,1226700368,1,12,0
23322134@N02,1068,14,1226705793,1226705793,1,12,0
23322134@N02,1068,4,1226740679,1226740679,1,12,0
23322134@N02,1068,2,1226702476,1226702476,1,12,0
23322134@N02,1068,8,1226736051,1226736051,1,12,0
23322134@N02,1068,16,1226739296,1226739296,1,12,0
23322134@N02,1068,9,1226738845,1226739069,2,12,224
23322134@N02,1068,12,1226702930,1226702930,1,12,0
23322134@N02,1069,11,1245395158,1245395158,1,5,0
23322134@N02,1069,5,1245403158,1245404988,2,5,1830
23322134@N02,1069,4,1245382480,1245383591,2,5,1111
23322134@N02,1069,2,1245394690,1245394690,1,5,0
23322134@N02,1069,1,1245394748,1245408477,2,5,13729
23322134@N02,1070,16,1254442884,1254442884,1,3,0
23322134@N02,1070,9,1254440962,1254440962,1,3,0
23322134@N02,1070,10,1254437904,1254437904,1,3,0
23322134@N02,1071,11,1254474380,1254474380,1,1,0
23322134@N02,1072,17,1254523475,1254523475,1,5,0
23322134@N02,1072,10,1254523777,1254523777,1,5,0
23322134@N02,1072,2,1254527867,1254527867,1,5,0
23322134@N02,1072,16,1254530168,1254530603,2,5,435
23322134@N02,1072,15,1254523014,1254523014,1,5,0
23322134@N02,1073,5,1254572439,1254572439,1,2,0
23322134@N02,1073,8,1254571614,1254571614,1,2,0
23322134@N02,1074,17,1267614227,1267614227,1,4,0
23322134@N02,1074,13,1267601822,1267601822,1,4,0
23322134@N02,1074,10,1267614600,1267614600,1,4,0
23322134@N02,1074,15,1267613563,1267613563,1,4,0
23322134@N02,1075,13,1267783242,1267787480,2,5,4238
23322134@N02,1075,11,1267792395,1267792728,2,5,333
23322134@N02,1075,4,1267743117,1267743117,1,5,0
23322134@N02,1075,1,1267791442,1267791442,1,5,0
23322134@N02,1075,8,1267755188,1267757930,2,5,2742
23322134@N02,1076,5,1273364686,1273364686,1,3,0
23322134@N02,1076,4,1273382441,1273382441,1,3,0
23322134@N02,1076,11,1273358852,1273358852,1,3,0
23322134@N02,1077,5,1287103909,1287103909,1,1,0
23322134@N02,1078,17,1291504430,1291504514,2,1,84
23322134@N02,1079,11,1291594176,1291612075,2,3,17899
23322134@N02,1079,2,1291588966,1291591168,3,3,2202
23322134@N02,1079,8,1291596849,1291615849,3,3,19000
23322134@N02,1080,8,1301384369,1301384369,1,1,0
23322134@N02,1081,11,1310365073,1310365073,1,1,0
23322134@N02,1082,11,1331154092,1331154092,1,1,0
23322134@N02,1083,11,1331203131,1331203131,1,1,0
23385595@N07,1084,11,1331078712,1331083158,19,1,4446
23400884@N07,1085,5,1237416064,1237416064,1,1,0
23400894@N08,1086,11,1419419050,1419419050,1,1,0
23429318@N00,1087,5,1317513681,1317513681,1,3,0
23429318@N00,1087,8,1317506198,1317511565,2,3,5367
23429318@N00,1087,17,1317502884,1317502884,1,3,0
23531496@N02,1088,8,1291012861,1291012861,1,1,0
23567711@N06,1089,11,1368086457,1368086457,1,1,0
23573205@N05,1090,11,1279160532,1279162388,3,4,1856
23573205@N05,1090,14,1279153356,1279155383,8,4,2027
23573205@N05,1090,2,1279168240,1279168470,3,4,230
23573205@N05,1090,3,1279159066,1279159430,16,4,364
23604805@N07,1091,5,1300330268,1300330268,1,4,0
23604805@N07,1091,17,1300322934,1300325345,2,4,2411
23604805@N07,1091,8,1300332920,1300332920,1,4,0
23604805@N07,1091,10,1300326331,1300326331,1,4,0
23604805@N07,1092,5,1331946662,1331946662,1,3,0
23604805@N07,1092,17,1331942963,1331942963,1,3,0
23604805@N07,1092,11,1331940452,1331940452,1,3,0
23621391@N00,1093,8,1212714542,1212714721,2,1,179
23673310@N02,1094,12,1200271572,1200275470,19,4,3898
23673310@N02,1094,8,1200290637,1200291846,3,4,1209
23673310@N02,1094,5,1200288879,1200289551,15,4,672
23673310@N02,1094,11,1200278478,1200279323,14,4,845
23673310@N02,1095,13,1200466501,1200466501,1,2,0
23673310@N02,1095,10,1200463235,1200465195,2,2,1960
23673310@N02,1096,15,1202113188,1202113188,1,1,0
23673310@N02,1097,4,1209286481,1209286503,2,1,22
23673310@N02,1098,13,1213698327,1213698327,1,4,0
23673310@N02,1098,6,1213692057,1213701235,7,4,9178
23673310@N02,1098,1,1213706624,1213706624,1,4,0
23673310@N02,1098,16,1213685489,1213685489,1,4,0
23673310@N02,1099,12,1292023073,1292023073,1,2,0
23673310@N02,1099,14,1292020528,1292020528,1,2,0
23673310@N02,1100,6,1292059530,1292059561,2,2,31
23673310@N02,1100,17,1292056716,1292056771,2,2,55
23673310@N02,1101,5,1292740075,1292741252,10,6,1177
23673310@N02,1101,15,1292746689,1292746825,5,6,136
23673310@N02,1101,11,1292708846,1292743923,12,6,35077
23673310@N02,1101,10,1292750263,1292755640,7,6,5377
23673310@N02,1101,12,1292720092,1292720092,1,6,0
23673310@N02,1101,8,1292738119,1292738119,1,6,0
23673310@N02,1102,4,1304215521,1304215595,2,9,74
23673310@N02,1102,6,1304238546,1304238626,3,9,80
23673310@N02,1102,16,1304210517,1304210532,2,9,15
23673310@N02,1102,11,1304210700,1304219386,4,9,8686
23673310@N02,1102,12,1304213269,1304213269,1,9,0
23673310@N02,1102,13,1304243073,1304243150,4,9,77
23673310@N02,1102,5,1304234859,1304235005,3,9,146
23673310@N02,1102,17,1304245479,1304245485,2,9,6
23673310@N02,1102,8,1304236605,1304236605,1,9,0
23673310@N02,1103,16,1339291238,1339300595,4,3,9357
23673310@N02,1103,11,1339288137,1339289640,5,3,1503
23673310@N02,1103,12,1339285443,1339285471,2,3,28
23679036@N04,1104,11,1412389134,1412389134,1,1,0
23681262@N02,1105,11,1222431691,1222431691,1,1,0
23684642@N08,1106,17,1253067903,1253067903,1,2,0
23684642@N08,1106,4,1253063730,1253063730,1,2,0
23684642@N08,1107,11,1254398021,1254398021,1,1,0
23684642@N08,1108,17,1254566607,1254566607,1,1,0
23684642@N08,1109,17,1255428631,1255428631,1,2,0
23684642@N08,1109,11,1255427926,1255427926,1,2,0
23684642@N08,1110,15,1260936043,1260936043,1,4,0
23684642@N08,1110,13,1260938289,1260942920,3,4,4631
23684642@N08,1110,5,1260960396,1260960396,1,4,0
23684642@N08,1110,10,1260935341,1260935495,3,4,154
23684642@N08,1111,5,1261105886,1261105886,1,2,0
23684642@N08,1111,16,1261104490,1261104490,1,2,0
23684642@N08,1112,1,1264407145,1264407145,1,1,0
23684642@N08,1113,5,1271821380,1271821380,1,3,0
23684642@N08,1113,17,1271829431,1271829431,2,3,0
23684642@N08,1113,8,1271822017,1271822017,1,3,0
23684642@N08,1114,11,1272088987,1272097963,2,3,8976
23684642@N08,1114,5,1272093749,1272093749,1,3,0
23684642@N08,1114,8,1272092001,1272092001,1,3,0
23684642@N08,1115,3,1275532233,1275532244,2,1,11
23684642@N08,1116,6,1284770030,1284770030,1,1,0
23684642@N08,1117,13,1285060082,1285060082,1,2,0
23684642@N08,1117,5,1285070726,1285070726,1,2,0
23684642@N08,1118,10,1285237789,1285237789,1,2,0
23684642@N08,1118,17,1285231162,1285238554,12,2,7392
23684642@N08,1119,17,1288078166,1288078166,1,1,0
23693999@N05,1120,1,1224905921,1224905921,1,1,0
23693999@N05,1121,16,1224992283,1224992283,1,3,0
23693999@N05,1121,8,1224986855,1224986855,1,3,0
23693999@N05,1121,2,1224979053,1224979053,1,3,0
23693999@N05,1122,4,1243048722,1243048722,1,1,0
23693999@N05,1123,4,1346113033,1346113033,1,1,0
23693999@N05,1124,2,1346405137,1346405137,1,1,0
23693999@N05,1125,8,1346661970,1346661970,1,2,0
23693999@N05,1125,2,1346662152,1346662152,1,2,0
23701913@N04,1126,5,1442886108,1442886108,1,2,0
23701913@N04,1126,13,1442900355,1442901669,6,2,1314
23716112@N06,1127,10,1254140040,1254140040,1,1,0
23716112@N06,1128,13,1408400262,1408400262,1,5,0
23716112@N06,1128,4,1408383181,1408383181,1,5,0
23716112@N06,1128,17,1408400209,1408400209,1,5,0
23716112@N06,1128,3,1408383243,1408383243,1,5,0
23716112@N06,1128,1,1408383057,1408383057,1,5,0
23720661@N08,1129,3,1244421292,1244421292,1,4,0
23720661@N08,1129,4,1244423999,1244423999,1,4,0
23720661@N08,1129,11,1244419246,1244419455,3,4,209
23720661@N08,1129,8,1244428364,1244428502,2,4,138
23720661@N08,1130,16,1244598804,1244598804,1,1,0
23720661@N08,1131,1,1244884444,1244884444,1,2,0
23720661@N08,1131,9,1244871931,1244872399,2,2,468
23720661@N08,1132,6,1245055109,1245055109,1,5,0
23720661@N08,1132,10,1245048033,1245048423,6,5,390
23720661@N08,1132,17,1245049232,1245049232,1,5,0
23720661@N08,1132,4,1245040371,1245040371,1,5,0
23720661@N08,1132,13,1245050174,1245053367,2,5,3193
23720661@N08,1133,5,1245129473,1245129473,1,2,0
23720661@N08,1133,16,1245131645,1245131645,1,2,0
23720661@N08,1134,10,1262573601,1262573601,1,6,0
23720661@N08,1134,11,1262594921,1262596834,2,6,1913
23720661@N08,1134,5,1262586230,1262586230,1,6,0
23720661@N08,1134,9,1262584273,1262584273,2,6,0
23720661@N08,1134,16,1262580741,1262580765,2,6,24
23720661@N08,1134,4,1262590444,1262590444,1,6,0
23720661@N08,1135,11,1262828786,1262828786,1,3,0
23720661@N08,1135,8,1262832801,1262832801,1,3,0
23720661@N08,1135,5,1262830265,1262830265,1,3,0
23720661@N08,1136,10,1275024914,1275024914,1,3,0
23720661@N08,1136,4,1275030417,1275030417,1,3,0
23720661@N08,1136,17,1275024772,1275024772,1,3,0
23720661@N08,1137,5,1275101429,1275102159,2,4,730
23720661@N08,1137,8,1275100379,1275100379,1,4,0
23720661@N08,1137,13,1275095164,1275095164,1,4,0
23720661@N08,1137,1,1275103038,1275103038,1,4,0
23720661@N08,1138,17,1275354696,1275354696,1,3,0
23720661@N08,1138,15,1275354678,1275354678,1,3,0
23720661@N08,1138,3,1275374940,1275374940,1,3,0
23720661@N08,1139,10,1275540416,1275540416,1,1,0
23720661@N08,1140,5,1275735028,1275735028,1,4,0
23720661@N08,1140,4,1275729190,1275729190,1,4,0
23720661@N08,1140,3,1275727690,1275727690,1,4,0
23720661@N08,1140,11,1275724812,1275724812,1,4,0
23720661@N08,1141,5,1307002235,1307002238,2,3,3
23720661@N08,1141,10,1306993453,1306993709,4,3,256
23720661@N08,1141,11,1306991129,1307003980,4,3,12851
23720661@N08,1142,9,1307147170,1307147801,3,6,631
23720661@N08,1142,3,1307151046,1307151046,1,6,0
23720661@N08,1142,16,1307144373,1307144466,3,6,93
23720661@N08,1142,1,1307149347,1307155345,10,6,5998
23720661@N08,1142,14,1307151000,1307151000,1,6,0
23720661@N08,1142,11,1307143818,1307176682,7,6,32864
23720661@N08,1143,5,1307406209,1307407101,3,3,892
23720661@N08,1143,15,1307404332,1307404510,4,3,178
23720661@N08,1143,8,1307407336,1307408296,3,3,960
23720661@N08,1144,3,1330927176,1330927882,2,4,706
23720661@N08,1144,5,1330930422,1330930422,1,4,0
23720661@N08,1144,1,1330928442,1330928442,2,4,0
23720661@N08,1144,11,1330934132,1330935231,2,4,1099
23720661@N08,1145,9,1331166787,1331166787,1,7,0
23720661@N08,1145,3,1331175488,1331176381,6,7,893
23720661@N08,1145,16,1331166530,1331173911,14,7,7381
23720661@N08,1145,4,1331176841,1331176902,2,7,61
23720661@N08,1145,2,1331176740,1331178479,4,7,1739
23720661@N08,1145,1,1331181558,1331181822,2,7,264
23720661@N08,1145,11,1331164340,1331165100,7,7,760
23720661@N08,1146,17,1331341557,1331341557,1,5,0
23720661@N08,1146,13,1331348254,1331350226,5,5,1972
23720661@N08,1146,4,1331357193,1331357193,1,5,0
23720661@N08,1146,3,1331355464,1331355464,1,5,0
23720661@N08,1146,10,1331337324,1331347133,16,5,9809
23720661@N08,1147,9,1369300576,1369300576,1,4,0
23720661@N08,1147,3,1369296358,1369298768,4,4,2410
23720661@N08,1147,1,1369300864,1369300864,1,4,0
23720661@N08,1147,11,1369292688,1369302785,10,4,10097
23720661@N08,1148,17,1369366249,1369366249,1,7,0
23720661@N08,1148,5,1369374405,1369374842,3,7,437
23720661@N08,1148,13,1369366653,1369366663,2,7,10
23720661@N08,1148,1,1369374746,1369384050,3,7,9304
23720661@N08,1148,10,1369363919,1369366081,6,7,2162
23720661@N08,1148,16,1369384336,1369384336,1,7,0
23720661@N08,1148,11,1369360652,1369385196,6,7,24544
23720661@N08,1149,17,1369635188,1369635188,1,5,0
23720661@N08,1149,3,1369637935,1369637935,1,5,0
23720661@N08,1149,5,1369625484,1369625484,1,5,0
23720661@N08,1149,11,1369622285,1369624038,12,5,1753
23720661@N08,1149,8,1369628346,1369631799,4,5,3453
23720661@N08,1150,15,1369803795,1369806233,17,3,2438
23720661@N08,1150,17,1369808679,1369808690,2,3,11
23720661@N08,1150,5,1369808671,1369808671,1,3,0
23720661@N08,1151,9,1370062724,1370064708,5,4,1984
23720661@N08,1151,3,1370055134,1370055975,4,4,841
23720661@N08,1151,13,1370052888,1370053374,2,4,486
23720661@N08,1151,16,1370060190,1370064695,4,4,4505
23722651@N05,1152,11,1457331666,1457331666,1,1,0
23724661@N00,1153,10,1299365829,1299365829,1,1,0
23748789@N02,1154,6,1383376236,1383376236,1,1,0
23748789@N02,1155,10,1411643090,1411643090,1,1,0
23748789@N02,1156,8,1412065604,1412065604,1,1,0
23764040@N08,1157,11,1460260828,1460260828,1,1,0
23828731@N02,1158,11,1226284005,1226307395,2,3,23390
23828731@N02,1158,1,1226294721,1226294732,2,3,11
23828731@N02,1158,9,1226294687,1226294754,2,3,67
23828731@N02,1159,16,1340608874,1340608874,1,3,0
23828731@N02,1159,11,1340608845,1340608969,6,3,124
23828731@N02,1159,1,1340608878,1340608887,2,3,9
23828731@N02,1160,13,1349072773,1349072773,1,4,0
23828731@N02,1160,11,1349069127,1349069127,1,4,0
23828731@N02,1160,8,1349073471,1349073471,1,4,0
23828731@N02,1160,17,1349072624,1349072667,2,4,43
23828731@N02,1161,7,1367455529,1367455539,2,2,10
23828731@N02,1161,4,1367455487,1367455487,1,2,0
23828731@N02,1162,1,1367920694,1367920694,1,2,0
23828731@N02,1162,10,1367924738,1367924912,8,2,174
23833168@N04,1163,8,1222600114,1222604452,25,11,4338
23833168@N04,1163,1,1222580362,1222585121,2,11,4759
23833168@N04,1163,5,1222598325,1222600064,18,11,1739
23833168@N04,1163,10,1222606189,1222612700,10,11,6511
23833168@N04,1163,11,1222578677,1222583207,5,11,4530
23833168@N04,1163,9,1222580468,1222580468,1,11,0
23833168@N04,1163,16,1222580537,1222585667,4,11,5130
23833168@N04,1163,14,1222592813,1222603899,9,11,11086
23833168@N04,1163,13,1222602114,1222602114,1,11,0
23833168@N04,1163,4,1222598559,1222598612,2,11,53
23833168@N04,1163,6,1222602447,1222605969,5,11,3522
23833168@N04,1164,8,1223009065,1223009812,8,12,747
23833168@N04,1164,1,1223012143,1223012903,2,12,760
23833168@N04,1164,17,1223002036,1223002058,2,12,22
23833168@N04,1164,11,1222998880,1223017329,8,12,18449
23833168@N04,1164,9,1223013103,1223013130,2,12,27
23833168@N04,1164,2,1222999129,1223001472,4,12,2343
23833168@N04,1164,7,1223001548,1223001548,1,12,0
23833168@N04,1164,16,1223013841,1223013841,1,12,0
23833168@N04,1164,15,1223001945,1223001945,1,12,0
23833168@N04,1164,12,1222999429,1223001269,38,12,1840
23833168@N04,1164,13,1223002169,1223036435,2,12,34266
23833168@N04,1164,6,1223023011,1223024255,7,12,1244
23833168@N04,1165,17,1223270868,1223270874,3,3,6
23833168@N04,1165,15,1223271059,1223272210,9,3,1151
23833168@N04,1165,7,1223275629,1223276231,6,3,602
23833168@N04,1166,11,1354445582,1354459619,4,4,14037
23833168@N04,1166,2,1354446365,1354447464,20,4,1099
23833168@N04,1166,3,1354447697,1354448397,5,4,700
23833168@N04,1166,4,1354455093,1354457794,25,4,2701
23833168@N04,1167,5,1354949118,1354955275,35,2,6157
23833168@N04,1167,15,1354946593,1354946605,3,2,12
23833168@N04,1168,8,1355133393,1355133408,2,1,15
23833168@N04,1169,8,1355222141,1355222973,5,2,832
23833168@N04,1169,13,1355223928,1355224694,8,2,766
23833168@N04,1170,13,1355540495,1355540502,4,3,7
23833168@N04,1170,8,1355545237,1355546477,3,3,1240
23833168@N04,1170,5,1355544153,1355544153,1,3,0
23942903@N00,1171,11,1326429590,1326429590,1,1,0
23942903@N00,1172,15,1326780275,1326780275,1,4,0
23942903@N00,1172,11,1326789147,1326789147,1,4,0
23942903@N00,1172,13,1326780515,1326781535,4,4,1020
23942903@N00,1172,3,1326760698,1326762533,9,4,1835
23942903@N00,1173,16,1326944898,1326944898,1,1,0
23953488@N03,1174,1,1226648555,1226656233,2,1,7678
24021297@N00,1175,11,1338607025,1338607025,1,1,0
24021297@N00,1176,9,1343463899,1343463899,1,2,0
24021297@N00,1176,11,1343471972,1343474053,3,2,2081
24021297@N00,1177,15,1350357135,1350357135,1,1,0
24021297@N00,1178,1,1355545011,1355545011,1,4,0
24021297@N00,1178,4,1355545644,1355545644,1,4,0
24021297@N00,1178,17,1355542085,1355542085,1,4,0
24021297@N00,1178,11,1355542143,1355542143,1,4,0
24021297@N00,1179,1,1402227518,1402227518,1,1,0
24048284@N02,1180,11,1203846269,1203846314,24,1,45
24048284@N02,1181,11,1205141706,1205142777,11,6,1071
24048284@N02,1181,2,1205142574,1205142574,1,6,0
24048284@N02,1181,16,1205142247,1205142271,2,6,24
24048284@N02,1181,1,1205142110,1205142219,5,6,109
24048284@N02,1181,15,1205141801,1205141939,3,6,138
24048284@N02,1181,4,1205142668,1205142670,2,6,2
24083444@N03,1182,5,1299383243,1299383243,1,1,0
24143798@N08,1183,11,1193528995,1193528995,1,2,0
24143798@N08,1183,8,1193539378,1193539392,2,2,14
24143798@N08,1184,9,1207463364,1207463364,1,5,0
24143798@N08,1184,17,1207463410,1207463416,2,5,6
24143798@N08,1184,11,1207463433,1207463433,1,5,0
24143798@N08,1184,8,1207463392,1207463399,2,5,7
24143798@N08,1184,2,1207463422,1207463428,2,5,6
24143798@N08,1185,11,1320455022,1320471607,27,3,16585
24143798@N08,1185,8,1320458404,1320458440,3,3,36
24143798@N08,1185,13,1320465477,1320466413,13,3,936
24143798@N08,1186,11,1393649566,1393649566,1,1,0
24143798@N08,1187,13,1394852379,1394852379,1,1,0
24143798@N08,1188,17,1401105070,1401105070,1,1,0
24143798@N08,1189,10,1409982384,1409982384,1,3,0
24143798@N08,1189,11,1409980246,1410006771,15,3,26525
24143798@N08,1189,13,1410005615,1410005615,1,3,0
24143798@N08,1190,8,1422686726,1422686726,1,2,0
24143798@N08,1190,3,1422674600,1422674600,1,2,0
24166619@N05,1191,11,1199515290,1199515476,2,1,186
24201217@N08,1192,11,1371177586,1371177586,1,2,0
24201217@N08,1192,5,1371183143,1371183143,1,2,0
24230954@N06,1193,11,1265494579,1265494579,1,1,0
24230954@N06,1194,5,1265596088,1265596088,1,2,0
24230954@N06,1194,11,1265588794,1265588794,1,2,0
24230954@N06,1195,2,1266020451,1266020451,1,1,0
24232695@N00,1196,1,1325482025,1325482025,1,5,0
24232695@N00,1196,2,1325469599,1325469644,2,5,45
24232695@N00,1196,15,1325473196,1325474131,5,5,935
24232695@N00,1196,6,1325474611,1325475495,2,5,884
24232695@N00,1196,17,1325474506,1325474506,1,5,0
24276365@N03,1197,11,1387955308,1387955308,1,1,0
24301080@N07,1198,11,1198759940,1198759940,1,1,0
24332304@N08,1199,4,1265361008,1265361008,1,1,0
24345053@N06,1200,11,1290649312,1290649312,1,2,0
24345053@N06,1200,13,1290660423,1290660423,1,2,0
24364325@N00,1201,5,1462359131,1462359131,1,2,0
24364325@N00,1201,11,1462358231,1462358231,1,2,0
24364447@N05,1202,11,1438861284,1438861284,1,1,0
24364723@N08,1203,17,1349484589,1349484959,3,2,370
24364723@N08,1203,5,1349484227,1349484486,3,2,259
24364723@N08,1204,11,1382747203,1382768286,6,3,21083
24364723@N08,1204,5,1382771478,1382771478,1,3,0
24364723@N08,1204,13,1382770748,1382771325,2,3,577
24372063@N00,1205,11,1447404371,1447404466,2,1,95
24376530@N00,1206,13,1327884426,1327884426,1,2,0
24376530@N00,1206,17,1327881532,1327882628,2,2,1096
24386268@N05,1207,15,1204262746,1204262746,1,5,0
24386268@N05,1207,2,1204248491,1204253790,2,5,5299
24386268@N05,1207,11,1204247279,1204247555,2,5,276
24386268@N05,1207,17,1204255175,1204255175,1,5,0
24386268@N05,1207,4,1204253762,1204253762,1,5,0
24386374@N00,1208,11,1378626531,1378638688,6,1,12157
24386374@N00,1209,11,1378691877,1378724408,15,1,32531
24435279@N00,1210,11,1198900423,1198900430,2,3,7
24435279@N00,1210,12,1198912861,1198912861,1,3,0
24435279@N00,1210,16,1198935779,1198935779,1,3,0
24435279@N00,1211,8,1198995738,1198995827,10,1,89
24435279@N00,1212,10,1199071630,1199071630,1,1,0
24435279@N00,1213,11,1209017588,1209017600,3,2,12
24435279@N00,1213,5,1209005818,1209006592,5,2,774
24435279@N00,1214,11,1209105362,1209105887,5,3,525
24435279@N00,1214,1,1209082755,1209082759,2,3,4
24435279@N00,1214,5,1209095220,1209097695,45,3,2475
24435279@N00,1215,11,1224328833,1224329206,12,3,373
24435279@N00,1215,17,1224319070,1224319134,2,3,64
24435279@N00,1215,10,1224316348,1224316369,2,3,21
24435279@N00,1216,11,1224378201,1224398669,12,2,20468
24435279@N00,1216,8,1224395349,1224395475,4,2,126
24435279@N00,1217,15,1237001566,1237001689,5,1,123
24435279@N00,1218,14,1239430890,1239434262,11,1,3372
24435279@N00,1219,15,1241175954,1241176010,8,1,56
24436359@N07,1220,10,1308881034,1308881034,1,1,0
24471842@N04,1221,11,1304548776,1304549097,2,1,321
24481280@N03,1222,11,1235962886,1235976907,2,1,14021
24496852@N00,1223,13,1327989055,1327989055,1,1,0
24508806@N04,1224,8,1345144174,1345144174,1,1,0
24519194@N08,1225,11,1381184220,1381184220,1,1,0
24537422@N02,1226,17,1421057342,1421057358,6,1,16
24589316@N06,1227,13,1331871426,1331871426,1,4,0
24589316@N06,1227,9,1331862740,1331862740,1,4,0
24589316@N06,1227,15,1331868830,1331868830,1,4,0
24589316@N06,1227,16,1331862302,1331874956,4,4,12654
24616128@N00,1228,15,1285930611,1285930611,1,3,0
24616128@N00,1228,17,1285930817,1285930824,2,3,7
24616128@N00,1228,5,1285924128,1285924128,1,3,0
24616128@N00,1229,7,1285984825,1285987589,2,7,2764
24616128@N00,1229,12,1285978831,1285983606,31,7,4775
24616128@N00,1229,2,1285979718,1285979753,3,7,35
24616128@N00,1229,17,1285993507,1285993507,1,7,0
24616128@N00,1229,1,1285974631,1285975227,2,7,596
24616128@N00,1229,13,1285992830,1285992860,2,7,30
24616128@N00,1229,5,1286020129,1286020129,1,7,0
24616128@N00,1230,13,1286097009,1286097414,2,4,405
24616128@N00,1230,15,1286097643,1286098005,2,4,362
24616128@N00,1230,8,1286091872,1286095709,3,4,3837
24616128@N00,1230,17,1286098192,1286098192,1,4,0
24626151@N06,1231,11,1445665597,1445665597,1,1,0
24638406@N08,1232,10,1353036569,1353036569,1,2,0
24638406@N08,1232,8,1353030281,1353030281,1,2,0
24638406@N08,1233,15,1377404005,1377404005,1,1,0
24640659@N05,1234,2,1188363713,1188370577,3,5,6864
24640659@N05,1234,5,1188360520,1188360544,2,5,24
24640659@N05,1234,17,1188362919,1188363240,5,5,321
24640659@N05,1234,4,1188348831,1188348831,1,5,0
24640659@N05,1234,13,1188362469,1188362469,1,5,0
24675445@N00,1235,11,1352153382,1352153802,2,3,420
24675445@N00,1235,9,1352158705,1352158705,1,3,0
24675445@N00,1235,2,1352175523,1352175523,1,3,0
24704473@N07,1236,4,1189467566,1189468098,9,9,532
24704473@N07,1236,16,1189464206,1189476799,5,9,12593
24704473@N07,1236,15,1189496372,1189496372,1,9,0
24704473@N07,1236,7,1189464683,1189468265,6,9,3582
24704473@N07,1236,2,1189468354,1189469841,8,9,1487
24704473@N07,1236,11,1189480410,1189480410,1,9,0
24704473@N07,1236,9,1189472145,1189476294,6,9,4149
24704473@N07,1236,1,1189472413,1189472517,4,9,104
24704473@N07,1236,12,1189470176,1189471325,9,9,1149
24704473@N07,1237,8,1189757849,1189758626,11,8,777
24704473@N07,1237,16,1189752502,1189752663,3,8,161
24704473@N07,1237,9,1189747641,1189748979,8,8,1338
24704473@N07,1237,3,1189744545,1189744545,1,8,0
24704473@N07,1237,14,1189744253,1189744515,3,8,262
24704473@N07,1237,5,1189756384,1189757553,8,8,1169
24704473@N07,1237,1,1189746494,1189753557,6,8,7063
24704473@N07,1237,4,1189745018,1189754261,4,8,9243
24704473@N07,1238,10,1234080477,1234080477,1,1,0
24704473@N07,1239,16,1234426084,1234426084,1,1,0
24704473@N07,1240,11,1237615085,1237620670,7,6,5585
24704473@N07,1240,14,1237621978,1237621978,1,6,0
24704473@N07,1240,1,1237626636,1237629380,15,6,2744
24704473@N07,1240,16,1237629394,1237629394,1,6,0
24704473@N07,1240,3,1237621962,1237622119,8,6,157
24704473@N07,1240,9,1237629483,1237629546,2,6,63
24704473@N07,1241,2,1237845250,1237849678,16,14,4428
24704473@N07,1241,10,1237858879,1237876841,24,14,17962
24704473@N07,1241,13,1237869206,1237870461,13,14,1255
24704473@N07,1241,1,1237858213,1237886033,11,14,27820
24704473@N07,1241,12,1237846508,1237849345,17,14,2837
24704473@N07,1241,5,1237883897,1237884338,6,14,441
24704473@N07,1241,4,1237850761,1237855575,16,14,4814
24704473@N07,1241,8,1237880253,1237883002,57,14,2749
24704473@N07,1241,16,1237857543,1237857543,1,14,0
24704473@N07,1241,15,1237864397,1237867322,8,14,2925
24704473@N07,1241,3,1237855496,1237855496,1,14,0
24704473@N07,1241,17,1237861982,1237873241,7,14,11259
24704473@N07,1241,7,1237845116,1237857255,8,14,12139
24704473@N07,1241,9,1237886289,1237888791,6,14,2502
24704473@N07,1242,2,1238137617,1238137617,1,9,0
24704473@N07,1242,11,1238135183,1238156695,23,9,21512
24704473@N07,1242,10,1238149175,1238149324,2,9,149
24704473@N07,1242,5,1238154990,1238154990,1,9,0
24704473@N07,1242,4,1238145365,1238146391,8,9,1026
24704473@N07,1242,8,1238154565,1238154918,3,9,353
24704473@N07,1242,16,1238143119,1238143119,1,9,0
24704473@N07,1242,17,1238149380,1238150585,3,9,1205
24704473@N07,1242,9,1238140802,1238142389,8,9,1587
24738911@N08,1243,5,1218263687,1218263884,2,1,197
24738911@N08,1244,8,1223790712,1223790819,2,1,107
24738911@N08,1245,17,1239346742,1239346742,1,1,0
24738911@N08,1246,8,1310595850,1310595850,1,1,0
24738911@N08,1247,13,1315429428,1315429428,1,1,0
24745847@N00,1248,11,1362278822,1362278847,3,5,25
24745847@N00,1248,17,1362267888,1362272896,4,5,5008
24745847@N00,1248,3,1362275100,1362277282,4,5,2182
24745847@N00,1248,14,1362277505,1362277549,4,5,44
24745847@N00,1248,9,1362281581,1362281629,3,5,48
24767349@N02,1249,6,1207738830,1207738830,1,2,0
24767349@N02,1249,11,1207728728,1207728728,1,2,0
24793767@N00,1250,11,1358289613,1358289613,1,1,0
24793767@N00,1251,7,1358320230,1358320230,1,2,0
24793767@N00,1251,11,1358323382,1358323382,1,2,0
24834202@N03,1252,5,1216614587,1216614587,1,1,0
24834202@N03,1253,8,1245730240,1245730240,1,2,0
24834202@N03,1253,5,1245738134,1245738139,2,2,5
24834202@N03,1254,15,1245899784,1245899784,1,1,0
24850040@N07,1255,1,1245059592,1245059823,3,1,231
24850040@N07,1256,9,1245141857,1245141992,3,3,135
24850040@N07,1256,11,1245140650,1245140851,3,3,201
24850040@N07,1256,1,1245142480,1245142589,2,3,109
24850040@N07,1257,9,1249739789,1249739789,1,1,0
24872311@N07,1258,1,1317370876,1317370876,1,1,0
24889779@N03,1259,11,1253087563,1253087625,6,2,62
24889779@N03,1259,1,1253087570,1253087583,12,2,13
24889779@N03,1260,11,1254718801,1254725753,3,2,6952
24889779@N03,1260,9,1254724010,1254726250,3,2,2240
24889779@N03,1261,11,1254896982,1254896982,1,1,0
24897645@N04,1262,15,1212394450,1212394450,1,1,0
24897645@N04,1263,8,1215146660,1215146660,1,1,0
24897645@N04,1264,2,1217400139,1217400139,1,1,0
24942535@N08,1265,11,1437990531,1437990539,2,2,8
24942535@N08,1265,9,1437988207,1437988207,1,2,0
24942535@N08,1266,17,1438340331,1438341422,63,1,1091
24965986@N00,1267,9,1310280325,1310280325,1,1,0
25001998@N08,1268,3,1235010541,1235013349,17,1,2808
25027171@N08,1269,17,1399965309,1399976663,49,8,11354
25027171@N08,1269,3,1399942451,1399942603,5,8,152
25027171@N08,1269,8,1399950577,1399956165,39,8,5588
25027171@N08,1269,11,1399936956,1399981282,12,8,44326
25027171@N08,1269,15,1399965522,1399966240,33,8,718
25027171@N08,1269,10,1399973578,1399979883,57,8,6305
25027171@N08,1269,5,1399949488,1399949863,15,8,375
25027171@N08,1269,13,1399964341,1399964984,19,8,643
25027171@N08,1270,11,1400042408,1400067049,4,4,24641
25027171@N08,1270,13,1400060963,1400062201,38,4,1238
25027171@N08,1270,17,1400063416,1400065977,53,4,2561
25027171@N08,1270,3,1400043514,1400043519,2,4,5
25027171@N08,1271,10,1400132076,1400132631,5,2,555
25027171@N08,1271,17,1400133095,1400133115,3,2,20
25027171@N08,1272,11,1449304900,1449305220,13,6,320
25027171@N08,1272,10,1449301693,1449302618,14,6,925
25027171@N08,1272,2,1449278745,1449278752,2,6,7
25027171@N08,1272,14,1449280708,1449280710,3,6,2
25027171@N08,1272,17,1449295803,1449301902,17,6,6099
25027171@N08,1272,3,1449280895,1449281019,3,6,124
25027171@N08,1273,15,1449377774,1449378076,3,3,302
25027171@N08,1273,5,1449367666,1449367666,1,3,0
25027171@N08,1273,4,1449377394,1449377591,4,3,197
25027171@N08,1274,8,1449904740,1449904773,5,5,33
25027171@N08,1274,11,1449887961,1449887961,1,5,0
25027171@N08,1274,15,1449892559,1449893060,5,5,501
25027171@N08,1274,10,1449891322,1449891329,3,5,7
25027171@N08,1274,17,1449891941,1449891941,1,5,0
25027171@N08,1275,8,1449955110,1449958591,12,7,3481
25027171@N08,1275,11,1449954246,1449954288,6,7,42
25027171@N08,1275,5,1449960778,1450001054,6,7,40276
25027171@N08,1275,17,1449973050,1449974973,10,7,1923
25027171@N08,1275,14,1449966483,1449966520,5,7,37
25027171@N08,1275,6,1449976625,1449976675,6,7,50
25027171@N08,1275,3,1449966452,1449987850,46,7,21398
25027171@N08,1276,17,1450873958,1450873958,1,1,0
25050086@N07,1277,11,1389332832,1389332832,1,1,0
25083094@N04,1278,13,1394942804,1394942804,1,2,0
25083094@N04,1278,15,1394941617,1394941617,1,2,0
25107556@N02,1279,11,1335576295,1335576295,1,1,0
25112704@N05,1280,11,1264718662,1264718969,2,1,307
25126729@N00,1281,15,1229051708,1229052153,2,4,445
25126729@N00,1281,17,1229052200,1229052200,1,4,0
25126729@N00,1281,2,1229070337,1229070337,1,4,0
25126729@N00,1281,8,1229060544,1229075324,3,4,14780
25126729@N00,1282,11,1276151545,1276151545,1,1,0
25126729@N00,1283,5,1276479331,1276479331,1,1,0
25126729@N00,1284,10,1276509058,1276510235,4,1,1177
25126729@N00,1285,9,1307253174,1307253174,1,2,0
25126729@N00,1285,16,1307254976,1307255073,3,2,97
25126729@N00,1286,10,1307411371,1307413526,3,5,2155
25126729@N00,1286,13,1307414377,1307414377,1,5,0
25126729@N00,1286,15,1307400993,1307400993,1,5,0
25126729@N00,1286,11,1307405718,1307405718,1,5,0
25126729@N00,1286,14,1307402917,1307402917,1,5,0
25126729@N00,1287,4,1307443709,1307445131,3,2,1422
25126729@N00,1287,2,1307446531,1307446531,1,2,0
25127614@N03,1288,13,1452732090,1452756183,3,1,24093
25138015@N03,1289,15,1330230090,1330230273,4,2,183
25138015@N03,1289,5,1330229972,1330229972,1,2,0
25138015@N03,1290,10,1335087865,1335091314,3,1,3449
25149550@N06,1291,15,1212280697,1212280715,2,2,18
25149550@N06,1291,13,1212272476,1212272491,2,2,15
25149550@N06,1292,1,1228089252,1228089415,2,1,163
25149550@N06,1293,17,1228194321,1228194321,1,2,0
25149550@N06,1293,13,1228193110,1228193151,5,2,41
25152546@N04,1294,13,1188857655,1188857655,1,4,0
25152546@N04,1294,10,1188857679,1188857679,1,4,0
25152546@N04,1294,1,1188857655,1188857655,1,4,0
25152546@N04,1294,11,1188857655,1188857655,1,4,0
25248468@N08,1295,13,1210923063,1210923186,2,1,123
25248468@N08,1296,17,1211114356,1211114356,1,2,0
25248468@N08,1296,13,1211114390,1211114417,2,2,27
25343363@N05,1297,10,1338364890,1338364890,1,1,0
25358521@N05,1298,11,1330075636,1330082495,2,1,6859
25360342@N02,1299,1,1395444354,1395444354,1,6,0
25360342@N02,1299,17,1395473450,1395473450,1,6,0
25360342@N02,1299,6,1395462149,1395462149,1,6,0
25360342@N02,1299,2,1395453074,1395455140,2,6,2066
25360342@N02,1299,11,1395472806,1395472806,1,6,0
25360342@N02,1299,3,1395440797,1395440797,1,6,0
25360342@N02,1300,11,1395822465,1395822853,3,4,388
25360342@N02,1300,17,1395815147,1395815147,1,4,0
25360342@N02,1300,10,1395815615,1395815855,2,4,240
25360342@N02,1300,16,1395818239,1395818239,1,4,0
25360342@N02,1301,11,1454621374,1454627843,7,5,6469
25360342@N02,1301,16,1454633405,1454633405,1,5,0
25360342@N02,1301,2,1454627821,1454628128,5,5,307
25360342@N02,1301,1,1454634897,1454634897,1,5,0
25360342@N02,1301,4,1454632475,1454632475,1,5,0
25360342@N02,1302,17,1454715872,1454715872,1,3,0
25360342@N02,1302,11,1454714851,1454714851,1,3,0
25360342@N02,1302,15,1454716217,1454716264,3,3,47
25361220@N07,1303,8,1269723981,1269723981,1,1,0
25373956@N06,1304,17,1229568296,1229568296,1,1,0
25382096@N05,1305,11,1462596695,1462620117,4,1,23422
25387061@N06,1306,8,1327022397,1327022528,2,1,131
25402555@N08,1307,11,1325731767,1325731767,1,1,0
25418288@N02,1308,16,1207538471,1207538471,1,1,0
25435542@N08,1309,1,1367896399,1367896399,1,1,0
25440549@N06,1310,13,1197508195,1197508195,1,2,0
25440549@N06,1310,8,1197511027,1197511027,1,2,0
25440549@N06,1311,1,1210638522,1210638522,1,1,0
25440549@N06,1312,6,1210762570,1210762570,1,2,0
25440549@N06,1312,8,1210760549,1210762815,2,2,2266
25440549@N06,1313,13,1231918227,1231918227,1,2,0
25440549@N06,1313,8,1231918629,1231918629,1,2,0
25440549@N06,1314,4,1232163475,1232163475,1,2,0
25440549@N06,1314,11,1232150712,1232150712,1,2,0
25440549@N06,1315,2,1257030751,1257030751,1,1,0
25455760@N02,1316,3,1374110319,1374110319,1,2,0
25455760@N02,1316,1,1374125223,1374125223,1,2,0
25515164@N04,1317,11,1402304869,1402304869,1,1,0
25543343@N02,1318,11,1284709493,1284709493,1,1,0
25548984@N06,1319,4,1190415088,1190415088,1,1,0
25548984@N06,1320,2,1210351753,1210351753,1,1,0
25548984@N06,1321,13,1221176594,1221176594,1,1,0
25548984@N06,1322,6,1228087281,1228087281,1,1,0
25555616@N02,1323,17,1317636630,1317636630,1,1,0
25564364@N07,1324,11,1214821869,1214821869,1,1,0
25585962@N06,1325,11,1412760890,1412761149,2,9,259
25585962@N06,1325,17,1412736810,1412736810,1,9,0
25585962@N06,1325,2,1412732219,1412732219,1,9,0
25585962@N06,1325,8,1412747286,1412747818,3,9,532
25585962@N06,1325,13,1412737756,1412737756,1,9,0
25585962@N06,1325,5,1412748720,1412749278,2,9,558
25585962@N06,1325,4,1412734359,1412761828,2,9,27469
25585962@N06,1325,10,1412735835,1412735835,1,9,0
25585962@N06,1325,1,1412731853,1412734262,2,9,2409
25601992@N00,1326,11,1412896241,1412896241,1,2,0
25601992@N00,1326,17,1412911202,1412911202,1,2,0
25627071@N00,1327,11,1312086041,1312104953,8,1,18912
25651350@N06,1328,6,1222425787,1222425787,1,2,0
25651350@N06,1328,13,1222425221,1222425221,1,2,0
25651350@N06,1329,8,1244168421,1244168706,4,1,285
25703511@N06,1330,2,1241412245,1241412376,5,5,131
25703511@N06,1330,8,1241419705,1241419800,2,5,95
25703511@N06,1330,11,1241403184,1241436749,16,5,33565
25703511@N06,1330,13,1241416713,1241417530,18,5,817
25703511@N06,1330,17,1241416177,1241416671,9,5,494
25737136@N06,1331,11,1307493946,1307493946,1,1,0
25772785@N00,1332,8,1420466012,1420466012,1,2,0
25772785@N00,1332,5,1420469635,1420469635,1,2,0
25839240@N08,1333,5,1354322339,1354322345,2,8,6
25839240@N08,1333,11,1354320928,1354320934,2,8,6
25839240@N08,1333,17,1354335135,1354335247,3,8,112
25839240@N08,1333,10,1354335541,1354335541,1,8,0
25839240@N08,1333,12,1354341277,1354341787,7,8,510
25839240@N08,1333,13,1354334419,1354334509,3,8,90
25839240@N08,1333,15,1354335139,1354335139,1,8,0
25839240@N08,1333,8,1354324431,1354345836,5,8,21405
25846522@N00,1334,5,1360223859,1360223859,1,1,0
25854008@N00,1335,11,1352521262,1352521262,1,1,0
25865463@N00,1336,2,1401088356,1401088356,1,1,0
25905065@N00,1337,6,1337146573,1337166589,13,5,20016
25905065@N00,1337,13,1337148734,1337149051,2,5,317
25905065@N00,1337,17,1337139541,1337139541,1,5,0
25905065@N00,1337,15,1337136423,1337143416,21,5,6993
25905065@N00,1337,8,1337143923,1337145907,2,5,1984
25958284@N04,1338,10,1454317500,1454317500,1,2,0
25958284@N04,1338,5,1454312633,1454312633,1,2,0
26094090@N00,1339,11,1345170683,1345170683,1,1,0
26127154@N00,1340,11,1322216172,1322216172,1,1,0
26143366@N00,1341,12,1205653324,1205653324,1,1,0
26143366@N00,1342,11,1205711169,1205711169,1,1,0
26176576@N07,1343,5,1444727512,1444727521,3,2,9
26176576@N07,1343,11,1444713779,1444713797,2,2,18
26211887@N07,1344,5,1223891175,1223891268,3,1,93
26211887@N07,1345,12,1224126149,1224126149,1,2,0
26211887@N07,1345,17,1224144470,1224144470,1,2,0
26211887@N07,1346,11,1224248365,1224248516,2,1,151
26236829@N00,1347,5,1291615763,1291615763,1,2,0
26236829@N00,1347,8,1291615794,1291615794,1,2,0
26236829@N00,1348,5,1295826139,1295826139,1,1,0
26247897@N03,1349,11,1197372138,1197372138,1,1,0
26247897@N03,1350,8,1232529551,1232529551,1,1,0
26284290@N05,1351,13,1221141602,1221141603,2,1,1
26284290@N05,1352,13,1253196000,1253196000,1,2,0
26284290@N05,1352,15,1253196001,1253196001,1,2,0
26284290@N05,1353,13,1285164000,1285164000,1,1,0
26284290@N05,1354,8,1285250400,1285250400,1,1,0
26284290@N05,1355,13,1305295201,1305295206,4,1,5
26284290@N05,1356,5,1321607420,1321607420,1,1,0
26302808@N07,1357,11,1263873621,1263873621,1,1,0
26302808@N07,1358,11,1263930842,1263941171,3,1,10329
26302808@N07,1359,11,1263973282,1263973282,1,1,0
26342127@N00,1360,11,1264377493,1264377500,2,1,7
26393454@N00,1361,2,1423103161,1423103161,1,2,0
26393454@N00,1361,17,1423109651,1423109651,1,2,0
26447682@N05,1362,11,1390167021,1390167021,1,1,0
26486487@N06,1363,15,1211247896,1211250084,4,8,2188
26486487@N06,1363,17,1211249660,1211249781,6,8,121
26486487@N06,1363,13,1211250171,1211250482,8,8,311
26486487@N06,1363,10,1211248155,1211248538,9,8,383
26486487@N06,1363,16,1211257410,1211257505,4,8,95
26486487@N06,1363,9,1211257319,1211258864,4,8,1545
26486487@N06,1363,1,1211257001,1211257098,2,8,97
26486487@N06,1363,4,1211259865,1211259865,1,8,0
26522673@N07,1364,1,1212480699,1212480699,1,1,0
26522673@N07,1365,2,1217920637,1217920637,1,3,0
26522673@N07,1365,1,1217931542,1217931542,1,3,0
26522673@N07,1365,9,1217931537,1217931537,1,3,0
26522673@N07,1366,4,1225586920,1225586920,1,1,0
26522673@N07,1367,2,1283241235,1283242740,5,8,1505
26522673@N07,1367,1,1283231357,1283231357,1,8,0
26522673@N07,1367,4,1283233091,1283236944,3,8,3853
26522673@N07,1367,16,1283231443,1283231443,1,8,0
26522673@N07,1367,11,1283227789,1283257064,5,8,29275
26522673@N07,1367,14,1283237596,1283240701,5,8,3105
26522673@N07,1367,10,1283243880,1283244100,3,8,220
26522673@N07,1367,15,1283244733,1283244830,2,8,97
26522673@N07,1368,5,1283564206,1283565640,8,10,1434
26522673@N07,1368,1,1283578244,1283579489,4,10,1245
26522673@N07,1368,16,1283579795,1283579795,1,10,0
26522673@N07,1368,9,1283578617,1283578783,4,10,166
26522673@N07,1368,17,1283575714,1283576467,2,10,753
26522673@N07,1368,13,1283573056,1283574763,3,10,1707
26522673@N07,1368,10,1283576552,1283576552,1,10,0
26522673@N07,1368,15,1283576397,1283576397,1,10,0
26522673@N07,1368,8,1283566380,1283569070,13,10,2690
26522673@N07,1368,11,1283561824,1283580274,4,10,18450
26522673@N07,1369,5,1346392106,1346395251,4,4,3145
26522673@N07,1369,8,1346402833,1346405614,5,4,2781
26522673@N07,1369,13,1346410969,1346410969,1,4,0
26522673@N07,1369,11,1346420184,1346420644,2,4,460
26522673@N07,1370,11,1346734190,1346734190,1,4,0
26522673@N07,1370,2,1346749396,1346749396,1,4,0
26522673@N07,1370,4,1346750384,1346751980,3,4,1596
26522673@N07,1370,13,1346756494,1346756494,1,4,0
26522673@N07,1371,11,1382488945,1382532650,3,5,43705
26522673@N07,1371,10,1382492008,1382493733,3,5,1725
26522673@N07,1371,4,1382519400,1382519828,2,5,428
26522673@N07,1371,8,1382513266,1382516402,5,5,3136
26522673@N07,1371,13,1382500409,1382500409,1,5,0
26531284@N02,1372,5,1320403581,1320403581,1,1,0
26531284@N02,1373,3,1351986304,1351986304,1,2,0
26531284@N02,1373,11,1351979568,1352005815,12,2,26247
26553713@N04,1374,11,1239963393,1239963393,1,1,0
26556494@N00,1375,11,1316427798,1316427798,1,1,0
26559120@N06,1376,11,1391173200,1391173200,1,1,0
26568149@N00,1377,11,1273875659,1273900940,17,1,25281
26573031@N05,1378,15,1465804109,1465804109,1,1,0
26603119@N00,1379,1,1367305159,1367316010,3,3,10851
26603119@N00,1379,2,1367301791,1367301791,1,3,0
26603119@N00,1379,5,1367296170,1367296170,1,3,0
26603119@N00,1380,2,1400319815,1400322629,2,1,2814
26603119@N00,1381,1,1463231218,1463231218,1,3,0
26603119@N00,1381,2,1463220720,1463220980,2,3,260
26603119@N00,1381,10,1463230463,1463230463,1,3,0
26616207@N00,1382,11,1209084918,1209085040,3,2,122
26616207@N00,1382,15,1209084922,1209084922,1,2,0
26616207@N00,1383,17,1328784026,1328784026,1,2,0
26616207@N00,1383,11,1328784026,1328784026,1,2,0
26633936@N03,1384,11,1400122531,1400122531,1,1,0
26652894@N06,1385,11,1195250004,1195250004,1,1,0
26652894@N06,1386,11,1199512669,1199512669,1,1,0
26660641@N02,1387,10,1344135422,1344135422,1,1,0
26670433@N07,1388,5,1233122117,1233122117,1,5,0
26670433@N07,1388,8,1233122477,1233122477,1,5,0
26670433@N07,1388,10,1233115890,1233115890,1,5,0
26670433@N07,1388,17,1233116049,1233116049,1,5,0
26670433@N07,1388,13,1233116634,1233117696,2,5,1062
26678134@N04,1389,11,1325037717,1325037717,1,2,0
26678134@N04,1389,5,1325057861,1325057861,1,2,0
26678134@N04,1390,11,1340015083,1340017623,2,2,2540
26678134@N04,1390,5,1340016221,1340016710,2,2,489
26678134@N04,1391,11,1340967626,1340967626,1,1,0
26678134@N04,1392,11,1347791610,1347791610,1,2,0
26678134@N04,1392,14,1347788081,1347788081,1,2,0
26678134@N04,1393,5,1350034177,1350034177,1,2,0
26678134@N04,1393,10,1350027736,1350027786,2,2,50
26678134@N04,1394,15,1351237708,1351237708,1,2,0
26678134@N04,1394,10,1351237396,1351237446,3,2,50
26678134@N04,1395,11,1354861636,1354861636,1,2,0
26678134@N04,1395,8,1354863463,1354863463,1,2,0
26678134@N04,1396,17,1356244295,1356244295,1,1,0
26678134@N04,1397,12,1358568728,1358568750,2,2,22
26678134@N04,1397,2,1358567974,1358568059,2,2,85
26678134@N04,1398,17,1360892788,1360892788,1,1,0
26678134@N04,1399,5,1364025340,1364026675,4,1,1335
26678134@N04,1400,15,1364631599,1364631599,1,1,0
26678134@N04,1401,1,1365145636,1365145636,1,4,0
26678134@N04,1401,11,1365144328,1365144328,1,4,0
26678134@N04,1401,7,1365147794,1365147794,1,4,0
26678134@N04,1401,4,1365147419,1365147632,5,4,213
26678134@N04,1402,8,1387442090,1387442090,1,1,0
26678134@N04,1403,11,1393657296,1393657296,1,1,0
26678134@N04,1404,10,1394186595,1394186595,1,3,0
26678134@N04,1404,1,1394181863,1394181863,1,3,0
26678134@N04,1404,4,1394180624,1394180624,1,3,0
26678134@N04,1405,3,1397017733,1397017733,1,3,0
26678134@N04,1405,1,1397012520,1397012704,3,3,184
26678134@N04,1405,11,1397025955,1397025955,1,3,0
26678134@N04,1406,17,1398238514,1398238514,1,2,0
26678134@N04,1406,7,1398234836,1398234836,1,2,0
26678134@N04,1407,3,1402627673,1402627673,1,3,0
26678134@N04,1407,5,1402633729,1402634334,2,3,605
26678134@N04,1407,2,1402629344,1402629919,6,3,575
26678134@N04,1408,5,1404373417,1404373417,1,2,0
26678134@N04,1408,11,1404372578,1404380247,2,2,7669
26678134@N04,1409,5,1407980023,1407980023,1,2,0
26678134@N04,1409,11,1407977974,1407977974,1,2,0
26678134@N04,1410,2,1408696926,1408696926,1,1,0
26678134@N04,1411,3,1410413652,1410413652,1,4,0
26678134@N04,1411,5,1410417066,1410417066,1,4,0
26678134@N04,1411,1,1410415038,1410415038,1,4,0
26678134@N04,1411,11,1410409248,1410409248,1,4,0
26678134@N04,1412,8,1412309151,1412325826,2,5,16675
26678134@N04,1412,14,1412315519,1412315519,1,5,0
26678134@N04,1412,3,1412313441,1412313441,1,5,0
26678134@N04,1412,5,1412308887,1412308887,1,5,0
26678134@N04,1412,11,1412306613,1412328528,2,5,21915
26678134@N04,1413,8,1412484725,1412485719,3,2,994
26678134@N04,1413,11,1412477229,1412501885,3,2,24656
26678134@N04,1414,11,1418196422,1418205392,2,1,8970
26678134@N04,1415,14,1423203464,1423203464,1,3,0
26678134@N04,1415,3,1423203662,1423203662,1,3,0
26678134@N04,1415,11,1423200677,1423200677,1,3,0
26678134@N04,1416,1,1423796449,1423796449,1,2,0
26678134@N04,1416,11,1423794404,1423797209,2,2,2805
26678134@N04,1417,8,1424416909,1424416909,1,5,0
26678134@N04,1417,3,1424423852,1424423852,1,5,0
26678134@N04,1417,14,1424423142,1424423142,1,5,0
26678134@N04,1417,5,1424416277,1424416277,2,5,0
26678134@N04,1417,11,1424424118,1424427768,2,5,3650
26678134@N04,1418,7,1425270325,1425270325,1,4,0
26678134@N04,1418,10,1425269762,1425269762,1,4,0
26678134@N04,1418,17,1425301156,1425301156,1,4,0
26678134@N04,1418,11,1425272993,1425272993,1,4,0
26678134@N04,1419,7,1426312020,1426312020,1,4,0
26678134@N04,1419,2,1426312632,1426313071,2,4,439
26678134@N04,1419,10,1426311279,1426311328,3,4,49
26678134@N04,1419,11,1426314843,1426314866,3,4,23
26678134@N04,1420,11,1426922581,1426922651,5,2,70
26678134@N04,1420,2,1426927369,1426927369,1,2,0
26678134@N04,1421,3,1427512244,1427515236,4,10,2992
26678134@N04,1421,10,1427529833,1427529950,2,10,117
26678134@N04,1421,17,1427532084,1427532084,1,10,0
26678134@N04,1421,5,1427527909,1427527918,2,10,9
26678134@N04,1421,1,1427528272,1427528272,1,10,0
26678134@N04,1421,11,1427511377,1427536751,6,10,25374
26678134@N04,1421,16,1427528438,1427528438,1,10,0
26678134@N04,1421,7,1427512287,1427512287,1,10,0
26678134@N04,1421,14,1427515009,1427515078,4,10,69
26678134@N04,1421,4,1427529029,1427529295,3,10,266
26678134@N04,1422,11,1430004954,1430030195,4,2,25241
26678134@N04,1422,16,1430026696,1430026696,1,2,0
26678134@N04,1423,11,1435446594,1435446685,3,1,91
26678134@N04,1424,11,1437259216,1437259618,2,2,402
26678134@N04,1424,8,1437257719,1437257719,1,2,0
26678134@N04,1425,5,1438237628,1438237628,1,1,0
26678134@N04,1426,3,1439539607,1439539607,1,4,0
26678134@N04,1426,5,1439528078,1439532196,2,4,4118
26678134@N04,1426,8,1439528555,1439544890,6,4,16335
26678134@N04,1426,14,1439539449,1439539449,1,4,0
26678134@N04,1427,14,1440638006,1440639971,11,1,1965
26678134@N04,1428,11,1440740741,1440740883,3,4,142
26678134@N04,1428,16,1440737578,1440737578,1,4,0
26678134@N04,1428,9,1440737407,1440737407,1,4,0
26678134@N04,1428,8,1440731422,1440731422,1,4,0
26678134@N04,1429,10,1441511297,1441511297,1,3,0
26678134@N04,1429,1,1441511696,1441511696,1,3,0
26678134@N04,1429,8,1441507334,1441507334,1,3,0
26678134@N04,1430,7,1441957094,1441957094,1,3,0
26678134@N04,1430,11,1441963399,1441963399,1,3,0
26678134@N04,1430,8,1441962285,1441962285,1,3,0
26678134@N04,1431,11,1443166568,1443166568,1,1,0
26678134@N04,1432,3,1443915535,1443915535,1,1,0
26678134@N04,1433,11,1444530940,1444530940,1,1,0
26678134@N04,1434,11,1446803045,1446803267,2,1,222
26678134@N04,1435,10,1448603102,1448603102,1,4,0
26678134@N04,1435,17,1448602781,1448602781,1,4,0
26678134@N04,1435,11,1448604439,1448604439,1,4,0
26678134@N04,1435,9,1448603617,1448603663,2,4,46
26678134@N04,1436,8,1451191488,1451191566,2,4,78
26678134@N04,1436,14,1451194922,1451194981,2,4,59
26678134@N04,1436,5,1451191781,1451191781,1,4,0
26678134@N04,1436,13,1451190308,1451190308,1,4,0
26678134@N04,1437,11,1451376556,1451376556,1,1,0
26678134@N04,1438,7,1451780011,1451780011,1,7,0
26678134@N04,1438,3,1451776921,1451776921,1,7,0
26678134@N04,1438,10,1451782351,1451782541,4,7,190
26678134@N04,1438,17,1451782782,1451782782,1,7,0
26678134@N04,1438,11,1451786402,1451786402,1,7,0
26678134@N04,1438,13,1451783029,1451783273,5,7,244
26678134@N04,1438,5,1451785301,1451785301,1,7,0
26678134@N04,1439,7,1452997003,1452997003,1,3,0
26678134@N04,1439,14,1452999757,1452999757,1,3,0
26678134@N04,1439,11,1452996498,1453002558,3,3,6060
26678134@N04,1440,11,1456031767,1456031767,1,2,0
26678134@N04,1440,14,1456028816,1456028816,1,2,0
26678134@N04,1441,11,1456795019,1456795019,1,2,0
26678134@N04,1441,8,1456793622,1456793622,1,2,0
26678134@N04,1442,3,1457235023,1457235023,1,1,0
26678134@N04,1443,11,1458282746,1458282762,2,2,16
26678134@N04,1443,3,1458283557,1458283557,1,2,0
26678134@N04,1444,11,1460174098,1460174139,2,2,41
26678134@N04,1444,7,1460175187,1460175187,1,2,0
26678134@N04,1445,10,1463124668,1463127813,2,1,3145
26680632@N04,1446,8,1276150410,1276150410,1,5,0
26680632@N04,1446,13,1276153219,1276153219,1,5,0
26680632@N04,1446,15,1276151300,1276151300,1,5,0
26680632@N04,1446,11,1276128873,1276128873,1,5,0
26680632@N04,1446,17,1276139388,1276139388,1,5,0
26686716@N02,1447,9,1211028581,1211028581,1,6,0
26686716@N02,1447,16,1211028482,1211045542,3,6,17060
26686716@N02,1447,8,1211031882,1211031882,1,6,0
26686716@N02,1447,15,1211036090,1211036668,4,6,578
26686716@N02,1447,4,1211026218,1211026218,1,6,0
26686716@N02,1447,12,1211024957,1211024957,1,6,0
26686716@N02,1448,16,1211471279,1211471303,2,1,24
26695377@N00,1449,11,1330098173,1330101152,3,1,2979
26750032@N03,1450,5,1205999626,1205999626,1,1,0
26847486@N05,1451,11,1377173375,1377173375,1,1,0
26859501@N00,1452,10,1281306823,1281306823,1,1,0
26874770@N06,1453,2,1188003031,1188003031,1,9,0
26874770@N06,1453,3,1187996893,1187996893,1,9,0
26874770@N06,1453,16,1188005723,1188007996,2,9,2273
26874770@N06,1453,8,1188014608,1188015036,2,9,428
26874770@N06,1453,11,1188017590,1188017590,1,9,0
26874770@N06,1453,5,1188013038,1188013038,1,9,0
26874770@N06,1453,9,1187999734,1187999734,1,9,0
26874770@N06,1453,1,1187998203,1188007591,2,9,9388
26874770@N06,1453,13,1188030144,1188030144,1,9,0
26874770@N06,1454,3,1191543189,1191543189,1,3,0
26874770@N06,1454,11,1191561725,1191591150,2,3,29425
26874770@N06,1454,4,1191579895,1191579895,1,3,0
26874770@N06,1455,11,1197274457,1197274457,1,2,0
26874770@N06,1455,6,1197272138,1197272138,1,2,0
26874770@N06,1456,11,1197339937,1197339972,2,1,35
26874770@N06,1457,16,1198906997,1198906997,1,4,0
26874770@N06,1457,15,1198901094,1198901094,1,4,0
26874770@N06,1457,11,1198905813,1198905829,2,4,16
26874770@N06,1457,6,1198915208,1198915208,1,4,0
26874770@N06,1458,10,1199108159,1199108159,1,3,0
26874770@N06,1458,11,1199088463,1199088463,1,3,0
26874770@N06,1458,4,1199076977,1199076977,1,3,0
26874770@N06,1459,11,1199174819,1199174819,1,1,0
26874770@N06,1460,8,1225790982,1225790982,1,2,0
26874770@N06,1460,6,1225790768,1225790768,1,2,0
26874770@N06,1461,11,1228732215,1228732215,1,1,0
26874770@N06,1462,11,1230540785,1230540785,1,1,0
26874770@N06,1463,11,1235867195,1235867195,1,1,0
26874770@N06,1464,8,1235896271,1235896271,1,1,0
26874770@N06,1465,15,1245488990,1245488990,1,5,0
26874770@N06,1465,11,1245492511,1245493796,2,5,1285
26874770@N06,1465,5,1245490021,1245490841,3,5,820
26874770@N06,1465,13,1245485518,1245487797,2,5,2279
26874770@N06,1465,4,1245484333,1245484333,1,5,0
26874770@N06,1466,11,1281845970,1281845970,1,1,0
26893219@N07,1467,6,1213008517,1213008738,2,4,221
26893219@N07,1467,9,1213001056,1213001364,4,4,308
26893219@N07,1467,8,1213011181,1213011181,1,4,0
26893219@N07,1467,17,1213005583,1213005583,1,4,0
26893219@N07,1468,13,1213092079,1213092236,3,1,157
26893219@N07,1469,8,1213180731,1213181255,3,1,524
26893219@N07,1470,13,1213337780,1213346050,2,2,8270
26893219@N07,1470,15,1213336801,1213337331,3,2,530
26901589@N00,1471,11,1326799155,1326799155,1,1,0
26913230@N03,1472,11,1248071909,1248071909,1,1,0
26913230@N03,1473,11,1248324514,1248324514,1,1,0
26931534@N04,1474,17,1425122810,1425122810,1,1,0
27064297@N04,1475,13,1360124119,1360128264,4,2,4145
27064297@N04,1475,15,1360122137,1360122439,2,2,302
27124343@N00,1476,8,1220669811,1220671563,9,5,1752
27124343@N00,1476,11,1220653442,1220676709,11,5,23267
27124343@N00,1476,12,1220655920,1220657894,5,5,1974
27124343@N00,1476,14,1220660255,1220661566,4,5,1311
27124343@N00,1476,5,1220662903,1220662935,7,5,32
27174905@N03,1477,5,1336634910,1336634910,1,1,0
27174905@N03,1478,11,1338103684,1338103684,1,1,0
27193990@N00,1479,11,1364179343,1364179343,1,1,0
27233089@N04,1480,8,1251763740,1251763740,1,1,0
27270108@N05,1481,11,1243817983,1243817983,1,1,0
27270108@N05,1482,11,1244196136,1244196136,1,1,0
27270108@N05,1483,13,1275445309,1275445309,2,1,0
27270108@N05,1484,11,1306670617,1306670663,2,2,46
27270108@N05,1484,15,1306662726,1306662726,1,2,0
27270108@N05,1485,3,1306973353,1306973353,1,1,0
27270108@N05,1486,11,1307144409,1307144954,2,4,545
27270108@N05,1486,2,1307155732,1307155732,1,4,0
27270108@N05,1486,1,1307149199,1307149900,3,4,701
27270108@N05,1486,9,1307145664,1307145820,7,4,156
27270108@N05,1487,5,1339320765,1339320765,1,1,0
27270108@N05,1488,14,1339375720,1339375720,1,5,0
27270108@N05,1488,11,1339374242,1339374253,2,5,11
27270108@N05,1488,8,1339387723,1339389972,17,5,2249
27270108@N05,1488,4,1339380787,1339380787,1,5,0
27270108@N05,1488,5,1339384000,1339384000,1,5,0
27270108@N05,1489,13,1339645304,1339646223,4,6,919
27270108@N05,1489,17,1339642182,1339642277,3,6,95
27270108@N05,1489,11,1339628555,1339629827,2,6,1272
27270108@N05,1489,15,1339642883,1339647179,5,6,4296
27270108@N05,1489,9,1339632626,1339633302,2,6,676
27270108@N05,1489,16,1339632441,1339632441,1,6,0
27270108@N05,1490,15,1357021932,1357036247,12,5,14315
27270108@N05,1490,13,1357022328,1357022328,1,5,0
27270108@N05,1490,17,1357036742,1357036742,1,5,0
27270108@N05,1490,11,1357038081,1357038245,2,5,164
27270108@N05,1490,10,1357036941,1357036941,1,5,0
27270108@N05,1491,8,1370258076,1370258309,3,1,233
27270108@N05,1492,17,1434107426,1434107582,2,1,156
27312248@N04,1493,8,1203645460,1203645460,1,2,0
27312248@N04,1493,5,1203643822,1203644013,7,2,191
27314026@N06,1494,11,1276561845,1276561845,1,1,0
27316914@N02,1495,5,1194457740,1194458653,2,1,913
27338137@N06,1496,17,1242731452,1242731452,1,1,0
27338137@N06,1497,17,1242817631,1242817631,1,1,0
27372897@N00,1498,8,1353025729,1353025729,1,1,0
27373375@N03,1499,11,1443576434,1443595151,3,1,18717
27373375@N03,1500,11,1443714551,1443715712,2,1,1161
27429042@N08,1501,2,1191160800,1191160800,1,1,0
27429042@N08,1502,11,1212910480,1212910480,1,1,0
27429042@N08,1503,8,1219475748,1219475748,1,1,0
27429042@N08,1504,6,1227918856,1227918856,1,1,0
27429042@N08,1505,11,1231463372,1231463372,1,2,0
27429042@N08,1505,12,1231460461,1231460461,1,2,0
27429042@N08,1506,16,1231494600,1231494600,1,1,0
27429042@N08,1507,13,1231723997,1231724145,2,1,148
27429042@N08,1508,10,1232839170,1232839170,1,1,0
27429042@N08,1509,11,1261912052,1261912052,1,2,0
27429042@N08,1509,4,1261911862,1261911862,1,2,0
27429042@N08,1510,15,1265783664,1265783698,2,3,34
27429042@N08,1510,8,1265776841,1265776841,1,3,0
27429042@N08,1510,3,1265772185,1265772185,1,3,0
27429042@N08,1511,16,1268266269,1268266269,1,5,0
27429042@N08,1511,11,1268258152,1268258152,1,5,0
27429042@N08,1511,4,1268262293,1268281337,3,5,19044
27429042@N08,1511,5,1268274711,1268274711,1,5,0
27429042@N08,1511,2,1268260171,1268267101,2,5,6930
27429042@N08,1512,9,1268529405,1268529405,1,3,0
27429042@N08,1512,11,1268529760,1268529760,1,3,0
27429042@N08,1512,10,1268531759,1268531759,1,3,0
27429042@N08,1513,11,1277023969,1277023969,1,1,0
27429042@N08,1514,11,1292645573,1292645573,1,1,0
27429042@N08,1515,17,1292816527,1292816527,1,1,0
27429042@N08,1516,9,1293061420,1293061420,1,6,0
27429042@N08,1516,15,1293073261,1293073261,1,6,0
27429042@N08,1516,16,1293061738,1293061738,1,6,0
27429042@N08,1516,8,1293065721,1293066143,3,6,422
27429042@N08,1516,17,1293071813,1293071813,1,6,0
27429042@N08,1516,1,1293061342,1293061342,1,6,0
27429042@N08,1517,11,1300942321,1300951900,2,2,9579
27429042@N08,1517,2,1300934309,1300936309,3,2,2000
27429042@N08,1518,10,1301103263,1301103263,1,1,0
27429042@N08,1519,15,1321807435,1321807435,1,1,0
27429042@N08,1520,5,1324172822,1324172822,1,2,0
27429042@N08,1520,15,1324169431,1324169431,1,2,0
27429042@N08,1521,10,1331166979,1331166979,1,3,0
27429042@N08,1521,14,1331164285,1331164285,1,3,0
27429042@N08,1521,13,1331168802,1331168802,1,3,0
27457334@N02,1522,4,1333690222,1333690222,1,2,0
27457334@N02,1522,11,1333685533,1333685533,1,2,0
27472404@N02,1523,8,1286005544,1286005544,1,1,0
27511563@N06,1524,4,1202103664,1202103664,1,1,0
27527078@N05,1525,8,1360396494,1360396494,1,3,0
27527078@N05,1525,2,1360394441,1360394443,2,3,2
27527078@N05,1525,11,1360390613,1360390678,3,3,65
27539218@N06,1526,11,1207375568,1207375568,1,1,0
27539218@N06,1527,15,1208331225,1208331703,2,1,478
27539218@N06,1528,8,1209195972,1209196567,2,1,595
27539218@N06,1529,10,1212221513,1212227264,2,1,5751
27539218@N06,1530,15,1213241144,1213241144,1,1,0
27539218@N06,1531,8,1223348393,1223348522,2,1,129
27539218@N06,1532,5,1230352565,1230352565,1,1,0
27539218@N06,1533,6,1237620219,1237620219,1,1,0
27539218@N06,1534,13,1247544612,1247544831,6,6,219
27539218@N06,1534,8,1247549259,1247549780,6,6,521
27539218@N06,1534,10,1247543356,1247543534,2,6,178
27539218@N06,1534,5,1247550736,1247552504,6,6,1768
27539218@N06,1534,17,1247543942,1247543942,1,6,0
27539218@N06,1534,15,1247544000,1247544389,4,6,389
27539218@N06,1535,11,1248176620,1248176620,1,1,0
27539218@N06,1536,6,1254296311,1254305202,24,1,8891
27539218@N06,1537,12,1257068682,1257069633,10,1,951
27539218@N06,1538,11,1257297799,1257297799,1,2,0
27539218@N06,1538,5,1257300988,1257301365,4,2,377
27539218@N06,1539,5,1260852881,1260852881,1,1,0
27539218@N06,1540,8,1270278827,1270278827,1,1,0
27539218@N06,1541,11,1300509040,1300509040,1,1,0
27599409@N02,1542,11,1200270820,1200310359,22,1,39539
27599409@N02,1543,11,1200556964,1200556989,3,1,25
27601113@N06,1544,11,1373840506,1373840506,1,1,0
27734159@N00,1545,11,1290392350,1290392350,1,1,0
27746179@N05,1546,11,1358063891,1358063891,1,1,0
27810107@N08,1547,11,1232948087,1232959467,2,2,11380
27810107@N08,1547,1,1232949078,1232949134,2,2,56
27866187@N06,1548,13,1201671204,1201671204,1,1,0
27866187@N06,1549,17,1214111946,1214111952,2,1,6
27866187@N06,1550,17,1214202796,1214202796,1,2,0
27866187@N06,1550,10,1214201577,1214201577,1,2,0
27874898@N00,1551,12,1349737546,1349749335,191,1,11789
27874898@N00,1552,11,1349854373,1349858461,12,4,4088
27874898@N00,1552,17,1349852630,1349864967,30,4,12337
27874898@N00,1552,12,1349855358,1349857711,17,4,2353
27874898@N00,1552,9,1349866948,1349867732,7,4,784
27874898@N00,1553,8,1350177602,1350177795,3,2,193
27874898@N00,1553,5,1350175249,1350176896,11,2,1647
27874898@N00,1554,1,1367987795,1367987795,1,1,0
27874898@N00,1555,11,1368148224,1368148224,1,3,0
27874898@N00,1555,1,1368157523,1368186641,7,3,29118
27874898@N00,1555,5,1368149086,1368151658,10,3,2572
27874898@N00,1556,5,1370669448,1370669512,6,1,64
27874898@N00,1557,13,1378963272,1378963770,2,4,498
27874898@N00,1557,12,1378951340,1378951644,5,4,304
27874898@N00,1557,1,1378948228,1378955035,9,4,6807
27874898@N00,1557,5,1378956316,1378956316,1,4,0
27938532@N00,1558,11,1292986140,1292986140,1,1,0
27967379@N08,1559,5,1410167709,1410167730,2,2,21
27967379@N08,1559,2,1410148063,1410148063,1,2,0
27969085@N00,1560,11,1327668052,1327668052,1,1,0
28004076@N04,1561,11,1399626626,1399626634,2,2,8
28004076@N04,1561,10,1399623747,1399623755,2,2,8
28019195@N07,1562,15,1419111402,1419111402,1,2,0
28019195@N07,1562,11,1419111083,1419111083,1,2,0
28044128@N03,1563,11,1388705463,1388727036,2,1,21573
28057734@N03,1564,17,1314073228,1314073228,1,1,0
28069677@N00,1565,6,1224061798,1224061846,3,1,48
28083255@N00,1566,8,1416189347,1416189347,1,1,0
28083255@N00,1567,11,1443395126,1443395165,2,1,39
28090908@N04,1568,13,1241250699,1241250744,2,5,45
28090908@N04,1568,9,1241234909,1241234909,1,5,0
28090908@N04,1568,8,1241231469,1241257188,2,5,25719
28090908@N04,1568,11,1241226728,1241258238,4,5,31510
28090908@N04,1568,5,1241230068,1241230165,2,5,97
28092308@N00,1569,14,1207100276,1207100584,14,6,308
28092308@N00,1569,11,1207096938,1207097257,2,6,319
28092308@N00,1569,4,1207100978,1207103955,4,6,2977
28092308@N00,1569,15,1207106499,1207106499,1,6,0
28092308@N00,1569,8,1207112048,1207112048,1,6,0
28092308@N00,1569,13,1207106727,1207107870,2,6,1143
28132447@N00,1570,11,1292548087,1292548163,6,2,76
28132447@N00,1570,17,1292552565,1292552687,6,2,122
28148319@N08,1571,11,1265190871,1265190871,1,1,0
28148319@N08,1572,11,1298285778,1298285778,1,1,0
28163344@N08,1573,11,1446797867,1446797867,1,1,0
28163344@N08,1574,9,1446866454,1446866633,4,2,179
28163344@N08,1574,11,1446866399,1446866399,1,2,0
28203925@N08,1575,8,1345111607,1345111626,2,2,19
28203925@N08,1575,17,1345115853,1345115954,2,2,101
28215341@N07,1576,9,1367826557,1367826557,1,2,0
28215341@N07,1576,11,1367816512,1367816512,1,2,0
28215341@N07,1577,1,1424316825,1424316825,1,2,0
28215341@N07,1577,4,1424320391,1424320391,1,2,0
28215341@N07,1578,15,1445501662,1445501669,5,1,7
28245557@N00,1579,17,1416792477,1416792477,1,1,0
28258189@N08,1580,11,1203482774,1203482774,1,1,0
28289576@N08,1581,11,1356937040,1356937040,1,1,0
28373086@N07,1582,13,1242071160,1242071333,2,4,173
28373086@N07,1582,8,1242077514,1242077770,3,4,256
28373086@N07,1582,11,1242061921,1242062310,5,4,389
28373086@N07,1582,17,1242069392,1242069392,1,4,0
28407078@N08,1583,11,1215428055,1215428055,1,1,0
28446856@N00,1584,11,1383253125,1383253125,1,1,0
28446856@N00,1585,11,1383286229,1383286229,1,1,0
28450912@N02,1586,11,1238813914,1238828498,6,4,14584
28450912@N02,1586,10,1238815250,1238815250,1,4,0
28450912@N02,1586,5,1238820083,1238820083,1,4,0
28450912@N02,1586,8,1238819601,1238819607,2,4,6
28450912@N02,1587,11,1249893064,1249893211,8,9,147
28450912@N02,1587,13,1249893049,1249893049,3,9,0
28450912@N02,1587,1,1249893062,1249893117,3,9,55
28450912@N02,1587,5,1249893114,1249893195,4,9,81
28450912@N02,1587,9,1249893063,1249893063,1,9,0
28450912@N02,1587,15,1249893049,1249893049,2,9,0
28450912@N02,1587,8,1249893118,1249893119,2,9,1
28450912@N02,1587,4,1249893045,1249893045,1,9,0
28450912@N02,1587,17,1249893048,1249893048,2,9,0
28450912@N02,1588,11,1252049786,1252066377,4,1,16591
28450912@N02,1589,3,1263626101,1263626628,5,4,527
28450912@N02,1589,4,1263625679,1263625679,1,4,0
28450912@N02,1589,1,1263620469,1263620469,1,4,0
28450912@N02,1589,17,1263605568,1263605852,4,4,284
28450912@N02,1590,8,1275051565,1275051565,1,1,0
28450912@N02,1591,11,1324115601,1324116439,6,2,838
28450912@N02,1591,13,1324118177,1324118177,1,2,0
28450912@N02,1592,17,1324171678,1324172117,6,3,439
28450912@N02,1592,10,1324170922,1324171592,11,3,670
28450912@N02,1592,1,1324178899,1324178899,1,3,0
28450912@N02,1593,13,1331351440,1331351440,1,2,0
28450912@N02,1593,10,1331350130,1331350339,4,2,209
28450912@N02,1594,13,1354874389,1354874389,1,2,0
28450912@N02,1594,10,1354872962,1354873309,2,2,347
28450912@N02,1595,11,1362733752,1362733752,1,1,0
28450912@N02,1596,11,1362804005,1362804654,3,1,649
28450912@N02,1597,6,1363153805,1363153805,1,7,0
28450912@N02,1597,15,1363152050,1363152050,1,7,0
28450912@N02,1597,8,1363160591,1363160676,2,7,85
28450912@N02,1597,4,1363147112,1363147112,1,7,0
28450912@N02,1597,17,1363149323,1363151308,4,7,1985
28450912@N02,1597,11,1363144813,1363145558,9,7,745
28450912@N02,1597,13,1363152176,1363152372,2,7,196
28450912@N02,1598,5,1400323908,1400323908,1,1,0
28450912@N02,1599,17,1400381068,1400381392,6,2,324
28450912@N02,1599,10,1400381372,1400381372,1,2,0
28469514@N05,1600,11,1380949653,1380949653,1,1,0
28478615@N03,1601,11,1331969930,1331969930,1,1,0
28495936@N03,1602,13,1292307489,1292307489,1,2,0
28495936@N03,1602,4,1292287456,1292287456,1,2,0
28495936@N03,1603,13,1302056956,1302056956,1,4,0
28495936@N03,1603,11,1302057951,1302066651,2,4,8700
28495936@N03,1603,15,1302057154,1302057154,1,4,0
28495936@N03,1603,17,1302056337,1302064485,3,4,8148
28495936@N03,1604,11,1317510196,1317510260,2,2,64
28495936@N03,1604,16,1317510231,1317510231,1,2,0
28495936@N03,1605,11,1318544331,1318544488,2,1,157
28495936@N03,1606,8,1327716321,1327716321,1,2,0
28495936@N03,1606,4,1327714575,1327714575,1,2,0
28495936@N03,1607,15,1328324779,1328324779,1,1,0
28495936@N03,1608,13,1329441673,1329441673,1,1,0
28495936@N03,1609,11,1330218023,1330218023,1,3,0
28495936@N03,1609,1,1330226914,1330226914,1,3,0
28495936@N03,1609,7,1330220545,1330220545,1,3,0
28495936@N03,1610,17,1330487981,1330487981,1,2,0
28495936@N03,1610,6,1330489646,1330489646,1,2,0
28495936@N03,1611,13,1331088652,1331088652,1,2,0
28495936@N03,1611,11,1331083444,1331083599,2,2,155
28495936@N03,1612,11,1333410774,1333410774,1,1,0
28495936@N03,1613,13,1336113784,1336113905,2,2,121
28495936@N03,1613,8,1336112067,1336112453,4,2,386
28495936@N03,1614,11,1340415231,1340423920,2,2,8689
28495936@N03,1614,8,1340422188,1340422188,1,2,0
28495936@N03,1615,7,1346637209,1346637209,1,1,0
28495936@N03,1616,11,1354848754,1354848754,1,1,0
28527853@N00,1617,3,1335574496,1335574496,1,6,0
28527853@N00,1617,11,1335566609,1335604192,2,6,37583
28527853@N00,1617,17,1335577498,1335577517,2,6,19
28527853@N00,1617,10,1335575922,1335575922,1,6,0
28527853@N00,1617,2,1335574572,1335574572,1,6,0
28527853@N00,1617,13,1335581010,1335581010,1,6,0
28527853@N00,1618,1,1354772080,1354772080,1,1,0
28527853@N00,1619,15,1354848370,1354848370,1,1,0
28530387@N06,1620,17,1408161266,1408161759,3,1,493
28530387@N06,1621,5,1443156708,1443156718,2,1,10
28530387@N06,1622,5,1470371898,1470371932,2,3,34
28530387@N06,1622,2,1470369916,1470370095,4,3,179
28530387@N06,1622,3,1470367269,1470367269,1,3,0
28559908@N00,1623,6,1389057138,1389084378,70,1,27240
28572085@N03,1624,11,1216734253,1216734253,1,3,0
28572085@N03,1624,13,1216748860,1216748877,4,3,17
28572085@N03,1624,12,1216738932,1216739029,4,3,97
28572085@N03,1625,8,1217092449,1217097057,6,4,4608
28572085@N03,1625,1,1217081985,1217082256,5,4,271
28572085@N03,1625,11,1217078719,1217078719,1,4,0
28572085@N03,1625,5,1217100780,1217101323,5,4,543
28572085@N03,1626,8,1219054783,1219069422,44,6,14639
28572085@N03,1626,5,1219054800,1219069445,49,6,14645
28572085@N03,1626,15,1219054693,1219069379,36,6,14686
28572085@N03,1626,11,1219069324,1219069324,1,6,0
28572085@N03,1626,10,1219069366,1219069372,6,6,6
28572085@N03,1626,13,1219069325,1219069383,5,6,58
28581468@N00,1627,17,1263789983,1263790407,6,1,424
28598412@N04,1628,10,1251581300,1251581300,1,1,0
28643802@N03,1629,8,1309655246,1309655246,1,1,0
28691893@N04,1630,11,1334346468,1334346524,2,1,56
28691893@N04,1631,2,1350169910,1350169980,2,2,70
28691893@N04,1631,9,1350162569,1350164024,2,2,1455
28691893@N04,1632,8,1350271737,1350271737,1,2,0
28691893@N04,1632,9,1350261515,1350261515,1,2,0
28691893@N04,1633,9,1350354534,1350354534,1,1,0
28691893@N04,1634,5,1350448164,1350450673,2,2,2509
28691893@N04,1634,9,1350444791,1350444791,1,2,0
28691893@N04,1635,9,1350591258,1350591258,1,1,0
28704523@N03,1636,10,1312867024,1312867024,1,1,0
28705786@N05,1637,6,1221189205,1221196991,2,1,7786
28712708@N06,1638,13,1282643936,1282643936,1,1,0
28713051@N05,1639,1,1294927437,1294927437,1,1,0
28720651@N04,1640,16,1219355919,1219378727,31,1,22808
28724781@N04,1641,2,1229145664,1229145719,2,3,55
28724781@N04,1641,15,1229135722,1229135722,1,3,0
28724781@N04,1641,17,1229149700,1229149700,1,3,0
28724781@N04,1642,1,1231316993,1231316993,1,3,0
28724781@N04,1642,11,1231316699,1231316699,1,3,0
28724781@N04,1642,12,1231318252,1231318252,1,3,0
28724781@N04,1643,5,1231473842,1231473842,1,4,0
28724781@N04,1643,10,1231458555,1231458555,1,4,0
28724781@N04,1643,9,1231457825,1231457825,1,4,0
28724781@N04,1643,8,1231466921,1231467465,6,4,544
28754076@N05,1644,10,1198432604,1198432615,2,2,11
28754076@N05,1644,11,1198433718,1198433718,1,2,0
28790043@N05,1645,13,1237002674,1237002685,2,1,11
28815288@N06,1646,17,1320891142,1320891142,1,1,0
28827391@N03,1647,11,1365229672,1365229672,1,1,0
28827568@N05,1648,11,1222422394,1222422435,2,1,41
28827568@N05,1649,11,1223872199,1223872686,3,1,487
28836018@N02,1650,3,1337401718,1337404981,41,1,3263
28836018@N02,1651,5,1358057602,1358057602,1,4,0
28836018@N02,1651,13,1358056904,1358056904,1,4,0
28836018@N02,1651,15,1358056785,1358056791,2,4,6
28836018@N02,1651,11,1358061474,1358061474,1,4,0
28936728@N04,1652,14,1222783200,1222783200,1,1,0
28946471@N00,1653,11,1373099537,1373099537,1,1,0
28971971@N00,1654,2,1194741854,1194741859,2,7,5
28971971@N00,1654,5,1194747789,1194749237,9,7,1448
28971971@N00,1654,12,1194744200,1194744200,1,7,0
28971971@N00,1654,11,1194759145,1194759145,1,7,0
28971971@N00,1654,10,1194753675,1194754156,6,7,481
28971971@N00,1654,7,1194745777,1194745817,2,7,40
28971971@N00,1654,8,1194750426,1194750426,1,7,0
28971971@N00,1655,11,1194955335,1194956059,2,1,724
28971971@N00,1656,13,1297405597,1297405597,1,6,0
28971971@N00,1656,2,1297379059,1297379353,6,6,294
28971971@N00,1656,15,1297404554,1297405085,6,6,531
28971971@N00,1656,12,1297379752,1297379883,5,6,131
28971971@N00,1656,16,1297389608,1297393310,5,6,3702
28971971@N00,1656,7,1297377308,1297386085,5,6,8777
28971971@N00,1657,13,1315014432,1315014448,5,1,16
28971971@N00,1658,13,1346067383,1346067383,1,1,0
28977782@N00,1659,12,1192067099,1192067099,1,2,0
28977782@N00,1659,2,1192063181,1192063270,2,2,89
28977782@N00,1660,12,1324223146,1324223146,1,1,0
28977782@N00,1661,8,1324656035,1324656035,1,3,0
28977782@N00,1661,16,1324649193,1324649193,1,3,0
28977782@N00,1661,5,1324664011,1324664011,1,3,0
28977782@N00,1662,1,1334355790,1334355790,1,1,0
28989691@N05,1663,13,1317184164,1317184164,1,1,0
29000027@N05,1664,11,1444788631,1444788631,1,1,0
29044494@N00,1665,4,1272426510,1272426510,1,2,0
29044494@N00,1665,10,1272432427,1272452910,2,2,20483
29057323@N07,1666,11,1207742648,1207749185,2,1,6537
29075130@N00,1667,11,1307862668,1307862668,1,2,0
29075130@N00,1667,8,1307855740,1307855740,1,2,0
29078580@N00,1668,2,1216429860,1216429920,2,4,60
29078580@N00,1668,4,1216431960,1216432020,2,4,60
29078580@N00,1668,11,1216432980,1216432980,1,4,0
29078580@N00,1668,5,1216450320,1216450740,5,4,420
29078580@N00,1669,11,1278635562,1278635562,1,1,0
29078580@N00,1670,5,1278670804,1278670859,3,2,55
29078580@N00,1670,4,1278666761,1278666761,1,2,0
29108089@N04,1671,6,1385788369,1385790429,6,7,2060
29108089@N04,1671,11,1385765926,1385811052,6,7,45126
29108089@N04,1671,15,1385777647,1385777647,1,7,0
29108089@N04,1671,10,1385776663,1385808297,2,7,31634
29108089@N04,1671,17,1385777046,1385807550,2,7,30504
29108089@N04,1671,13,1385778003,1385778003,1,7,0
29108089@N04,1671,4,1385775904,1385775904,1,7,0
29129621@N05,1672,13,1246618319,1246618365,2,4,46
29129621@N05,1672,11,1246602818,1246602818,1,4,0
29129621@N05,1672,16,1246605761,1246605761,1,4,0
29129621@N05,1672,8,1246611481,1246611481,1,4,0
29129621@N05,1673,4,1269129532,1269129532,1,1,0
29129621@N05,1674,4,1289033107,1289033107,1,1,0
29129621@N05,1675,5,1291593928,1291593928,1,2,0
29129621@N05,1675,16,1291592114,1291592587,2,2,473
29129621@N05,1676,4,1299298859,1299298859,1,4,0
29129621@N05,1676,5,1299321621,1299321621,1,4,0
29129621@N05,1676,13,1299325240,1299325240,1,4,0
29129621@N05,1676,9,1299285604,1299285604,1,4,0
29129621@N05,1677,16,1317534089,1317534089,1,1,0
29129621@N05,1678,4,1317706502,1317706502,1,4,0
29129621@N05,1678,1,1317710704,1317710704,1,4,0
29129621@N05,1678,11,1317699917,1317699917,1,4,0
29129621@N05,1678,9,1317710113,1317710113,1,4,0
29129621@N05,1679,2,1321061680,1321061680,1,2,0
29129621@N05,1679,13,1321077219,1321077219,1,2,0
29129621@N05,1680,2,1327109827,1327109827,1,3,0
29129621@N05,1680,10,1327120432,1327120432,1,3,0
29129621@N05,1680,11,1327126231,1327126309,2,3,78
29129621@N05,1681,11,1348790932,1348790932,1,1,0
29129621@N05,1682,2,1348965372,1348965372,1,1,0
29129621@N05,1683,2,1358653426,1358653426,1,1,0
29129621@N05,1684,11,1410504309,1410504309,1,1,0
29168905@N00,1685,8,1313477738,1313477780,5,2,42
29168905@N00,1685,5,1313482458,1313484833,10,2,2375
29196274@N02,1686,5,1201633184,1201633184,1,1,0
29196274@N02,1687,2,1201710374,1201710374,1,1,0
29225947@N00,1688,6,1380254103,1380254759,8,1,656
29225947@N00,1689,2,1380358962,1380358962,2,1,0
29225947@N00,1690,11,1380705398,1380705398,1,7,0
29225947@N00,1690,13,1380676501,1380678754,15,7,2253
29225947@N00,1690,7,1380663735,1380666657,4,7,2922
29225947@N00,1690,17,1380678081,1380678346,3,7,265
29225947@N00,1690,5,1380681503,1380681503,1,7,0
29225947@N00,1690,10,1380673307,1380676222,17,7,2915
29225947@N00,1690,2,1380666823,1380668314,4,7,1491
29232178@N03,1691,11,1410641541,1410641541,1,1,0
29232178@N03,1692,8,1432310868,1432310868,1,1,0
29236889@N07,1693,11,1268317419,1268317419,1,2,0
29236889@N07,1693,10,1268317421,1268317421,1,2,0
29259314@N04,1694,13,1285806594,1285806594,1,6,0
29259314@N04,1694,16,1285800137,1285800137,1,6,0
29259314@N04,1694,9,1285798196,1285798302,2,6,106
29259314@N04,1694,8,1285811651,1285811651,1,6,0
29259314@N04,1694,17,1285802202,1285803836,7,6,1634
29259314@N04,1694,11,1285797815,1285806440,4,6,8625
29259314@N04,1695,17,1285979784,1285981277,4,5,1493
29259314@N04,1695,15,1285979399,1285979399,1,5,0
29259314@N04,1695,13,1285971101,1285979153,2,5,8052
29259314@N04,1695,2,1285972853,1285972853,1,5,0
29259314@N04,1695,14,1285969275,1285969620,6,5,345
29259314@N04,1696,6,1411859217,1411899512,8,1,40295
29259314@N04,1697,11,1411957368,1411978863,4,1,21495
29352917@N00,1698,4,1255486415,1255487089,5,1,674
29352917@N00,1699,11,1255593452,1255593452,1,1,0
29398148@N05,1700,8,1226076612,1226076651,3,1,39
29426902@N02,1701,11,1286851506,1286851750,2,1,244
29460926@N08,1702,11,1299922001,1299922001,1,3,0
29460926@N08,1702,17,1299918372,1299918372,1,3,0
29460926@N08,1702,13,1299917540,1299917540,1,3,0
29465267@N00,1703,13,1344907662,1344907662,1,2,0
29465267@N00,1703,11,1344899201,1344899201,1,2,0
29498908@N05,1704,14,1258972244,1258972244,1,1,0
29530452@N06,1705,8,1355111584,1355111584,1,1,0
29568026@N07,1706,17,1397132688,1397135381,2,3,2693
29568026@N07,1706,11,1397131729,1397131840,2,3,111
29568026@N07,1706,13,1397135508,1397140759,5,3,5251
29583624@N04,1707,13,1223030813,1223030813,1,1,0
29583624@N04,1708,10,1223169280,1223169363,3,1,83
29619840@N00,1709,11,1209896450,1209901031,6,2,4581
29619840@N00,1709,17,1209898529,1209899551,30,2,1022
29619840@N00,1710,15,1210220415,1210242222,13,15,21807
29619840@N00,1710,3,1210208266,1210209927,3,15,1661
29619840@N00,1710,16,1210226497,1210226517,2,15,20
29619840@N00,1710,12,1210209417,1210209472,2,15,55
29619840@N00,1710,1,1210216053,1210218600,5,15,2547
29619840@N00,1710,10,1210234496,1210234820,7,15,324
29619840@N00,1710,2,1210208581,1210209760,2,15,1179
29619840@N00,1710,9,1210224975,1210226402,7,15,1427
29619840@N00,1710,5,1210235315,1210237178,13,15,1863
29619840@N00,1710,11,1210223516,1210244611,17,15,21095
29619840@N00,1710,8,1210238256,1210239639,36,15,1383
29619840@N00,1710,13,1210231906,1210242085,18,15,10179
29619840@N00,1710,4,1210212169,1210213197,3,15,1028
29619840@N00,1710,17,1210220621,1210234323,7,15,13702
29619840@N00,1710,14,1210211588,1210211588,1,15,0
29648523@N05,1711,9,1258548271,1258548271,1,3,0
29648523@N05,1711,8,1258544393,1258544393,1,3,0
29648523@N05,1711,11,1258548761,1258548761,1,3,0
29648523@N05,1712,10,1258793041,1258793041,1,5,0
29648523@N05,1712,8,1258783230,1258783230,1,5,0
29648523@N05,1712,2,1258770821,1258770821,1,5,0
29648523@N05,1712,17,1258765643,1258765643,1,5,0
29648523@N05,1712,5,1258780287,1258781116,2,5,829
29648523@N05,1713,8,1258861083,1258861083,1,1,0
29651901@N00,1714,11,1374469196,1374497096,2,1,27900
29675024@N05,1715,11,1276165494,1276165494,1,2,0
29675024@N05,1715,17,1276138985,1276168299,5,2,29314
29756928@N03,1716,13,1399084591,1399084591,1,1,0
29757228@N06,1717,9,1389648030,1389648030,1,1,0
29758442@N00,1718,13,1217212178,1217212178,1,2,0
29758442@N00,1718,10,1217208028,1217208028,1,2,0
29775332@N00,1719,11,1383800398,1383800560,2,2,162
29775332@N00,1719,1,1383784797,1383784797,1,2,0
29845947@N00,1720,1,1278751222,1278753427,3,1,2205
29847315@N00,1721,11,1220730539,1220733243,2,1,2704
29847315@N00,1722,11,1220811346,1220812193,3,1,847
29847315@N00,1723,11,1220955225,1220955225,1,1,0
29847315@N00,1724,11,1221033976,1221058724,2,1,24748
29847315@N00,1725,11,1221136835,1221152730,2,1,15895
29847315@N00,1726,11,1221183791,1221183791,1,1,0
29865634@N04,1727,4,1214643915,1214643915,1,1,0
29865634@N04,1728,3,1221296197,1221296197,1,2,0
29865634@N04,1728,11,1221294525,1221294809,3,2,284
29865634@N04,1729,5,1223607199,1223607199,1,2,0
29865634@N04,1729,1,1223610234,1223610234,1,2,0
29865634@N04,1730,8,1226729669,1226729669,1,1,0
29865634@N04,1731,13,1233993891,1233993980,2,3,89
29865634@N04,1731,8,1233991545,1233991634,2,3,89
29865634@N04,1731,11,1233989528,1233991011,5,3,1483
29865634@N04,1732,13,1238216598,1238216598,1,6,0
29865634@N04,1732,15,1238216139,1238216139,1,6,0
29865634@N04,1732,10,1238209940,1238215609,5,6,5669
29865634@N04,1732,2,1238202051,1238204818,2,6,2767
29865634@N04,1732,12,1238205812,1238208836,6,6,3024
29865634@N04,1732,11,1238201117,1238201117,1,6,0
29865634@N04,1733,13,1240055270,1240055270,1,5,0
29865634@N04,1733,15,1240041555,1240046296,4,5,4741
29865634@N04,1733,8,1240046598,1240046598,1,5,0
29865634@N04,1733,11,1240034440,1240035735,8,5,1295
29865634@N04,1733,6,1240049847,1240049847,1,5,0
29865634@N04,1734,11,1250321404,1250322241,5,1,837
29865634@N04,1735,15,1252013944,1252014019,2,4,75
29865634@N04,1735,5,1252014118,1252014118,1,4,0
29865634@N04,1735,3,1252012728,1252012765,2,4,37
29865634@N04,1735,11,1252009089,1252009089,1,4,0
29865634@N04,1736,13,1252067550,1252067646,2,4,96
29865634@N04,1736,17,1252064546,1252064546,1,4,0
29865634@N04,1736,7,1252066008,1252066008,1,4,0
29865634@N04,1736,2,1252063914,1252063914,1,4,0
29865634@N04,1737,13,1254051333,1254051333,1,4,0
29865634@N04,1737,15,1254051031,1254051031,1,4,0
29865634@N04,1737,17,1254050741,1254050741,1,4,0
29865634@N04,1737,8,1254031930,1254055551,3,4,23621
29865634@N04,1738,5,1254134402,1254134402,1,3,0
29865634@N04,1738,8,1254134744,1254135871,2,3,1127
29865634@N04,1738,11,1254133253,1254133253,1,3,0
29875277@N02,1739,11,1389000706,1389000706,1,1,0
29875277@N02,1740,13,1389143516,1389143516,1,3,0
29875277@N02,1740,11,1389153895,1389153895,1,3,0
29875277@N02,1740,8,1389151267,1389151483,2,3,216
29896241@N06,1741,6,1220160153,1220161119,4,1,966
29914374@N05,1742,11,1240703336,1240703336,1,2,0
29914374@N05,1742,1,1240714536,1240714536,1,2,0
29924665@N05,1743,1,1454540752,1454540752,1,3,0
29924665@N05,1743,15,1454551919,1454551919,1,3,0
29924665@N05,1743,13,1454553196,1454554130,7,3,934
29954772@N00,1744,6,1353947575,1353947923,73,2,348
29954772@N00,1744,5,1353949367,1353949367,1,2,0
29957186@N04,1745,11,1378289010,1378289010,1,1,0
29980560@N06,1746,16,1287373074,1287373074,1,1,0
30030726@N05,1747,8,1437375507,1437375568,3,2,61
30030726@N05,1747,17,1437369067,1437369067,1,2,0
30042168@N03,1748,2,1328487064,1328492651,2,3,5587
30042168@N03,1748,11,1328484018,1328485157,4,3,1139
30042168@N03,1748,12,1328488811,1328488835,3,3,24
30042168@N03,1749,11,1328763323,1328763380,6,1,57
30143403@N07,1750,2,1256776183,1256776211,3,2,28
30143403@N07,1750,3,1256772681,1256774191,2,2,1510
30171461@N05,1751,8,1310463531,1310463531,1,1,0
30180330@N07,1752,11,1383375055,1383375715,7,1,660
30213408@N00,1753,9,1233394662,1233394663,4,4,1
30213408@N00,1753,11,1233394660,1233394660,2,4,0
30213408@N00,1753,16,1233394663,1233394664,2,4,1
30213408@N00,1753,4,1233394664,1233394666,6,4,2
30256684@N02,1754,8,1190168811,1190168811,1,4,0
30256684@N02,1754,5,1190168811,1190168811,2,4,0
30256684@N02,1754,10,1190168811,1190168811,1,4,0
30256684@N02,1754,11,1190168811,1190168811,2,4,0
30269754@N05,1755,5,1327651033,1327658258,2,2,7225
30269754@N05,1755,11,1327650305,1327665224,3,2,14919
30269754@N05,1756,15,1380961137,1380961202,2,1,65
30302460@N03,1757,11,1373180618,1373180618,1,1,0
30373545@N06,1758,11,1365843527,1365843587,3,1,60
30375952@N02,1759,11,1351678440,1351678440,1,1,0
30422798@N00,1760,11,1327964602,1327964602,1,1,0
30446909@N07,1761,11,1345621787,1345621787,1,1,0
30485540@N03,1762,8,1244330997,1244331119,2,3,122
30485540@N03,1762,15,1244330280,1244330280,1,3,0
30485540@N03,1762,11,1244331496,1244331496,1,3,0
30485540@N03,1763,9,1244914600,1244914600,1,1,0
30493847@N04,1764,15,1317528388,1317528388,1,3,0
30493847@N04,1764,5,1317536715,1317536715,1,3,0
30493847@N04,1764,11,1317545204,1317545204,1,3,0
30498272@N07,1765,5,1231568654,1231568654,1,1,0
30514233@N05,1766,5,1382691266,1382691266,1,2,0
30514233@N05,1766,11,1382693656,1382693656,1,2,0
30550906@N06,1767,11,1365852071,1365852071,1,1,0
30571673@N07,1768,5,1355980981,1355980981,1,1,0
30629351@N00,1769,10,1218429211,1218429211,1,10,0
30629351@N00,1769,15,1218429305,1218432214,3,10,2909
30629351@N00,1769,1,1218441306,1218441306,1,10,0
30629351@N00,1769,17,1218429510,1218429510,1,10,0
30629351@N00,1769,4,1218426576,1218427350,3,10,774
30629351@N00,1769,11,1218424123,1218424166,2,10,43
30629351@N00,1769,5,1218437866,1218438364,6,10,498
30629351@N00,1769,8,1218435754,1218436415,2,10,661
30629351@N00,1769,13,1218432326,1218432959,4,10,633
30629351@N00,1769,12,1218444037,1218444552,2,10,515
30650680@N02,1770,8,1411775218,1411775218,1,1,0
30667744@N00,1771,17,1392346404,1392346404,1,1,0
30673732@N06,1772,9,1326433707,1326433707,1,1,0
30683917@N07,1773,10,1310207411,1310207993,4,4,582
30683917@N07,1773,17,1310200282,1310206737,6,4,6455
30683917@N07,1773,13,1310199194,1310199412,3,4,218
30683917@N07,1773,11,1310194659,1310195453,7,4,794
30696089@N05,1774,17,1230189368,1230189368,1,1,0
30699184@N03,1775,11,1354498319,1354498319,1,1,0
30708841@N05,1776,2,1327885558,1327885558,1,1,0
30708841@N05,1777,9,1328695208,1328695208,1,2,0
30708841@N05,1777,11,1328684139,1328684139,1,2,0
30708841@N05,1778,13,1359017037,1359017037,1,1,0
30738244@N07,1779,5,1201836004,1201839596,2,3,3592
30738244@N07,1779,2,1201845119,1201845119,1,3,0
30738244@N07,1779,11,1201835094,1201835094,1,3,0
30743089@N05,1780,8,1292976831,1292977309,2,1,478
30793917@N07,1781,13,1275117278,1275117278,1,1,0
30831872@N08,1782,17,1241417294,1241417294,1,2,0
30831872@N08,1782,11,1241431717,1241431757,2,2,40
30831872@N08,1783,17,1241774214,1241774434,7,5,220
30831872@N08,1783,5,1241761480,1241761504,3,5,24
30831872@N08,1783,12,1241744512,1241744512,1,5,0
30831872@N08,1783,1,1241758556,1241758590,2,5,34
30831872@N08,1783,11,1241753533,1241785684,6,5,32151
30868771@N03,1784,2,1464088484,1464088484,1,1,0
30891516@N08,1785,2,1304842028,1304842028,1,2,0
30891516@N08,1785,11,1304841746,1304841875,2,2,129
30891516@N08,1786,13,1304937983,1304938332,3,5,349
30891516@N08,1786,5,1304919699,1304919699,1,5,0
30891516@N08,1786,2,1304906073,1304906095,2,5,22
30891516@N08,1786,8,1304922188,1304924189,4,5,2001
30891516@N08,1786,17,1304938381,1304938381,1,5,0
30960094@N04,1787,13,1262837184,1262837586,4,4,402
30960094@N04,1787,15,1262836820,1262836820,1,4,0
30960094@N04,1787,17,1262835753,1262836191,2,4,438
30960094@N04,1787,8,1262845613,1262845613,1,4,0
31006502@N04,1788,1,1402190964,1402190964,1,1,0
31006502@N04,1789,13,1433058595,1433058595,1,1,0
31058815@N00,1790,8,1356245259,1356245259,1,1,0
31072721@N02,1791,11,1252222012,1252222012,1,1,0
31164678@N08,1792,11,1210563457,1210563457,1,1,0
31223689@N00,1793,15,1199085868,1199085868,1,2,0
31223689@N00,1793,11,1199061721,1199061721,1,2,0
31223689@N00,1794,3,1222321061,1222321069,2,1,8
31272004@N06,1795,11,1344174000,1344174000,1,1,0
31281767@N04,1796,13,1348888155,1348888155,1,2,0
31281767@N04,1796,11,1348881577,1348881577,1,2,0
31291728@N05,1797,13,1415067879,1415067883,2,1,4
31291728@N05,1798,13,1415234343,1415234553,3,3,210
31291728@N05,1798,1,1415229088,1415229088,1,3,0
31291728@N05,1798,8,1415236485,1415236488,2,3,3
31291728@N05,1799,1,1431060669,1431061038,2,2,369
31291728@N05,1799,11,1431042924,1431042924,1,2,0
31291728@N05,1800,11,1431162235,1431162439,3,2,204
31291728@N05,1800,15,1431167266,1431167306,3,2,40
31291728@N05,1801,13,1431243367,1431246890,7,2,3523
31291728@N05,1801,11,1431253775,1431253775,1,2,0
31291728@N05,1802,6,1431334488,1431334488,1,1,0
31291728@N05,1803,11,1461632933,1461632933,1,2,0
31291728@N05,1803,10,1461642647,1461642647,1,2,0
31291728@N05,1804,13,1461832467,1461840464,6,2,7997
31291728@N05,1804,11,1461841200,1461841200,1,2,0
31291728@N05,1805,8,1461918564,1461918636,3,1,72
31295108@N00,1806,11,1451399789,1451399789,1,1,0
31331814@N04,1807,1,1376264157,1376264187,3,1,30
31348155@N03,1808,11,1326388297,1326388297,1,1,0
31369133@N04,1809,11,1291962702,1291962702,1,1,0
31449648@N05,1810,11,1378024102,1378024102,1,1,0
31474844@N02,1811,13,1269223269,1269223269,1,3,0
31474844@N02,1811,1,1269230028,1269230028,1,3,0
31474844@N02,1811,11,1269214592,1269218668,2,3,4076
31499593@N03,1812,11,1321958674,1321958674,1,1,0
31535569@N00,1813,7,1255299603,1255299603,1,1,0
31535569@N00,1814,17,1255341717,1255341721,2,1,4
31535569@N00,1815,11,1255503624,1255503624,1,1,0
31541646@N06,1816,11,1271028893,1271053130,30,1,24237
31545574@N02,1817,11,1313724696,1313724696,1,2,0
31545574@N02,1817,8,1313734143,1313734143,1,2,0
31559075@N00,1818,10,1257654131,1257654131,1,8,0
31559075@N00,1818,2,1257640813,1257640813,1,8,0
31559075@N00,1818,15,1257658022,1257658189,2,8,167
31559075@N00,1818,17,1257647493,1257647493,1,8,0
31559075@N00,1818,11,1257634221,1257679617,3,8,45396
31559075@N00,1818,1,1257669698,1257673307,2,8,3609
31559075@N00,1818,13,1257662682,1257662682,1,8,0
31559075@N00,1818,9,1257675845,1257676273,3,8,428
31572810@N04,1819,5,1353823050,1353823050,1,1,0
31616435@N04,1820,13,1311405245,1311405350,3,3,105
31616435@N04,1820,8,1311395954,1311395954,1,3,0
31616435@N04,1820,11,1311379107,1311418403,4,3,39296
31616435@N04,1821,13,1324253991,1324286648,31,1,32657
31646024@N00,1822,5,1192305473,1192305473,1,2,0
31646024@N00,1822,11,1192283415,1192284508,3,2,1093
31646024@N00,1823,13,1194023069,1194023069,1,2,0
31646024@N00,1823,17,1194029317,1194029317,1,2,0
31646024@N00,1824,13,1210404639,1210405104,7,7,465
31646024@N00,1824,11,1210382318,1210382407,5,7,89
31646024@N00,1824,10,1210392388,1210401467,17,7,9079
31646024@N00,1824,9,1210390362,1210390503,4,7,141
31646024@N00,1824,1,1210391150,1210391632,11,7,482
31646024@N00,1824,2,1210385900,1210385900,1,7,0
31646024@N00,1824,15,1210403691,1210404134,12,7,443
31646024@N00,1825,13,1284195336,1284195974,3,4,638
31646024@N00,1825,11,1284210526,1284210561,2,4,35
31646024@N00,1825,10,1284187179,1284187320,2,4,141
31646024@N00,1825,15,1284187217,1284187217,1,4,0
31681108@N07,1826,11,1246529913,1246529913,1,1,0
31692641@N00,1827,10,1228535959,1228543202,4,8,7243
31692641@N00,1827,4,1228543203,1228543203,1,8,0
31692641@N00,1827,1,1228543200,1228543200,1,8,0
31692641@N00,1827,15,1228534039,1228535150,2,8,1111
31692641@N00,1827,5,1228543204,1228543204,1,8,0
31692641@N00,1827,13,1228533751,1228541401,3,8,7650
31692641@N00,1827,2,1228542838,1228542838,1,8,0
31692641@N00,1827,11,1228539527,1228548939,9,8,9412
31692641@N00,1828,9,1238504400,1238504400,1,1,0
31692641@N00,1829,10,1317819601,1317819601,1,4,0
31692641@N00,1829,5,1317819611,1317819611,1,4,0
31692641@N00,1829,13,1317819602,1317819605,4,4,3
31692641@N00,1829,12,1317819600,1317819600,1,4,0
31692641@N00,1830,13,1317873115,1317873506,6,4,391
31692641@N00,1830,11,1317871157,1317871157,1,4,0
31692641@N00,1830,2,1317870720,1317870810,6,4,90
31692641@N00,1830,1,1317852462,1317853329,2,4,867
31764887@N02,1831,5,1333198800,1333198800,1,4,0
31764887@N02,1831,15,1333198800,1333198800,1,4,0
31764887@N02,1831,8,1333198800,1333198800,2,4,0
31764887@N02,1831,13,1333198800,1333198800,2,4,0
31764887@N02,1832,17,1335163979,1335163979,1,1,0
31764887@N02,1833,8,1364734800,1364734800,1,3,0
31764887@N02,1833,15,1364734800,1364734800,1,3,0
31764887@N02,1833,17,1364734800,1364734800,1,3,0
31764887@N02,1834,5,1383224400,1383224400,1,1,0
31764887@N02,1835,15,1396270800,1396270800,2,1,0
31764887@N02,1836,15,1398866400,1398866400,1,2,0
31764887@N02,1836,13,1398866400,1398866400,1,2,0
31770349@N02,1837,17,1223536575,1223536675,3,3,100
31770349@N02,1837,1,1223526992,1223527131,3,3,139
31770349@N02,1837,11,1223521723,1223522161,3,3,438
31770349@N02,1838,11,1223619923,1223619923,1,2,0
31770349@N02,1838,5,1223617796,1223617796,1,2,0
31821378@N00,1839,9,1256038351,1256038351,1,1,0
31846143@N08,1840,11,1238903349,1238903475,32,1,126
31858821@N07,1841,11,1448849960,1448849988,2,1,28
31858821@N07,1842,11,1448881594,1448881594,1,1,0
31868255@N00,1843,11,1313487477,1313487477,1,1,0
31911001@N00,1844,11,1414147856,1414147856,1,1,0
31911001@N00,1845,5,1414314322,1414315551,2,1,1229
31912731@N08,1846,11,1225845278,1225845278,1,1,0
31924266@N02,1847,4,1304681309,1304681309,1,1,0
31937081@N07,1848,9,1421972077,1421972535,3,1,458
31937081@N07,1849,10,1422013850,1422017711,2,1,3861
31957707@N08,1850,8,1419748293,1419748293,1,1,0
31962189@N04,1851,11,1401139205,1401139205,1,1,0
32037921@N06,1852,11,1414479895,1414479895,1,1,0
32040587@N04,1853,11,1304603176,1304603176,1,1,0
32072533@N08,1854,2,1344348010,1344348010,1,1,0
32263245@N00,1855,11,1289027554,1289027582,2,2,28
32263245@N00,1855,8,1289020511,1289021032,12,2,521
32263245@N00,1856,17,1291635539,1291636031,5,1,492
32301780@N06,1857,17,1399437833,1399437833,1,2,0
32301780@N06,1857,11,1399429035,1399429035,1,2,0
32359947@N00,1858,1,1243655900,1243655900,1,2,0
32359947@N00,1858,3,1243670970,1243671005,2,2,35
32372198@N00,1859,11,1360984250,1360989698,2,1,5448
32388039@N03,1860,5,1381884876,1381884876,1,5,0
32388039@N03,1860,6,1381879576,1381880229,7,5,653
32388039@N03,1860,1,1381890073,1381890073,1,5,0
32388039@N03,1860,8,1381883888,1381883888,1,5,0
32388039@N03,1860,17,1381874641,1381878524,12,5,3883
32399171@N00,1861,5,1300664200,1300664200,1,1,0
32399171@N00,1862,11,1373503149,1373503149,1,1,0
32399171@N00,1863,11,1468195946,1468195946,1,1,0
32527241@N04,1864,6,1266223270,1266229345,27,3,6075
32527241@N04,1864,1,1266215172,1266218700,3,3,3528
32527241@N04,1864,11,1266213983,1266213983,1,3,0
32536732@N00,1865,11,1204185251,1204185251,1,1,0
32617425@N00,1866,17,1351383438,1351383438,1,2,0
32617425@N00,1866,15,1351383384,1351383384,1,2,0
32617425@N00,1867,17,1352601421,1352601421,1,1,0
32644191@N07,1868,17,1254642997,1254643105,4,2,108
32644191@N07,1868,10,1254634391,1254634391,1,2,0
32644191@N07,1869,6,1254927705,1254928362,3,1,657
32644191@N07,1870,17,1255730744,1255730764,2,1,20
32663429@N04,1871,17,1351854121,1351854774,13,1,653
32663429@N04,1872,11,1457855022,1457855026,2,1,4
32734603@N05,1873,17,1413693932,1413694625,6,1,693
32744581@N05,1874,11,1277243852,1277243852,1,1,0
32858590@N00,1875,14,1188087200,1188105577,9,1,18377
32858590@N00,1876,14,1188775891,1188814740,30,1,38849
32858590@N00,1877,14,1189149298,1189164697,30,1,15399
32858590@N00,1878,14,1189215096,1189252956,39,1,37860
32858590@N00,1879,14,1189817432,1189835648,8,1,18216
32858590@N00,1880,14,1189921465,1189921465,1,1,0
32858590@N00,1881,14,1190360248,1190368804,9,1,8556
32858590@N00,1882,14,1191304108,1191324166,10,1,20058
32858590@N00,1883,14,1191974485,1191990564,6,1,16079
32858590@N00,1884,14,1194066128,1194093912,17,1,27784
32858590@N00,1885,14,1194652594,1194694037,29,1,41443
32858590@N00,1886,14,1194733537,1194740700,3,1,7163
32858590@N00,1887,14,1195186288,1195199297,17,1,13009
32858590@N00,1888,14,1195375566,1195382415,9,1,6849
32858590@N00,1889,14,1197778215,1197783941,8,1,5726
32858590@N00,1890,14,1198223246,1198230234,7,1,6988
32858590@N00,1891,14,1199578850,1199600729,18,1,21879
32858590@N00,1892,14,1200791035,1200801413,16,1,10378
32858590@N00,1893,14,1201411954,1201419062,10,1,7108
32858590@N00,1894,14,1203838529,1203839388,6,1,859
32858590@N00,1895,14,1204934174,1204950032,27,1,15858
32858590@N00,1896,14,1205034077,1205050843,22,1,16766
32858590@N00,1897,14,1206752210,1206770070,68,1,17860
32858590@N00,1898,14,1208000358,1208000358,1,1,0
32858590@N00,1899,14,1208509739,1208510834,10,1,1095
32858590@N00,1900,14,1209769888,1209788221,5,1,18333
32858590@N00,1901,14,1212223502,1212225943,4,1,2441
32858590@N00,1902,14,1218785188,1218794053,8,1,8865
32858590@N00,1903,14,1218844689,1218853513,3,1,8824
32858590@N00,1904,14,1218933501,1218933501,1,1,0
32858590@N00,1905,14,1219456713,1219466066,7,1,9353
32858590@N00,1906,14,1220143561,1220150146,2,1,6585
32858590@N00,1907,14,1220599746,1220605889,8,1,6143
32858590@N00,1908,14,1220688577,1220692435,5,1,3858
32858590@N00,1909,14,1220747289,1220764350,3,1,17061
32858590@N00,1910,14,1221281520,1221283895,4,1,2375
32858590@N00,1911,14,1223193029,1223193029,1,1,0
32858590@N00,1912,14,1223691436,1223714777,6,1,23341
32858590@N00,1913,14,1223751376,1223806324,24,1,54948
32858590@N00,1914,14,1224142128,1224142320,22,1,192
32858590@N00,1915,14,1224904667,1224931106,18,1,26439
32858590@N00,1916,14,1224970750,1224976011,21,1,5261
32904352@N00,1917,11,1346968263,1346968263,1,1,0
32904352@N00,1918,11,1347236287,1347236287,1,1,0
32904352@N00,1919,11,1347442503,1347442503,1,1,0
32935283@N06,1920,17,1357030252,1357030252,1,1,0
33050020@N08,1921,17,1360967344,1360967344,1,1,0
33063488@N02,1922,4,1286529029,1286529029,1,1,0
33063488@N02,1923,11,1301053342,1301053342,1,2,0
33063488@N02,1923,2,1301051554,1301051554,1,2,0
33115152@N06,1924,11,1248072899,1248072899,1,1,0
33121758@N04,1925,11,1229211084,1229211084,1,2,0
33121758@N04,1925,10,1229212330,1229214168,9,2,1838
33121758@N04,1926,13,1345265674,1345265674,1,1,0
33121758@N04,1927,6,1350272837,1350272837,1,1,0
33121758@N04,1928,11,1354334018,1354334018,1,1,0
33121758@N04,1929,1,1359155389,1359155485,2,1,96
33121758@N04,1930,13,1362265538,1362265538,1,2,0
33121758@N04,1930,11,1362263721,1362263721,1,2,0
33121758@N04,1931,15,1365816779,1365816779,1,1,0
33121758@N04,1932,11,1368781206,1368781206,1,1,0
33121758@N04,1933,11,1378533166,1378533166,1,1,0
33121758@N04,1934,5,1380935646,1380935646,1,1,0
33121758@N04,1935,5,1383445863,1383445863,1,1,0
33197996@N07,1936,11,1397066717,1397066717,1,1,0
33197996@N07,1937,8,1403467491,1403467491,1,1,0
33197996@N07,1938,11,1452302609,1452302609,1,1,0
33237989@N06,1939,11,1238055393,1238065031,2,1,9638
33244915@N00,1940,2,1329264198,1329264378,2,1,180
33244915@N00,1941,8,1329300736,1329301142,12,6,406
33244915@N00,1941,4,1329299662,1329299682,2,6,20
33244915@N00,1941,3,1329299560,1329299638,5,6,78
33244915@N00,1941,2,1329299704,1329300124,20,6,420
33244915@N00,1941,5,1329300460,1329300650,12,6,190
33244915@N00,1941,14,1329299510,1329299544,3,6,34
33244915@N00,1942,11,1329540904,1329541352,25,1,448
33257765@N05,1943,11,1333855530,1333855530,1,1,0
33257765@N05,1944,9,1373784817,1373784817,1,1,0
33272592@N00,1945,11,1381049514,1381049816,2,2,302
33272592@N00,1945,17,1381058459,1381058459,1,2,0
33334548@N05,1946,11,1221907721,1221907721,1,1,0
33360568@N05,1947,1,1389067419,1389067419,1,6,0
33360568@N05,1947,5,1389078219,1389078219,1,6,0
33360568@N05,1947,11,1389080540,1389080540,1,6,0
33360568@N05,1947,8,1389074512,1389078016,7,6,3504
33360568@N05,1947,13,1389068526,1389068526,1,6,0
33360568@N05,1947,15,1389068394,1389068394,1,6,0
33419223@N08,1948,11,1342847593,1342847593,1,1,0
33433883@N02,1949,5,1276263265,1276263265,1,1,0
33455872@N05,1950,8,1306773782,1306773794,2,3,12
33455872@N05,1950,3,1306773494,1306773494,1,3,0
33455872@N05,1950,13,1306773663,1306773663,1,3,0
33455872@N05,1951,1,1313578994,1313578994,1,1,0
33455872@N05,1952,10,1345021734,1345021813,2,3,79
33455872@N05,1952,11,1345009196,1345009196,1,3,0
33455872@N05,1952,5,1345013543,1345013670,3,3,127
33462708@N06,1953,11,1272248918,1272248918,1,1,0
33479020@N04,1954,5,1263507955,1263507955,1,1,0
33479020@N04,1955,12,1263566268,1263566268,1,1,0
33479020@N04,1956,1,1265260158,1265260158,1,1,0
33479020@N04,1957,5,1267797387,1267797387,1,1,0
33479020@N04,1958,9,1268026934,1268026934,1,1,0
33479020@N04,1959,14,1270021798,1270021798,1,1,0
33479020@N04,1960,16,1290449759,1290449759,1,1,0
33479020@N04,1961,11,1291184611,1291184611,1,1,0
33479020@N04,1962,1,1295233711,1295233711,1,1,0
33479020@N04,1963,1,1296713084,1296713084,1,1,0
33479020@N04,1964,13,1297662271,1297662271,1,1,0
33479020@N04,1965,5,1299648173,1299648173,1,1,0
33479020@N04,1966,11,1302679521,1302679521,1,1,0
33479020@N04,1967,11,1303109906,1303109906,1,1,0
33479020@N04,1968,4,1306909773,1306909773,1,1,0
33479020@N04,1969,2,1312357037,1312357037,1,1,0
33479020@N04,1970,1,1313564072,1313564072,1,1,0
33479020@N04,1971,11,1314771555,1314771555,1,1,0
33494202@N04,1972,5,1252293554,1252295102,6,8,1548
33494202@N04,1972,7,1252290888,1252290914,2,8,26
33494202@N04,1972,12,1252281091,1252283369,5,8,2278
33494202@N04,1972,16,1252279712,1252279712,1,8,0
33494202@N04,1972,4,1252296548,1252296961,2,8,413
33494202@N04,1972,14,1252290794,1252290794,1,8,0
33494202@N04,1972,11,1252276753,1252277772,10,8,1019
33494202@N04,1972,2,1252283243,1252283243,1,8,0
33494202@N04,1973,5,1252659424,1252664071,7,1,4647
33507605@N03,1974,10,1250060224,1250060566,7,5,342
33507605@N03,1974,4,1250053265,1250059861,7,5,6596
33507605@N03,1974,8,1250087442,1250089070,5,5,1628
33507605@N03,1974,15,1250052702,1250062444,7,5,9742
33507605@N03,1974,13,1250063034,1250067259,6,5,4225
33507605@N03,1975,15,1250165608,1250165654,2,1,46
33507605@N03,1976,8,1250260102,1250260276,5,3,174
33507605@N03,1976,5,1250260611,1250260611,1,3,0
33507605@N03,1976,13,1250256214,1250256936,2,3,722
33515112@N00,1977,1,1382917652,1382917652,1,1,0
33539876@N06,1978,11,1261471229,1261471229,1,1,0
33546659@N08,1979,7,1323740241,1323740241,1,1,0
33546659@N08,1980,11,1323855942,1323855942,1,4,0
33546659@N08,1980,16,1323833736,1323833736,1,4,0
33546659@N08,1980,2,1323836989,1323836989,1,4,0
33546659@N08,1980,8,1323854253,1323854253,1,4,0
33563310@N06,1981,17,1349429577,1349429577,1,6,0
33563310@N06,1981,5,1349428324,1349428324,1,6,0
33563310@N06,1981,13,1349429922,1349429922,1,6,0
33563310@N06,1981,9,1349427256,1349427256,1,6,0
33563310@N06,1981,11,1349424333,1349433288,4,6,8955
33563310@N06,1981,1,1349427882,1349448821,4,6,20939
33563310@N06,1982,17,1357121040,1357121058,3,2,18
33563310@N06,1982,11,1357118301,1357125090,2,2,6789
33590021@N04,1983,11,1327731758,1327731758,1,1,0
33593400@N04,1984,16,1326271524,1326271524,1,1,0
33598193@N03,1985,8,1325340094,1325340094,1,1,0
33598193@N03,1986,2,1368265039,1368265039,1,1,0
33598193@N03,1987,1,1379917458,1379917458,1,1,0
33598193@N03,1988,13,1381205013,1381205013,1,3,0
33598193@N03,1988,15,1381204744,1381204744,1,3,0
33598193@N03,1988,9,1381204424,1381204424,1,3,0
33598193@N03,1989,14,1389423206,1389423206,1,1,0
33598193@N03,1990,11,1394269823,1394269823,1,2,0
33598193@N03,1990,15,1394269276,1394269276,1,2,0
33598193@N03,1991,5,1394409996,1394409996,1,1,0
33598193@N03,1992,11,1394494666,1394494666,1,1,0
33598193@N03,1993,11,1395461960,1395461960,1,1,0
33598193@N03,1994,13,1396153182,1396153182,1,1,0
33598193@N03,1995,8,1412164646,1412164777,2,1,131
33598193@N03,1996,11,1463285271,1463285271,1,1,0
33623158@N04,1997,11,1230197356,1230197356,1,1,0
33636257@N06,1998,13,1415924580,1415924580,1,1,0
33667899@N07,1999,11,1318455875,1318482646,4,2,26771
33667899@N07,1999,8,1318470519,1318472460,2,2,1941
33667899@N07,2000,8,1318838646,1318838646,1,2,0
33667899@N07,2000,11,1318838709,1318838715,2,2,6
33667899@N07,2001,9,1349927204,1349928029,2,3,825
33667899@N07,2001,11,1349916367,1349916367,1,3,0
33667899@N07,2001,12,1349913892,1349914008,2,3,116
33667899@N07,2002,2,1350282521,1350282521,1,3,0
33667899@N07,2002,8,1350292402,1350292402,1,3,0
33667899@N07,2002,11,1350278548,1350279425,2,3,877
33667899@N07,2003,7,1382091301,1382091306,2,4,5
33667899@N07,2003,8,1382087152,1382087152,1,4,0
33667899@N07,2003,14,1382090921,1382090921,1,4,0
33667899@N07,2003,11,1382079944,1382079944,1,4,0
33700145@N05,2004,13,1278925754,1278929472,7,5,3718
33700145@N05,2004,11,1278937790,1278937790,1,5,0
33700145@N05,2004,17,1278927534,1278928877,4,5,1343
33700145@N05,2004,15,1278927553,1278929205,9,5,1652
33700145@N05,2004,6,1278922010,1278922157,3,5,147
33700145@N05,2005,13,1279015899,1279015899,1,1,0
33704098@N00,2006,11,1389220348,1389220360,2,5,12
33704098@N00,2006,10,1389226645,1389226655,2,5,10
33704098@N00,2006,15,1389228089,1389228144,2,5,55
33704098@N00,2006,13,1389228471,1389228616,3,5,145
33704098@N00,2006,8,1389242530,1389244180,4,5,1650
33719077@N06,2007,17,1323680143,1323682867,3,1,2724
33719077@N06,2008,5,1323935623,1323935623,1,2,0
33719077@N06,2008,11,1323934159,1323934841,5,2,682
33719077@N06,2009,1,1390863124,1390863124,1,3,0
33719077@N06,2009,2,1390872124,1390872124,2,3,0
33719077@N06,2009,12,1390872717,1390872717,2,3,0
33719077@N06,2010,16,1391224942,1391224983,2,2,41
33719077@N06,2010,1,1391216045,1391216945,5,2,900
33722213@N06,2011,15,1355823400,1355823400,1,1,0
33725927@N00,2012,7,1299017967,1299017967,1,1,0
33754377@N03,2013,11,1363507760,1363507760,1,1,0
33754377@N03,2014,17,1395542806,1395542819,2,7,13
33754377@N03,2014,8,1395542843,1395542851,2,7,8
33754377@N03,2014,3,1395542388,1395542388,1,7,0
33754377@N03,2014,11,1395541807,1395543238,11,7,1431
33754377@N03,2014,5,1395541847,1395541847,1,7,0
33754377@N03,2014,13,1395541753,1395542964,4,7,1211
33754377@N03,2014,15,1395541835,1395541835,1,7,0
33754377@N03,2015,8,1396145224,1396145224,1,2,0
33754377@N03,2015,13,1396145214,1396145214,1,2,0
33754377@N03,2016,9,1412993171,1412995045,3,1,1874
33754377@N03,2017,16,1414721000,1414721000,1,2,0
33754377@N03,2017,9,1414723877,1414723877,1,2,0
33754377@N03,2018,9,1415489652,1415490660,2,1,1008
33754377@N03,2019,8,1425693707,1425693707,1,2,0
33754377@N03,2019,13,1425686395,1425688263,2,2,1868
33754377@N03,2020,8,1425799368,1425799392,2,1,24
33754377@N03,2021,11,1443868677,1443868677,1,1,0
33754377@N03,2022,6,1444544964,1444544964,1,1,0
33754377@N03,2023,11,1445056007,1445056007,1,1,0
33754377@N03,2024,11,1445745363,1445745363,1,1,0
33765978@N00,2025,5,1204074447,1204074897,5,5,450
33765978@N00,2025,17,1204103322,1204103492,5,5,170
33765978@N00,2025,8,1204078220,1204080640,12,5,2420
33765978@N00,2025,13,1204102508,1204102508,1,5,0
33765978@N00,2025,10,1204096360,1204096526,4,5,166
33786609@N02,2026,11,1437032853,1437032853,1,3,0
33786609@N02,2026,2,1437034815,1437037703,5,3,2888
33786609@N02,2026,15,1437036302,1437036333,2,3,31
33817868@N00,2027,11,1268877445,1268877445,1,1,0
33822743@N08,2028,11,1230306655,1230331973,2,1,25318
33822743@N08,2029,11,1257741377,1257741907,5,1,530
33822743@N08,2030,11,1259895898,1259896252,4,1,354
33822743@N08,2031,6,1273230594,1273230594,1,2,0
33822743@N08,2031,11,1273226980,1273226980,1,2,0
33822743@N08,2032,8,1273876775,1273876775,1,1,0
33822743@N08,2033,4,1274665017,1274665017,1,1,0
33822743@N08,2034,11,1275004661,1275004661,1,1,0
33822743@N08,2035,17,1289014931,1289014931,1,1,0
33822743@N08,2036,5,1291618111,1291618111,1,1,0
33822743@N08,2037,17,1297993568,1297993568,1,1,0
33822883@N06,2038,16,1231450305,1231450305,1,1,0
33824882@N07,2039,17,1398049217,1398049217,1,1,0
33877234@N07,2040,10,1211405897,1211407796,4,1,1899
33877234@N07,2041,5,1211441810,1211441810,1,1,0
33912195@N05,2042,11,1305616906,1305616906,1,1,0
33929547@N03,2043,11,1431059289,1431061512,3,2,2223
33929547@N03,2043,9,1431060707,1431060707,1,2,0
33931717@N03,2044,8,1230344642,1230344642,1,2,0
33931717@N03,2044,4,1230351021,1230351500,3,2,479
33934966@N00,2045,9,1290239931,1290242486,2,7,2555
33934966@N00,2045,11,1290237635,1290256575,5,7,18940
33934966@N00,2045,13,1290255339,1290255339,1,7,0
33934966@N00,2045,10,1290255954,1290255954,1,7,0
33934966@N00,2045,5,1290252149,1290253197,11,7,1048
33934966@N00,2045,8,1290250402,1290252050,4,7,1648
33934966@N00,2045,15,1290247286,1290255643,4,7,8357
33934966@N00,2046,13,1290580541,1290581498,4,3,957
33934966@N00,2046,14,1290567684,1290577487,5,3,9803
33934966@N00,2046,10,1290579992,1290579992,1,3,0
33934966@N00,2047,11,1320219550,1320219763,2,6,213
33934966@N00,2047,4,1320204324,1320204324,1,6,0
33934966@N00,2047,2,1320205889,1320205926,2,6,37
33934966@N00,2047,1,1320201753,1320201753,1,6,0
33934966@N00,2047,8,1320215708,1320215757,2,6,49
33934966@N00,2047,5,1320214028,1320214028,1,6,0
33934966@N00,2048,11,1320587940,1320589371,3,1,1431
33971415@N07,2049,13,1248683716,1248683843,2,2,127
33971415@N07,2049,8,1248685119,1248685119,1,2,0
34003939@N08,2050,6,1356084070,1356084077,2,1,7
34008523@N06,2051,1,1292938448,1292938448,1,1,0
34008756@N07,2052,17,1268886673,1268886673,1,1,0
34012582@N04,2053,11,1209718316,1209718316,1,1,0
34021154@N00,2054,1,1300761697,1300761697,1,2,0
34021154@N00,2054,11,1300771333,1300771333,1,2,0
34038355@N06,2055,17,1353024610,1353024610,1,3,0
34038355@N06,2055,13,1353024902,1353024902,1,3,0
34038355@N06,2055,11,1353019707,1353020770,5,3,1063
34056195@N00,2056,17,1341829043,1341829043,1,1,0
34091054@N00,2057,13,1286929018,1286929018,1,2,0
34091054@N00,2057,17,1286928624,1286928624,1,2,0
34104198@N06,2058,11,1350706283,1350706283,1,1,0
34104198@N06,2059,8,1379257254,1379257254,1,1,0
34127338@N04,2060,11,1445740213,1445785526,251,1,45313
34153311@N05,2061,11,1318751704,1318751706,2,1,2
34153311@N05,2062,11,1361084328,1361084328,1,2,0
34153311@N05,2062,12,1361080307,1361080515,2,2,208
34153311@N05,2063,11,1361173594,1361173594,1,1,0
34153311@N05,2064,14,1361256817,1361260654,7,1,3837
34153311@N05,2065,5,1361434327,1361434327,1,1,0
34153311@N05,2066,11,1408158215,1408178778,8,2,20563
34153311@N05,2066,12,1408159045,1408159051,3,2,6
34153311@N05,2067,2,1408419260,1408419272,3,2,12
34153311@N05,2067,1,1408402423,1408402474,2,2,51
34153311@N05,2068,2,1408518930,1408519141,15,1,211
34157227@N04,2069,13,1319178610,1319178623,3,1,13
34157227@N04,2070,2,1324523114,1324523255,2,1,141
34168306@N08,2071,8,1296477260,1296477260,1,1,0
34176066@N00,2072,2,1319591659,1319594868,7,2,3209
34176066@N00,2072,11,1319595458,1319595821,6,2,363
34176066@N00,2073,1,1319629719,1319629720,2,1,1
34239398@N00,2074,12,1197527362,1197527362,1,3,0
34239398@N00,2074,16,1197520454,1197520454,1,3,0
34239398@N00,2074,1,1197550800,1197550800,1,3,0
34361916@N00,2075,13,1339670279,1339670279,1,2,0
34361916@N00,2075,16,1339657906,1339657906,1,2,0
34387526@N02,2076,16,1253431010,1253431010,1,1,0
34390084@N07,2077,11,1200249105,1200249133,2,1,28
34390084@N07,2078,11,1231787718,1231796109,6,1,8391
34390084@N07,2079,9,1234856857,1234856885,2,5,28
34390084@N07,2079,5,1234854445,1234854445,1,5,0
34390084@N07,2079,11,1234840705,1234858388,5,5,17683
34390084@N07,2079,8,1234852751,1234852751,1,5,0
34390084@N07,2079,2,1234855327,1234855436,2,5,109
34390084@N07,2080,5,1235634511,1235634511,1,2,0
34390084@N07,2080,8,1235635875,1235635875,1,2,0
34390084@N07,2081,11,1236566148,1236566148,1,1,0
34390084@N07,2082,5,1238467641,1238467641,1,4,0
34390084@N07,2082,16,1238465844,1238465844,1,4,0
34390084@N07,2082,8,1238468059,1238468059,1,4,0
34390084@N07,2082,11,1238466044,1238473418,6,4,7374
34390084@N07,2083,13,1238740857,1238740857,1,4,0
34390084@N07,2083,16,1238738449,1238738449,1,4,0
34390084@N07,2083,8,1238739666,1238739666,1,4,0
34390084@N07,2083,11,1238736650,1238737079,7,4,429
34390084@N07,2084,10,1238801756,1238801795,2,1,39
34390084@N07,2085,9,1239162139,1239162139,1,3,0
34390084@N07,2085,16,1239162005,1239162005,1,3,0
34390084@N07,2085,11,1239160052,1239170976,4,3,10924
34390084@N07,2086,10,1241224346,1241224428,2,1,82
34390084@N07,2087,5,1260593811,1260594106,3,1,295
34396244@N05,2088,11,1249048800,1249048800,1,1,0
34396697@N00,2089,6,1329991584,1329991938,2,1,354
34396697@N00,2090,9,1334192599,1334192599,1,1,0
34407909@N07,2091,2,1202157627,1202159777,2,1,2150
34444521@N03,2092,8,1317767154,1317767154,1,1,0
34463478@N08,2093,11,1364085152,1364085152,1,1,0
34482114@N07,2094,17,1398887430,1398887430,1,1,0
34486247@N00,2095,11,1234230619,1234230619,1,1,0
34595143@N07,2096,7,1294047081,1294047081,1,1,0
34659812@N03,2097,17,1246878491,1246878491,1,1,0
34664691@N03,2098,5,1301708317,1301708317,1,1,0
34677189@N07,2099,5,1459840991,1459840991,1,1,0
34695134@N00,2100,17,1197869897,1197871194,4,2,1297
34695134@N00,2100,5,1197855794,1197855794,1,2,0
34703628@N00,2101,6,1300584722,1300584722,1,1,0
34709732@N08,2102,11,1373677629,1373677662,2,2,33
34709732@N08,2102,10,1373692273,1373692273,1,2,0
34727974@N05,2103,17,1291867510,1291869355,6,2,1845
34727974@N05,2103,8,1291861505,1291874941,5,2,13436
34736908@N05,2104,8,1318766436,1318766436,1,1,0
34737607@N00,2105,10,1234347749,1234347912,6,5,163
34737607@N00,2105,1,1234338709,1234344802,16,5,6093
34737607@N00,2105,13,1234350661,1234350923,3,5,262
34737607@N00,2105,5,1234336120,1234336193,3,5,73
34737607@N00,2105,11,1234331346,1234359758,20,5,28412
34748748@N02,2106,5,1295000076,1295016972,7,2,16896
34748748@N02,2106,13,1295013894,1295013894,1,2,0
34771728@N00,2107,11,1200781579,1200815326,2,3,33747
34771728@N00,2107,8,1200799560,1200812800,2,3,13240
34771728@N00,2107,5,1200803719,1200803719,1,3,0
34866307@N05,2108,14,1323579288,1323579288,1,1,0
34982494@N06,2109,16,1295932105,1295932105,1,1,0
35034348373@N01,2110,10,1363837587,1363837587,1,2,0
35034348373@N01,2110,11,1363830542,1363854391,2,2,23849
35034348373@N01,2111,11,1364009600,1364009600,1,1,0
35034348373@N01,2112,11,1364374930,1364374959,3,1,29
35034348373@N01,2113,16,1364606296,1364606920,2,2,624
35034348373@N01,2113,8,1364610102,1364610641,3,2,539
35034354650@N01,2114,17,1301026676,1301027194,2,4,518
35034354650@N01,2114,5,1301014694,1301014694,1,4,0
35034354650@N01,2114,11,1301006136,1301030125,4,4,23989
35034354650@N01,2114,8,1301020496,1301020496,1,4,0
35034363370@N01,2115,12,1414796031,1414797538,8,15,1507
35034363370@N01,2115,5,1414816628,1414816655,2,15,27
35034363370@N01,2115,1,1414793452,1414793843,9,15,391
35034363370@N01,2115,9,1414812761,1414813179,3,15,418
35034363370@N01,2115,8,1414816308,1414816358,2,15,50
35034363370@N01,2115,2,1414795283,1414808838,6,15,13555
35034363370@N01,2115,13,1414805015,1414815002,4,15,9987
35034363370@N01,2115,15,1414805447,1414805447,1,15,0
35034363370@N01,2115,16,1414811377,1414812798,5,15,1421
35034363370@N01,2115,17,1414804745,1414814497,5,15,9752
35034363370@N01,2115,3,1414800514,1414800514,1,15,0
35034363370@N01,2115,7,1414797905,1414798035,3,15,130
35034363370@N01,2115,11,1414792599,1414808967,12,15,16368
35034363370@N01,2115,14,1414800285,1414800324,3,15,39
35034363370@N01,2115,4,1414806532,1414806532,1,15,0
35034364890@N01,2116,13,1194510925,1194510925,1,1,0
35034364890@N01,2117,5,1194584610,1194584821,2,10,211
35034364890@N01,2117,1,1194579114,1194584011,3,10,4897
35034364890@N01,2117,9,1194565558,1194583637,3,10,18079
35034364890@N01,2117,8,1194589403,1194589403,1,10,0
35034364890@N01,2117,2,1194571625,1194573288,3,10,1663
35034364890@N01,2117,16,1194568032,1194571225,2,10,3193
35034364890@N01,2117,17,1194597233,1194603245,2,10,6012
35034364890@N01,2117,3,1194575701,1194575805,4,10,104
35034364890@N01,2117,11,1194613416,1194613488,3,10,72
35034364890@N01,2117,14,1194575591,1194575591,1,10,0
35041397@N00,2118,11,1309514740,1309514740,1,2,0
35041397@N00,2118,2,1309509890,1309511511,4,2,1621
35071666@N00,2119,11,1351984151,1351984151,1,2,0
35071666@N00,2119,9,1351995452,1351995452,1,2,0
35082889@N05,2120,6,1415336871,1415345967,2,1,9096
35122574@N00,2121,11,1222726666,1222727318,9,1,652
35144236@N07,2122,13,1326348274,1326348274,1,1,0
35209467@N02,2123,11,1295645627,1295645627,1,2,0
35209467@N02,2123,2,1295649805,1295654174,4,2,4369
35209467@N02,2124,11,1295683046,1295683046,1,1,0
35261894@N00,2125,15,1404375975,1404382453,10,8,6478
35261894@N00,2125,5,1404348495,1404348590,4,8,95
35261894@N00,2125,8,1404345323,1404359739,26,8,14416
35261894@N00,2125,13,1404382192,1404382252,2,8,60
35261894@N00,2125,1,1404362519,1404362768,2,8,249
35261894@N00,2125,2,1404370418,1404371038,19,8,620
35261894@N00,2125,17,1404382590,1404382782,4,8,192
35261894@N00,2125,11,1404347387,1404372871,17,8,25484
35285073@N08,2126,11,1414311066,1414311066,1,1,0
35285073@N08,2127,11,1424859050,1424859050,1,2,0
35285073@N08,2127,8,1424857133,1424857133,1,2,0
35285073@N08,2128,4,1425459419,1425459419,1,3,0
35285073@N08,2128,17,1425457267,1425457267,1,3,0
35285073@N08,2128,11,1425452260,1425460763,3,3,8503
35313641@N02,2129,8,1297870849,1297870862,2,1,13
35356940@N00,2130,9,1393718184,1393718184,1,7,0
35356940@N00,2130,3,1393711943,1393712554,2,7,611
35356940@N00,2130,17,1393728954,1393732768,7,7,3814
35356940@N00,2130,1,1393715573,1393716353,3,7,780
35356940@N00,2130,10,1393726878,1393731880,3,7,5002
35356940@N00,2130,13,1393733824,1393734286,3,7,462
35356940@N00,2130,11,1393711008,1393725991,4,7,14983
35378947@N07,2131,11,1205060822,1205096177,85,1,35355
35378947@N07,2132,11,1205334907,1205350445,19,1,15538
35378947@N07,2133,11,1205432914,1205435964,4,1,3050
35378947@N07,2134,11,1233812670,1233812670,1,1,0
35378947@N07,2135,11,1233960757,1233971197,23,1,10440
35378947@N07,2136,11,1234134504,1234173924,42,1,39420
35378947@N07,2137,11,1234342189,1234347105,8,1,4916
35378947@N07,2138,11,1234396960,1234396960,1,1,0
35378947@N07,2139,11,1260324270,1260324270,1,2,0
35378947@N07,2139,17,1260340580,1260346728,3,2,6148
35378947@N07,2140,15,1260405874,1260405956,3,2,82
35378947@N07,2140,11,1260397421,1260409999,5,2,12578
35378947@N07,2141,17,1281605744,1281607707,4,4,1963
35378947@N07,2141,9,1281617138,1281617138,1,4,0
35378947@N07,2141,4,1281569807,1281614583,3,4,44776
35378947@N07,2141,11,1281582259,1281616381,5,4,34122
35378947@N07,2142,13,1281750905,1281751011,3,3,106
35378947@N07,2142,17,1281756609,1281756609,1,3,0
35378947@N07,2142,15,1281750377,1281750430,5,3,53
35378947@N07,2143,15,1284798373,1284798373,1,1,0
35378947@N07,2144,14,1285032790,1285032790,1,3,0
35378947@N07,2144,15,1285029277,1285029322,3,3,45
35378947@N07,2144,11,1285031247,1285031247,1,3,0
35378947@N07,2145,17,1304915076,1304916771,5,8,1695
35378947@N07,2145,5,1304911213,1304928454,3,8,17241
35378947@N07,2145,10,1304926447,1304926527,3,8,80
35378947@N07,2145,16,1304910210,1304910210,1,8,0
35378947@N07,2145,4,1304904036,1304904036,1,8,0
35378947@N07,2145,1,1304907400,1304910867,2,8,3467
35378947@N07,2145,15,1304913544,1304914531,2,8,987
35378947@N07,2145,11,1304900573,1304924650,5,8,24077
35378947@N07,2146,4,1305292284,1305292284,1,1,0
35378947@N07,2147,4,1305333121,1305338886,2,2,5765
35378947@N07,2147,11,1305333252,1305337039,5,2,3787
35378947@N07,2148,15,1305508394,1305514001,5,1,5607
35378947@N07,2149,5,1305702702,1305702702,1,5,0
35378947@N07,2149,10,1305687636,1305695259,2,5,7623
35378947@N07,2149,16,1305681411,1305681411,1,5,0
35378947@N07,2149,11,1305686620,1305686620,1,5,0
35378947@N07,2149,4,1305698898,1305698898,1,5,0
35378947@N07,2150,3,1328483670,1328483670,1,2,0
35378947@N07,2150,7,1328493581,1328493581,1,2,0
35378947@N07,2151,10,1328609461,1328609760,2,1,299
35378947@N07,2152,15,1328834576,1328837875,2,2,3299
35378947@N07,2152,11,1328840188,1328840188,1,2,0
35380796@N03,2153,11,1230728400,1230728400,1,2,0
35380796@N03,2153,3,1230728400,1230728400,5,2,0
35380796@N03,2154,1,1292196097,1292210376,5,10,14279
35380796@N03,2154,10,1292224591,1292225104,3,10,513
35380796@N03,2154,11,1292198414,1292228829,6,10,30415
35380796@N03,2154,6,1292230925,1292234645,4,10,3720
35380796@N03,2154,5,1292211966,1292213981,4,10,2015
35380796@N03,2154,4,1292200818,1292208831,4,10,8013
35380796@N03,2154,3,1292203167,1292203547,12,10,380
35380796@N03,2154,13,1292218788,1292218788,1,10,0
35380796@N03,2154,16,1292195582,1292195609,2,10,27
35380796@N03,2154,2,1292228527,1292228527,1,10,0
35380796@N03,2155,1,1318573480,1318573488,2,10,8
35380796@N03,2155,10,1318565250,1318565250,1,10,0
35380796@N03,2155,11,1318578777,1318579634,6,10,857
35380796@N03,2155,5,1318555129,1318555646,2,10,517
35380796@N03,2155,4,1318549937,1318575988,3,10,26051
35380796@N03,2155,3,1318548265,1318548344,2,10,79
35380796@N03,2155,14,1318547800,1318548242,4,10,442
35380796@N03,2155,16,1318567463,1318571790,6,10,4327
35380796@N03,2155,2,1318548801,1318549290,3,10,489
35380796@N03,2155,17,1318565566,1318565573,2,10,7
35404547@N02,2156,11,1375144240,1375145217,2,3,977
35404547@N02,2156,8,1375159430,1375162782,2,3,3352
35404547@N02,2156,9,1375150415,1375151491,2,3,1076
35457947@N04,2157,11,1280191819,1280196782,2,4,4963
35457947@N04,2157,3,1280203579,1280203579,1,4,0
35457947@N04,2157,4,1280207933,1280207933,1,4,0
35457947@N04,2157,13,1280221160,1280228913,2,4,7753
35466736@N04,2158,11,1360556464,1360580291,34,1,23827
35468140399@N01,2159,11,1333071582,1333099060,6,1,27478
35473328@N00,2160,11,1197017800,1197018939,2,1,1139
35473328@N00,2161,8,1356435754,1356435754,1,1,0
35498711@N04,2162,2,1346115281,1346115353,2,4,72
35498711@N04,2162,13,1346137667,1346137667,1,4,0
35498711@N04,2162,9,1346132083,1346132083,1,4,0
35498711@N04,2162,5,1346123400,1346124361,2,4,961
35498711@N04,2163,10,1346650400,1346650400,1,4,0
35498711@N04,2163,13,1346642718,1346642718,1,4,0
35498711@N04,2163,4,1346653913,1346653913,1,4,0
35498711@N04,2163,15,1346650805,1346650805,1,4,0
35501722@N05,2164,10,1383964799,1383964799,1,1,0
35501722@N05,2165,5,1394704004,1394704004,1,2,0
35501722@N05,2165,11,1394688266,1394688266,1,2,0
35509457@N00,2166,8,1367660975,1367660975,1,1,0
35509457@N00,2167,3,1367879914,1367879914,1,1,0
35509457@N00,2168,11,1367923642,1367923642,1,1,0
35559589@N04,2169,8,1369303230,1369303230,1,2,0
35559589@N04,2169,11,1369275975,1369295209,2,2,19234
35617346@N02,2170,11,1375405913,1375405913,1,1,0
35617346@N02,2171,11,1375757641,1375757641,1,1,0
35629408@N03,2172,2,1248366727,1248368105,2,3,1378
35629408@N03,2172,3,1248369746,1248369746,1,3,0
35629408@N03,2172,8,1248378694,1248378982,2,3,288
35654250@N04,2173,11,1236782209,1236792619,32,1,10410
35665675@N04,2174,2,1197248768,1197248768,1,1,0
35674933@N03,2175,11,1228820460,1228820460,1,1,0
35721568@N00,2176,11,1221275634,1221283084,2,4,7450
35721568@N00,2176,8,1221293635,1221293893,3,4,258
35721568@N00,2176,17,1221299558,1221299558,1,4,0
35721568@N00,2176,3,1221281426,1221281426,1,4,0
35736481@N00,2177,13,1258511929,1258513456,6,8,1527
35736481@N00,2177,12,1258495413,1258499493,11,8,4080
35736481@N00,2177,8,1258533116,1258533116,1,8,0
35736481@N00,2177,4,1258509662,1258510379,7,8,717
35736481@N00,2177,15,1258510758,1258513678,11,8,2920
35736481@N00,2177,17,1258510548,1258510552,2,8,4
35736481@N00,2177,14,1258502674,1258507962,3,8,5288
35736481@N00,2177,11,1258493299,1258494658,5,8,1359
35736481@N00,2178,8,1258609762,1258610868,2,2,1106
35736481@N00,2178,11,1258597173,1258597173,1,2,0
35736481@N00,2179,8,1296181800,1296181954,3,7,154
35736481@N00,2179,13,1296192354,1296192354,1,7,0
35736481@N00,2179,5,1296187053,1296193150,3,7,6097
35736481@N00,2179,10,1296194466,1296194466,1,7,0
35736481@N00,2179,15,1296195919,1296197620,4,7,1701
35736481@N00,2179,14,1296171384,1296171384,1,7,0
35736481@N00,2179,11,1296170331,1296188179,4,7,17848
35736481@N00,2180,11,1296514488,1296554913,3,6,40425
35736481@N00,2180,9,1296515138,1296523927,6,6,8789
35736481@N00,2180,13,1296543544,1296551883,18,6,8339
35736481@N00,2180,5,1296526630,1296528008,3,6,1378
35736481@N00,2180,4,1296518521,1296519174,5,6,653
35736481@N00,2180,8,1296532901,1296532901,1,6,0
35737340@N08,2181,11,1370173192,1370173192,1,1,0
35758162@N00,2182,11,1194768116,1194768116,1,4,0
35758162@N00,2182,8,1194768127,1194768127,1,4,0
35758162@N00,2182,9,1194768121,1194768123,2,4,2
35758162@N00,2182,4,1194768119,1194768119,1,4,0
35772202@N00,2183,11,1448801125,1448801125,1,1,0
35808173@N04,2184,11,1358897783,1358897783,1,1,0
35808173@N04,2185,11,1359001400,1359001400,1,1,0
35816811@N04,2186,14,1379362514,1379362514,1,1,0
35816811@N04,2187,14,1379402814,1379402814,1,1,0
35816811@N04,2188,7,1389164783,1389164783,1,2,0
35816811@N04,2188,8,1389139809,1389139809,1,2,0
35838612@N03,2189,5,1328589194,1328589194,1,1,0
35853462@N00,2190,11,1231304091,1231304091,1,1,0
35853462@N00,2191,13,1283592195,1283594760,3,4,2565
35853462@N00,2191,1,1283579098,1283597494,2,4,18396
35853462@N00,2191,15,1283589782,1283589782,1,4,0
35853462@N00,2191,17,1283588439,1283590463,5,4,2024
35853462@N00,2192,13,1283751293,1283751790,4,5,497
35853462@N00,2192,4,1283744466,1283744466,1,5,0
35853462@N00,2192,3,1283740998,1283740998,1,5,0
35853462@N00,2192,15,1283749687,1283749687,1,5,0
35853462@N00,2192,17,1283749676,1283751290,2,5,1614
35853462@N00,2193,11,1283937932,1283938513,3,1,581
35853462@N00,2194,14,1284090225,1284090573,12,4,348
35853462@N00,2194,3,1284087073,1284090752,9,4,3679
35853462@N00,2194,2,1284087828,1284096119,3,4,8291
35853462@N00,2194,11,1284081164,1284103519,6,4,22355
35853462@N00,2195,13,1284174062,1284174064,2,2,2
35853462@N00,2195,17,1284179370,1284179432,6,2,62
35853462@N00,2196,13,1388905710,1388908147,8,2,2437
35853462@N00,2196,11,1388904272,1388904272,1,2,0
35853462@N00,2197,5,1388978680,1388978683,2,3,3
35853462@N00,2197,8,1388978490,1388978600,4,3,110
35853462@N00,2197,11,1388975454,1388975454,1,3,0
35853462@N00,2198,1,1389051689,1389052001,2,6,312
35853462@N00,2198,5,1389068415,1389068415,1,6,0
35853462@N00,2198,3,1389057037,1389057037,1,6,0
35853462@N00,2198,17,1389068848,1389068848,1,6,0
35853462@N00,2198,8,1389069372,1389069372,1,6,0
35853462@N00,2198,11,1389087767,1389087767,1,6,0
35853462@N00,2199,13,1389328507,1389328735,7,4,228
35853462@N00,2199,4,1389322554,1389322584,18,4,30
35853462@N00,2199,7,1389323656,1389323731,7,4,75
35853462@N00,2199,11,1389322584,1389323324,3,4,740
35853462@N00,2200,3,1389412945,1389412945,1,5,0
35853462@N00,2200,5,1389409825,1389409825,1,5,0
35853462@N00,2200,13,1389405202,1389405202,1,5,0
35853462@N00,2200,6,1389406031,1389407613,4,5,1582
35853462@N00,2200,11,1389415464,1389415464,1,5,0
35872939@N00,2201,15,1233638674,1233638674,1,7,0
35872939@N00,2201,4,1233629697,1233629697,1,7,0
35872939@N00,2201,12,1233622340,1233625506,2,7,3166
35872939@N00,2201,13,1233638093,1233638093,1,7,0
35872939@N00,2201,10,1233638780,1233638780,1,7,0
35872939@N00,2201,5,1233632493,1233632493,1,7,0
35872939@N00,2201,8,1233633602,1233634317,4,7,715
35872939@N00,2202,15,1267494917,1267496540,7,4,1623
35872939@N00,2202,4,1267501465,1267501465,1,4,0
35872939@N00,2202,2,1267491718,1267491718,1,4,0
35872939@N00,2202,11,1267490270,1267490270,1,4,0
35872939@N00,2203,12,1267664846,1267681723,4,4,16877
35872939@N00,2203,16,1267668286,1267669263,11,4,977
35872939@N00,2203,2,1267661909,1267666627,2,4,4718
35872939@N00,2203,9,1267667790,1267674300,2,4,6510
35872939@N00,2204,15,1364263279,1364263279,1,1,0
35888901@N00,2205,13,1325158597,1325158597,1,2,0
35888901@N00,2205,11,1325160726,1325162655,2,2,1929
35888901@N00,2206,9,1325396874,1325396874,1,2,0
35888901@N00,2206,8,1325413401,1325413401,1,2,0
35897523@N04,2207,8,1243219518,1243219518,1,2,0
35897523@N04,2207,11,1243212480,1243223909,3,2,11429
35897523@N04,2208,13,1251272115,1251272115,1,1,0
35897523@N04,2209,15,1251446567,1251446567,1,1,0
35897523@N04,2210,11,1314066916,1314067078,3,1,162
35897523@N04,2211,11,1314108037,1314108401,2,1,364
35897587@N08,2212,1,1402196254,1402196254,1,1,0
35928519@N00,2213,1,1260877991,1260877991,1,1,0
35928519@N00,2214,17,1323141731,1323141731,1,1,0
35928519@N00,2215,11,1323316883,1323316883,1,1,0
35928519@N00,2216,9,1323403266,1323403266,1,1,0
35928519@N00,2217,13,1385874529,1385879779,2,1,5250
35928519@N00,2218,11,1385951601,1385951601,1,1,0
35928519@N00,2219,2,1386061461,1386061461,1,1,0
35928519@N00,2220,9,1386188105,1386209319,2,7,21214
35928519@N00,2220,14,1386198571,1386198674,2,7,103
35928519@N00,2220,7,1386190920,1386204911,2,7,13991
35928519@N00,2220,11,1386244413,1386244413,1,7,0
35928519@N00,2220,5,1386219373,1386219373,1,7,0
35928519@N00,2220,3,1386193810,1386193810,1,7,0
35928519@N00,2220,1,1386187215,1386187215,1,7,0
35928519@N00,2221,13,1386298701,1386303636,3,2,4935
35928519@N00,2221,11,1386306932,1386326071,3,2,19139
36017094@N04,2222,1,1358574976,1358575387,4,4,411
36017094@N04,2222,8,1358570504,1358570522,6,4,18
36017094@N04,2222,5,1358572239,1358572239,1,4,0
36017094@N04,2222,10,1358571101,1358571101,2,4,0
36041393@N06,2223,5,1415410409,1415410523,2,4,114
36041393@N06,2223,11,1415427506,1415428962,4,4,1456
36041393@N06,2223,6,1415412406,1415412566,2,4,160
36041393@N06,2223,8,1415411646,1415411646,1,4,0
36041393@N06,2224,12,1415691876,1415691876,1,2,0
36041393@N06,2224,2,1415692178,1415692178,1,2,0
36048845@N06,2225,2,1392775791,1392775791,1,2,0
36048845@N06,2225,11,1392771596,1392795352,2,2,23756
36101699901@N01,2226,8,1317522560,1317522560,1,1,0
36101699901@N01,2227,6,1334911427,1334911427,1,1,0
36112910@N02,2228,11,1355712446,1355712446,1,1,0
36125909@N00,2229,8,1232565708,1232565708,1,3,0
36125909@N00,2229,5,1232578606,1232578606,1,3,0
36125909@N00,2229,1,1232575722,1232575769,2,3,47
36191363@N00,2230,8,1214831828,1214833500,4,1,1672
36226805@N03,2231,11,1221978664,1221978664,1,3,0
36226805@N03,2231,6,1221981648,1221981648,1,3,0
36226805@N03,2231,7,1221969194,1221970430,2,3,1236
36226805@N03,2232,13,1242498217,1242498217,1,1,0
36226805@N03,2233,5,1253433287,1253433287,1,2,0
36226805@N03,2233,3,1253441791,1253441791,1,2,0
36226805@N03,2234,11,1253527774,1253527774,1,1,0
36226805@N03,2235,15,1284883405,1284883405,1,1,0
36226805@N03,2236,8,1285233838,1285233838,1,1,0
36226805@N03,2237,1,1316325629,1316325629,1,11,0
36226805@N03,2237,12,1316316853,1316321989,9,11,5136
36226805@N03,2237,9,1316325513,1316331332,7,11,5819
36226805@N03,2237,2,1316321273,1316321927,4,11,654
36226805@N03,2237,11,1316322158,1316344406,6,11,22248
36226805@N03,2237,8,1316330360,1316330458,2,11,98
36226805@N03,2237,6,1316335367,1316335367,1,11,0
36226805@N03,2237,3,1316315839,1316324392,4,11,8553
36226805@N03,2237,14,1316315831,1316324427,5,11,8596
36226805@N03,2237,16,1316344200,1316344200,1,11,0
36226805@N03,2237,5,1316326913,1316330663,7,11,3750
36226805@N03,2238,4,1316776719,1316777849,3,7,1130
36226805@N03,2238,1,1316757178,1316757178,1,7,0
36226805@N03,2238,2,1316779945,1316779945,1,7,0
36226805@N03,2238,11,1316757121,1316780242,7,7,23121
36226805@N03,2238,6,1316761934,1316763783,4,7,1849
36226805@N03,2238,10,1316761059,1316761059,1,7,0
36226805@N03,2238,3,1316777663,1316777663,1,7,0
36226805@N03,2239,11,1347454224,1347454448,6,3,224
36226805@N03,2239,3,1347444962,1347445223,2,3,261
36226805@N03,2239,16,1347445242,1347445242,1,3,0
36226805@N03,2240,15,1347610904,1347610904,1,6,0
36226805@N03,2240,9,1347621366,1347621366,1,6,0
36226805@N03,2240,12,1347621366,1347621366,1,6,0
36226805@N03,2240,13,1347612017,1347617889,3,6,5872
36226805@N03,2240,10,1347611140,1347611140,1,6,0
36226805@N03,2240,11,1347621505,1347621597,4,6,92
36226805@N03,2241,3,1378607762,1378628247,10,7,20485
36226805@N03,2241,7,1378614974,1378614974,1,7,0
36226805@N03,2241,14,1378627392,1378629205,5,7,1813
36226805@N03,2241,16,1378617409,1378617697,3,7,288
36226805@N03,2241,1,1378617708,1378623435,5,7,5727
36226805@N03,2241,9,1378616297,1378619245,9,7,2948
36226805@N03,2241,11,1378607492,1378617805,4,7,10313
36226805@N03,2242,3,1378713277,1378713277,1,3,0
36226805@N03,2242,11,1378712149,1378723329,6,3,11180
36226805@N03,2242,6,1378714541,1378721754,5,3,7213
36226805@N03,2243,3,1379041909,1379056774,9,12,14865
36226805@N03,2243,15,1379067628,1379067628,1,12,0
36226805@N03,2243,5,1379057263,1379057282,2,12,19
36226805@N03,2243,14,1379043893,1379045950,4,12,2057
36226805@N03,2243,1,1379051937,1379055254,4,12,3317
36226805@N03,2243,9,1379052024,1379052382,5,12,358
36226805@N03,2243,4,1379046483,1379046633,2,12,150
36226805@N03,2243,13,1379060144,1379067374,6,12,7230
36226805@N03,2243,10,1379048421,1379048482,2,12,61
36226805@N03,2243,11,1379041387,1379069373,9,12,27986
36226805@N03,2243,6,1379059824,1379059824,1,12,0
36226805@N03,2243,8,1379058195,1379059018,19,12,823
36231632@N00,2244,11,1432253513,1432253513,1,1,0
36255480@N08,2245,15,1382183620,1382183620,1,1,0
36310471@N04,2246,11,1386324515,1386324515,1,1,0
36319399@N00,2247,5,1232615253,1232615253,1,2,0
36319399@N00,2247,11,1232604142,1232604142,1,2,0
36399194@N03,2248,11,1389303408,1389303408,1,1,0
36399194@N03,2249,11,1389496856,1389496856,1,1,0
36459656@N00,2250,1,1360927371,1360927528,5,1,157
36521963326@N01,2251,12,1361150839,1361150839,1,2,0
36521963326@N01,2251,11,1361155864,1361155864,1,2,0
36521965790@N01,2252,11,1285239576,1285239576,1,1,0
36521978259@N01,2253,11,1304329809,1304329809,1,1,0
36524061@N04,2254,11,1320492474,1320492474,1,1,0
36607954@N05,2255,10,1246436549,1246436549,1,9,0
36607954@N05,2255,9,1246422323,1246422719,4,9,396
36607954@N05,2255,4,1246430506,1246430511,2,9,5
36607954@N05,2255,14,1246434615,1246435614,5,9,999
36607954@N05,2255,11,1246418969,1246448301,10,9,29332
36607954@N05,2255,1,1246422175,1246422175,1,9,0
36607954@N05,2255,16,1246427014,1246427014,1,9,0
36607954@N05,2255,6,1246445661,1246447180,17,9,1519
36607954@N05,2255,8,1246441205,1246441205,1,9,0
36607954@N05,2256,2,1246955509,1246955509,1,7,0
36607954@N05,2256,11,1246955452,1246955452,1,7,0
36607954@N05,2256,13,1246961824,1246962427,2,7,603
36607954@N05,2256,14,1246953455,1246954198,11,7,743
36607954@N05,2256,5,1246956701,1246959731,3,7,3030
36607954@N05,2256,6,1246960740,1246960838,2,7,98
36607954@N05,2256,8,1246960681,1246960681,1,7,0
36662788@N00,2257,11,1258239183,1258239183,1,1,0
36671802@N04,2258,11,1364358706,1364379417,72,1,20711
36671802@N04,2259,11,1425863201,1425885924,35,1,22723
36671802@N04,2260,11,1426068353,1426069044,15,1,691
36675073@N02,2261,11,1250159747,1250159747,1,1,0
36694655@N08,2262,1,1402217832,1402217832,1,1,0
36694655@N08,2263,9,1402472887,1402472887,1,7,0
36694655@N08,2263,4,1402467524,1402467524,1,7,0
36694655@N08,2263,3,1402449037,1402449897,2,7,860
36694655@N08,2263,1,1402449000,1402449013,2,7,13
36694655@N08,2263,16,1402469455,1402469455,1,7,0
36694655@N08,2263,11,1402443181,1402455102,2,7,11921
36694655@N08,2263,2,1402455125,1402455125,1,7,0
36694655@N08,2264,8,1402548984,1402549048,3,5,64
36694655@N08,2264,17,1402557161,1402557180,2,5,19
36694655@N08,2264,13,1402554147,1402554147,1,5,0
36694655@N08,2264,5,1402547787,1402547829,3,5,42
36694655@N08,2264,10,1402558439,1402558460,2,5,21
36702908@N05,2265,10,1421720859,1421720899,4,6,40
36702908@N05,2265,2,1421712287,1421745396,15,6,33109
36702908@N05,2265,17,1421722247,1421722262,2,6,15
36702908@N05,2265,3,1421717243,1421717243,1,6,0
36702908@N05,2265,11,1421709608,1421709608,1,6,0
36702908@N05,2265,4,1421719884,1421720188,3,6,304
36702908@N05,2266,8,1421989094,1421989094,1,3,0
36702908@N05,2266,17,1421983096,1421984096,2,3,1000
36702908@N05,2266,3,1421978430,1421978430,1,3,0
36702908@N05,2267,13,1422320334,1422321443,4,1,1109
36702908@N05,2268,11,1422428204,1422428204,1,2,0
36702908@N05,2268,15,1422412206,1422412241,4,2,35
36735086@N07,2269,17,1252207893,1252207893,1,3,0
36735086@N07,2269,15,1252207850,1252207886,2,3,36
36735086@N07,2269,1,1252217244,1252217296,4,3,52
36771701@N00,2270,11,1392350371,1392364378,7,1,14007
36801190@N00,2271,11,1357340089,1357340089,1,1,0
36814245@N00,2272,8,1325315730,1325315730,1,1,0
36819642@N00,2273,11,1200089802,1200089802,1,1,0
36864630@N00,2274,11,1370306150,1370306150,1,1,0
36864630@N00,2275,11,1401839811,1401839811,1,1,0
36895960@N00,2276,11,1422947517,1422947517,1,1,0
36911028@N00,2277,2,1410671300,1410671300,1,3,0
36911028@N00,2277,10,1410681781,1410681781,1,3,0
36911028@N00,2277,5,1410676909,1410676909,1,3,0
36916766@N08,2278,13,1275887415,1275887415,1,1,0
36916766@N08,2279,9,1276329333,1276329341,2,2,8
36916766@N08,2279,17,1276329302,1276329326,3,2,24
36916766@N08,2280,6,1285921879,1285924047,3,1,2168
36916766@N08,2281,13,1287721795,1287721795,1,1,0
36916766@N08,2282,6,1287820166,1287820166,1,2,0
36916766@N08,2282,17,1287811023,1287811175,3,2,152
36916766@N08,2283,10,1319280060,1319280060,1,3,0
36916766@N08,2283,15,1319277997,1319277997,1,3,0
36916766@N08,2283,17,1319258721,1319261754,3,3,3033
36964870@N00,2284,11,1445413386,1445413386,1,1,0
37020356@N06,2285,11,1307263166,1307264474,4,1,1308
37046031@N00,2286,9,1225748769,1225748769,1,6,0
37046031@N00,2286,14,1225753201,1225753201,1,6,0
37046031@N00,2286,11,1225765336,1225765362,3,6,26
37046031@N00,2286,12,1225758041,1225759723,5,6,1682
37046031@N00,2286,2,1225748739,1225748739,1,6,0
37046031@N00,2286,5,1225761177,1225762041,5,6,864
37046031@N00,2287,11,1225807658,1225815568,5,2,7910
37046031@N00,2287,13,1225809437,1225814987,3,2,5550
37046031@N00,2288,17,1226138473,1226138500,2,2,27
37046031@N00,2288,11,1226139629,1226139629,1,2,0
37046031@N00,2289,17,1226225352,1226225445,3,2,93
37046031@N00,2289,13,1226221650,1226221980,3,2,330
37046031@N00,2290,11,1226384502,1226389532,2,3,5030
37046031@N00,2290,5,1226395495,1226398688,2,3,3193
37046031@N00,2290,16,1226385776,1226388423,3,3,2647
37046031@N00,2291,11,1226667600,1226667600,1,1,0
37046031@N00,2292,5,1236256589,1236256589,1,1,0
37084921@N04,2293,13,1336182243,1336182243,1,1,0
37084963@N08,2294,11,1393572898,1393572898,1,1,0
37088822@N00,2295,11,1236937889,1236937960,4,2,71
37088822@N00,2295,2,1236932713,1236932769,5,2,56
37088822@N00,2296,10,1237444333,1237444458,10,2,125
37088822@N00,2296,11,1237451173,1237451295,11,2,122
37097738@N02,2297,5,1444300547,1444300547,1,2,0
37097738@N02,2297,8,1444300373,1444300403,2,2,30
37097738@N02,2298,2,1450155046,1450156680,7,10,1634
37097738@N02,2298,14,1450157224,1450157240,2,10,16
37097738@N02,2298,10,1450167948,1450167948,1,10,0
37097738@N02,2298,15,1450167157,1450167157,1,10,0
37097738@N02,2298,5,1450158506,1450159035,2,10,529
37097738@N02,2298,8,1450160429,1450160683,5,10,254
37097738@N02,2298,3,1450156739,1450157501,6,10,762
37097738@N02,2298,11,1450153568,1450178242,7,10,24674
37097738@N02,2298,13,1450166522,1450166612,3,10,90
37097738@N02,2298,17,1450167187,1450167299,2,10,112
37159320@N00,2299,11,1274408150,1274408150,1,3,0
37159320@N00,2299,6,1274428688,1274428688,1,3,0
37159320@N00,2299,5,1274424268,1274424268,1,3,0
37159320@N00,2300,11,1274667713,1274667713,1,1,0
37159320@N00,2301,11,1345592635,1345592635,1,2,0
37159320@N00,2301,10,1345600800,1345600800,1,2,0
37159320@N00,2302,6,1345634436,1345634436,1,1,0
37159320@N00,2303,11,1360022426,1360022426,1,1,0
37159320@N00,2304,5,1360459020,1360459020,1,1,0
37159320@N00,2305,1,1360664152,1360664152,1,2,0
37159320@N00,2305,10,1360656626,1360656626,1,2,0
37159320@N00,2306,11,1379207676,1379207980,2,2,304
37159320@N00,2306,5,1379227737,1379227935,3,2,198
37159320@N00,2307,4,1379295160,1379295160,1,1,0
37159320@N00,2308,11,1379495360,1379496131,3,4,771
37159320@N00,2308,2,1379500570,1379502460,2,4,1890
37159320@N00,2308,4,1379506539,1379506660,2,4,121
37159320@N00,2308,5,1379469593,1379469593,1,4,0
37182874@N04,2309,12,1259021479,1259021479,1,1,0
37186095@N08,2310,14,1306119379,1306119379,1,3,0
37186095@N08,2310,16,1306112444,1306112444,1,3,0
37186095@N08,2310,1,1306111948,1306111948,1,3,0
37186095@N08,2311,11,1306150777,1306150777,1,1,0
37186095@N08,2312,13,1306652816,1306652816,1,1,0
37186095@N08,2313,11,1308830002,1308830002,1,1,0
37186095@N08,2314,4,1317544057,1317544057,1,6,0
37186095@N08,2314,1,1317543153,1317543153,1,6,0
37186095@N08,2314,11,1317513666,1317553180,3,6,39514
37186095@N08,2314,12,1317538711,1317539307,3,6,596
37186095@N08,2314,2,1317537339,1317537339,1,6,0
37186095@N08,2314,13,1317517798,1317517798,1,6,0
37186095@N08,2315,4,1330660778,1330661283,2,11,505
37186095@N08,2315,17,1330662689,1330662703,2,11,14
37186095@N08,2315,15,1330662858,1330662890,2,11,32
37186095@N08,2315,11,1330654967,1330655482,4,11,515
37186095@N08,2315,10,1330662696,1330662696,1,11,0
37186095@N08,2315,12,1330652129,1330652746,2,11,617
37186095@N08,2315,16,1330657359,1330657359,1,11,0
37186095@N08,2315,9,1330640714,1330641194,2,11,480
37186095@N08,2315,13,1330662993,1330663081,2,11,88
37186095@N08,2315,5,1330679082,1330679082,1,11,0
37186095@N08,2315,14,1330645526,1330645526,1,11,0
37216383@N05,2316,17,1338599841,1338599862,3,2,21
37216383@N05,2316,15,1338597400,1338598324,3,2,924
37216383@N05,2317,17,1348187956,1348187956,2,1,0
37216383@N05,2318,17,1348923587,1348923587,1,1,0
37216383@N05,2319,15,1349046460,1349046509,3,1,49
37216383@N05,2320,17,1350458226,1350458226,1,1,0
37216383@N05,2321,17,1351731329,1351731329,1,1,0
37216383@N05,2322,15,1352076251,1352076261,2,1,10
37216383@N05,2323,15,1364706643,1364706643,1,2,0
37216383@N05,2323,17,1364730363,1364730363,1,2,0
37230837@N04,2324,17,1371356287,1371356287,1,1,0
37242378@N02,2325,17,1245300219,1245300260,3,1,41
37274056@N05,2326,5,1295334452,1295334746,7,1,294
37274056@N05,2327,1,1295594855,1295598942,2,2,4087
37274056@N05,2327,9,1295599967,1295599980,2,2,13
37287420@N08,2328,11,1325311657,1325311657,1,2,0
37287420@N08,2328,8,1325326421,1325327419,2,2,998
37288603@N08,2329,3,1239276820,1239276833,2,1,13
37306398@N08,2330,6,1319263078,1319263078,2,1,0
37306398@N08,2331,2,1389429156,1389429182,2,1,26
37324769@N06,2332,4,1255562840,1255562840,1,1,0
37335919@N02,2333,8,1237346971,1237346971,1,3,0
37335919@N02,2333,10,1237344975,1237345122,2,3,147
37335919@N02,2333,15,1237344241,1237344241,1,3,0
37335919@N02,2334,8,1243735868,1243735868,1,1,0
37504803@N00,2335,10,1200891107,1200892949,2,3,1842
37504803@N00,2335,11,1200886889,1200887074,2,3,185
37504803@N00,2335,17,1200893303,1200893303,1,3,0
37515566@N00,2336,6,1447673914,1447673914,1,2,0
37515566@N00,2336,11,1447677630,1447677630,1,2,0
37541950@N08,2337,11,1286181078,1286181429,8,1,351
37553034@N03,2338,8,1313993127,1313993127,1,3,0
37553034@N03,2338,11,1313962290,1313962290,1,3,0
37553034@N03,2338,3,1313975794,1313975794,1,3,0
37553034@N03,2339,8,1315641546,1315641546,1,2,0
37553034@N03,2339,5,1315641829,1315641829,1,2,0
37553034@N03,2340,13,1317277682,1317277755,2,1,73
37553034@N03,2341,4,1317352214,1317352214,1,1,0
37556258@N03,2342,11,1256373719,1256374998,2,1,1279
37556258@N03,2343,6,1257403777,1257407243,2,3,3466
37556258@N03,2343,11,1257402845,1257402845,1,3,0
37556258@N03,2343,13,1257403502,1257403502,1,3,0
37561427@N04,2344,11,1345433079,1345438180,3,1,5101
37561427@N04,2345,11,1345482474,1345483082,3,1,608
37572076@N08,2346,17,1329536324,1329536324,1,1,0
37585370@N00,2347,11,1263592129,1263592129,1,1,0
37595844@N08,2348,11,1287147558,1287147558,1,5,0
37595844@N08,2348,8,1287137215,1287137215,1,5,0
37595844@N08,2348,10,1287123832,1287123832,1,5,0
37595844@N08,2348,5,1287109252,1287131150,6,5,21898
37595844@N08,2348,17,1287137063,1287144406,3,5,7343
37606273@N07,2349,17,1360808906,1360808906,1,1,0
37620552@N06,2350,11,1368103056,1368103056,1,1,0
37620552@N06,2351,11,1368162314,1368162314,1,1,0
37620552@N06,2352,1,1368194397,1368194397,1,1,0
37657436@N04,2353,2,1262291112,1262291112,1,2,0
37657436@N04,2353,15,1262292101,1262292101,1,2,0
37657436@N04,2354,15,1262450883,1262451241,3,2,358
37657436@N04,2354,13,1262449905,1262450429,6,2,524
37657436@N04,2355,11,1262483095,1262484500,3,1,1405
37657436@N04,2356,17,1262736995,1262737247,4,2,252
37657436@N04,2356,13,1262737556,1262738574,2,2,1018
37657436@N04,2357,17,1310178796,1310178796,1,3,0
37657436@N04,2357,11,1310182540,1310190921,5,3,8381
37657436@N04,2357,15,1310178934,1310179131,3,3,197
37657436@N04,2358,10,1461714773,1461714810,2,2,37
37657436@N04,2358,5,1461713832,1461714142,2,2,310
37657436@N04,2359,1,1461789106,1461789280,3,1,174
37657436@N04,2360,8,1461834624,1461834858,2,4,234
37657436@N04,2360,13,1461837423,1461837423,1,4,0
37657436@N04,2360,17,1461837649,1461837649,1,4,0
37657436@N04,2360,10,1461837835,1461837835,1,4,0
37657436@N04,2361,11,1461871678,1461871678,1,1,0
37673257@N06,2362,11,1369525748,1369525748,1,1,0
37700500@N04,2363,8,1250264836,1250264836,1,1,0
37709784@N00,2364,11,1239170686,1239170698,2,2,12
37709784@N00,2364,7,1239175061,1239175061,1,2,0
37714481@N00,2365,1,1189483550,1189483550,1,3,0
37714481@N00,2365,7,1189493363,1189500530,4,3,7167
37714481@N00,2365,2,1189484069,1189485130,5,3,1061
37718677660@N01,2366,15,1290572724,1290572724,1,1,0
37729827@N05,2367,3,1337562326,1337564947,13,4,2621
37729827@N05,2367,5,1337575940,1337579177,6,4,3237
37729827@N05,2367,7,1337562348,1337565480,3,4,3132
37729827@N05,2367,4,1337567715,1337567770,6,4,55
37729827@N05,2368,5,1337684479,1337685106,4,1,627
37747991@N02,2369,11,1240710668,1240710668,1,1,0
37775700@N02,2370,11,1265370476,1265370476,1,1,0
37775700@N02,2371,13,1274555099,1274555099,1,1,0
37775700@N02,2372,8,1304023881,1304023881,1,2,0
37775700@N02,2372,9,1304019020,1304019020,1,2,0
37775700@N02,2373,13,1304174910,1304174910,1,1,0
37785868@N05,2374,11,1273885400,1273885400,1,1,0
37841068@N04,2375,8,1303544263,1303544263,1,1,0
37869753@N06,2376,8,1312855420,1312856107,5,2,687
37869753@N06,2376,1,1312870730,1312870749,2,2,19
37896708@N06,2377,11,1394821869,1394821869,1,1,0
37908196@N07,2378,10,1329610143,1329610143,1,3,0
37908196@N07,2378,13,1329610798,1329610798,1,3,0
37908196@N07,2378,11,1329617180,1329617180,1,3,0
37908196@N07,2379,11,1355270150,1355270150,1,1,0
37996603748@N01,2380,6,1418117197,1418117197,1,2,0
37996603748@N01,2380,11,1418104945,1418104945,1,2,0
37996654902@N01,2381,6,1355715444,1355716151,2,1,707
37998051@N00,2382,11,1278210936,1278210936,1,3,0
37998051@N00,2382,8,1278225275,1278225275,1,3,0
37998051@N00,2382,7,1278214687,1278214687,1,3,0
37998051@N00,2383,10,1278664664,1278664664,1,1,0
37998051@N00,2384,8,1310045163,1310045163,1,1,0
37998051@N00,2385,11,1334227955,1334227955,1,1,0
38022350@N04,2386,10,1241745603,1241745603,1,2,0
38022350@N04,2386,9,1241729168,1241729168,1,2,0
38022350@N04,2387,13,1241901596,1241901596,1,1,0
38067879@N08,2388,17,1323491081,1323491081,1,1,0
38067879@N08,2389,11,1348565897,1348565897,1,2,0
38067879@N08,2389,4,1348553331,1348553331,1,2,0
38067879@N08,2390,4,1349073446,1349073446,1,3,0
38067879@N08,2390,9,1349059620,1349059620,1,3,0
38067879@N08,2390,16,1349053717,1349053717,1,3,0
38067879@N08,2391,8,1363839759,1363839759,1,2,0
38067879@N08,2391,5,1363839393,1363839393,1,2,0
38067879@N08,2392,11,1368607559,1368607559,1,1,0
38067879@N08,2393,1,1368646936,1368646936,1,1,0
38067879@N08,2394,14,1368836542,1368836542,1,1,0
38067879@N08,2395,3,1412124514,1412124514,1,1,0
38067879@N08,2396,15,1449466484,1449466484,1,1,0
38067879@N08,2397,3,1457568200,1457568200,1,1,0
38084526@N06,2398,15,1229424995,1229424995,1,1,0
38084526@N06,2399,11,1230205555,1230205555,1,2,0
38084526@N06,2399,5,1230181354,1230181354,1,2,0
38084526@N06,2400,12,1240390150,1240390150,1,1,0
38084526@N06,2401,15,1241012634,1241012634,1,1,0
38084526@N06,2402,12,1284277101,1284277101,1,2,0
38084526@N06,2402,16,1284260664,1284260664,1,2,0
38084526@N06,2403,13,1315652444,1315652444,1,2,0
38084526@N06,2403,11,1315650790,1315650790,1,2,0
38088964@N00,2404,4,1330683356,1330683356,1,1,0
38090510@N06,2405,11,1246881013,1246881013,1,1,0
38102706@N05,2406,16,1200281030,1200281030,1,1,0
38102706@N05,2407,1,1238130420,1238133528,2,1,3108
38102706@N05,2408,13,1252729517,1252729522,2,1,5
38102706@N05,2409,4,1254639658,1254640850,2,2,1192
38102706@N05,2409,11,1254637508,1254644740,4,2,7232
38102706@N05,2410,11,1260086828,1260094909,12,1,8081
38102706@N05,2411,11,1260929696,1260929696,1,1,0
38102706@N05,2412,3,1261039099,1261039118,3,1,19
38102706@N05,2413,11,1262145635,1262145635,1,1,0
38102706@N05,2414,11,1263637361,1263637361,1,1,0
38102706@N05,2415,3,1263719290,1263719334,2,1,44
38102706@N05,2416,11,1266728278,1266728293,2,2,15
38102706@N05,2416,3,1266721192,1266721192,1,2,0
38102706@N05,2417,3,1267161112,1267177094,9,1,15982
38102706@N05,2418,3,1268710273,1268710677,2,1,404
38102706@N05,2419,11,1274001451,1274001451,1,1,0
38102706@N05,2420,4,1277545499,1277545499,1,1,0
38102706@N05,2421,3,1283739746,1283739746,1,1,0
38102706@N05,2422,4,1297500541,1297500541,1,1,0
38102706@N05,2423,6,1299474417,1299474417,1,1,0
38102706@N05,2424,11,1304239633,1304239633,1,1,0
38102706@N05,2425,8,1309770696,1309770696,1,2,0
38102706@N05,2425,2,1309789061,1309789356,2,2,295
38102706@N05,2426,3,1319357957,1319357957,1,1,0
38102706@N05,2427,17,1350897738,1350897738,1,1,0
38102706@N05,2428,10,1352698533,1352698533,1,1,0
38102706@N05,2429,8,1356952964,1356957081,4,1,4117
38102706@N05,2430,11,1360120334,1360120334,1,1,0
38102706@N05,2431,11,1364696353,1364696353,1,1,0
38102706@N05,2432,11,1368607962,1368607962,1,2,0
38102706@N05,2432,9,1368603261,1368603261,1,2,0
38102706@N05,2433,11,1369483337,1369483337,1,2,0
38102706@N05,2433,13,1369478291,1369478291,1,2,0
38102706@N05,2434,11,1379852379,1379852379,1,1,0
38102706@N05,2435,13,1388567297,1388567297,1,2,0
38102706@N05,2435,11,1388564002,1388564384,2,2,382
38102706@N05,2436,11,1390701887,1390701887,1,1,0
38102706@N05,2437,8,1402389690,1402389690,1,1,0
38117199@N07,2438,11,1253415793,1253415809,2,1,16
38153332@N00,2439,11,1372642546,1372642546,1,1,0
38189526@N02,2440,2,1241532001,1241532001,1,3,0
38189526@N02,2440,3,1241532002,1241532002,1,3,0
38189526@N02,2440,16,1241532003,1241532003,1,3,0
38194020@N00,2441,2,1219823079,1219829334,17,1,6255
38194020@N00,2442,12,1220004216,1220005187,4,2,971
38194020@N00,2442,5,1219982419,1219989157,9,2,6738
38194020@N00,2443,8,1220250899,1220251579,7,3,680
38194020@N00,2443,6,1220249625,1220249625,1,3,0
38194020@N00,2443,5,1220249310,1220249455,3,3,145
38194020@N00,2444,9,1220315140,1220315687,2,5,547
38194020@N00,2444,13,1220310141,1220310141,1,5,0
38194020@N00,2444,15,1220308493,1220309934,3,5,1441
38194020@N00,2444,11,1220307207,1220307207,1,5,0
38194020@N00,2444,1,1220314319,1220314801,9,5,482
38235069@N00,2445,2,1450836651,1450839828,16,2,3177
38235069@N00,2445,11,1450832062,1450832100,2,2,38
38235069@N00,2446,8,1451290421,1451290644,3,3,223
38235069@N00,2446,10,1451278749,1451279048,10,3,299
38235069@N00,2446,9,1451295427,1451295427,1,3,0
38257984@N04,2447,8,1337238099,1337238099,1,1,0
38275458@N05,2448,15,1244541947,1244541947,1,1,0
38308378@N05,2449,15,1291961050,1291961050,1,2,0
38308378@N05,2449,11,1291976408,1291976408,1,2,0
38331851@N00,2450,11,1466938059,1466940902,4,2,2843
38331851@N00,2450,2,1466940772,1466940772,1,2,0
38505413@N06,2451,11,1322348602,1322348602,1,1,0
38505413@N06,2452,15,1322802136,1322802136,1,3,0
38505413@N06,2452,5,1322782912,1322782912,1,3,0
38505413@N06,2452,13,1322819293,1322830419,2,3,11126
38505413@N06,2453,1,1324702613,1324702613,1,1,0
38555308@N02,2454,10,1318947145,1318947145,1,1,0
38604142@N08,2455,17,1317529680,1317529680,1,1,0
38646505@N03,2456,11,1456623333,1456623333,1,1,0
38653388@N00,2457,11,1426321197,1426321197,1,1,0
38773853@N06,2458,11,1342861396,1342861609,3,1,213
38773853@N06,2459,11,1342961910,1342961910,1,1,0
38803734@N06,2460,2,1408077104,1408077104,1,1,0
38806446@N05,2461,15,1435053130,1435057482,6,2,4352
38806446@N05,2461,10,1435051616,1435056294,10,2,4678
38848642@N00,2462,6,1217917717,1217917717,1,1,0
38848642@N00,2463,6,1217987181,1217988691,2,1,1510
38848642@N00,2464,12,1218098504,1218098504,1,1,0
38848642@N00,2465,6,1218175370,1218175370,1,1,0
38848642@N00,2466,5,1255577997,1255578008,2,2,11
38848642@N00,2466,15,1255586526,1255586526,1,2,0
38848642@N00,2467,17,1255860623,1255861559,3,2,936
38848642@N00,2467,6,1255862838,1255862858,2,2,20
38848642@N00,2468,11,1255952840,1255953146,5,1,306
38848642@N00,2469,8,1256295977,1256302164,22,1,6187
38848642@N00,2470,11,1338873550,1338900343,4,1,26793
38848642@N00,2471,11,1339133235,1339154795,20,1,21560
38848642@N00,2472,17,1339323042,1339323042,1,1,0
38848642@N00,2473,11,1339740881,1339748110,11,1,7229
38848642@N00,2474,11,1339807250,1339815573,7,1,8323
38879474@N04,2475,10,1242944076,1242944076,1,1,0
38879474@N04,2476,8,1288227814,1288227814,1,1,0
38879474@N04,2477,6,1350879169,1350879169,1,1,0
38879474@N04,2478,4,1380490962,1380490962,1,1,0
38880314@N07,2479,14,1189935762,1189935762,1,1,0
38937312@N00,2480,13,1449072277,1449072277,1,1,0
38937312@N00,2481,13,1449207114,1449207114,1,1,0
38959313@N02,2482,17,1398309537,1398309537,1,1,0
39008310@N05,2483,3,1368396002,1368396002,1,1,0
39024895@N00,2484,10,1309326002,1309326954,38,3,952
39024895@N00,2484,15,1309325537,1309325570,2,3,33
39024895@N00,2484,13,1309325151,1309325165,2,3,14
39037826@N00,2485,17,1449020602,1449020630,2,6,28
39037826@N00,2485,8,1449033941,1449034543,4,6,602
39037826@N00,2485,13,1449020785,1449022706,3,6,1921
39037826@N00,2485,10,1449016544,1449018931,15,6,2387
39037826@N00,2485,11,1449038512,1449038512,1,6,0
39037826@N00,2485,15,1449019755,1449020062,2,6,307
39039509@N05,2486,16,1267672846,1267672846,1,1,0
39078602@N04,2487,3,1464833892,1464835910,2,1,2018
39104390@N07,2488,11,1284950885,1284964389,2,1,13504
39146060@N00,2489,10,1188007634,1188007634,1,3,0
39146060@N00,2489,13,1188013378,1188013378,1,3,0
39146060@N00,2489,9,1188010388,1188010388,1,3,0
39146060@N00,2490,13,1188168218,1188168218,1,2,0
39146060@N00,2490,1,1188176984,1188176994,2,2,10
39146060@N00,2491,12,1190359502,1190359502,1,1,0
39146060@N00,2492,5,1190439446,1190444162,2,1,4716
39146060@N00,2493,7,1190587306,1190587306,1,4,0
39146060@N00,2493,8,1190614120,1190614174,2,4,54
39146060@N00,2493,17,1190619900,1190619903,2,4,3
39146060@N00,2493,10,1190593650,1190593892,6,4,242
39146060@N00,2494,5,1190848942,1190848942,1,6,0
39146060@N00,2494,13,1190854630,1190854630,1,6,0
39146060@N00,2494,11,1190843468,1190843468,1,6,0
39146060@N00,2494,8,1190850028,1190851228,7,6,1200
39146060@N00,2494,10,1190859966,1190860062,2,6,96
39146060@N00,2494,16,1190846108,1190860696,2,6,14588
39146060@N00,2495,6,1190968242,1190968242,1,11,0
39146060@N00,2495,12,1190973274,1190973274,1,11,0
39146060@N00,2495,8,1190970476,1190970596,2,11,120
39146060@N00,2495,1,1190971684,1190971684,1,11,0
39146060@N00,2495,4,1190973576,1190973576,1,11,0
39146060@N00,2495,5,1190970908,1190971000,3,11,92
39146060@N00,2495,2,1190972670,1190973036,4,11,366
39146060@N00,2495,9,1190971886,1190972006,4,11,120
39146060@N00,2495,11,1190968526,1190968526,1,11,0
39146060@N00,2495,17,1190975342,1190975342,1,11,0
39146060@N00,2495,10,1190974874,1190974874,1,11,0
39146060@N00,2496,7,1192266385,1192266385,1,9,0
39146060@N00,2496,13,1192266390,1192266390,1,9,0
39146060@N00,2496,4,1192266373,1192266418,3,9,45
39146060@N00,2496,9,1192266382,1192266384,3,9,2
39146060@N00,2496,11,1192266421,1192266426,2,9,5
39146060@N00,2496,1,1192266393,1192266406,2,9,13
39146060@N00,2496,15,1192266392,1192266392,1,9,0
39146060@N00,2496,16,1192266403,1192266403,1,9,0
39146060@N00,2496,3,1192266412,1192266412,1,9,0
39146060@N00,2497,6,1223126814,1223126814,1,7,0
39146060@N00,2497,1,1223126820,1223126827,6,7,7
39146060@N00,2497,4,1223126830,1223126830,1,7,0
39146060@N00,2497,2,1223126821,1223126821,1,7,0
39146060@N00,2497,9,1223126817,1223126818,3,7,1
39146060@N00,2497,3,1223126829,1223126829,1,7,0
39146060@N00,2497,17,1223126824,1223126824,1,7,0
39146060@N00,2498,13,1228834668,1228834668,1,5,0
39146060@N00,2498,4,1228831949,1228831949,1,5,0
39146060@N00,2498,11,1228828948,1228828994,3,5,46
39146060@N00,2498,17,1228835709,1228835709,1,5,0
39146060@N00,2498,10,1228833130,1228833130,1,5,0
39146060@N00,2499,11,1229116716,1229117098,2,1,382
39146060@N00,2500,15,1229249106,1229249116,2,3,10
39146060@N00,2500,4,1229260263,1229260263,1,3,0
39146060@N00,2500,16,1229246879,1229247067,2,3,188
39146060@N00,2501,5,1311566688,1311566688,1,1,0
39149225@N08,2502,9,1418791085,1418791085,1,2,0
39149225@N08,2502,11,1418786721,1418786721,1,2,0
39149225@N08,2503,10,1418938778,1418938914,4,1,136
39156069@N03,2504,4,1451452686,1451452688,2,2,2
39156069@N03,2504,5,1451457797,1451459197,8,2,1400
39179826@N04,2505,11,1302488575,1302488575,1,1,0
39181997@N08,2506,13,1316299232,1316299232,1,1,0
39276962@N07,2507,11,1265768938,1265771030,5,1,2092
39312075@N06,2508,15,1249866090,1249866090,1,2,0
39312075@N06,2508,4,1249856624,1249856624,1,2,0
39312075@N06,2509,5,1250164128,1250164128,1,2,0
39312075@N06,2509,17,1250160410,1250160410,1,2,0
39360988@N05,2510,5,1273969876,1273969876,1,2,0
39360988@N05,2510,13,1273970121,1273970121,1,2,0
39364877@N05,2511,17,1391159502,1391160509,3,1,1007
39478938@N03,2512,6,1231299461,1231299461,1,1,0
39482180@N00,2513,10,1257910573,1257910602,2,1,29
39487324@N08,2514,11,1334735859,1334735859,1,1,0
39635921@N02,2515,2,1313748020,1313748020,1,1,0
39707801@N00,2516,11,1195367829,1195367829,1,1,0
39803308@N08,2517,11,1451390460,1451390460,1,1,0
39864275@N02,2518,13,1417652687,1417652698,4,1,11
39893757@N00,2519,11,1409720408,1409720431,3,2,23
39893757@N00,2519,8,1409720254,1409720254,1,2,0
39909510@N07,2520,5,1233021868,1233021868,2,1,0
39953677@N06,2521,11,1348244253,1348244253,1,1,0
40048950@N04,2522,11,1337765042,1337775404,2,1,10362
40048950@N04,2523,4,1343465576,1343465576,1,1,0
40067092@N00,2524,11,1372206266,1372206266,1,1,0
40084924@N08,2525,15,1206153235,1206156073,3,2,2838
40084924@N08,2525,11,1206153352,1206173525,3,2,20173
40084924@N08,2526,15,1206219593,1206219593,1,1,0
40116549@N03,2527,16,1247298584,1247298591,2,1,7
40172365@N00,2528,13,1324877137,1324877182,2,2,45
40172365@N00,2528,11,1324856253,1324856253,1,2,0
40172365@N00,2529,13,1337820916,1337820916,1,1,0
40205611@N04,2530,11,1351078369,1351078369,1,1,0
40262057@N06,2531,7,1236640852,1236643703,2,10,2851
40262057@N06,2531,8,1236653028,1236654871,4,10,1843
40262057@N06,2531,1,1236637582,1236639504,11,10,1922
40262057@N06,2531,11,1236637114,1236637114,2,10,0
40262057@N06,2531,4,1236645812,1236647593,5,10,1781
40262057@N06,2531,5,1236651197,1236651375,3,10,178
40262057@N06,2531,17,1236655851,1236660947,2,10,5096
40262057@N06,2531,13,1236658440,1236659062,3,10,622
40262057@N06,2531,15,1236659355,1236659823,2,10,468
40262057@N06,2531,10,1236660212,1236678359,5,10,18147
40262057@N06,2532,2,1236820200,1236820215,2,2,15
40262057@N06,2532,11,1236819543,1236819762,6,2,219
40262057@N06,2533,11,1236853756,1236854242,10,1,486
40262057@N06,2534,11,1355007792,1355007792,1,1,0
40262057@N06,2535,2,1355191213,1355197145,5,2,5932
40262057@N06,2535,11,1355187366,1355188029,8,2,663
40279984@N00,2536,1,1395870261,1395870261,1,7,0
40279984@N00,2536,15,1395886873,1395886873,1,7,0
40279984@N00,2536,13,1395883288,1395883288,1,7,0
40279984@N00,2536,9,1395869547,1395869574,3,7,27
40279984@N00,2536,4,1395889739,1395889739,1,7,0
40279984@N00,2536,17,1395886975,1395886975,1,7,0
40279984@N00,2536,16,1395869183,1395869283,3,7,100
40286663@N06,2537,8,1254476639,1254476779,4,4,140
40286663@N06,2537,5,1254475824,1254475824,1,4,0
40286663@N06,2537,10,1254474294,1254474715,8,4,421
40286663@N06,2537,17,1254474052,1254474171,2,4,119
40303166@N06,2538,16,1288139083,1288139083,1,1,0
40303166@N06,2539,11,1288490437,1288515533,3,4,25096
40303166@N06,2539,5,1288478419,1288478613,2,4,194
40303166@N06,2539,8,1288481389,1288481389,1,4,0
40303166@N06,2539,15,1288488937,1288488937,1,4,0
40303166@N06,2540,6,1289027138,1289031189,18,1,4051
40303166@N06,2541,5,1289384461,1289384461,1,10,0
40303166@N06,2541,8,1289385213,1289385213,1,10,0
40303166@N06,2541,15,1289387787,1289387787,1,10,0
40303166@N06,2541,2,1289378332,1289378332,1,10,0
40303166@N06,2541,10,1289388088,1289388088,1,10,0
40303166@N06,2541,1,1289382594,1289382594,1,10,0
40303166@N06,2541,4,1289378754,1289379612,3,10,858
40303166@N06,2541,17,1289387970,1289387970,1,10,0
40303166@N06,2541,16,1289382285,1289382285,1,10,0
40303166@N06,2541,13,1289387597,1289387597,1,10,0
40356131@N04,2542,11,1247368902,1247368902,1,1,0
40437944@N00,2543,11,1389207456,1389213835,2,1,6379
40437944@N00,2544,11,1389291596,1389300068,2,1,8472
40437944@N00,2545,11,1389394739,1389394739,1,1,0
40437944@N00,2546,11,1389484931,1389484931,1,1,0
40547030@N00,2547,5,1393815033,1393815460,7,1,427
40563308@N02,2548,13,1250144715,1250144715,1,1,0
40563308@N02,2549,2,1250223994,1250226271,5,3,2277
40563308@N02,2549,15,1250230926,1250230926,1,3,0
40563308@N02,2549,8,1250200041,1250200041,1,3,0
40563308@N02,2550,11,1250539333,1250539333,1,1,0
40563308@N02,2551,2,1312438039,1312440204,4,1,2165
40563308@N02,2552,8,1312668096,1312668096,1,2,0
40563308@N02,2552,13,1312681077,1312681077,1,2,0
40563308@N02,2553,10,1312845063,1312845063,1,1,0
40563308@N02,2554,10,1340317271,1340317271,1,1,0
40571088@N00,2555,13,1463644467,1463647054,10,2,2587
40571088@N00,2555,5,1463626456,1463626522,6,2,66
40571088@N00,2556,11,1463723928,1463736027,12,7,12099
40571088@N00,2556,8,1463731219,1463731315,2,7,96
40571088@N00,2556,17,1463725798,1463725798,1,7,0
40571088@N00,2556,9,1463733459,1463733501,2,7,42
40571088@N00,2556,10,1463725442,1463725637,2,7,195
40571088@N00,2556,13,1463725936,1463726704,4,7,768
40571088@N00,2556,1,1463732482,1463733152,7,7,670
40598203@N08,2557,4,1210773694,1210773694,1,1,0
40598203@N08,2558,3,1279783449,1279783449,1,5,0
40598203@N08,2558,9,1279776631,1279806987,4,5,30356
40598203@N08,2558,16,1279806240,1279806240,1,5,0
40598203@N08,2558,11,1279769927,1279797122,7,5,27195
40598203@N08,2558,4,1279781050,1279781959,4,5,909
40610681@N06,2559,15,1387254692,1387254692,1,3,0
40610681@N06,2559,11,1387255020,1387255020,1,3,0
40610681@N06,2559,13,1387254757,1387254757,1,3,0
40646519@N00,2560,11,1191655561,1191656003,9,12,442
40646519@N00,2560,4,1191634161,1191634161,1,12,0
40646519@N00,2560,5,1191641655,1191642120,3,12,465
40646519@N00,2560,16,1191649712,1191649908,3,12,196
40646519@N00,2560,15,1191636240,1191636240,1,12,0
40646519@N00,2560,7,1191632203,1191632203,1,12,0
40646519@N00,2560,13,1191636208,1191636208,1,12,0
40646519@N00,2560,10,1191653348,1191653882,3,12,534
40646519@N00,2560,2,1191647389,1191647412,2,12,23
40646519@N00,2560,12,1191647812,1191649744,12,12,1932
40646519@N00,2560,17,1191635827,1191635827,1,12,0
40646519@N00,2560,3,1191633524,1191633524,1,12,0
40646519@N00,2561,11,1274570204,1274598920,11,12,28716
40646519@N00,2561,5,1274595927,1274597105,5,12,1178
40646519@N00,2561,7,1274572867,1274572867,1,12,0
40646519@N00,2561,13,1274583522,1274583583,2,12,61
40646519@N00,2561,8,1274592997,1274595412,7,12,2415
40646519@N00,2561,4,1274578559,1274582587,5,12,4028
40646519@N00,2561,10,1274583013,1274583027,2,12,14
40646519@N00,2561,2,1274576333,1274598609,8,12,22276
40646519@N00,2561,12,1274577634,1274577634,1,12,0
40646519@N00,2561,17,1274583169,1274583260,4,12,91
40646519@N00,2561,14,1274573815,1274573985,2,12,170
40646519@N00,2561,3,1274574468,1274580825,4,12,6357
40646519@N00,2562,11,1286411937,1286447391,10,11,35454
40646519@N00,2562,6,1286432664,1286432911,11,11,247
40646519@N00,2562,5,1286439367,1286442127,20,11,2760
40646519@N00,2562,15,1286424783,1286444244,10,11,19461
40646519@N00,2562,13,1286425942,1286428049,18,11,2107
40646519@N00,2562,8,1286436640,1286438079,6,11,1439
40646519@N00,2562,4,1286417486,1286420908,9,11,3422
40646519@N00,2562,10,1286423787,1286424349,5,11,562
40646519@N00,2562,2,1286417228,1286417473,4,11,245
40646519@N00,2562,12,1286415946,1286416454,2,11,508
40646519@N00,2562,17,1286423910,1286444387,7,11,20477
40646519@N00,2563,11,1320977354,1321007068,18,9,29714
40646519@N00,2563,5,1320988873,1320993349,35,9,4476
40646519@N00,2563,15,1320999875,1321000106,3,9,231
40646519@N00,2563,8,1320994400,1320994945,5,9,545
40646519@N00,2563,4,1320982314,1320983955,6,9,1641
40646519@N00,2563,10,1321000810,1321000810,1,9,0
40646519@N00,2563,2,1320984636,1321005168,3,9,20532
40646519@N00,2563,12,1320984958,1320986777,10,9,1819
40646519@N00,2563,17,1321000569,1321000569,1,9,0
40647915@N03,2564,2,1290384514,1290384514,1,1,0
40692503@N07,2565,8,1246668311,1246668311,1,1,0
40727760@N08,2566,11,1299747492,1299747492,1,1,0
40732558787@N01,2567,15,1327122008,1327122008,1,1,0
40732565660@N01,2568,11,1201935567,1201953626,10,2,18059
40732565660@N01,2568,12,1201937724,1201937724,1,2,0
40732565660@N01,2569,7,1238042430,1238042553,3,1,123
40732565660@N01,2570,7,1298783997,1298783999,2,1,2
40745887@N05,2571,14,1284685933,1284686084,4,2,151
40745887@N05,2571,4,1284687744,1284687744,1,2,0
40802704@N05,2572,11,1274230598,1274255782,33,1,25184
40802704@N05,2573,11,1274423205,1274423205,1,1,0
40812847@N05,2574,11,1396411563,1396411563,1,1,0
40814689@N00,2575,3,1451267847,1451267847,1,3,0
40814689@N00,2575,11,1451269808,1451269808,1,3,0
40814689@N00,2575,5,1451259673,1451259673,1,3,0
40827705@N04,2576,11,1208236518,1208236518,1,1,0
40897907@N08,2577,13,1354265716,1354286007,2,2,20291
40897907@N08,2577,15,1354306307,1354306307,1,2,0
40899173@N05,2578,11,1261831897,1261831897,1,1,0
40919416@N06,2579,11,1281306484,1281339072,10,1,32588
40919416@N06,2580,5,1326521021,1326522524,3,2,1503
40919416@N06,2580,15,1326522537,1326523093,3,2,556
40937461@N02,2581,6,1329299312,1329299312,1,9,0
40937461@N02,2581,2,1329270284,1329272928,2,9,2644
40937461@N02,2581,15,1329301354,1329301354,1,9,0
40937461@N02,2581,16,1329294510,1329297363,2,9,2853
40937461@N02,2581,8,1329285709,1329285968,2,9,259
40937461@N02,2581,11,1329260498,1329302083,2,9,41585
40937461@N02,2581,5,1329265539,1329268135,5,9,2596
40937461@N02,2581,13,1329288473,1329288682,3,9,209
40937461@N02,2581,1,1329262644,1329282467,3,9,19823
40937461@N02,2582,10,1329615711,1329624155,7,1,8444
40947197@N06,2583,11,1466685063,1466685063,1,1,0
40968098@N07,2584,3,1432295870,1432302441,4,10,6571
40968098@N07,2584,14,1432296650,1432296650,1,10,0
40968098@N07,2584,1,1432278924,1432280937,5,10,2013
40968098@N07,2584,2,1432283866,1432286352,6,10,2486
40968098@N07,2584,8,1432261982,1432264188,6,10,2206
40968098@N07,2584,11,1432279988,1432290860,8,10,10872
40968098@N07,2584,9,1432270865,1432279728,7,10,8863
40968098@N07,2584,17,1432302372,1432302372,1,10,0
40968098@N07,2584,4,1432286474,1432286559,2,10,85
40968098@N07,2584,13,1432302880,1432302916,2,10,36
40968098@N07,2585,1,1432380648,1432380648,1,2,0
40968098@N07,2585,8,1432355804,1432355804,1,2,0
40983857@N00,2586,11,1261170535,1261170535,1,1,0
40983857@N00,2587,11,1261204754,1261204754,1,1,0
41019626@N00,2588,11,1296606247,1296606247,1,1,0
41019626@N00,2589,11,1296637758,1296637843,2,1,85
41111981@N02,2590,5,1302506916,1302506916,1,1,0
41126359@N00,2591,4,1278720065,1278720065,1,2,0
41126359@N00,2591,3,1278724449,1278724449,1,2,0
41126359@N00,2592,8,1280565166,1280565166,1,1,0
41126359@N00,2593,8,1283506851,1283506851,1,3,0
41126359@N00,2593,16,1283500179,1283500179,1,3,0
41126359@N00,2593,11,1283517528,1283517751,2,3,223
41126359@N00,2594,6,1295176297,1295176297,1,1,0
41126359@N00,2595,11,1362647054,1362647054,1,1,0
41134616@N00,2596,11,1225147687,1225147698,2,4,11
41134616@N00,2596,16,1225178029,1225178029,1,4,0
41134616@N00,2596,9,1225168953,1225168953,1,4,0
41134616@N00,2596,2,1225153081,1225159638,6,4,6557
41134616@N00,2597,8,1225429510,1225429510,1,3,0
41134616@N00,2597,10,1225418992,1225418992,1,3,0
41134616@N00,2597,15,1225419091,1225420437,5,3,1346
41138825@N00,2598,17,1393492991,1393493125,3,2,134
41138825@N00,2598,11,1393492657,1393492900,3,2,243
41138825@N00,2599,11,1393653099,1393675114,6,1,22015
41197583@N00,2600,11,1250400301,1250400301,1,2,0
41197583@N00,2600,5,1250405040,1250405040,1,2,0
41197583@N00,2601,17,1250465781,1250465781,1,7,0
41197583@N00,2601,10,1250465377,1250465449,2,7,72
41197583@N00,2601,11,1250458392,1250458392,1,7,0
41197583@N00,2601,15,1250466066,1250466066,1,7,0
41197583@N00,2601,5,1250468919,1250468919,1,7,0
41197583@N00,2601,13,1250465984,1250465984,1,7,0
41197583@N00,2601,2,1250460477,1250460477,1,7,0
41211080@N02,2602,11,1336429336,1336429808,2,1,472
41221221@N02,2603,11,1212714067,1212714067,1,1,0
41236077@N02,2604,11,1326623447,1326623447,1,4,0
41236077@N02,2604,10,1326600597,1326600597,1,4,0
41236077@N02,2604,8,1326610366,1326610366,1,4,0
41236077@N02,2604,14,1326590085,1326590085,1,4,0
41236077@N02,2605,11,1335518606,1335518606,1,4,0
41236077@N02,2605,17,1335500407,1335500407,1,4,0
41236077@N02,2605,13,1335499742,1335499785,2,4,43
41236077@N02,2605,8,1335491385,1335494134,2,4,2749
41251621@N00,2606,11,1352386881,1352386881,1,1,0
41277655@N07,2607,8,1399250275,1399252383,2,1,2108
41299606@N00,2608,11,1425029146,1425029146,1,1,0
41335227@N00,2609,5,1360640439,1360640439,1,1,0
41365056@N00,2610,5,1251863989,1251863989,1,1,0
41365794@N07,2611,11,1310124954,1310124954,1,1,0
41395151@N04,2612,11,1325639504,1325639504,1,1,0
41396402@N03,2613,17,1396589743,1396590127,4,6,384
41396402@N03,2613,2,1396598256,1396599584,2,6,1328
41396402@N03,2613,11,1396568762,1396568762,1,6,0
41396402@N03,2613,1,1396575426,1396577341,2,6,1915
41396402@N03,2613,15,1396589645,1396589645,1,6,0
41396402@N03,2613,13,1396589233,1396589299,2,6,66
41407408@N00,2614,8,1272021007,1272021007,1,1,0
41407408@N00,2615,9,1273134688,1273134688,1,1,0
41407408@N00,2616,4,1277767175,1277767175,1,1,0
41407408@N00,2617,9,1306464627,1306464627,1,4,0
41407408@N00,2617,4,1306464948,1306465071,2,4,123
41407408@N00,2617,11,1306463587,1306463587,1,4,0
41407408@N00,2617,16,1306463305,1306463305,1,4,0
41407408@N00,2618,2,1375867753,1375867753,1,1,0
41407408@N00,2619,11,1416371287,1416371287,1,1,0
41407408@N00,2620,13,1419060818,1419060818,1,2,0
41407408@N00,2620,15,1419061042,1419061042,1,2,0
41419160@N03,2621,11,1256362117,1256362666,2,3,549
41419160@N03,2621,2,1256393819,1256393819,1,3,0
41419160@N03,2621,1,1256378361,1256378361,1,3,0
41427544@N00,2622,13,1298086621,1298086621,1,1,0
41454017@N05,2623,9,1310377534,1310377534,1,2,0
41454017@N05,2623,8,1310365101,1310365158,2,2,57
41491112@N00,2624,11,1192681667,1192681709,2,2,42
41491112@N00,2624,10,1192693955,1192693955,1,2,0
41508163@N07,2625,8,1307771811,1307771811,1,1,0
41545932@N02,2626,11,1356929223,1356929223,1,1,0
41545932@N02,2627,9,1357204294,1357204294,1,1,0
41610763@N04,2628,11,1326869376,1326869376,1,3,0
41610763@N04,2628,9,1326868061,1326868061,1,3,0
41610763@N04,2628,8,1326868700,1326868784,2,3,84
41624223@N08,2629,8,1338444433,1338444433,1,4,0
41624223@N08,2629,11,1338433033,1338433123,3,4,90
41624223@N08,2629,17,1338455886,1338456444,2,4,558
41624223@N08,2629,13,1338455305,1338455305,1,4,0
41644332@N07,2630,11,1263072153,1263072153,1,1,0
41644332@N07,2631,11,1263456527,1263458850,2,1,2323
41644332@N07,2632,11,1267160224,1267160224,1,1,0
41661621@N00,2633,13,1215236794,1215236794,1,1,0
41661621@N00,2634,2,1392094144,1392096004,18,8,1860
41661621@N00,2634,9,1392102625,1392102845,3,8,220
41661621@N00,2634,8,1392100894,1392101349,2,8,455
41661621@N00,2634,4,1392098241,1392098241,1,8,0
41661621@N00,2634,13,1392099496,1392099592,3,8,96
41661621@N00,2634,3,1392097062,1392097766,12,8,704
41661621@N00,2634,14,1392096829,1392096829,1,8,0
41661621@N00,2634,11,1392092338,1392104542,4,8,12204
41663556@N00,2635,13,1303029281,1303029281,1,6,0
41663556@N00,2635,8,1303010508,1303020846,2,6,10338
41663556@N00,2635,5,1303019114,1303019114,1,6,0
41663556@N00,2635,1,1303003409,1303016678,3,6,13269
41663556@N00,2635,9,1303005870,1303008942,5,6,3072
41663556@N00,2635,11,1302995607,1302996490,5,6,883
41685885@N05,2636,11,1291212933,1291212933,1,1,0
41693381@N00,2637,9,1292301987,1292302052,2,4,65
41693381@N00,2637,6,1292308090,1292315401,2,4,7311
41693381@N00,2637,3,1292298392,1292298392,1,4,0
41693381@N00,2637,2,1292293383,1292293383,1,4,0
41693381@N00,2638,11,1292383784,1292385167,2,2,1383
41693381@N00,2638,1,1292387927,1292387927,1,2,0
41693381@N00,2639,17,1292495594,1292495594,1,2,0
41693381@N00,2639,6,1292496051,1292496051,1,2,0
41693381@N00,2640,4,1337592972,1337592978,2,3,6
41693381@N00,2640,11,1337593811,1337593811,1,3,0
41693381@N00,2640,9,1337574723,1337574723,1,3,0
41693381@N00,2641,11,1337686996,1337686996,1,2,0
41693381@N00,2641,17,1337684548,1337685100,6,2,552
41693381@N00,2642,11,1349081808,1349081889,2,1,81
41693381@N00,2643,11,1365680746,1365680855,2,1,109
41693381@N00,2644,11,1408610718,1408610718,1,1,0
41693381@N00,2645,11,1419581644,1419581644,1,1,0
41693381@N00,2646,11,1423875784,1423875784,1,1,0
41693381@N00,2647,5,1425707723,1425707723,1,1,0
41693381@N00,2648,15,1426232285,1426232285,1,1,0
41693381@N00,2649,11,1427179937,1427179937,1,1,0
41693381@N00,2650,4,1430641004,1430641004,1,2,0
41693381@N00,2650,13,1430645801,1430645801,1,2,0
41693381@N00,2651,5,1438852413,1438858872,2,2,6459
41693381@N00,2651,11,1438860953,1438860953,1,2,0
41693381@N00,2652,5,1443251583,1443251583,1,1,0
41693381@N00,2653,11,1443606297,1443606297,1,2,0
41693381@N00,2653,16,1443596687,1443596687,1,2,0
41693381@N00,2654,13,1447542135,1447542135,1,1,0
41693381@N00,2655,5,1456555988,1456558517,3,1,2529
41693381@N00,2656,11,1459650434,1459650434,1,2,0
41693381@N00,2656,8,1459654549,1459654549,1,2,0
41693381@N00,2657,17,1460196675,1460196675,1,1,0
41693381@N00,2658,2,1464513534,1464513534,1,1,0
41808955@N00,2659,11,1288765470,1288765470,1,3,0
41808955@N00,2659,4,1288746766,1288746766,1,3,0
41808955@N00,2659,17,1288753217,1288753217,1,3,0
41850050@N02,2660,1,1307831368,1307831368,1,1,0
41872770@N05,2661,15,1272117602,1272117602,1,3,0
41872770@N05,2661,17,1272117600,1272117601,2,3,1
41872770@N05,2661,13,1272117603,1272117603,1,3,0
41872770@N05,2662,5,1272162958,1272162958,1,1,0
41894165897@N01,2663,11,1356651522,1356670751,2,2,19229
41894165897@N01,2663,15,1356674817,1356674817,1,2,0
41894178016@N01,2664,11,1345274369,1345274369,1,1,0
41894185936@N01,2665,11,1381449561,1381449561,1,1,0
41903519@N07,2666,2,1379692629,1379692629,1,3,0
41903519@N07,2666,13,1379693190,1379693190,1,3,0
41903519@N07,2666,15,1379674870,1379693249,2,3,18379
41903519@N07,2667,16,1380267725,1380267725,1,1,0
41903519@N07,2668,4,1411826635,1411826635,1,2,0
41903519@N07,2668,11,1411831488,1411831488,1,2,0
41967511@N00,2669,11,1244293444,1244293444,1,1,0
41972914@N07,2670,13,1342677951,1342678253,3,2,302
41972914@N07,2670,17,1342678249,1342678249,1,2,0
41976006@N02,2671,11,1401965136,1401965136,1,1,0
41995153@N08,2672,4,1277541990,1277541990,1,1,0
42034882@N00,2673,15,1365779387,1365779387,1,1,0
42034882@N00,2674,11,1365833476,1365833476,1,1,0
42045401@N00,2675,11,1350029538,1350029538,1,1,0
42048765@N03,2676,3,1247608938,1247608938,1,1,0
42048765@N03,2677,13,1343105066,1343105066,1,1,0
42048765@N03,2678,8,1398503877,1398503877,1,2,0
42048765@N03,2678,13,1398486208,1398486208,1,2,0
42118699@N08,2679,8,1210128568,1210128568,1,2,0
42118699@N08,2679,17,1210138195,1210138195,1,2,0
42118699@N08,2680,8,1254458592,1254458592,1,1,0
42118699@N08,2681,17,1254809447,1254809447,1,4,0
42118699@N08,2681,15,1254789913,1254789913,1,4,0
42118699@N08,2681,8,1254795403,1254796742,2,4,1339
42118699@N08,2681,10,1254786057,1254786057,1,4,0
42118699@N08,2682,9,1254873749,1254873749,1,1,0
42118699@N08,2683,13,1257810410,1257810410,1,1,0
42118699@N08,2684,16,1257997559,1257997559,1,3,0
42118699@N08,2684,2,1257993012,1257994618,6,3,1606
42118699@N08,2684,8,1257999875,1257999875,1,3,0
42118699@N08,2685,16,1286685702,1286685702,1,3,0
42118699@N08,2685,9,1286685079,1286685298,2,3,219
42118699@N08,2685,13,1286665210,1286665210,1,3,0
42118699@N08,2686,16,1286755532,1286755532,1,1,0
42118699@N08,2687,11,1286934567,1286934567,1,2,0
42118699@N08,2687,10,1286930642,1286930642,1,2,0
42118699@N08,2688,5,1305200387,1305200387,1,5,0
42118699@N08,2688,13,1305169705,1305169705,1,5,0
42118699@N08,2688,2,1305206039,1305206039,1,5,0
42118699@N08,2688,11,1305164828,1305197090,3,5,32262
42118699@N08,2688,10,1305167619,1305167619,1,5,0
42118699@N08,2689,8,1351140989,1351141108,2,1,119
42118699@N08,2690,13,1367379625,1367379625,1,2,0
42118699@N08,2690,17,1367375880,1367375880,1,2,0
42118699@N08,2691,11,1367522675,1367522762,2,4,87
42118699@N08,2691,16,1367551499,1367551499,1,4,0
42118699@N08,2691,17,1367524136,1367524334,2,4,198
42118699@N08,2691,9,1367551049,1367551049,1,4,0
42118699@N08,2692,8,1368235391,1368235528,2,1,137
42118699@N08,2693,13,1368423289,1368423289,1,1,0
42118699@N08,2694,8,1368485711,1368485711,1,1,0
42118699@N08,2695,17,1368603809,1368603809,1,1,0
42118699@N08,2696,8,1430023243,1430023243,1,1,0
42118699@N08,2697,11,1460277301,1460277301,1,2,0
42118699@N08,2697,10,1460288497,1460288497,1,2,0
42118699@N08,2698,13,1460449439,1460449439,1,1,0
42118699@N08,2699,17,1460501774,1460501774,1,1,0
42118699@N08,2700,13,1460612520,1460612520,1,1,0
42118699@N08,2701,9,1460693762,1460693762,1,1,0
42151752@N05,2702,8,1448426715,1448426715,1,5,0
42151752@N05,2702,11,1448390526,1448390526,1,5,0
42151752@N05,2702,17,1448403794,1448403794,1,5,0
42151752@N05,2702,2,1448433646,1448433646,1,5,0
42151752@N05,2702,1,1448392987,1448392987,1,5,0
42201001@N07,2703,8,1286951529,1286951529,1,1,0
42229053@N03,2704,11,1391217116,1391217116,1,1,0
42285443@N04,2705,5,1253014017,1253014017,1,1,0
42299049@N06,2706,1,1453726800,1453726800,1,1,0
42320709@N06,2707,11,1453848466,1453849423,2,1,957
42320709@N06,2708,11,1453881766,1453881766,1,1,0
42327762@N03,2709,13,1258170160,1258170272,3,2,112
42327762@N03,2709,8,1258165984,1258165984,1,2,0
42327762@N03,2710,16,1286247574,1286247574,1,2,0
42327762@N03,2710,5,1286253206,1286253206,1,2,0
42340071@N05,2711,8,1349666611,1349666611,1,3,0
42340071@N05,2711,17,1349671128,1349671128,1,3,0
42340071@N05,2711,11,1349662914,1349662914,1,3,0
42354918@N00,2712,2,1431521463,1431521463,1,1,0
42398872@N03,2713,11,1325482024,1325482024,1,2,0
42398872@N03,2713,1,1325502866,1325502866,1,2,0
42399173@N05,2714,15,1345364240,1345364240,1,1,0
42399173@N05,2715,11,1345885894,1345885933,3,2,39
42399173@N05,2715,16,1345871177,1345871198,4,2,21
42416044@N04,2716,9,1291941800,1291941800,1,1,0
42486569@N00,2717,8,1299978931,1299979427,2,2,496
42486569@N00,2717,16,1299976366,1299988203,6,2,11837
42486569@N00,2718,11,1300046011,1300046253,3,4,242
42486569@N00,2718,8,1300047159,1300051196,24,4,4037
42486569@N00,2718,13,1300060195,1300061908,8,4,1713
42486569@N00,2718,15,1300059914,1300060190,2,4,276
42491975@N04,2719,16,1469109601,1469109601,1,1,0
42493559@N07,2720,11,1282141874,1282141874,1,1,0
42533701@N00,2721,2,1215146000,1215148868,12,2,2868
42533701@N00,2721,8,1215155249,1215155358,3,2,109
42533701@N00,2722,11,1221637529,1221637529,1,1,0
42580834@N08,2723,13,1256530494,1256530494,1,8,0
42580834@N08,2723,12,1256513948,1256513975,2,8,27
42580834@N08,2723,4,1256523750,1256525677,8,8,1927
42580834@N08,2723,9,1256515342,1256515373,3,8,31
42580834@N08,2723,8,1256529398,1256529582,3,8,184
42580834@N08,2723,3,1256509456,1256523795,15,8,14339
42580834@N08,2723,16,1256520309,1256520309,1,8,0
42580834@N08,2723,2,1256511723,1256514137,3,8,2414
42580834@N08,2724,10,1256796642,1256796642,1,5,0
42580834@N08,2724,13,1256794511,1256794511,1,5,0
42580834@N08,2724,9,1256802238,1256802238,1,5,0
42580834@N08,2724,11,1256779113,1256779113,1,5,0
42580834@N08,2724,3,1256775673,1256775905,6,5,232
42580834@N08,2725,13,1350288116,1350288116,1,6,0
42580834@N08,2725,6,1350296187,1350296194,2,6,7
42580834@N08,2725,11,1350271736,1350297624,3,6,25888
42580834@N08,2725,16,1350271270,1350271270,1,6,0
42580834@N08,2725,17,1350287918,1350287918,1,6,0
42580834@N08,2725,7,1350260442,1350260817,2,6,375
42580834@N08,2726,9,1350533403,1350533403,1,6,0
42580834@N08,2726,11,1350547393,1350547396,2,6,3
42580834@N08,2726,8,1350535509,1350535922,3,6,413
42580834@N08,2726,16,1350547158,1350547158,1,6,0
42580834@N08,2726,4,1350531262,1350531262,1,6,0
42580834@N08,2726,7,1350528920,1350530304,2,6,1384
42605688@N02,2727,3,1339148753,1339148753,1,1,0
42688661@N06,2728,11,1442138469,1442138469,1,2,0
42688661@N06,2728,5,1442142790,1442143051,8,2,261
42688661@N06,2729,8,1442194665,1442194665,1,4,0
42688661@N06,2729,4,1442224848,1442224848,1,4,0
42688661@N06,2729,2,1442220486,1442221855,2,4,1369
42688661@N06,2729,13,1442200295,1442200295,1,4,0
42688661@N06,2730,5,1442401374,1442401966,9,1,592
42688661@N06,2731,5,1442488444,1442488744,7,1,300
42695644@N04,2732,17,1261970571,1261970611,2,2,40
42695644@N04,2732,4,1261967052,1261967130,2,2,78
42695644@N04,2733,2,1262218817,1262218885,2,1,68
42695644@N04,2734,17,1263607850,1263607850,1,1,0
42695644@N04,2735,17,1263796799,1263796799,1,1,0
42695644@N04,2736,17,1267865739,1267865739,1,1,0
42723893@N00,2737,11,1426033826,1426051614,2,1,17788
42786185@N06,2738,8,1283068070,1283070610,12,8,2540
42786185@N06,2738,1,1283053704,1283054043,6,8,339
42786185@N06,2738,13,1283063733,1283063803,2,8,70
42786185@N06,2738,10,1283065414,1283067159,5,8,1745
42786185@N06,2738,15,1283063842,1283064390,3,8,548
42786185@N06,2738,14,1283045581,1283047980,6,8,2399
42786185@N06,2738,5,1283055824,1283067933,4,8,12109
42786185@N06,2738,11,1283041615,1283080852,2,8,39237
42786185@N06,2739,17,1337058809,1337075115,3,7,16306
42786185@N06,2739,10,1337059554,1337059554,1,7,0
42786185@N06,2739,15,1337059252,1337059252,1,7,0
42786185@N06,2739,4,1337055696,1337055710,2,7,14
42786185@N06,2739,8,1337065386,1337065386,1,7,0
42786185@N06,2739,2,1337038905,1337060114,4,7,21209
42786185@N06,2739,11,1337037353,1337038516,4,7,1163
42786185@N06,2740,2,1367129193,1367129193,1,1,0
42786185@N06,2741,2,1367197012,1367197012,1,6,0
42786185@N06,2741,11,1367192687,1367192687,1,6,0
42786185@N06,2741,17,1367198616,1367198616,1,6,0
42786185@N06,2741,10,1367222866,1367223132,3,6,266
42786185@N06,2741,13,1367198757,1367199556,4,6,799
42786185@N06,2741,15,1367197749,1367198013,2,6,264
42786185@N06,2742,15,1383173462,1383191592,5,7,18130
42786185@N06,2742,5,1383175954,1383175954,1,7,0
42786185@N06,2742,6,1383204009,1383208082,6,7,4073
42786185@N06,2742,11,1383172220,1383172259,2,7,39
42786185@N06,2742,10,1383173120,1383174745,5,7,1625
42786185@N06,2742,8,1383210458,1383210458,1,7,0
42786185@N06,2742,13,1383173696,1383173696,1,7,0
42786185@N06,2743,13,1399111616,1399111616,1,1,0
42786185@N06,2744,11,1414833740,1414833740,1,7,0
42786185@N06,2744,5,1414805449,1414834381,2,7,28932
42786185@N06,2744,6,1414827930,1414830800,2,7,2870
42786185@N06,2744,15,1414800764,1414808811,2,7,8047
42786185@N06,2744,8,1414831839,1414833715,2,7,1876
42786185@N06,2744,10,1414799937,1414799937,1,7,0
42786185@N06,2744,13,1414802065,1414802065,1,7,0
42786185@N06,2745,6,1431764568,1431766002,5,4,1434
42786185@N06,2745,11,1431734649,1431734649,1,4,0
42786185@N06,2745,10,1431736024,1431736024,1,4,0
42786185@N06,2745,13,1431736977,1431737177,2,4,200
42786185@N06,2746,8,1446253242,1446253242,1,3,0
42786185@N06,2746,10,1446249933,1446249933,1,3,0
42786185@N06,2746,15,1446250478,1446251185,2,3,707
42786185@N06,2747,11,1458341902,1458341902,1,1,0
42815122@N02,2748,16,1347069184,1347069184,1,2,0
42815122@N02,2748,11,1347071138,1347071138,1,2,0
42848911@N05,2749,8,1297580919,1297580919,1,2,0
42848911@N05,2749,11,1297555771,1297591577,3,2,35806
42848911@N05,2750,11,1298176539,1298176539,1,1,0
42848911@N05,2751,7,1298494852,1298494852,1,1,0
42848911@N05,2752,12,1299150330,1299150330,1,1,0
42852007@N07,2753,1,1295940640,1295940640,1,1,0
42853203@N00,2754,11,1443437656,1443437839,2,1,183
42863397@N05,2755,8,1358577111,1358577111,1,2,0
42863397@N05,2755,11,1358552438,1358552438,1,2,0
42912463@N02,2756,16,1298703140,1298703655,10,5,515
42912463@N02,2756,11,1298696401,1298706257,3,5,9856
42912463@N02,2756,7,1298697742,1298697742,1,5,0
42912463@N02,2756,8,1298700656,1298703900,3,5,3244
42912463@N02,2756,17,1298703739,1298703739,1,5,0
42912996@N00,2757,13,1379736023,1379736023,1,3,0
42912996@N00,2757,11,1379716043,1379753553,3,3,37510
42912996@N00,2757,4,1379722959,1379723096,2,3,137
42912996@N00,2758,11,1379825330,1379825330,1,1,0
42912996@N00,2759,13,1380005859,1380009934,2,1,4075
42987207@N03,2760,11,1352635351,1352635351,1,1,0
43074401@N07,2761,4,1386385702,1386385702,1,1,0
43082306@N00,2762,11,1189839671,1189839671,1,1,0
43082306@N00,2763,11,1199090582,1199090582,1,2,0
43082306@N00,2763,16,1199091164,1199091164,1,2,0
43082306@N00,2764,11,1206082670,1206082670,1,1,0
43082306@N00,2765,10,1224923605,1224923605,1,1,0
43082306@N00,2766,1,1230687336,1230687649,2,1,313
43082306@N00,2767,8,1233988456,1233988456,1,1,0
43082306@N00,2768,3,1234590294,1234590294,1,2,0
43082306@N00,2768,10,1234592389,1234592389,1,2,0
43082306@N00,2769,10,1238815035,1238815035,1,1,0
43082306@N00,2770,15,1241242414,1241242414,1,2,0
43082306@N00,2770,8,1241239187,1241239187,1,2,0
43082306@N00,2771,11,1249020013,1249020288,3,1,275
43082306@N00,2772,11,1249625424,1249631952,4,1,6528
43082306@N00,2773,11,1251611888,1251611888,1,1,0
43082306@N00,2774,11,1254563779,1254563779,1,3,0
43082306@N00,2774,16,1254530391,1254530391,1,3,0
43082306@N00,2774,17,1254544796,1254544796,1,3,0
43082306@N00,2775,4,1256348518,1256348518,1,3,0
43082306@N00,2775,16,1256346112,1256346112,1,3,0
43082306@N00,2775,9,1256360140,1256360140,1,3,0
43082306@N00,2776,11,1256986736,1256986736,1,1,0
43082306@N00,2777,15,1259991456,1259991456,1,2,0
43082306@N00,2777,17,1259991217,1259991217,1,2,0
43082306@N00,2778,16,1267331230,1267331230,1,1,0
43082306@N00,2779,2,1267746861,1267746861,1,1,0
43082306@N00,2780,15,1267783477,1267783477,1,1,0
43082306@N00,2781,10,1267921232,1267921232,1,1,0
43082306@N00,2782,15,1273230562,1273230808,3,1,246
43082306@N00,2783,11,1276989888,1276989888,1,1,0
43082306@N00,2784,10,1280551930,1280551930,1,2,0
43082306@N00,2784,15,1280552270,1280552270,1,2,0
43082306@N00,2785,11,1282976853,1282976853,1,2,0
43082306@N00,2785,8,1282985396,1282985396,1,2,0
43082306@N00,2786,9,1283563005,1283563005,1,1,0
43082306@N00,2787,3,1289629519,1289629519,1,1,0
43082306@N00,2788,15,1291344385,1291344385,1,2,0
43082306@N00,2788,4,1291340335,1291340335,1,2,0
43082306@N00,2789,15,1291631906,1291631906,1,1,0
43082306@N00,2790,4,1292064364,1292064364,1,1,0
43082306@N00,2791,9,1296363788,1296363788,1,1,0
43082306@N00,2792,11,1298698922,1298698973,2,1,51
43082306@N00,2793,9,1299905107,1299905107,1,1,0
43082306@N00,2794,9,1313748330,1313748330,1,1,0
43082306@N00,2795,8,1314955934,1314955934,1,1,0
43082306@N00,2796,8,1317363599,1317363599,1,1,0
43082306@N00,2797,17,1322289060,1322289060,1,2,0
43082306@N00,2797,15,1322289312,1322289312,1,2,0
43082306@N00,2798,11,1333097907,1333097907,1,1,0
43082306@N00,2799,16,1333687671,1333687671,1,1,0
43082306@N00,2800,11,1337242872,1337242872,1,1,0
43082306@N00,2801,13,1343477412,1343477412,1,1,0
43082306@N00,2802,9,1351326028,1351326028,1,1,0
43082306@N00,2803,11,1356936266,1356936266,1,1,0
43082306@N00,2804,11,1364618440,1364618440,1,1,0
43082306@N00,2805,11,1365226022,1365226022,1,1,0
43082306@N00,2806,8,1377861916,1377861916,1,1,0
43082306@N00,2807,11,1414737562,1414737562,1,1,0
43082306@N00,2808,13,1418988752,1418988752,1,1,0
43082306@N00,2809,8,1421406041,1421406041,1,1,0
43082306@N00,2810,15,1434124277,1434124277,1,1,0
43122711@N02,2811,8,1253686484,1253686577,4,3,93
43122711@N02,2811,5,1253686115,1253686221,6,3,106
43122711@N02,2811,10,1253685219,1253685517,15,3,298
43122711@N02,2812,8,1253788793,1253788983,5,5,190
43122711@N02,2812,13,1253789719,1253791810,8,5,2091
43122711@N02,2812,5,1253788549,1253788667,3,5,118
43122711@N02,2812,10,1253788136,1253788164,2,5,28
43122711@N02,2812,17,1253787992,1253788012,4,5,20
43122711@N02,2813,8,1307241318,1307241318,1,2,0
43122711@N02,2813,17,1307257156,1307260355,7,2,3199
43186161@N04,2814,10,1254470777,1254470777,1,2,0
43186161@N04,2814,13,1254471512,1254472089,4,2,577
43198257@N03,2815,11,1362710033,1362710050,3,1,17
43244835@N00,2816,9,1354234999,1354235009,2,1,10
43245053@N00,2817,14,1332757977,1332757977,1,3,0
43245053@N00,2817,11,1332757961,1332757987,2,3,26
43245053@N00,2817,5,1332758031,1332758031,1,3,0
43245053@N00,2818,11,1338551840,1338551840,1,1,0
43245053@N00,2819,13,1346851615,1346851615,1,1,0
43245053@N00,2820,14,1348668295,1348668295,1,1,0
43287199@N08,2821,13,1269606759,1269606759,1,1,0
43293904@N00,2822,11,1276009769,1276009769,1,1,0
43297700@N00,2823,11,1321660526,1321660526,1,1,0
43362679@N00,2824,11,1357256890,1357256890,1,1,0
43364045@N04,2825,11,1298109662,1298109662,1,1,0
43365284@N00,2826,11,1246754462,1246783534,115,1,29072
43391619@N06,2827,6,1265061172,1265061172,1,1,0
43391619@N06,2828,5,1266204417,1266205045,2,1,628
43391619@N06,2829,11,1271717372,1271717372,1,1,0
43391619@N06,2830,11,1272780580,1272780845,2,1,265
43391619@N06,2831,11,1272848811,1272848811,1,1,0
43391619@N06,2832,11,1273013138,1273013138,1,1,0
43391619@N06,2833,6,1289090585,1289104542,2,1,13957
43451359@N00,2834,10,1387692568,1387692584,2,1,16
43511960@N08,2835,5,1334560356,1334560356,1,1,0
43535605@N00,2836,1,1360557815,1360557815,1,2,0
43535605@N00,2836,11,1360539703,1360539703,1,2,0
43549138@N00,2837,8,1257064102,1257064102,1,1,0
43558449@N04,2838,11,1219537835,1219538508,2,2,673
43558449@N04,2838,13,1219559870,1219559870,1,2,0
43592222@N04,2839,2,1349763381,1349763381,1,1,0
43608757@N08,2840,11,1420283804,1420283804,1,1,0
43612819@N03,2841,8,1256350434,1256350434,1,1,0
43612819@N03,2842,10,1270873805,1270873805,1,2,0
43612819@N03,2842,8,1270884453,1270884453,1,2,0
43612819@N03,2843,1,1282354405,1282354405,1,1,0
43612819@N03,2844,14,1287710221,1287710221,1,1,0
43612819@N03,2845,5,1325733947,1325733947,1,1,0
43612819@N03,2846,9,1332577989,1332577989,1,2,0
43612819@N03,2846,2,1332581713,1332581713,1,2,0
43612819@N03,2847,9,1335312451,1335312715,2,1,264
43612819@N03,2848,13,1335585316,1335585316,1,1,0
43636216@N00,2849,11,1228868886,1228868886,1,3,0
43636216@N00,2849,14,1228867242,1228867242,1,3,0
43636216@N00,2849,6,1228896437,1228896437,1,3,0
43642153@N04,2850,11,1412141850,1412141850,1,1,0
43642153@N04,2851,15,1412405837,1412405837,1,3,0
43642153@N04,2851,13,1412407519,1412407519,1,3,0
43642153@N04,2851,1,1412384350,1412384350,1,3,0
43643415@N07,2852,13,1293073858,1293074420,2,1,562
43652558@N00,2853,8,1463720137,1463720714,2,1,577
43652558@N00,2854,8,1470186647,1470186647,1,2,0
43652558@N00,2854,5,1470186561,1470189210,7,2,2649
43667163@N00,2855,11,1256434221,1256437863,2,4,3642
43667163@N00,2855,14,1256459168,1256459168,1,4,0
43667163@N00,2855,13,1256450715,1256450715,1,4,0
43667163@N00,2855,16,1256446021,1256446021,1,4,0
43667163@N00,2856,11,1256815921,1256819831,3,3,3910
43667163@N00,2856,1,1256809318,1256809318,1,3,0
43667163@N00,2856,10,1256807863,1256807863,1,3,0
43676934@N06,2857,11,1253359803,1253359803,1,1,0
43681824@N00,2858,11,1212907694,1212907762,4,2,68
43681824@N00,2858,16,1212895632,1212895795,6,2,163
43681824@N00,2859,8,1213411727,1213411727,1,2,0
43681824@N00,2859,11,1213411728,1213412257,4,2,529
43681824@N00,2860,11,1228461085,1228461898,3,1,813
43700437@N06,2861,13,1362996653,1362996653,1,2,0
43700437@N06,2861,11,1362996461,1362996461,1,2,0
43700437@N06,2862,13,1363034222,1363034814,5,2,592
43700437@N06,2862,11,1363035030,1363035030,1,2,0
43700437@N06,2863,15,1363083587,1363083587,1,1,0
43700437@N06,2864,13,1365802979,1365802979,1,1,0
43700437@N06,2865,1,1374885861,1374885861,1,1,0
43700437@N06,2866,11,1394403132,1394403132,1,1,0
43700437@N06,2867,11,1406796745,1406796745,1,1,0
43700437@N06,2868,13,1420963724,1420963724,1,2,0
43700437@N06,2868,11,1420962372,1420962372,1,2,0
43700437@N06,2869,5,1438935896,1438935904,2,1,8
43730464@N07,2870,11,1341098884,1341117978,52,1,19094
43749215@N03,2871,11,1368326486,1368326486,1,1,0
43808803@N00,2872,2,1461997891,1462008265,3,2,10374
43808803@N00,2872,11,1461997070,1462010579,3,2,13509
43808803@N00,2873,1,1462062535,1462062602,2,5,67
43808803@N00,2873,11,1462060965,1462063081,2,5,2116
43808803@N00,2873,16,1462085783,1462085783,1,5,0
43808803@N00,2873,4,1462086008,1462089042,5,5,3034
43808803@N00,2873,8,1462094733,1462094733,1,5,0
43808803@N00,2874,16,1462666134,1462666134,1,3,0
43808803@N00,2874,4,1462694904,1462695649,3,3,745
43808803@N00,2874,3,1462691225,1462694288,2,3,3063
43808803@N00,2875,1,1463035305,1463035305,1,1,0
43843206@N06,2876,13,1256114531,1256114531,1,1,0
43854580@N03,2877,11,1330477258,1330477263,2,1,5
43906182@N04,2878,11,1267913220,1267913220,1,1,0
43906182@N04,2879,15,1268517334,1268517334,1,1,0
43906182@N04,2880,15,1268604810,1268604810,1,1,0
43906182@N04,2881,15,1273203915,1273203915,1,1,0
43906182@N04,2882,13,1273284847,1273284847,1,1,0
43906182@N04,2883,4,1275099286,1275099327,2,1,41
43906182@N04,2884,4,1275178999,1275178999,1,1,0
43906182@N04,2885,4,1277352859,1277352895,2,1,36
43920951@N08,2886,11,1255766837,1255766837,1,1,0
43920951@N08,2887,13,1265928218,1265928218,1,1,0
44022769@N00,2888,11,1344732813,1344732813,1,2,0
44022769@N00,2888,5,1344733175,1344733175,1,2,0
44051675@N05,2889,11,1457152830,1457152830,1,1,0
44082489@N00,2890,10,1230537016,1230537032,2,5,16
44082489@N00,2890,15,1230529111,1230529111,1,5,0
44082489@N00,2890,17,1230528895,1230529552,4,5,657
44082489@N00,2890,13,1230528248,1230528834,4,5,586
44082489@N00,2890,11,1230505030,1230505114,2,5,84
44082489@N00,2891,17,1230877030,1230877210,3,3,180
44082489@N00,2891,13,1230875854,1230876117,2,3,263
44082489@N00,2891,1,1230862468,1230862468,1,3,0
44082489@N00,2892,6,1261118867,1261118947,2,5,80
44082489@N00,2892,8,1261099541,1261099541,1,5,0
44082489@N00,2892,11,1261123234,1261123234,1,5,0
44082489@N00,2892,12,1261124500,1261124999,3,5,499
44082489@N00,2892,2,1261123223,1261123223,1,5,0
44082489@N00,2893,17,1332721563,1332721563,1,1,0
44082489@N00,2894,10,1332792965,1332792982,2,4,17
44082489@N00,2894,15,1332792644,1332792644,1,4,0
44082489@N00,2894,17,1332792697,1332798457,5,4,5760
44082489@N00,2894,1,1332797346,1332797480,3,4,134
44082489@N00,2895,1,1332884482,1332884482,1,1,0
44082489@N00,2896,15,1333077415,1333077415,1,1,0
44082489@N00,2897,15,1395628650,1395628650,1,5,0
44082489@N00,2897,17,1395616532,1395616587,2,5,55
44082489@N00,2897,10,1395616889,1395617144,2,5,255
44082489@N00,2897,13,1395627847,1395627847,1,5,0
44082489@N00,2897,6,1395627211,1395627211,1,5,0
44114304@N07,2898,3,1199931337,1199931337,1,1,0
44124305550@N01,2899,11,1189466631,1189466765,2,1,134
44124341154@N01,2900,11,1353557274,1353557399,5,1,125
44124364198@N01,2901,13,1420775060,1420775060,1,1,0
44124367235@N01,2902,2,1364808202,1364810397,3,1,2195
44124372331@N01,2903,4,1217279838,1217280780,2,1,942
44124395373@N01,2904,16,1238120579,1238120579,1,7,0
44124395373@N01,2904,13,1238125161,1238125206,2,7,45
44124395373@N01,2904,5,1238137143,1238140600,4,7,3457
44124395373@N01,2904,2,1238120905,1238121921,2,7,1016
44124395373@N01,2904,8,1238132187,1238132722,3,7,535
44124395373@N01,2904,9,1238118784,1238118784,1,7,0
44124395373@N01,2904,11,1238116524,1238143727,3,7,27203
44124401501@N01,2905,5,1362382499,1362382513,2,1,14
44124401501@N01,2906,14,1383465921,1383465921,1,1,0
44124401501@N01,2907,11,1394698202,1394698202,1,1,0
44124414397@N01,2908,13,1317960745,1317960745,1,1,0
44124415797@N01,2909,11,1334718171,1334718171,1,1,0
44124426205@N01,2910,17,1317448651,1317448651,1,2,0
44124426205@N01,2910,11,1317438131,1317438131,1,2,0
44124426205@N01,2911,6,1352512052,1352512052,1,1,0
44124426205@N01,2912,8,1354670706,1354670706,1,1,0
44124426205@N01,2913,9,1385947851,1385947930,2,1,79
44124426205@N01,2914,8,1411628454,1411628454,1,1,0
44124427374@N01,2915,1,1202259725,1202259725,1,1,0
44124427374@N01,2916,11,1349078373,1349078391,2,3,18
44124427374@N01,2916,12,1349076898,1349076898,1,3,0
44124427374@N01,2916,3,1349074674,1349074674,1,3,0
44124427374@N01,2917,11,1415351778,1415351778,1,2,0
44124427374@N01,2917,5,1415341373,1415343027,7,2,1654
44124427374@N01,2918,17,1415444215,1415444215,1,2,0
44124427374@N01,2918,10,1415443771,1415443771,1,2,0
44124427374@N01,2919,5,1415499890,1415512250,3,1,12360
44124461706@N01,2920,11,1413506444,1413507514,4,1,1070
44275181@N00,2921,11,1316753273,1316753273,1,1,0
44275181@N00,2922,1,1354512187,1354512187,1,1,0
44275181@N00,2923,11,1368586527,1368586527,1,4,0
44275181@N00,2923,5,1368587754,1368587754,1,4,0
44275181@N00,2923,16,1368596147,1368596147,1,4,0
44275181@N00,2923,9,1368594823,1368594823,1,4,0
44275181@N00,2924,13,1368665848,1368665877,2,4,29
44275181@N00,2924,5,1368681441,1368681441,1,4,0
44275181@N00,2924,17,1368665337,1368665337,1,4,0
44275181@N00,2924,15,1368685894,1368685894,1,4,0
44275181@N00,2925,3,1451015017,1451015017,1,1,0
44314064@N06,2926,11,1261902881,1261902881,1,1,0
44318907@N08,2927,2,1286186723,1286186723,1,3,0
44318907@N08,2927,5,1286212852,1286212852,1,3,0
44318907@N08,2927,11,1286191184,1286191312,3,3,128
44318907@N08,2928,6,1296860283,1296886165,2,6,25882
44318907@N08,2928,13,1296861917,1296861917,1,6,0
44318907@N08,2928,11,1296856281,1296856556,2,6,275
44318907@N08,2928,5,1296867647,1296867647,1,6,0
44318907@N08,2928,17,1296860981,1296888878,4,6,27897
44318907@N08,2928,8,1296886822,1296886822,1,6,0
44318907@N08,2929,15,1306067507,1306067515,2,1,8
44318907@N08,2930,8,1310942063,1310942063,1,1,0
44318907@N08,2931,10,1317250916,1317255332,2,2,4416
44318907@N08,2931,11,1317261698,1317261751,2,2,53
44318907@N08,2932,11,1317374144,1317374399,2,1,255
44318907@N08,2933,8,1329043135,1329043135,1,1,0
44318907@N08,2934,17,1329129956,1329129956,1,6,0
44318907@N08,2934,8,1329109403,1329109749,4,6,346
44318907@N08,2934,15,1329129650,1329129650,1,6,0
44318907@N08,2934,13,1329106700,1329129264,4,6,22564
44318907@N08,2934,5,1329111857,1329111857,1,6,0
44318907@N08,2934,11,1329112944,1329112975,2,6,31
44318907@N08,2935,17,1361704593,1361704593,1,3,0
44318907@N08,2935,13,1361703542,1361703542,1,3,0
44318907@N08,2935,11,1361706324,1361706324,1,3,0
44318907@N08,2936,13,1371949237,1371949237,1,2,0
44318907@N08,2936,8,1371952597,1371952597,1,2,0
44337661@N07,2937,11,1337899749,1337899906,3,3,157
44337661@N07,2937,3,1337906774,1337906783,2,3,9
44337661@N07,2937,2,1337912976,1337913082,3,3,106
44375167@N00,2938,13,1324861984,1324861984,1,3,0
44375167@N00,2938,8,1324868176,1324868176,1,3,0
44375167@N00,2938,1,1324860210,1324860210,1,3,0
44407852@N06,2939,11,1364805007,1364805007,1,1,0
44412893@N02,2940,3,1360688443,1360693192,2,7,4749
44412893@N02,2940,13,1360684079,1360684079,1,7,0
44412893@N02,2940,16,1360667982,1360667982,1,7,0
44412893@N02,2940,5,1360665204,1360676925,3,7,11721
44412893@N02,2940,1,1360670107,1360672373,3,7,2266
44412893@N02,2940,15,1360684109,1360684109,1,7,0
44412893@N02,2940,10,1360684735,1360685083,2,7,348
44432534@N07,2941,8,1298777359,1298777359,1,1,0
44432534@N07,2942,13,1298946703,1298946703,1,1,0
44452722@N03,2943,2,1376713380,1376713449,3,5,69
44452722@N03,2943,9,1376713900,1376713951,2,5,51
44452722@N03,2943,5,1376727726,1376736664,2,5,8938
44452722@N03,2943,3,1376709426,1376709426,1,5,0
44452722@N03,2943,8,1376727104,1376727233,2,5,129
44452722@N03,2944,9,1376789627,1376789627,1,1,0
44458225@N00,2945,11,1451572592,1451572592,1,1,0
44490358@N04,2946,13,1200296761,1200297216,2,1,455
44490358@N04,2947,8,1218528464,1218530317,6,1,1853
44490358@N04,2948,8,1318574885,1318574901,4,2,16
44490358@N04,2948,13,1318574857,1318574904,6,2,47
44490358@N04,2949,11,1324277336,1324277336,1,1,0
44510773@N08,2950,11,1313815016,1313815016,1,1,0
44510773@N08,2951,4,1355173008,1355173008,1,2,0
44510773@N08,2951,11,1355182014,1355182100,2,2,86
44510773@N08,2952,8,1355604579,1355604767,2,1,188
44510773@N08,2953,16,1440763839,1440763839,1,1,0
44536766@N00,2954,5,1267762693,1267762693,1,1,0
44543461@N00,2955,6,1438213337,1438256171,14,1,42834
44559103@N02,2956,11,1387419602,1387419602,1,1,0
44599500@N06,2957,15,1284709636,1284709636,1,3,0
44599500@N06,2957,11,1284698988,1284698988,1,3,0
44599500@N06,2957,10,1284701561,1284701572,2,3,11
44599500@N06,2958,9,1284777477,1284777477,1,1,0
44599500@N06,2959,11,1320460900,1320460900,1,1,0
44599500@N06,2960,14,1320632817,1320632817,1,1,0
44603553@N03,2961,11,1352355304,1352355304,1,1,0
44606137@N00,2962,9,1414561731,1414561731,1,1,0
44621966@N00,2963,11,1429407350,1429407350,1,1,0
44633742@N02,2964,6,1279451214,1279451214,1,1,0
44756479@N00,2965,17,1197453360,1197453360,1,1,0
44813763@N07,2966,11,1425451046,1425458216,5,1,7170
44816688@N00,2967,2,1430109505,1430113275,4,1,3770
44816688@N00,2968,11,1446961960,1446961960,1,1,0
44861310@N03,2969,13,1337429448,1337429448,1,1,0
44948268@N02,2970,11,1327970425,1327971670,5,1,1245
44948268@N02,2971,11,1359085306,1359085306,1,1,0
44948268@N02,2972,11,1398562520,1398562520,1,1,0
44948268@N02,2973,13,1398773243,1398773243,1,1,0
44948268@N02,2974,8,1399180213,1399180213,1,1,0
44948268@N02,2975,11,1400290564,1400305094,2,1,14530
44948268@N02,2976,13,1422960006,1422960006,1,1,0
44957651@N00,2977,1,1281265023,1281265023,1,2,0
44957651@N00,2977,3,1281258284,1281258284,1,2,0
44957651@N00,2978,11,1281362008,1281362008,1,1,0
44957651@N00,2979,16,1281746376,1281746376,1,1,0
44957651@N00,2980,4,1320393827,1320393827,1,3,0
44957651@N00,2980,11,1320395698,1320395698,1,3,0
44957651@N00,2980,2,1320404602,1320404602,1,3,0
44957651@N00,2981,5,1320692982,1320692982,1,2,0
44957651@N00,2981,13,1320687809,1320687809,1,2,0
44978333@N06,2982,6,1293781677,1293781677,1,1,0
45032460@N06,2983,11,1380928716,1380929781,13,3,1065
45032460@N06,2983,1,1380930823,1380933113,2,3,2290
45032460@N06,2983,16,1380950499,1380950538,2,3,39
45033503@N06,2984,8,1285567236,1285567236,1,1,0
45033503@N06,2985,11,1285804858,1285804858,1,1,0
45033503@N06,2986,11,1290030296,1290030892,2,1,596
45033503@N06,2987,3,1290164778,1290164778,1,1,0
45033503@N06,2988,11,1290247648,1290247648,1,1,0
45033503@N06,2989,10,1306989110,1306989110,1,1,0
45033503@N06,2990,11,1307166954,1307166954,1,2,0
45033503@N06,2990,2,1307159912,1307159912,1,2,0
45067258@N00,2991,17,1318929760,1318931105,2,2,1345
45067258@N00,2991,13,1318928502,1318930882,2,2,2380
45067258@N00,2992,9,1318993873,1318993873,1,3,0
45067258@N00,2992,6,1318985005,1318985005,1,3,0
45067258@N00,2992,10,1318983203,1318983203,1,3,0
45067258@N00,2993,2,1339505559,1339505605,2,1,46
45067258@N00,2994,17,1339903671,1339903671,1,1,0
45067258@N00,2995,13,1355490185,1355490199,3,1,14
45067258@N00,2996,15,1370407247,1370407247,1,4,0
45067258@N00,2996,10,1370389766,1370390185,8,4,419
45067258@N00,2996,13,1370390725,1370406781,7,4,16056
45067258@N00,2996,11,1370387176,1370387176,1,4,0
45067258@N00,2997,10,1372782232,1372782232,1,1,0
45067258@N00,2998,3,1383737100,1383737100,1,3,0
45067258@N00,2998,5,1383725954,1383726032,2,3,78
45067258@N00,2998,11,1383724183,1383724183,1,3,0
45067258@N00,2999,17,1383786888,1383786915,4,5,27
45067258@N00,2999,5,1383789052,1383790769,11,5,1717
45067258@N00,2999,11,1383783608,1383783608,1,5,0
45067258@N00,2999,9,1383799314,1383799825,27,5,511
45067258@N00,2999,10,1383786143,1383786160,5,5,17
45067258@N00,3000,8,1383887169,1383887621,7,1,452
45067258@N00,3001,5,1391100506,1391100506,1,1,0
45067258@N00,3002,5,1432529858,1432530187,2,5,329
45067258@N00,3002,6,1432527816,1432528457,6,5,641
45067258@N00,3002,15,1432520042,1432520042,1,5,0
45067258@N00,3002,17,1432515170,1432520065,4,5,4895
45067258@N00,3002,11,1432532936,1432532936,1,5,0
45072542@N00,3003,2,1317294986,1317295037,5,4,51
45072542@N00,3003,10,1317288759,1317292425,21,4,3666
45072542@N00,3003,17,1317288495,1317288548,6,4,53
45072542@N00,3003,11,1317286343,1317286634,2,4,291
45072542@N00,3004,4,1317446769,1317449943,4,2,3174
45072542@N00,3004,6,1317442498,1317444996,12,2,2498
45083310@N06,3005,15,1353819220,1353819602,7,2,382
45083310@N06,3005,10,1353818967,1353819224,2,2,257
45083310@N06,3006,15,1357893977,1357894711,2,1,734
45083310@N06,3007,1,1369604921,1369604921,1,2,0
45083310@N06,3007,11,1369605041,1369607233,2,2,2192
45130440@N03,3008,15,1368076151,1368076151,1,1,0
45217757@N03,3009,8,1330315344,1330316843,3,1,1499
45226076@N07,3010,16,1261214063,1261214888,3,1,825
45226076@N07,3011,16,1339132674,1339132674,1,1,0
45226076@N07,3012,16,1341987918,1341987918,1,1,0
45228416@N03,3013,11,1298288374,1298288958,3,1,584
45228416@N03,3014,11,1299124479,1299124479,1,1,0
45444404@N04,3015,2,1425279218,1425279219,5,1,1
45444404@N04,3016,10,1425447655,1425447659,4,1,4
45463314@N06,3017,11,1369535058,1369552677,2,1,17619
45463314@N06,3018,11,1370085162,1370085162,1,1,0
45491779@N04,3019,9,1397520442,1397520442,1,2,0
45491779@N04,3019,17,1397527645,1397547589,2,2,19944
45491779@N04,3020,17,1397599572,1397599572,1,1,0
45491779@N04,3021,17,1397629834,1397629834,1,1,0
45491779@N04,3022,11,1397713258,1397713258,1,2,0
45491779@N04,3022,2,1397691203,1397691203,1,2,0
45561435@N00,3023,13,1295162433,1295162433,1,4,0
45561435@N00,3023,2,1295154205,1295154205,1,4,0
45561435@N00,3023,17,1295148436,1295148444,2,4,8
45561435@N00,3023,8,1295164986,1295164986,1,4,0
45561435@N00,3024,17,1426480748,1426480748,1,3,0
45561435@N00,3024,13,1426480889,1426484150,6,3,3261
45561435@N00,3024,11,1426473120,1426474330,2,3,1210
45561435@N00,3025,10,1426751480,1426751480,1,4,0
45561435@N00,3025,11,1426743379,1426753301,5,4,9922
45561435@N00,3025,8,1426748915,1426748948,2,4,33
45561435@N00,3025,1,1426743992,1426747338,3,4,3346
45571875@N06,3026,11,1267071374,1267071751,3,1,377
45571875@N06,3027,11,1279253770,1279253770,1,1,0
45571875@N06,3028,11,1280492276,1280492697,3,1,421
45571875@N06,3029,2,1282284301,1282284584,3,2,283
45571875@N06,3029,11,1282283399,1282299222,4,2,15823
45571875@N06,3030,1,1332917681,1332917681,1,1,0
45571875@N06,3031,11,1337224644,1337224702,2,3,58
45571875@N06,3031,9,1337230109,1337230150,2,3,41
45571875@N06,3031,16,1337227016,1337227016,1,3,0
45571875@N06,3032,6,1348914818,1348914818,1,1,0
45571875@N06,3033,15,1360043234,1360043234,1,1,0
45571875@N06,3034,1,1362564231,1362564231,1,1,0
45571875@N06,3035,2,1364551488,1364551488,1,3,0
45571875@N06,3035,11,1364556950,1364556950,1,3,0
45571875@N06,3035,12,1364551823,1364551823,1,3,0
45571875@N06,3036,8,1365242800,1365242800,1,1,0
45571875@N06,3037,6,1383033830,1383034905,3,1,1075
45571875@N06,3038,11,1399527786,1399527786,1,1,0
45571875@N06,3039,11,1412680832,1412681205,2,2,373
45571875@N06,3039,6,1412674426,1412674426,1,2,0
45571875@N06,3040,6,1413968548,1413969684,2,1,1136
45571875@N06,3041,11,1425528368,1425528368,1,1,0
45583433@N00,3042,13,1287372678,1287372678,1,4,0
45583433@N00,3042,15,1287372725,1287372725,1,4,0
45583433@N00,3042,4,1287375944,1287382485,2,4,6541
45583433@N00,3042,8,1287366942,1287366942,1,4,0
45614589@N02,3043,11,1226457908,1226474687,11,1,16779
45614589@N02,3044,11,1289611072,1289612630,4,1,1558
45614589@N02,3045,11,1320556058,1320556058,1,1,0
45614589@N02,3046,11,1320802992,1320803523,2,1,531
45629924@N03,3047,9,1277180619,1277180620,4,2,1
45629924@N03,3047,11,1277177520,1277177520,1,2,0
45652530@N08,3048,5,1266045409,1266046125,11,6,716
45652530@N08,3048,4,1266038986,1266039002,2,6,16
45652530@N08,3048,15,1266037423,1266037423,1,6,0
45652530@N08,3048,11,1266042349,1266042652,5,6,303
45652530@N08,3048,1,1266044933,1266045138,8,6,205
45652530@N08,3048,17,1266037696,1266037696,1,6,0
45676151@N08,3049,11,1225695521,1225695521,1,1,0
45681479@N04,3050,8,1298667334,1298667401,4,10,67
45681479@N04,3050,17,1298668957,1298669141,3,10,184
45681479@N04,3050,5,1298666901,1298667136,4,10,235
45681479@N04,3050,4,1298669644,1298670395,4,10,751
45681479@N04,3050,10,1298669191,1298669203,2,10,12
45681479@N04,3050,1,1298665461,1298666855,3,10,1394
45681479@N04,3050,13,1298668714,1298668880,6,10,166
45681479@N04,3050,15,1298669038,1298669072,2,10,34
45681479@N04,3050,9,1298665579,1298666833,7,10,1254
45681479@N04,3050,11,1298665176,1298665250,3,10,74
45716980@N00,3051,17,1327279441,1327292617,15,5,13176
45716980@N00,3051,11,1327265946,1327307245,15,5,41299
45716980@N00,3051,3,1327304747,1327304747,1,5,0
45716980@N00,3051,2,1327266072,1327273330,3,5,7258
45716980@N00,3051,10,1327301021,1327302616,3,5,1595
45716980@N00,3052,9,1327534328,1327534328,1,4,0
45716980@N00,3052,13,1327545835,1327545996,4,4,161
45716980@N00,3052,8,1327531081,1327539722,5,4,8641
45716980@N00,3052,10,1327547401,1327547811,11,4,410
45716980@N00,3053,10,1327601114,1327608350,4,1,7236
45716980@N00,3054,17,1361923675,1361947048,26,10,23373
45716980@N00,3054,15,1361951959,1361951959,1,10,0
45716980@N00,3054,9,1361921261,1361921447,12,10,186
45716980@N00,3054,11,1361911219,1361954823,16,10,43604
45716980@N00,3054,6,1361926880,1361926880,1,10,0
45716980@N00,3054,13,1361924120,1361924364,14,10,244
45716980@N00,3054,1,1361921026,1361922991,10,10,1965
45716980@N00,3054,8,1361929672,1361930297,6,10,625
45716980@N00,3054,5,1361923156,1361931664,5,10,8508
45716980@N00,3054,10,1361923613,1361946201,14,10,22588
45716980@N00,3055,7,1362037243,1362037253,2,2,10
45716980@N00,3055,11,1362036164,1362036197,2,2,33
45716980@N00,3056,11,1362190825,1362190825,1,1,0
45749280@N00,3057,16,1303978327,1303978381,2,3,54
45749280@N00,3057,11,1303976185,1303992686,2,3,16501
45749280@N00,3057,9,1303976808,1303976823,2,3,15
45749280@N00,3058,8,1304064436,1304065087,2,2,651
45749280@N00,3058,11,1304061757,1304073175,5,2,11418
45749280@N00,3059,8,1413526219,1413526219,1,3,0
45749280@N00,3059,12,1413547797,1413547932,3,3,135
45749280@N00,3059,11,1413514937,1413563512,3,3,48575
45756179@N03,3060,5,1315930852,1315930852,1,3,0
45756179@N03,3060,8,1315893369,1315893369,1,3,0
45756179@N03,3060,11,1315910473,1315910473,1,3,0
45769608@N00,3061,11,1194162952,1194162952,1,1,0
45842774@N00,3062,8,1190610955,1190610955,1,1,0
45842774@N00,3063,8,1237942291,1237943635,2,1,1344
45842774@N00,3064,5,1249457526,1249457526,1,1,0
45842803@N00,3065,12,1254630505,1254633539,3,3,3034
45842803@N00,3065,4,1254613542,1254613873,7,3,331
45842803@N00,3065,2,1254613934,1254614473,6,3,539
45898619@N08,3066,17,1423291739,1423291739,1,1,0
45906008@N00,3067,16,1340492914,1340511472,10,1,18558
45959609@N00,3068,5,1369616540,1369616540,1,1,0
45959609@N00,3069,4,1463179739,1463179739,1,1,0
46009332@N07,3070,11,1263570034,1263570034,1,1,0
46023761@N08,3071,17,1307791440,1307791835,9,1,395
46023761@N08,3072,17,1307962550,1307964763,127,1,2213
46023761@N08,3073,17,1308199681,1308212032,12,1,12351
46023761@N08,3074,14,1308366863,1308368594,17,4,1731
46023761@N08,3074,11,1308368622,1308368622,1,4,0
46023761@N08,3074,15,1308387848,1308387848,1,4,0
46023761@N08,3074,17,1308365500,1308385360,10,4,19860
46027550@N00,3075,11,1236821967,1236842461,2,5,20494
46027550@N00,3075,3,1236827867,1236827867,1,5,0
46027550@N00,3075,7,1236826110,1236826110,1,5,0
46027550@N00,3075,16,1236829976,1236829976,1,5,0
46027550@N00,3075,1,1236847390,1236847390,1,5,0
46050386@N03,3076,8,1242723276,1242724292,6,2,1016
46050386@N03,3076,11,1242716462,1242717188,7,2,726
46050386@N03,3077,12,1242798970,1242800333,4,4,1363
46050386@N03,3077,9,1242801031,1242801082,2,4,51
46050386@N03,3077,2,1242798006,1242800454,5,4,2448
46050386@N03,3077,14,1242797229,1242797229,1,4,0
46050386@N03,3078,9,1242873730,1242873730,1,5,0
46050386@N03,3078,16,1242874278,1242874278,1,5,0
46050386@N03,3078,1,1242872821,1242873878,3,5,1057
46050386@N03,3078,13,1242870076,1242870076,1,5,0
46050386@N03,3078,11,1242874974,1242874974,1,5,0
46072084@N07,3079,12,1341466701,1341466701,1,2,0
46072084@N07,3079,8,1341479861,1341479861,1,2,0
46097191@N00,3080,8,1197273760,1197274276,2,1,516
46097191@N00,3081,6,1197364480,1197367298,8,5,2818
46097191@N00,3081,13,1197349437,1197349559,2,5,122
46097191@N00,3081,10,1197331964,1197331964,1,5,0
46097191@N00,3081,8,1197337931,1197338452,3,5,521
46097191@N00,3081,15,1197358681,1197359917,5,5,1236
46108419@N00,3082,6,1362378864,1362378864,1,7,0
46108419@N00,3082,17,1362383058,1362383101,2,7,43
46108419@N00,3082,13,1362379730,1362382759,6,7,3029
46108419@N00,3082,11,1362358368,1362397727,4,7,39359
46108419@N00,3082,8,1362362065,1362364472,5,7,2407
46108419@N00,3082,10,1362385876,1362386459,8,7,583
46108419@N00,3082,5,1362359360,1362361306,4,7,1946
46108419@N00,3083,13,1363255236,1363255236,1,1,0
46109335@N06,3084,11,1318512917,1318512917,1,1,0
46115074@N04,3085,11,1349070908,1349070908,1,1,0
46115074@N04,3086,11,1393976702,1393976702,1,1,0
46115074@N04,3087,11,1394251973,1394251973,1,1,0
46115074@N04,3088,11,1457042862,1457042862,1,1,0
46117104@N06,3089,13,1327387813,1327387813,1,3,0
46117104@N06,3089,11,1327394662,1327395114,2,3,452
46117104@N06,3089,5,1327387316,1327387351,2,3,35
46117613@N08,3090,5,1320890613,1320890613,1,1,0
46117613@N08,3091,8,1321160934,1321160934,1,1,0
46144142@N08,3092,8,1189597162,1189597162,1,1,0
46193283@N00,3093,8,1234583284,1234583284,1,3,0
46193283@N00,3093,11,1234576532,1234576532,1,3,0
46193283@N00,3093,1,1234564277,1234564277,1,3,0
46216518@N05,3094,10,1240391030,1240391030,1,1,0
46229761@N02,3095,8,1307479432,1307479432,1,2,0
46229761@N02,3095,11,1307452561,1307452561,1,2,0
46272979@N08,3096,5,1292898359,1292913116,5,1,14757
46296638@N04,3097,14,1256739466,1256739612,6,2,146
46296638@N04,3097,7,1256733536,1256733536,1,2,0
46304772@N02,3098,11,1375005940,1375005940,1,1,0
46328592@N00,3099,3,1268036433,1268037045,8,1,612
46339232@N07,3100,16,1396942583,1396942583,1,2,0
46339232@N07,3100,11,1396941815,1396941815,1,2,0
46339232@N07,3101,11,1396972431,1396972431,1,1,0
46364076@N02,3102,6,1204211619,1204211923,12,1,304
46364076@N02,3103,6,1204501875,1204529244,31,1,27369
46364076@N02,3104,6,1258745782,1258745943,3,1,161
46401409@N00,3105,2,1467245190,1467245238,2,1,48
46401409@N00,3106,11,1467289562,1467289562,1,1,0
46401409@N00,3107,11,1467459150,1467459150,1,1,0
46418486@N04,3108,11,1425981829,1425982611,2,1,782
46453719@N00,3109,5,1205981233,1205981233,1,4,0
46453719@N00,3109,10,1205999724,1205999724,1,4,0
46453719@N00,3109,8,1205985697,1205985697,1,4,0
46453719@N00,3109,13,1205996377,1205996477,2,4,100
46514221@N03,3110,6,1393048880,1393048880,1,2,0
46514221@N03,3110,3,1393035521,1393035567,2,2,46
46602694@N00,3111,11,1354939248,1354939248,1,1,0
46602694@N00,3112,13,1355200261,1355200261,1,1,0
46602694@N00,3113,7,1355298700,1355298700,1,1,0
46602694@N00,3114,11,1358063523,1358063855,2,1,332
46602694@N00,3115,11,1372414535,1372414535,1,1,0
46602694@N00,3116,17,1389177329,1389177329,1,1,0
46602694@N00,3117,15,1415253691,1415253691,1,1,0
46621193@N08,3118,11,1302388695,1302388695,1,2,0
46621193@N08,3118,13,1302402641,1302402928,6,2,287
46671006@N00,3119,11,1253404520,1253404639,3,3,119
46671006@N00,3119,4,1253404570,1253404570,1,3,0
46671006@N00,3119,7,1253404578,1253404578,1,3,0
46724048@N00,3120,11,1295692374,1295692374,1,3,0
46724048@N00,3120,6,1295691090,1295691532,4,3,442
46724048@N00,3120,4,1295685247,1295685247,1,3,0
46775639@N00,3121,11,1192605559,1192607881,4,1,2322
46837385@N03,3122,11,1354316384,1354316384,1,1,0
46859740@N03,3123,11,1404038579,1404038579,1,1,0
46859740@N03,3124,11,1412069241,1412069241,1,1,0
46866350@N00,3125,11,1293861777,1293863010,2,1,1233
46866350@N00,3126,5,1294036440,1294036440,1,3,0
46866350@N00,3126,15,1294049757,1294049757,1,3,0
46866350@N00,3126,11,1294051541,1294051541,1,3,0
46914481@N07,3127,13,1420802692,1420802692,1,1,0
47064447@N00,3128,9,1351419769,1351419769,1,1,0
47087576@N00,3129,10,1213165251,1213167998,3,1,2747
47125846@N08,3130,8,1232781679,1232781679,1,1,0
47125846@N08,3131,11,1242456785,1242456785,1,1,0
47125846@N08,3132,11,1266226449,1266226449,1,1,0
47125846@N08,3133,11,1272799826,1272799826,1,4,0
47125846@N08,3133,4,1272765678,1272765678,1,4,0
47125846@N08,3133,5,1272774555,1272775067,2,4,512
47125846@N08,3133,13,1272784978,1272784978,1,4,0
47125846@N08,3134,4,1286439550,1286439550,1,5,0
47125846@N08,3134,11,1286438362,1286438362,1,5,0
47125846@N08,3134,17,1286445749,1286446247,3,5,498
47125846@N08,3134,15,1286448742,1286448742,1,5,0
47125846@N08,3134,10,1286441143,1286441947,2,5,804
47125846@N08,3135,8,1288771702,1288775466,8,1,3764
47125846@N08,3136,4,1289560211,1289560875,2,2,664
47125846@N08,3136,8,1289556190,1289558150,6,2,1960
47125846@N08,3137,8,1291251358,1291251358,1,1,0
47125846@N08,3138,3,1291854583,1291854583,1,1,0
47125846@N08,3139,8,1291894370,1291895261,3,1,891
47125846@N08,3140,9,1295166414,1295167276,3,1,862
47125846@N08,3141,2,1296285328,1296285328,1,1,0
47125846@N08,3142,10,1299062558,1299062558,1,2,0
47125846@N08,3142,11,1299063887,1299064163,2,2,276
47125846@N08,3143,2,1299127882,1299127882,1,8,0
47125846@N08,3143,9,1299124952,1299124952,1,8,0
47125846@N08,3143,13,1299115159,1299115159,1,8,0
47125846@N08,3143,16,1299134490,1299134490,1,8,0
47125846@N08,3143,4,1299130768,1299130890,2,8,122
47125846@N08,3143,11,1299136116,1299136116,1,8,0
47125846@N08,3143,15,1299114311,1299114421,3,8,110
47125846@N08,3143,1,1299132882,1299133764,3,8,882
47125846@N08,3144,11,1299898662,1299925968,2,2,27306
47125846@N08,3144,1,1299924727,1299924727,1,2,0
47125846@N08,3145,10,1301040491,1301040491,1,2,0
47125846@N08,3145,11,1301037013,1301037013,1,2,0
47125846@N08,3146,10,1302527515,1302527515,1,1,0
47125846@N08,3147,11,1302768558,1302781689,5,2,13131
47125846@N08,3147,5,1302773604,1302773960,2,2,356
47125846@N08,3148,17,1304075242,1304077900,2,2,2658
47125846@N08,3148,11,1304083148,1304083148,1,2,0
47125846@N08,3149,14,1305791705,1305791705,1,4,0
47125846@N08,3149,8,1305794642,1305796152,3,4,1510
47125846@N08,3149,3,1305791564,1305791564,1,4,0
47125846@N08,3149,15,1305801675,1305801675,1,4,0
47125846@N08,3150,11,1306658100,1306658100,1,3,0
47125846@N08,3150,8,1306663707,1306664983,3,3,1276
47125846@N08,3150,9,1306658797,1306658860,2,3,63
47125846@N08,3151,11,1307002602,1307002912,2,2,310
47125846@N08,3151,13,1307009483,1307009483,1,2,0
47125846@N08,3152,5,1309427775,1309428505,3,1,730
47125846@N08,3153,3,1309768570,1309768570,1,1,0
47125846@N08,3154,1,1310292073,1310293921,3,1,1848
47125846@N08,3155,11,1311487421,1311499863,6,2,12442
47125846@N08,3155,2,1311498351,1311498351,1,2,0
47125846@N08,3156,13,1314357488,1314357488,1,1,0
47125846@N08,3157,15,1314967934,1314967934,1,3,0
47125846@N08,3157,11,1314954427,1314954427,1,3,0
47125846@N08,3157,8,1314955900,1314955900,1,3,0
47125846@N08,3158,15,1317203249,1317203249,1,2,0
47125846@N08,3158,11,1317201038,1317201038,1,2,0
47125846@N08,3159,5,1319101891,1319101891,1,2,0
47125846@N08,3159,13,1319109333,1319109333,1,2,0
47125846@N08,3160,16,1321174930,1321174930,1,2,0
47125846@N08,3160,1,1321166861,1321166861,1,2,0
47125846@N08,3161,8,1323515304,1323515789,3,2,485
47125846@N08,3161,11,1323518243,1323518243,1,2,0
47125846@N08,3162,15,1323945914,1323945974,4,1,60
47125846@N08,3163,4,1325061347,1325061347,1,1,0
47125846@N08,3164,13,1327564804,1327564804,1,2,0
47125846@N08,3164,4,1327566974,1327566974,1,2,0
47125846@N08,3165,10,1331962677,1331962677,1,3,0
47125846@N08,3165,11,1331958900,1331959258,3,3,358
47125846@N08,3165,5,1331963167,1331964464,3,3,1297
47125846@N08,3166,13,1332501550,1332501550,1,2,0
47125846@N08,3166,15,1332494360,1332494360,2,2,0
47125846@N08,3167,11,1333095767,1333095767,1,1,0
47125846@N08,3168,8,1335085847,1335086088,2,1,241
47125846@N08,3169,5,1341399411,1341400174,2,1,763
47125846@N08,3170,8,1342864168,1342864168,1,1,0
47125846@N08,3171,4,1345282276,1345283017,2,3,741
47125846@N08,3171,11,1345269198,1345269198,1,3,0
47125846@N08,3171,9,1345272581,1345272702,2,3,121
47125846@N08,3172,8,1345895137,1345895137,1,1,0
47125846@N08,3173,4,1348397300,1348398680,2,1,1380
47125846@N08,3174,11,1348819675,1348819675,1,3,0
47125846@N08,3174,9,1348826795,1348826795,1,3,0
47125846@N08,3174,10,1348824351,1348824351,1,3,0
47125846@N08,3175,11,1351920525,1351921483,5,1,958
47125846@N08,3176,11,1354092486,1354092486,1,1,0
47125846@N08,3177,1,1354871497,1354871618,2,1,121
47125846@N08,3178,9,1356603231,1356603231,1,1,0
47125846@N08,3179,11,1356936639,1356936639,1,1,0
47125846@N08,3180,13,1357986610,1357986610,1,1,0
47125846@N08,3181,8,1360321832,1360321832,1,2,0
47125846@N08,3181,11,1360325199,1360325199,1,2,0
47125846@N08,3182,5,1362902887,1362902887,1,1,0
47125846@N08,3183,2,1364028094,1364028094,1,2,0
47125846@N08,3183,12,1364027175,1364027175,1,2,0
47125846@N08,3184,17,1371986021,1371986021,1,1,0
47125846@N08,3185,8,1374916467,1374916467,1,1,0
47125846@N08,3186,10,1377344390,1377344934,2,2,544
47125846@N08,3186,11,1377347137,1377347137,1,2,0
47125846@N08,3187,8,1377861180,1377861180,1,1,0
47125846@N08,3188,15,1379763359,1379763359,1,2,0
47125846@N08,3188,5,1379761970,1379761970,1,2,0
47125846@N08,3189,2,1380353274,1380356841,2,2,3567
47125846@N08,3189,16,1380361971,1380361971,1,2,0
47125846@N08,3190,17,1382523100,1382523100,1,1,0
47125846@N08,3191,5,1384595020,1384595345,2,1,325
47125846@N08,3192,4,1390546493,1390546493,1,2,0
47125846@N08,3192,1,1390560970,1390560970,1,2,0
47125846@N08,3193,1,1394258386,1394258386,1,1,0
47125846@N08,3194,9,1397375230,1397375230,1,1,0
47136771@N03,3195,13,1347185037,1347185037,1,1,0
47223527@N05,3196,11,1412244988,1412245277,2,2,289
47223527@N05,3196,2,1412238854,1412238854,1,2,0
47266119@N00,3197,11,1413188228,1413188228,1,1,0
47343648@N04,3198,13,1271128422,1271128422,1,1,0
47363316@N08,3199,11,1361550278,1361569137,3,1,18859
47363316@N08,3200,11,1361673446,1361673446,1,1,0
47423151@N06,3201,5,1317988677,1317988677,1,1,0
47423151@N06,3202,5,1318169620,1318169620,1,2,0
47423151@N06,3202,11,1318150313,1318150313,1,2,0
47423151@N06,3203,11,1368620029,1368620029,1,1,0
47423151@N06,3204,11,1389395066,1389395066,1,1,0
47423151@N06,3205,3,1399595671,1399595671,1,1,0
47423151@N06,3206,11,1415686209,1415686209,1,1,0
47473683@N06,3207,15,1265774561,1265774561,1,1,0
47473683@N06,3208,6,1266142088,1266142180,3,1,92
47567986@N00,3209,13,1303456234,1303456234,1,3,0
47567986@N00,3209,3,1303436117,1303436132,3,3,15
47567986@N00,3209,8,1303446431,1303446445,2,3,14
47573122@N05,3210,3,1289607094,1289607622,5,15,528
47573122@N05,3210,16,1289628166,1289628166,1,15,0
47573122@N05,3210,10,1289637768,1289639289,22,15,1521
47573122@N05,3210,4,1289624433,1289627222,17,15,2789
47573122@N05,3210,7,1289605193,1289623959,20,15,18766
47573122@N05,3210,5,1289608671,1289609920,21,15,1249
47573122@N05,3210,14,1289606966,1289606966,1,15,0
47573122@N05,3210,13,1289634009,1289636873,46,15,2864
47573122@N05,3210,2,1289603265,1289605122,27,15,1857
47573122@N05,3210,8,1289610330,1289613295,41,15,2965
47573122@N05,3210,1,1289629959,1289630108,3,15,149
47573122@N05,3210,9,1289628176,1289629855,24,15,1679
47573122@N05,3210,15,1289636992,1289637059,3,15,67
47573122@N05,3210,11,1289601193,1289644283,34,15,43090
47573122@N05,3210,17,1289637078,1289637718,22,15,640
47580197@N07,3211,14,1279000015,1279088391,126,1,88376
47580197@N07,3212,14,1279139550,1279139550,1,1,0
47597914@N00,3213,11,1299109075,1299109231,2,2,156
47597914@N00,3213,15,1299123290,1299134090,3,2,10800
47615165@N04,3214,1,1358220885,1358220885,1,1,0
47694179@N06,3215,10,1444092139,1444092149,2,3,10
47694179@N06,3215,8,1444101574,1444101574,1,3,0
47694179@N06,3215,15,1444094899,1444094901,3,3,2
47705525@N06,3216,11,1307169877,1307169877,1,2,0
47705525@N06,3216,12,1307169993,1307169993,1,2,0
47705525@N06,3217,2,1308216401,1308216401,1,1,0
47716066@N05,3218,13,1306839544,1306842007,4,1,2463
47716066@N05,3219,13,1306918707,1306918707,1,1,0
47785122@N06,3220,5,1367722325,1367722325,1,1,0
47785122@N06,3221,11,1379847345,1379847345,1,1,0
47826387@N03,3222,11,1339420244,1339420244,1,1,0
47826387@N03,3223,5,1339678065,1339678065,1,1,0
47861479@N02,3224,11,1355778810,1355778810,1,1,0
47861479@N02,3225,3,1381390478,1381390478,1,2,0
47861479@N02,3225,11,1381378526,1381401049,3,2,22523
47861479@N02,3226,11,1403476819,1403476819,1,1,0
47861479@N02,3227,11,1403776143,1403776143,1,1,0
47861479@N02,3228,11,1418454982,1418454982,1,1,0
47861479@N02,3229,11,1418759603,1418763290,3,1,3687
47861479@N02,3230,2,1433117585,1433117585,1,1,0
47943464@N06,3231,11,1318236267,1318236267,1,1,0
47953780@N07,3232,8,1400062039,1400065982,2,1,3943
48105777@N00,3233,15,1275288092,1275288343,4,4,251
48105777@N00,3233,8,1275291829,1275291829,1,4,0
48105777@N00,3233,13,1275288701,1275298956,3,4,10255
48105777@N00,3233,11,1275286329,1275305083,2,4,18754
48105777@N00,3234,12,1275610026,1275610026,1,1,0
48257423@N02,3235,3,1300485913,1300485913,1,1,0
48271781@N00,3236,10,1347870648,1347870648,1,1,0
48275668@N02,3237,1,1346973983,1346973983,1,1,0
48275668@N02,3238,16,1347211985,1347211985,1,3,0
48275668@N02,3238,13,1347219563,1347219563,1,3,0
48275668@N02,3238,14,1347228076,1347228076,1,3,0
48275668@N02,3239,10,1348815767,1348815767,1,6,0
48275668@N02,3239,8,1348815564,1348827896,5,6,12332
48275668@N02,3239,13,1348813236,1348813656,4,6,420
48275668@N02,3239,5,1348816256,1348828587,6,6,12331
48275668@N02,3239,17,1348811955,1348815002,7,6,3047
48275668@N02,3239,11,1348828981,1348828981,1,6,0
48275668@N02,3240,6,1350309549,1350309549,1,2,0
48275668@N02,3240,13,1350307431,1350307431,1,2,0
48275668@N02,3241,6,1350634819,1350634819,1,3,0
48275668@N02,3241,4,1350627308,1350627308,1,3,0
48275668@N02,3241,17,1350633978,1350634668,3,3,690
48275668@N02,3242,5,1357197845,1357197845,1,1,0
48275668@N02,3243,5,1357438143,1357438299,3,2,156
48275668@N02,3243,10,1357434061,1357434302,6,2,241
48275668@N02,3244,6,1359367117,1359367971,7,2,854
48275668@N02,3244,8,1359368797,1359368797,1,2,0
48275668@N02,3245,6,1363338190,1363338603,3,1,413
48275668@N02,3246,6,1363425019,1363425184,2,1,165
48275668@N02,3247,13,1395571528,1395571528,1,1,0
48275668@N02,3248,5,1395800250,1395800250,1,1,0
48275668@N02,3249,8,1426036233,1426036233,1,3,0
48275668@N02,3249,11,1426046214,1426046881,2,3,667
48275668@N02,3249,2,1426044908,1426044931,2,3,23
48275668@N02,3250,13,1450268086,1450268086,1,1,0
48275668@N02,3251,16,1457575525,1457575525,1,1,0
48275668@N02,3252,13,1457663603,1457663808,2,1,205
48311919@N00,3253,17,1362707734,1362715126,71,1,7392
48311919@N00,3254,11,1412380416,1412384003,5,6,3587
48311919@N00,3254,16,1412382150,1412382182,3,6,32
48311919@N00,3254,13,1412390365,1412390684,12,6,319
48311919@N00,3254,5,1412387670,1412388821,11,6,1151
48311919@N00,3254,10,1412384103,1412385034,5,6,931
48311919@N00,3254,9,1412383377,1412383476,5,6,99
48311919@N00,3255,11,1418434861,1418435064,4,5,203
48311919@N00,3255,10,1418435787,1418446976,21,5,11189
48311919@N00,3255,4,1418435463,1418435586,3,5,123
48311919@N00,3255,13,1418447106,1418447283,3,5,177
48311919@N00,3255,5,1418439083,1418446890,3,5,7807
48311919@N00,3256,2,1423356996,1423357427,19,2,431
48311919@N00,3256,8,1423360790,1423363222,12,2,2432
48311919@N00,3257,11,1426302693,1426302702,3,1,9
48311919@N00,3258,15,1433574025,1433577358,10,2,3333
48311919@N00,3258,10,1433571679,1433574036,28,2,2357
48311919@N00,3259,15,1443230767,1443252233,326,1,21466
48311919@N00,3260,2,1456102673,1456109847,49,1,7174
48311919@N00,3261,5,1468384216,1468384411,15,1,195
48355351@N07,3262,13,1312803439,1312803479,3,2,40
48355351@N07,3262,8,1312782416,1312783920,6,2,1504
48378226@N02,3263,11,1312200473,1312200473,1,1,0
48391953@N02,3264,8,1285837851,1285837931,2,3,80
48391953@N02,3264,12,1285840590,1285840590,1,3,0
48391953@N02,3264,5,1285838256,1285838256,1,3,0
48391953@N02,3265,4,1286361648,1286361648,1,3,0
48391953@N02,3265,11,1286375480,1286375714,2,3,234
48391953@N02,3265,8,1286366928,1286366944,2,3,16
48427787@N00,3266,1,1320384070,1320384076,2,3,6
48427787@N00,3266,11,1320381888,1320381888,1,3,0
48427787@N00,3266,5,1320394530,1320394530,1,3,0
48427787@N00,3267,17,1320565677,1320565703,3,1,26
48481127@N08,3268,11,1356710499,1356710793,2,3,294
48481127@N08,3268,17,1356719435,1356719435,1,3,0
48481127@N08,3268,5,1356725271,1356725271,1,3,0
48494440@N04,3269,11,1222837839,1222837839,1,1,0
48494440@N04,3270,11,1253584422,1253584422,1,1,0
48494440@N04,3271,13,1253714852,1253714852,1,1,0
48513718@N02,3272,1,1222128003,1222128003,1,1,0
48553408@N00,3273,11,1326428681,1326428681,1,1,0
48566562@N06,3274,11,1391272884,1391272884,1,1,0
48592227@N08,3275,10,1327813022,1327813022,2,1,0
48592227@N08,3276,17,1330138218,1330138218,1,1,0
48592227@N08,3277,11,1330254395,1330254395,1,1,0
48603464@N05,3278,5,1457664379,1457664379,1,3,0
48603464@N05,3278,11,1457659695,1457659695,1,3,0
48603464@N05,3278,17,1457662430,1457662430,1,3,0
48623792@N00,3279,13,1369199541,1369200020,4,2,479
48623792@N00,3279,14,1369197242,1369198893,10,2,1651
48624550@N00,3280,4,1328252184,1328252184,2,4,0
48624550@N00,3280,2,1328242965,1328243718,9,4,753
48624550@N00,3280,11,1328241245,1328258078,9,4,16833
48624550@N00,3280,12,1328242401,1328242622,3,4,221
48658532@N06,3281,17,1311159099,1311159099,1,4,0
48658532@N06,3281,8,1311162314,1311162314,1,4,0
48658532@N06,3281,12,1311157573,1311158338,7,4,765
48658532@N06,3281,15,1311159427,1311159427,1,4,0
48658532@N06,3282,4,1320143226,1320143226,1,1,0
48658532@N06,3283,1,1330996702,1330996924,2,1,222
48658532@N06,3284,5,1331083457,1331083457,1,2,0
48658532@N06,3284,11,1331099793,1331099793,1,2,0
48658532@N06,3285,13,1346282178,1346282178,1,2,0
48658532@N06,3285,15,1346286519,1346286519,1,2,0
48658532@N06,3286,8,1352592728,1352592728,1,1,0
48658532@N06,3287,5,1362464930,1362464930,1,4,0
48658532@N06,3287,13,1362468061,1362468061,1,4,0
48658532@N06,3287,8,1362474170,1362474170,1,4,0
48658532@N06,3287,1,1362477080,1362477080,1,4,0
48699368@N08,3288,15,1304408297,1304408326,2,2,29
48699368@N08,3288,17,1304408621,1304408639,2,2,18
48763139@N00,3289,11,1199744480,1199744480,1,1,0
48763139@N00,3290,10,1231137599,1231137599,1,3,0
48763139@N00,3290,15,1231126988,1231126988,1,3,0
48763139@N00,3290,5,1231137574,1231137574,1,3,0
48763139@N00,3291,10,1231397085,1231397085,1,2,0
48763139@N00,3291,3,1231406674,1231406674,1,2,0
48763139@N00,3292,3,1231461375,1231461375,1,2,0
48763139@N00,3292,7,1231461898,1231461898,1,2,0
48763139@N00,3293,17,1263193067,1263193067,1,1,0
48763139@N00,3294,3,1294117191,1294117245,2,2,54
48763139@N00,3294,11,1294093849,1294093849,1,2,0
48763139@N00,3295,16,1294793735,1294793735,1,1,0
48763139@N00,3296,16,1357172761,1357172761,1,1,0
48763139@N00,3297,17,1357466938,1357466938,1,1,0
48816143@N00,3298,6,1198651067,1198651067,1,1,0
48826873@N08,3299,9,1332404074,1332404074,1,1,0
48826873@N08,3300,11,1391931839,1391931839,1,1,0
48826873@N08,3301,11,1432617640,1432617640,1,1,0
48826873@N08,3302,13,1436862067,1436862067,1,2,0
48826873@N08,3302,11,1436855450,1436855450,1,2,0
48849941@N07,3303,11,1269910606,1269910606,1,1,0
48861861@N08,3304,9,1422923367,1422923367,1,1,0
48861861@N08,3305,2,1423442258,1423442258,1,1,0
48861861@N08,3306,11,1423781671,1423781671,1,1,0
48861861@N08,3307,11,1424244158,1424244158,1,1,0
48861861@N08,3308,1,1427160647,1427160647,1,1,0
48861861@N08,3309,16,1427770392,1427770392,1,1,0
48861861@N08,3310,14,1429416999,1429416999,1,1,0
48861861@N08,3311,17,1431329364,1431329364,1,1,0
48861861@N08,3312,11,1431481880,1431481880,1,2,0
48861861@N08,3312,4,1431485401,1431485401,1,2,0
48861861@N08,3313,11,1432860048,1432860048,1,1,0
48861861@N08,3314,4,1438576220,1438576220,1,1,0
48861861@N08,3315,3,1439003534,1439003534,1,1,0
48861861@N08,3316,3,1445387535,1445387535,1,1,0
48861861@N08,3317,2,1446063890,1446063890,1,1,0
48861861@N08,3318,4,1447998090,1447998090,1,1,0
48861861@N08,3319,5,1448766765,1448766765,1,1,0
48861861@N08,3320,11,1448843799,1448843799,1,1,0
48861861@N08,3321,1,1449821574,1449821574,1,1,0
48861861@N08,3322,9,1451452313,1451452313,1,1,0
48861861@N08,3323,1,1451791159,1451791159,1,1,0
48861861@N08,3324,2,1454355894,1454355894,1,1,0
48861861@N08,3325,1,1454541309,1454541309,1,1,0
48861861@N08,3326,7,1460889752,1460889752,1,1,0
48861861@N08,3327,11,1462348657,1462348657,1,1,0
48861861@N08,3328,16,1463790529,1463790529,1,1,0
48861861@N08,3329,10,1463978296,1463978296,1,1,0
48861861@N08,3330,13,1464833365,1464833365,1,1,0
48886342@N00,3331,17,1293795239,1293810821,2,1,15582
48886342@N00,3332,17,1294059773,1294059773,1,2,0
48886342@N00,3332,6,1294060205,1294060205,1,2,0
48886342@N00,3333,13,1295788501,1295788501,1,1,0
48889042674@N01,3334,11,1222385685,1222385685,1,1,0
48889052497@N01,3335,11,1311816769,1311817510,6,2,741
48889052497@N01,3335,2,1311824021,1311826894,8,2,2873
48889071072@N01,3336,11,1305714528,1305714528,1,1,0
48889119704@N01,3337,11,1273382279,1273382325,2,1,46
48889119704@N01,3338,17,1273489250,1273490048,9,1,798
48891180@N00,3339,8,1229800571,1229800906,5,6,335
48891180@N00,3339,10,1229813301,1229813301,1,6,0
48891180@N00,3339,12,1229776047,1229776047,1,6,0
48891180@N00,3339,5,1229794709,1229806619,2,6,11910
48891180@N00,3339,17,1229790573,1229790573,1,6,0
48891180@N00,3339,11,1229771131,1229771131,1,6,0
48938973@N07,3340,11,1379336413,1379336413,1,1,0
48938973@N07,3341,11,1379571120,1379571120,1,1,0
48973233@N05,3342,10,1295927353,1295927353,1,1,0
48980448@N05,3343,11,1263883615,1263883615,1,2,0
48980448@N05,3343,2,1263880415,1263880415,1,2,0
49008511@N04,3344,11,1265210808,1265210808,1,1,0
49014295@N06,3345,9,1396827296,1396841346,2,4,14050
49014295@N06,3345,11,1396859729,1396866133,2,4,6404
49014295@N06,3345,13,1396828831,1396828831,1,4,0
49014295@N06,3345,4,1396844692,1396844692,1,4,0
49029406@N00,3346,11,1361662396,1361662396,1,1,0
49032331@N05,3347,11,1340104033,1340104033,1,1,0
49039096@N04,3348,11,1388433769,1388476070,111,1,42301
49052221@N00,3349,5,1366976825,1366988948,2,1,12123
49075539@N06,3350,9,1298508051,1298508051,1,6,0
49075539@N06,3350,2,1298512726,1298512726,1,6,0
49075539@N06,3350,8,1298527151,1298527151,1,6,0
49075539@N06,3350,16,1298504594,1298508726,2,6,4132
49075539@N06,3350,7,1298512209,1298512209,1,6,0
49075539@N06,3350,4,1298513356,1298513356,1,6,0
49092364@N04,3351,16,1306218863,1306218863,1,1,0
49098167@N07,3352,11,1455010519,1455010519,1,1,0
49098167@N07,3353,11,1455975806,1455975806,1,1,0
49098167@N07,3354,11,1458726292,1458726292,1,1,0
49098167@N07,3355,11,1462022152,1462022152,1,1,0
49103297@N04,3356,2,1408149924,1408150952,34,4,1028
49103297@N04,3356,11,1408146116,1408188988,30,4,42872
49103297@N04,3356,1,1408153861,1408153909,6,4,48
49103297@N04,3356,5,1408157560,1408162673,34,4,5113
49109678@N04,3357,11,1251538993,1251538993,1,1,0
49109678@N04,3358,13,1277712767,1277712767,1,3,0
49109678@N04,3358,10,1277712500,1277712500,2,3,0
49109678@N04,3358,11,1277711835,1277726782,2,3,14947
49109678@N04,3359,2,1309410435,1309410466,2,5,31
49109678@N04,3359,7,1309396520,1309396520,1,5,0
49109678@N04,3359,4,1309396736,1309413565,4,5,16829
49109678@N04,3359,12,1309411247,1309411247,1,5,0
49109678@N04,3359,3,1309395724,1309396609,2,5,885
49109678@N04,3360,4,1343885751,1343885751,1,5,0
49109678@N04,3360,11,1343864965,1343865110,2,5,145
49109678@N04,3360,9,1343869985,1343869985,1,5,0
49109678@N04,3360,16,1343888582,1343888584,2,5,2
49109678@N04,3360,2,1343884221,1343884221,1,5,0
49109678@N04,3361,12,1364957949,1364957949,1,3,0
49109678@N04,3361,4,1364961730,1364961730,1,3,0
49109678@N04,3361,2,1364958685,1364958685,1,3,0
49109678@N04,3362,11,1365028697,1365029046,3,2,349
49109678@N04,3362,16,1365031227,1365031227,1,2,0
49109678@N04,3363,17,1365066819,1365066828,2,5,9
49109678@N04,3363,11,1365072676,1365072676,1,5,0
49109678@N04,3363,13,1365067928,1365067928,1,5,0
49109678@N04,3363,16,1365071081,1365071081,1,5,0
49109678@N04,3363,1,1365070526,1365070526,1,5,0
49109678@N04,3364,10,1365152477,1365152477,1,2,0
49109678@N04,3364,16,1365135797,1365135797,1,2,0
49109678@N04,3365,11,1405564313,1405564313,1,1,0
49109678@N04,3366,10,1426899310,1426899310,1,1,0
49150220@N03,3367,4,1342864168,1342864168,1,1,0
49165041@N00,3368,7,1281312021,1281312021,1,11,0
49165041@N00,3368,13,1281289592,1281330467,3,11,40875
49165041@N00,3368,1,1281298004,1281300664,11,11,2660
49165041@N00,3368,14,1281311445,1281311462,2,11,17
49165041@N00,3368,9,1281301126,1281302352,2,11,1226
49165041@N00,3368,10,1281292593,1281332046,2,11,39453
49165041@N00,3368,2,1281307605,1281310679,7,11,3074
49165041@N00,3368,11,1281257663,1281297330,12,11,39667
49165041@N00,3368,16,1281303720,1281305529,3,11,1809
49165041@N00,3368,8,1281278312,1281318221,10,11,39909
49165041@N00,3368,15,1281330948,1281330948,1,11,0
49169223@N00,3369,8,1230987617,1230987624,6,3,7
49169223@N00,3369,5,1230987606,1230987626,3,3,20
49169223@N00,3369,11,1230987628,1230987628,1,3,0
49169223@N00,3370,4,1231419606,1231419606,1,5,0
49169223@N00,3370,11,1231419602,1231419602,1,5,0
49169223@N00,3370,13,1231419600,1231419600,1,5,0
49169223@N00,3370,10,1231419603,1231419605,3,5,2
49169223@N00,3370,17,1231419601,1231419601,1,5,0
49275237@N00,3371,15,1206596500,1206596830,2,2,330
49275237@N00,3371,17,1206596170,1206596170,1,2,0
49275237@N00,3372,8,1301465387,1301465387,1,1,0
49275237@N00,3373,10,1301528213,1301528213,1,1,0
49275237@N00,3374,10,1329277075,1329277267,3,7,192
49275237@N00,3374,14,1329279052,1329283584,20,7,4532
49275237@N00,3374,11,1329259787,1329290096,8,7,30309
49275237@N00,3374,5,1329263126,1329263138,2,7,12
49275237@N00,3374,13,1329272492,1329295373,11,7,22881
49275237@N00,3374,15,1329274484,1329274484,1,7,0
49275237@N00,3374,17,1329274694,1329295645,5,7,20951
49275237@N00,3375,10,1329719092,1329719329,2,6,237
49275237@N00,3375,11,1329704125,1329704202,5,6,77
49275237@N00,3375,13,1329715614,1329715785,11,6,171
49275237@N00,3375,5,1329706519,1329723154,10,6,16635
49275237@N00,3375,17,1329717237,1329718862,10,6,1625
49275237@N00,3375,8,1329709747,1329710138,12,6,391
49299827@N06,3376,2,1467246333,1467247114,5,2,781
49299827@N06,3376,11,1467239400,1467249223,2,2,9823
49305593@N05,3377,11,1389697976,1389698001,2,1,25
49305593@N05,3378,11,1429531745,1429532265,2,1,520
49347514@N04,3379,1,1243040766,1243040766,1,1,0
49355124@N04,3380,2,1357730807,1357730807,1,1,0
49355124@N04,3381,2,1357810559,1357810559,1,1,0
49375330@N02,3382,11,1322758066,1322758066,1,1,0
49395260@N00,3383,11,1333530539,1333530539,1,1,0
49395260@N00,3384,11,1333961910,1333961910,1,1,0
49465515@N00,3385,10,1241323487,1241323726,4,4,239
49465515@N00,3385,2,1241324691,1241325138,4,4,447
49465515@N00,3385,15,1241323327,1241323327,1,4,0
49465515@N00,3385,11,1241325220,1241325512,3,4,292
49465515@N00,3386,10,1241506546,1241506546,1,2,0
49465515@N00,3386,8,1241507806,1241513199,5,2,5393
49472870@N04,3387,11,1394520748,1394520748,1,1,0
49473802@N05,3388,5,1457915144,1457915144,1,1,0
49502978053@N01,3389,17,1316067811,1316067811,1,1,0
49502978053@N01,3390,8,1317467390,1317467390,1,9,0
49502978053@N01,3390,2,1317467194,1317467194,1,9,0
49502978053@N01,3390,10,1317467112,1317467163,4,9,51
49502978053@N01,3390,15,1317467479,1317469495,3,9,2016
49502978053@N01,3390,13,1317467443,1317467443,1,9,0
49502978053@N01,3390,11,1317470849,1317470933,11,9,84
49502978053@N01,3390,9,1317470821,1317470838,2,9,17
49502978053@N01,3390,1,1317470297,1317470782,6,9,485
49502978053@N01,3390,17,1317467235,1317470722,11,9,3487
49502987176@N01,3391,2,1275202759,1275202759,1,5,0
49502987176@N01,3391,12,1275176015,1275176015,1,5,0
49502987176@N01,3391,4,1275178698,1275178698,1,5,0
49502987176@N01,3391,1,1275210315,1275210345,2,5,30
49502987176@N01,3391,5,1275183936,1275183936,1,5,0
49502987176@N01,3392,13,1275546964,1275546964,1,1,0
49502987176@N01,3393,8,1314350761,1314350761,1,1,0
49503002894@N01,3394,11,1445896472,1445896472,1,1,0
49503033361@N01,3395,12,1285977699,1285977699,1,1,0
49503033361@N01,3396,2,1431074400,1431074406,6,2,6
49503033361@N01,3396,12,1431074405,1431074405,1,2,0
49503053139@N01,3397,7,1381711185,1381711185,1,1,0
49503068447@N01,3398,11,1203926262,1203926262,1,2,0
49503068447@N01,3398,5,1203934843,1203934843,1,2,0
49503068447@N01,3399,8,1204079617,1204079617,1,6,0
49503068447@N01,3399,11,1204092931,1204096344,4,6,3413
49503068447@N01,3399,15,1204090433,1204090433,1,6,0
49503068447@N01,3399,5,1204076629,1204076629,1,6,0
49503068447@N01,3399,13,1204088951,1204089782,2,6,831
49503068447@N01,3399,10,1204090938,1204090938,1,6,0
49503068447@N01,3400,11,1267429622,1267429622,1,1,0
49503114584@N01,3401,11,1218119593,1218119965,3,1,372
49503114584@N01,3402,8,1281081235,1281081345,2,1,110
49503114584@N01,3403,5,1343699626,1343699626,1,3,0
49503114584@N01,3403,11,1343696094,1343696094,1,3,0
49503114584@N01,3403,8,1343702249,1343704292,4,3,2043
49503114584@N01,3404,11,1343961779,1343961928,3,2,149
49503114584@N01,3404,10,1343966749,1343966749,1,2,0
49503114584@N01,3405,11,1344309486,1344309486,1,2,0
49503114584@N01,3405,8,1344310668,1344311265,3,2,597
49503114584@N01,3406,11,1344507688,1344507688,1,1,0
49503114584@N01,3407,15,1344825562,1344825562,1,5,0
49503114584@N01,3407,10,1344823592,1344823592,1,5,0
49503114584@N01,3407,17,1344823696,1344823696,1,5,0
49503114584@N01,3407,11,1344831555,1344833177,3,5,1622
49503114584@N01,3407,5,1344829965,1344829965,1,5,0
49503114584@N01,3408,8,1406518020,1406518187,2,1,167
49503114584@N01,3409,13,1406789601,1406789601,1,1,0
49503114584@N01,3410,11,1406963406,1406963461,2,2,55
49503114584@N01,3410,14,1406966173,1406966393,2,2,220
49503114584@N01,3411,10,1407122408,1407122408,1,1,0
49645702@N00,3412,11,1363339491,1363340360,17,1,869
49675952@N07,3413,3,1268469946,1268469946,1,1,0
49675952@N07,3414,8,1304127460,1304127460,1,3,0
49675952@N07,3414,11,1304132167,1304132167,1,3,0
49675952@N07,3414,17,1304118755,1304118755,1,3,0
49675952@N07,3415,9,1305420264,1305420264,1,1,0
49677598@N00,3416,11,1220929200,1220929230,2,1,30
49677598@N00,3417,9,1221220740,1221220800,2,1,60
49691404@N04,3418,4,1413353779,1413353779,1,2,0
49691404@N04,3418,11,1413333457,1413333457,1,2,0
49692767@N07,3419,11,1451529512,1451529512,1,1,0
49738389@N00,3420,2,1287566746,1287566746,1,1,0
49738389@N00,3421,5,1295784914,1295784914,1,1,0
49786625@N07,3422,5,1416545126,1416545126,1,2,0
49786625@N07,3422,11,1416558872,1416558872,1,2,0
49814544@N00,3423,11,1455758457,1455782029,3,3,23572
49814544@N00,3423,13,1455765622,1455765622,1,3,0
49814544@N00,3423,17,1455764353,1455764431,2,3,78
49836029@N06,3424,15,1329042583,1329042583,1,1,0
49855440@N00,3425,4,1229839705,1229839705,1,3,0
49855440@N00,3425,8,1229835931,1229836178,6,3,247
49855440@N00,3425,1,1229839408,1229839408,1,3,0
49855440@N00,3426,17,1230101308,1230101308,1,2,0
49855440@N00,3426,11,1230096251,1230096251,1,2,0
49855440@N00,3427,15,1316912613,1316912613,1,2,0
49855440@N00,3427,7,1316908551,1316908551,1,2,0
49858381@N04,3428,10,1358052818,1358052818,1,1,0
49887039@N04,3429,11,1283389806,1283389806,1,6,0
49887039@N04,3429,2,1283392405,1283392405,1,6,0
49887039@N04,3429,17,1283424765,1283426019,11,6,1254
49887039@N04,3429,1,1283394416,1283394416,1,6,0
49887039@N04,3429,9,1283396048,1283396048,1,6,0
49887039@N04,3429,4,1283421479,1283421479,1,6,0
49887039@N04,3430,11,1346688521,1346688831,3,3,310
49887039@N04,3430,2,1346688669,1346688774,2,3,105
49887039@N04,3430,4,1346688731,1346688731,1,3,0
49887039@N04,3431,3,1347172672,1347172672,1,2,0
49887039@N04,3431,9,1347181603,1347181603,1,2,0
49887039@N04,3432,8,1347530392,1347530552,2,4,160
49887039@N04,3432,11,1347520720,1347520720,1,4,0
49887039@N04,3432,5,1347523479,1347523479,1,4,0
49887039@N04,3432,1,1347526633,1347526633,1,4,0
49887039@N04,3433,11,1347807975,1347810802,2,1,2827
49887039@N04,3434,13,1361364681,1361364681,1,1,0
49934509@N00,3435,17,1291703867,1291711811,3,3,7944
49934509@N00,3435,2,1291689016,1291689016,1,3,0
49934509@N00,3435,8,1291691412,1291691412,1,3,0
49934509@N00,3436,11,1292051426,1292051426,1,1,0
49934509@N00,3437,3,1327039701,1327039701,1,1,0
49934509@N00,3438,12,1351317053,1351317053,1,1,0
49934509@N00,3439,7,1351506277,1351506412,6,6,135
49934509@N00,3439,5,1351479849,1351480374,2,6,525
49934509@N00,3439,9,1351477904,1351477904,1,6,0
49934509@N00,3439,3,1351476194,1351506397,2,6,30203
49934509@N00,3439,8,1351481541,1351482018,2,6,477
49934509@N00,3439,13,1351499471,1351501279,4,6,1808
49934509@N00,3440,6,1351829744,1351829744,1,4,0
49934509@N00,3440,13,1351827176,1351828439,7,4,1263
49934509@N00,3440,10,1351847230,1351850485,12,4,3255
49934509@N00,3440,15,1351849618,1351849797,5,4,179
49934509@N00,3441,3,1351930849,1351933707,5,1,2858
50023219@N05,3442,6,1271399971,1271399971,1,1,0
50023219@N05,3443,6,1272250052,1272250068,6,2,16
50023219@N05,3443,11,1272250070,1272250070,1,2,0
50178943@N03,3444,11,1412383347,1412383347,1,2,0
50178943@N03,3444,2,1412387057,1412387057,1,2,0
50196916@N00,3445,10,1311305512,1311305512,1,1,0
50207065@N00,3446,10,1203208620,1203208620,1,2,0
50207065@N00,3446,8,1203215810,1203215816,2,2,6
50223961@N03,3447,16,1320484145,1320484150,2,1,5
50267281@N07,3448,11,1354438557,1354448077,8,1,9520
50267281@N07,3449,11,1354491915,1354507513,8,1,15598
50267281@N07,3450,11,1354745930,1354783984,27,1,38054
50267281@N07,3451,11,1415174710,1415182486,15,1,7776
50267281@N07,3452,13,1415417090,1415418381,2,2,1291
50267281@N07,3452,11,1415409599,1415420542,37,2,10943
50267281@N07,3453,11,1415575709,1415587747,63,1,12038
50276147@N05,3454,11,1305017254,1305017254,1,1,0
50428026@N00,3455,11,1431562741,1431565388,2,4,2647
50428026@N00,3455,17,1431572085,1431572085,1,4,0
50428026@N00,3455,4,1431569802,1431569802,1,4,0
50428026@N00,3455,1,1431582243,1431582243,1,4,0
50514859@N00,3456,8,1248654201,1248654550,3,1,349
50559670@N04,3457,8,1369810780,1369810780,1,1,0
50565671@N00,3458,11,1398214547,1398214547,1,1,0
50584538@N07,3459,10,1271320741,1271321811,9,1,1070
50584538@N07,3460,10,1272184951,1272185702,5,1,751
50584538@N07,3461,10,1272357553,1272358545,3,1,992
50584538@N07,3462,10,1272526788,1272535098,8,1,8310
50584538@N07,3463,17,1304761729,1304763599,6,1,1870
50584538@N07,3464,17,1304848174,1304849494,2,1,1320
50584538@N07,3465,17,1305448908,1305449979,4,1,1071
50584538@N07,3466,17,1308213740,1308213909,3,1,169
50639889@N00,3467,8,1222979028,1222979028,1,1,0
50728212@N00,3468,12,1212558813,1212565256,2,1,6443
50753203@N02,3469,1,1295148842,1295148842,1,2,0
50753203@N02,3469,8,1295158207,1295158207,1,2,0
50753203@N02,3470,8,1425809022,1425809477,2,1,455
50764296@N03,3471,11,1305780223,1305791294,5,1,11071
50968580@N00,3472,17,1317547588,1317547588,1,1,0
50968580@N00,3473,11,1319369696,1319369696,1,1,0
50968580@N00,3474,11,1352030187,1352030187,1,2,0
50968580@N00,3474,9,1352002677,1352002677,1,2,0
50968580@N00,3475,5,1356834875,1356843364,6,2,8489
50968580@N00,3475,13,1356851405,1356851405,1,2,0
50968580@N00,3476,5,1362807256,1362807256,1,2,0
50968580@N00,3476,11,1362801233,1362828891,4,2,27658
50968580@N00,3477,16,1378025763,1378025763,1,5,0
50968580@N00,3477,5,1378017367,1378023208,3,5,5841
50968580@N00,3477,3,1378006777,1378009831,4,5,3054
50968580@N00,3477,11,1378050308,1378050308,1,5,0
50968580@N00,3477,7,1378001057,1378003882,2,5,2825
50968580@N00,3478,5,1387251217,1387253307,2,5,2090
50968580@N00,3478,4,1387257744,1387257984,2,5,240
50968580@N00,3478,11,1387243246,1387243246,1,5,0
50968580@N00,3478,2,1387264159,1387265624,2,5,1465
50968580@N00,3478,15,1387268436,1387268436,1,5,0
51011933@N00,3479,2,1366157991,1366160074,3,5,2083
51011933@N00,3479,9,1366165879,1366165879,1,5,0
51011933@N00,3479,11,1366154802,1366154802,1,5,0
51011933@N00,3479,10,1366186750,1366187355,2,5,605
51011933@N00,3479,3,1366168550,1366168550,1,5,0
51011933@N00,3480,2,1366235012,1366235012,1,2,0
51011933@N00,3480,11,1366234000,1366234000,1,2,0
51011933@N00,3481,4,1366278666,1366278666,1,2,0
51011933@N00,3481,9,1366276168,1366276168,1,2,0
51035587259@N01,3482,11,1354082023,1354082023,1,1,0
51035641205@N01,3483,4,1271979081,1271979081,1,1,0
51035647214@N01,3484,16,1273981543,1273981543,1,2,0
51035647214@N01,3484,2,1273992224,1273992226,2,2,2
51035650382@N01,3485,11,1350103335,1350109754,2,1,6419
51035650382@N01,3486,11,1350271928,1350271928,1,1,0
51035650382@N01,3487,11,1445127101,1445127101,1,1,0
51035650382@N01,3488,11,1445566134,1445571540,2,1,5406
51035650382@N01,3489,11,1445747635,1445747635,1,1,0
51035760029@N01,3490,2,1383712654,1383712664,2,1,10
51035771246@N01,3491,11,1254453794,1254453794,1,3,0
51035771246@N01,3491,17,1254461833,1254462496,5,3,663
51035771246@N01,3491,5,1254467608,1254467608,1,3,0
51037533@N00,3492,8,1359189532,1359189532,1,1,0
51038094@N04,3493,15,1360567047,1360567047,1,3,0
51038094@N04,3493,13,1360568138,1360568138,1,3,0
51038094@N04,3493,11,1360579077,1360585550,2,3,6473
51052219@N00,3494,10,1290913524,1290913524,1,1,0
51052219@N00,3495,13,1317222420,1317222420,1,1,0
51065161@N00,3496,11,1386766490,1386775959,2,3,9469
51065161@N00,3496,2,1386784369,1386784369,1,3,0
51065161@N00,3496,8,1386775642,1386775812,3,3,170
51116425@N06,3497,1,1330335080,1330335080,1,1,0
51141147@N02,3498,10,1335145318,1335145528,3,10,210
51141147@N02,3498,16,1335167599,1335168368,4,10,769
51141147@N02,3498,8,1335156578,1335158712,13,10,2134
51141147@N02,3498,15,1335146779,1335146779,1,10,0
51141147@N02,3498,9,1335166145,1335167531,4,10,1386
51141147@N02,3498,11,1335136887,1335168535,3,10,31648
51141147@N02,3498,5,1335163179,1335163179,1,10,0
51141147@N02,3498,7,1335145010,1335145036,2,10,26
51141147@N02,3498,13,1335147746,1335150436,8,10,2690
51141147@N02,3498,17,1335146073,1335146628,4,10,555
51159953@N00,3499,11,1304382565,1304418181,8,5,35616
51159953@N00,3499,17,1304378708,1304378717,2,5,9
51159953@N00,3499,2,1304385923,1304389731,7,5,3808
51159953@N00,3499,1,1304384063,1304384109,2,5,46
51159953@N00,3499,7,1304389875,1304389892,3,5,17
51159953@N00,3500,12,1304651971,1304652029,3,3,58
51159953@N00,3500,11,1304678155,1304678401,3,3,246
51159953@N00,3500,2,1304646227,1304646227,1,3,0
51166785@N06,3501,3,1351927320,1351927320,1,5,0
51166785@N06,3501,5,1351914343,1351914918,2,5,575
51166785@N06,3501,16,1351912304,1351912304,1,5,0
51166785@N06,3501,11,1351898298,1351898298,1,5,0
51166785@N06,3501,9,1351911741,1351911924,2,5,183
51238318@N07,3502,8,1311734577,1311739138,2,1,4561
51267780@N00,3503,17,1224111874,1224112036,3,9,162
51267780@N00,3503,15,1224112121,1224112121,1,9,0
51267780@N00,3503,13,1224112197,1224120549,15,9,8352
51267780@N00,3503,16,1224107671,1224108201,5,9,530
51267780@N00,3503,10,1224109286,1224109402,3,9,116
51267780@N00,3503,8,1224124972,1224127001,6,9,2029
51267780@N00,3503,9,1224107419,1224107565,4,9,146
51267780@N00,3503,11,1224104372,1224104802,4,9,430
51267780@N00,3503,5,1224125345,1224126679,5,9,1334
51267780@N00,3504,17,1224285534,1224286123,6,4,589
51267780@N00,3504,15,1224285453,1224285453,1,4,0
51267780@N00,3504,1,1224276155,1224276155,1,4,0
51267780@N00,3504,5,1224276458,1224276510,2,4,52
51313971@N08,3505,11,1443408912,1443409379,2,1,467
51437422@N03,3506,8,1427884826,1427884826,1,1,0
51437422@N03,3507,11,1465789348,1465789348,1,1,0
51446559@N06,3508,11,1322045614,1322062562,2,1,16948
51460585@N03,3509,11,1375664897,1375664897,1,1,0
51501947@N05,3510,13,1319795618,1319795618,1,1,0
51501947@N05,3511,15,1319859785,1319859785,1,1,0
51501947@N05,3512,8,1320286175,1320286175,1,1,0
51531384@N00,3513,11,1415503835,1415512535,3,1,8700
51547237@N00,3514,17,1291795680,1291795680,1,1,0
51547237@N00,3515,11,1412462731,1412462733,2,1,2
51547237@N00,3516,6,1449038484,1449038484,1,1,0
51579577@N00,3517,8,1388028042,1388028042,1,2,0
51579577@N00,3517,5,1388025449,1388025449,1,2,0
51636307@N00,3518,1,1323235014,1323235014,1,10,0
51636307@N00,3518,9,1323236120,1323236246,2,10,126
51636307@N00,3518,4,1323245657,1323245657,1,10,0
51636307@N00,3518,11,1323214035,1323247953,11,10,33918
51636307@N00,3518,17,1323216576,1323217506,8,10,930
51636307@N00,3518,13,1323217609,1323217996,4,10,387
51636307@N00,3518,3,1323240052,1323240838,3,10,786
51636307@N00,3518,8,1323231007,1323233808,10,10,2801
51636307@N00,3518,15,1323217237,1323217513,4,10,276
51636307@N00,3518,5,1323234491,1323234491,1,10,0
51662658@N05,3519,15,1266644851,1266644851,1,1,0
51692964@N05,3520,4,1236817604,1236817604,1,1,0
51746064@N07,3521,11,1362720872,1362729699,11,3,8827
51746064@N07,3521,1,1362722718,1362722718,1,3,0
51746064@N07,3521,2,1362723418,1362723451,2,3,33
51746586@N06,3522,11,1281371619,1281371619,1,1,0
51746586@N06,3523,11,1282304571,1282304571,1,1,0
51746586@N06,3524,2,1312332458,1312332458,1,6,0
51746586@N06,3524,15,1312347933,1312350174,5,6,2241
51746586@N06,3524,10,1312332213,1312332213,1,6,0
51746586@N06,3524,7,1312332866,1312332866,1,6,0
51746586@N06,3524,13,1312331541,1312331541,1,6,0
51746586@N06,3524,17,1312331406,1312346947,4,6,15541
51746586@N06,3525,13,1313053805,1313062545,4,1,8740
51746586@N06,3526,8,1313462233,1313462233,1,1,0
51746586@N06,3527,15,1344068839,1344068840,2,3,1
51746586@N06,3527,7,1344068151,1344068422,2,3,271
51746586@N06,3527,6,1344075913,1344078943,5,3,3030
51746586@N06,3528,8,1344403221,1344407157,4,6,3936
51746586@N06,3528,15,1344407782,1344407782,1,6,0
51746586@N06,3528,13,1344388323,1344388833,5,6,510
51746586@N06,3528,6,1344409498,1344409512,2,6,14
51746586@N06,3528,5,1344408781,1344409492,3,6,711
51746586@N06,3528,17,1344387524,1344415048,3,6,27524
51746586@N06,3529,6,1344856269,1344856456,3,1,187
51746586@N06,3530,15,1345000539,1345003953,8,1,3414
51746586@N06,3531,5,1406802511,1406802511,1,1,0
51773303@N00,3532,9,1350400140,1350400140,1,1,0
51791370@N03,3533,13,1300319987,1300320790,3,2,803
51791370@N03,3533,1,1300337189,1300337221,2,2,32
51821103@N07,3534,11,1340271227,1340282448,9,1,11221
51931244@N02,3535,5,1266679502,1266679502,1,1,0
51931244@N02,3536,11,1269773614,1269773614,1,3,0
51931244@N02,3536,5,1269762535,1269762535,1,3,0
51931244@N02,3536,13,1269745479,1269745479,1,3,0
51965232@N06,3537,11,1408238205,1408238205,1,1,0
52066610@N03,3538,11,1394521531,1394521531,1,2,0
52066610@N03,3538,8,1394516619,1394516619,1,2,0
52082189@N03,3539,11,1328014800,1328014800,2,1,0
52135752@N07,3540,11,1392966038,1392966038,1,1,0
52168854@N00,3541,17,1348392829,1348392899,3,1,70
52168854@N00,3542,8,1348817698,1348817698,1,1,0
52192784@N08,3543,1,1389763845,1389764597,3,3,752
52192784@N08,3543,11,1389757391,1389762488,4,3,5097
52192784@N08,3543,8,1389773698,1389773698,1,3,0
52195956@N03,3544,1,1314412775,1314413394,17,1,619
52226961@N04,3545,7,1376804196,1376804480,2,2,284
52226961@N04,3545,5,1376804696,1376804911,2,2,215
52226961@N04,3546,3,1401503939,1401503939,1,2,0
52226961@N04,3546,11,1401494590,1401494590,1,2,0
52242069@N04,3547,1,1331275753,1331275753,1,1,0
52254014@N00,3548,10,1278229800,1278229800,1,1,0
52254014@N00,3549,8,1293865309,1293865309,1,2,0
52254014@N00,3549,13,1293863873,1293863873,1,2,0
52254014@N00,3550,8,1304851447,1304851447,1,1,0
52254014@N00,3551,11,1317507671,1317507671,1,1,0
52254014@N00,3552,9,1326359682,1326359682,1,4,0
52254014@N00,3552,11,1326360649,1326360649,1,4,0
52254014@N00,3552,15,1326352070,1326355022,2,4,2952
52254014@N00,3552,13,1326356189,1326356189,1,4,0
52254014@N00,3553,11,1349857571,1349857571,1,2,0
52254014@N00,3553,8,1349856097,1349856097,1,2,0
52254014@N00,3554,15,1362211573,1362211573,1,1,0
52364637@N00,3555,10,1378527219,1378527219,1,3,0
52364637@N00,3555,11,1378524527,1378524527,1,3,0
52364637@N00,3555,9,1378526682,1378526682,1,3,0
52378595@N06,3556,10,1297134392,1297134392,1,1,0
52378595@N06,3557,11,1311834850,1311834850,1,1,0
52407821@N00,3558,11,1354917922,1354917922,1,1,0
52458519@N07,3559,15,1250902905,1250902905,1,3,0
52458519@N07,3559,6,1250917097,1250917097,1,3,0
52458519@N07,3559,4,1250899776,1250899776,1,3,0
52465495@N06,3560,2,1378543007,1378543007,1,2,0
52465495@N06,3560,13,1378540397,1378540397,1,2,0
52495257@N02,3561,6,1247328741,1247328741,1,1,0
52495497@N08,3562,6,1328410559,1328410559,1,1,0
52495497@N08,3563,17,1394711090,1394711090,1,1,0
52504278@N00,3564,11,1254142421,1254142421,1,1,0
52504278@N00,3565,13,1333490574,1333490574,1,2,0
52504278@N00,3565,6,1333481667,1333481667,1,2,0
52504278@N00,3566,11,1333535381,1333535381,1,1,0
52574631@N00,3567,2,1455415175,1455418473,7,6,3298
52574631@N00,3567,8,1455438989,1455439103,2,6,114
52574631@N00,3567,11,1455410078,1455444370,5,6,34292
52574631@N00,3567,3,1455414546,1455414546,1,6,0
52574631@N00,3567,1,1455426563,1455426563,1,6,0
52574631@N00,3567,16,1455423988,1455425118,6,6,1130
52574631@N00,3568,5,1455784121,1455784380,2,4,259
52574631@N00,3568,4,1455770408,1455774299,6,4,3891
52574631@N00,3568,11,1455768469,1455786604,2,4,18135
52574631@N00,3568,14,1455769389,1455769389,1,4,0
52574631@N00,3569,11,1455901429,1455911343,2,1,9914
52574631@N00,3570,11,1456910619,1456910619,1,1,0
52608533@N04,3571,2,1411258935,1411258935,1,1,0
52636686@N07,3572,7,1390351174,1390353650,17,9,2476
52636686@N07,3572,16,1390360958,1390365479,24,9,4521
52636686@N07,3572,4,1390353794,1390354773,14,9,979
52636686@N07,3572,11,1390342280,1390383959,35,9,41679
52636686@N07,3572,1,1390357086,1390362023,12,9,4937
52636686@N07,3572,2,1390348133,1390350913,27,9,2780
52636686@N07,3572,8,1390369535,1390377931,49,9,8396
52636686@N07,3572,5,1390368019,1390368874,20,9,855
52636686@N07,3572,9,1390359807,1390360925,6,9,1118
52636686@N07,3573,10,1390439473,1390441733,26,7,2260
52636686@N07,3573,7,1390437163,1390437205,2,7,42
52636686@N07,3573,17,1390442851,1390443029,3,7,178
52636686@N07,3573,8,1390457143,1390459002,25,7,1859
52636686@N07,3573,5,1390460042,1390460940,4,7,898
52636686@N07,3573,15,1390434331,1390443954,26,7,9623
52636686@N07,3573,13,1390444485,1390446629,15,7,2144
52645917@N08,3574,5,1424593678,1424595039,2,2,1361
52645917@N08,3574,8,1424596795,1424609790,2,2,12995
52666614@N06,3575,9,1407924982,1407924986,2,3,4
52666614@N06,3575,11,1407912866,1407912869,2,3,3
52666614@N06,3575,1,1407927233,1407927233,1,3,0
52666614@N06,3576,5,1408270118,1408274351,2,3,4233
52666614@N06,3576,11,1408265096,1408265096,1,3,0
52666614@N06,3576,8,1408273363,1408273363,1,3,0
52666614@N06,3577,13,1408419004,1408419004,1,3,0
52666614@N06,3577,16,1408422532,1408422532,1,3,0
52666614@N06,3577,10,1408419989,1408420039,4,3,50
52683535@N00,3578,11,1322822966,1322822966,1,1,0
52752881@N03,3579,16,1302056724,1302056724,1,3,0
52752881@N03,3579,11,1302055423,1302055423,1,3,0
52752881@N03,3579,10,1302078159,1302078159,1,3,0
52758053@N07,3580,8,1335059747,1335060339,2,1,592
52758053@N07,3581,11,1335437857,1335438073,2,2,216
52758053@N07,3581,13,1335427732,1335427732,1,2,0
52758053@N07,3582,2,1375515259,1375515259,1,2,0
52758053@N07,3582,4,1375522722,1375522722,1,2,0
52758053@N07,3583,8,1375794961,1375795234,3,7,273
52758053@N07,3583,11,1375758554,1375796611,2,7,38057
52758053@N07,3583,4,1375787425,1375787611,3,7,186
52758053@N07,3583,1,1375779342,1375779342,1,7,0
52758053@N07,3583,3,1375787470,1375787470,1,7,0
52758053@N07,3583,10,1375787382,1375789367,2,7,1985
52758053@N07,3583,13,1375791214,1375791252,2,7,38
52758053@N07,3584,8,1376041002,1376041002,1,1,0
52758053@N07,3585,17,1400298439,1400298439,1,1,0
52758053@N07,3586,8,1465297783,1465297825,2,1,42
52774491@N00,3587,11,1305192486,1305192486,1,1,0
52793155@N07,3588,11,1190886675,1190886675,1,1,0
52793155@N07,3589,13,1283075022,1283075022,1,1,0
52793155@N07,3590,11,1285049272,1285049272,1,3,0
52793155@N07,3590,8,1285044709,1285044709,1,3,0
52793155@N07,3590,5,1285047857,1285059261,2,3,11404
52793155@N07,3591,11,1286885389,1286885389,1,1,0
52793155@N07,3592,2,1291813961,1291813961,1,1,0
52793155@N07,3593,2,1292250372,1292250372,1,1,0
52793155@N07,3594,11,1295686879,1295686879,1,1,0
52793155@N07,3595,13,1316241876,1316241876,1,1,0
52793155@N07,3596,8,1316334892,1316334892,1,1,0
52793155@N07,3597,13,1316415350,1316415350,1,1,0
52793155@N07,3598,13,1316760449,1316760449,1,1,0
52793155@N07,3599,15,1329025205,1329025205,1,2,0
52793155@N07,3599,13,1329025555,1329025555,1,2,0
52793155@N07,3600,9,1332204358,1332204700,3,2,342
52793155@N07,3600,8,1332210122,1332210897,3,2,775
52793155@N07,3601,8,1334448296,1334448296,1,1,0
52793155@N07,3602,11,1337671173,1337671173,1,1,0
52793155@N07,3603,10,1345363277,1345363277,1,1,0
52793155@N07,3604,3,1358754398,1358754398,1,1,0
52793155@N07,3605,8,1363492334,1363495533,3,1,3199
52793155@N07,3606,3,1381300796,1381300796,1,1,0
52793155@N07,3607,9,1382844627,1382844741,2,4,114
52793155@N07,3607,5,1382846591,1382846591,1,4,0
52793155@N07,3607,16,1382844051,1382844051,1,4,0
52793155@N07,3607,11,1382843242,1382843242,1,4,0
52793155@N07,3608,3,1385182893,1385182893,1,4,0
52793155@N07,3608,4,1385183170,1385183792,7,4,622
52793155@N07,3608,8,1385190885,1385190885,1,4,0
52793155@N07,3608,9,1385181079,1385181835,15,4,756
52793155@N07,3609,5,1386115496,1386115496,1,1,0
52793155@N07,3610,8,1386284125,1386284125,1,1,0
52793155@N07,3611,8,1389500319,1389502164,2,1,1845
52793155@N07,3612,3,1390721184,1390721184,1,1,0
52793155@N07,3613,8,1399095177,1399095177,1,1,0
52793155@N07,3614,11,1400796563,1400797141,3,3,578
52793155@N07,3614,13,1400803679,1400803679,1,3,0
52793155@N07,3614,15,1400802358,1400802358,1,3,0
52793155@N07,3615,8,1409991407,1409991407,1,1,0
52793155@N07,3616,8,1410478786,1410478786,1,1,0
52793155@N07,3617,5,1416017852,1416017852,1,1,0
52793155@N07,3618,8,1421627422,1421627422,1,1,0
52793155@N07,3619,8,1425171964,1425171964,1,1,0
52793155@N07,3620,8,1456557229,1456557229,1,1,0
52812594@N00,3621,15,1274089719,1274089719,1,1,0
52828533@N00,3622,11,1220920092,1220920849,2,2,757
52828533@N00,3622,4,1220927638,1220927638,1,2,0
52842822@N04,3623,4,1358938945,1358938945,1,1,0
52842822@N04,3624,11,1359029812,1359029812,1,1,0
52842822@N04,3625,4,1360216708,1360216708,1,1,0
52842822@N04,3626,13,1362652881,1362652881,1,1,0
52842822@N04,3627,11,1373112768,1373112768,1,1,0
52842822@N04,3628,16,1373972723,1373972723,1,1,0
52842822@N04,3629,1,1391854668,1391854668,1,1,0
52842822@N04,3630,10,1401878797,1401878797,1,1,0
52842822@N04,3631,13,1409221503,1409221503,1,1,0
52842822@N04,3632,8,1411790092,1411790092,1,1,0
52842822@N04,3633,10,1415563784,1415563784,1,1,0
52842822@N04,3634,15,1425537626,1425537626,1,1,0
52842822@N04,3635,8,1434363457,1434363457,1,1,0
52855156@N00,3636,11,1217159999,1217160342,3,1,343
52862869@N07,3637,1,1300085184,1300085184,1,6,0
52862869@N07,3637,15,1300091786,1300092236,2,6,450
52862869@N07,3637,9,1300085108,1300085108,1,6,0
52862869@N07,3637,13,1300091208,1300091208,1,6,0
52862869@N07,3637,11,1300078469,1300079220,3,6,751
52862869@N07,3637,4,1300094429,1300094550,2,6,121
52872213@N04,3638,8,1294414495,1294414495,1,1,0
52892088@N02,3639,11,1346536293,1346538188,2,1,1895
52892088@N02,3640,11,1367752517,1367752517,1,2,0
52892088@N02,3640,17,1367754400,1367754400,1,2,0
52906672@N00,3641,8,1408073118,1408073161,2,2,43
52906672@N00,3641,11,1408068382,1408068384,2,2,2
52976240@N00,3642,11,1354854289,1354854289,1,1,0
52976240@N00,3643,11,1354901314,1354901314,1,2,0
52976240@N00,3643,8,1354896055,1354896055,1,2,0
52976240@N00,3644,11,1355058085,1355064123,2,1,6038
52976240@N00,3645,17,1365837427,1365837427,1,1,0
52976240@N00,3646,11,1365948494,1365948494,1,1,0
52976240@N00,3647,11,1424592928,1424592928,1,1,0
52982457@N00,3648,11,1278195803,1278244226,30,1,48423
52989928@N07,3649,11,1280288560,1280288560,1,1,0
53024970@N07,3650,2,1273523116,1273523116,1,2,0
53024970@N07,3650,6,1273523589,1273523589,1,2,0
53024970@N07,3651,13,1273591906,1273591906,1,3,0
53024970@N07,3651,2,1273582099,1273582110,2,3,11
53024970@N07,3651,4,1273577624,1273577656,2,3,32
53024970@N07,3652,2,1282299072,1282301168,2,1,2096
53024970@N07,3653,13,1283519875,1283520029,3,1,154
53024970@N07,3654,17,1334465027,1334465027,1,1,0
53034361@N00,3655,6,1463117295,1463128529,4,1,11234
53034361@N00,3656,5,1463386574,1463386574,1,2,0
53034361@N00,3656,8,1463387170,1463387170,1,2,0
53055319@N00,3657,16,1188721732,1188721732,1,1,0
53093866@N00,3658,2,1361784259,1361784259,1,1,0
53127166@N04,3659,11,1390429741,1390429741,1,1,0
53157520@N07,3660,5,1285994070,1285994070,1,2,0
53157520@N07,3660,8,1285995816,1285995816,1,2,0
53179863@N07,3661,15,1426292389,1426292389,1,1,0
53199533@N07,3662,12,1268917334,1268917350,14,12,16
53199533@N07,3662,15,1268917205,1268917210,5,12,5
53199533@N07,3662,10,1268917212,1268917221,9,12,9
53199533@N07,3662,13,1268917259,1268917285,25,12,26
53199533@N07,3662,2,1268917347,1268917356,5,12,9
53199533@N07,3662,7,1268917354,1268917355,2,12,1
53199533@N07,3662,3,1268917353,1268917353,1,12,0
53199533@N07,3662,11,1268917200,1268917360,8,12,160
53199533@N07,3662,5,1268917328,1268917333,6,12,5
53199533@N07,3662,1,1268917325,1268917325,1,12,0
53199533@N07,3662,8,1268917224,1268917326,13,12,102
53199533@N07,3662,17,1268917208,1268917211,2,12,3
53199533@N07,3663,10,1269003600,1269003606,7,1,6
53228494@N00,3664,15,1270971492,1270971803,9,5,311
53228494@N00,3664,10,1270952160,1270952160,1,5,0
53228494@N00,3664,1,1270941900,1270941919,2,5,19
53228494@N00,3664,16,1270967257,1270967288,3,5,31
53228494@N00,3664,13,1270972183,1270972779,6,5,596
53325263@N07,3665,11,1301034108,1301034407,2,1,299
53353745@N00,3666,5,1399947962,1399947962,1,6,0
53353745@N00,3666,11,1399936848,1399937991,2,6,1143
53353745@N00,3666,15,1399945027,1399945027,1,6,0
53353745@N00,3666,10,1399944831,1399944831,1,6,0
53353745@N00,3666,8,1399946591,1399946591,1,6,0
53353745@N00,3666,17,1399944946,1399944955,2,6,9
53407359@N00,3667,11,1417472602,1417472602,2,1,0
53450473@N06,3668,8,1308344704,1308344812,2,1,108
53516741@N04,3669,2,1319096580,1319096580,1,2,0
53516741@N04,3669,8,1319101678,1319101678,1,2,0
53516741@N04,3670,8,1354527800,1354527800,1,1,0
53516741@N04,3671,17,1354844929,1354844929,1,1,0
53566822@N00,3672,11,1364006290,1364006290,1,1,0
53574480@N03,3673,11,1281681259,1281681259,1,1,0
53602988@N02,3674,2,1324191688,1324191695,2,1,7
53613159@N04,3675,11,1319666424,1319666424,1,1,0
53670581@N02,3676,11,1326010428,1326010428,1,1,0
53770108@N03,3677,1,1323482927,1323482927,1,1,0
53770108@N03,3678,11,1364869904,1364869904,1,1,0
53797701@N07,3679,11,1406343616,1406343616,1,1,0
53848863@N02,3680,8,1357427888,1357427888,1,1,0
53848863@N02,3681,8,1357707639,1357707639,1,3,0
53848863@N02,3681,9,1357691119,1357691119,1,3,0
53848863@N02,3681,11,1357685451,1357685451,1,3,0
54066480@N04,3682,11,1398372849,1398372849,1,1,0
54193979@N06,3683,11,1251727200,1251727200,1,1,0
54250081@N05,3684,8,1370145713,1370146345,24,5,632
54250081@N05,3684,13,1370162746,1370163261,7,5,515
54250081@N05,3684,10,1370164982,1370164982,1,5,0
54250081@N05,3684,5,1370142584,1370142620,4,5,36
54250081@N05,3684,17,1370163424,1370173500,7,5,10076
54276855@N07,3685,9,1351265311,1351265311,1,1,0
54364530@N08,3686,5,1354513266,1354513292,3,7,26
54364530@N08,3686,8,1354513549,1354514707,52,7,1158
54364530@N08,3686,16,1354511232,1354511239,2,7,7
54364530@N08,3686,13,1354516801,1354516801,1,7,0
54364530@N08,3686,9,1354512878,1354512878,1,7,0
54364530@N08,3686,11,1354511898,1354511908,3,7,10
54364530@N08,3686,2,1354511303,1354511310,2,7,7
54364530@N08,3687,13,1354572180,1354572180,1,1,0
54364530@N08,3688,1,1386727283,1386727475,5,1,192
54399332@N02,3689,11,1280586009,1280606628,2,2,20619
54399332@N02,3689,5,1280602047,1280602047,1,2,0
54432460@N08,3690,16,1295495476,1295495476,1,2,0
54432460@N08,3690,17,1295495213,1295495231,2,2,18
54491498@N00,3691,17,1254718541,1254718572,2,5,31
54491498@N00,3691,15,1254718038,1254718083,3,5,45
54491498@N00,3691,5,1254701181,1254701292,5,5,111
54491498@N00,3691,11,1254693853,1254693988,4,5,135
54491498@N00,3691,8,1254703748,1254704275,11,5,527
54497431@N05,3692,15,1318146152,1318146152,1,1,0
54589898@N00,3693,11,1415613676,1415613676,1,1,0
54612194@N05,3694,13,1364709073,1364709073,1,1,0
54679799@N03,3695,11,1370511811,1370511811,1,1,0
54679799@N03,3696,11,1370640330,1370655707,2,1,15377
54679799@N03,3697,11,1464065584,1464065584,1,4,0
54679799@N03,3697,9,1464055620,1464055620,1,4,0
54679799@N03,3697,13,1464066205,1464066205,1,4,0
54679799@N03,3697,1,1464055521,1464055521,1,4,0
54845704@N05,3698,11,1298507245,1298507245,1,7,0
54845704@N05,3698,8,1298534642,1298534843,2,7,201
54845704@N05,3698,2,1298510008,1298510008,1,7,0
54845704@N05,3698,9,1298524835,1298524947,3,7,112
54845704@N05,3698,1,1298523139,1298523139,1,7,0
54845704@N05,3698,14,1298517516,1298517516,1,7,0
54845704@N05,3698,12,1298511316,1298512161,5,7,845
54855264@N00,3699,1,1192851450,1192890600,3,7,39150
54855264@N00,3699,6,1192875113,1192875330,4,7,217
54855264@N00,3699,11,1192856680,1192890718,5,7,34038
54855264@N00,3699,4,1192833843,1192834010,2,7,167
54855264@N00,3699,7,1192836135,1192852667,5,7,16532
54855264@N00,3699,3,1192836745,1192852607,2,7,15862
54855264@N00,3699,8,1192837725,1192890488,16,7,52763
54855264@N00,3700,11,1371199396,1371199396,1,1,0
54855264@N00,3701,11,1376121457,1376121457,1,1,0
54902025@N00,3702,11,1286599592,1286599785,2,1,193
54902025@N00,3703,11,1328883802,1328883808,2,3,6
54902025@N00,3703,5,1328881948,1328882091,2,3,143
54902025@N00,3703,9,1328855221,1328855221,1,3,0
54902025@N00,3704,11,1329197670,1329198898,3,3,1228
54902025@N00,3704,4,1329196635,1329196635,1,3,0
54902025@N00,3704,5,1329190345,1329190345,1,3,0
54902025@N00,3705,8,1354795222,1354796355,3,3,1133
54902025@N00,3705,1,1354785211,1354785211,1,3,0
54902025@N00,3705,16,1354786376,1354786462,2,3,86
54902025@N00,3706,1,1358064564,1358064564,1,1,0
54905383@N07,3707,8,1238922517,1238922517,1,1,0
55041396@N00,3708,13,1398420554,1398420837,3,4,283
55041396@N00,3708,4,1398411253,1398411253,1,4,0
55041396@N00,3708,11,1398421962,1398422485,3,4,523
55041396@N00,3708,17,1398421101,1398421179,2,4,78
55052349@N00,3709,11,1342932611,1342974761,6,2,42150
55052349@N00,3709,15,1342953748,1342953748,1,2,0
55114802@N00,3710,11,1251539976,1251539976,1,1,0
55143107@N00,3711,11,1224116212,1224116213,3,1,1
55171970@N00,3712,15,1440056179,1440056179,1,3,0
55171970@N00,3712,8,1440048924,1440048924,1,3,0
55171970@N00,3712,17,1440056251,1440056251,1,3,0
55217458@N00,3713,9,1352864201,1352864249,2,1,48
55217458@N00,3714,10,1389158108,1389158108,1,2,0
55217458@N00,3714,15,1389164026,1389164026,1,2,0
55217458@N00,3715,17,1389306332,1389306332,1,6,0
55217458@N00,3715,9,1389306172,1389306172,1,6,0
55217458@N00,3715,11,1389324408,1389324408,1,6,0
55217458@N00,3715,1,1389301908,1389301908,1,6,0
55217458@N00,3715,2,1389323956,1389323956,1,6,0
55217458@N00,3715,8,1389289101,1389289101,1,6,0
55217458@N00,3716,11,1389487396,1389487396,1,1,0
55266776@N00,3717,4,1266575083,1266575083,1,1,0
55287129@N04,3718,9,1296632254,1296632254,1,1,0
55332987@N00,3719,17,1265364746,1265364746,1,1,0
55362088@N06,3720,13,1342062636,1342062636,1,1,0
55404083@N08,3721,11,1303207367,1303231396,2,1,24029
55404083@N08,3722,15,1303729920,1303729920,1,1,0
55455788@N00,3723,4,1194158733,1194158733,1,1,0
55455788@N00,3724,11,1222428556,1222428556,1,3,0
55455788@N00,3724,8,1222420658,1222421201,10,3,543
55455788@N00,3724,10,1222427245,1222427562,9,3,317
55455788@N00,3725,4,1225960036,1225960210,8,9,174
55455788@N00,3725,11,1225957464,1225967155,13,9,9691
55455788@N00,3725,15,1225961871,1225962064,8,9,193
55455788@N00,3725,7,1225959471,1225959577,7,9,106
55455788@N00,3725,17,1225961731,1225961731,1,9,0
55455788@N00,3725,8,1225963297,1225963689,14,9,392
55455788@N00,3725,10,1225961545,1225961649,6,9,104
55455788@N00,3725,5,1225962709,1225963943,7,9,1234
55455788@N00,3725,9,1225958072,1225958207,7,9,135
55455788@N00,3726,15,1232786298,1232801420,6,4,15122
55455788@N00,3726,8,1232778053,1232799878,37,4,21825
55455788@N00,3726,5,1232777616,1232798721,4,4,21105
55455788@N00,3726,13,1232787380,1232787640,4,4,260
55455788@N00,3727,1,1239351867,1239356447,5,5,4580
55455788@N00,3727,12,1239347485,1239348829,7,5,1344
55455788@N00,3727,2,1239346105,1239346145,3,5,40
55455788@N00,3727,11,1239344805,1239358094,11,5,13289
55455788@N00,3727,8,1239353339,1239353373,2,5,34
55455788@N00,3728,13,1239514900,1239515235,6,3,335
55455788@N00,3728,11,1239512427,1239519943,7,3,7516
55455788@N00,3728,10,1239513768,1239514786,13,3,1018
55455788@N00,3729,11,1242456786,1242457208,11,1,422
55455788@N00,3730,8,1255163999,1255163999,1,1,0
55455788@N00,3731,7,1263704417,1263706912,2,7,2495
55455788@N00,3731,10,1263698361,1263729010,3,7,30649
55455788@N00,3731,5,1263718432,1263720184,17,7,1752
55455788@N00,3731,4,1263709650,1263709668,2,7,18
55455788@N00,3731,13,1263727990,1263728565,30,7,575
55455788@N00,3731,11,1263713553,1263730678,21,7,17125
55455788@N00,3731,17,1263699928,1263728880,10,7,28952
55455788@N00,3732,11,1271569890,1271569890,1,1,0
55455788@N00,3733,4,1283746455,1283746553,2,2,98
55455788@N00,3733,12,1283745790,1283745942,4,2,152
55455788@N00,3734,17,1307864231,1307864231,1,1,0
55455788@N00,3735,10,1310265832,1310265832,1,1,0
55455788@N00,3736,4,1325058642,1325058755,2,1,113
55455788@N00,3737,11,1429412423,1429412423,1,1,0
55488870@N08,3738,11,1451006742,1451006742,1,1,0
55569174@N00,3739,13,1349577284,1349577728,11,2,444
55569174@N00,3739,11,1349568975,1349570163,12,2,1188
55569174@N00,3740,11,1358932539,1358932539,1,1,0
55570231@N03,3741,11,1284432680,1284432680,1,1,0
55615740@N00,3742,5,1404444023,1404452297,3,2,8274
55615740@N00,3742,8,1404445190,1404445190,1,2,0
55615740@N00,3743,17,1405754179,1405754286,3,2,107
55615740@N00,3743,10,1405754845,1405756753,5,2,1908
55615740@N00,3744,1,1405825011,1405825011,1,2,0
55615740@N00,3744,8,1405825600,1405830534,8,2,4934
55615740@N00,3745,8,1410058503,1410058503,1,1,0
55615740@N00,3746,11,1413534700,1413534700,1,1,0
55615740@N00,3747,10,1445654304,1445654347,2,4,43
55615740@N00,3747,11,1445642067,1445642067,1,4,0
55615740@N00,3747,13,1445645472,1445645920,2,4,448
55615740@N00,3747,17,1445644894,1445646986,2,4,2092
55629006@N02,3748,8,1297230134,1297230134,1,1,0
55629006@N02,3749,10,1299543901,1299543901,1,1,0
55639632@N03,3750,11,1343134575,1343134575,1,1,0
55639632@N03,3751,11,1343290443,1343290443,1,1,0
55664248@N04,3752,11,1288183309,1288183309,1,1,0
55762226@N00,3753,4,1423970671,1423970671,1,1,0
55762226@N00,3754,11,1446859218,1446859218,1,1,0
55818814@N04,3755,5,1313687616,1313687616,1,1,0
55822383@N02,3756,9,1345158263,1345158263,1,1,0
55894487@N00,3757,6,1333797170,1333797170,1,1,0
55991777@N00,3758,9,1433375624,1433375624,1,2,0
55991777@N00,3758,5,1433397699,1433397701,2,2,2
55991777@N00,3759,17,1433650559,1433651626,10,1,1067
56027706@N00,3760,13,1266207175,1266207175,1,5,0
56027706@N00,3760,17,1266207270,1266207406,4,5,136
56027706@N00,3760,8,1266203879,1266204676,5,5,797
56027706@N00,3760,5,1266203243,1266203284,2,5,41
56027706@N00,3760,15,1266207561,1266207618,2,5,57
56027706@N00,3761,13,1267933806,1267933806,1,3,0
56027706@N00,3761,11,1267929376,1267929376,1,3,0
56027706@N00,3761,10,1267933817,1267934078,5,3,261
56027706@N00,3762,1,1272015287,1272015287,1,2,0
56027706@N00,3762,10,1272016082,1272016082,1,2,0
56027706@N00,3763,13,1274522097,1274522217,2,1,120
56068273@N06,3764,1,1359671309,1359671309,1,1,0
56074800@N00,3765,7,1378795690,1378806507,4,6,10817
56074800@N00,3765,11,1378786401,1378808180,7,6,21779
56074800@N00,3765,9,1378786665,1378786796,2,6,131
56074800@N00,3765,13,1378796518,1378798398,4,6,1880
56074800@N00,3765,12,1378804424,1378805838,9,6,1414
56074800@N00,3765,3,1378792141,1378795314,5,6,3173
56119942@N00,3766,5,1238474586,1238474586,1,1,0
56223610@N07,3767,10,1336034611,1336034666,3,4,55
56223610@N07,3767,12,1336026509,1336026509,1,4,0
56223610@N07,3767,2,1336024678,1336024678,1,4,0
56223610@N07,3767,13,1336033868,1336033868,1,4,0
56279017@N03,3768,11,1373967907,1373967907,1,2,0
56279017@N03,3768,5,1373961192,1373962118,2,2,926
56279017@N03,3769,4,1374369371,1374369371,1,1,0
56279017@N03,3770,16,1384059997,1384059997,1,1,0
56414555@N03,3771,6,1311744734,1311744734,1,4,0
56414555@N03,3771,11,1311727506,1311728229,2,4,723
56414555@N03,3771,17,1311736769,1311736769,1,4,0
56414555@N03,3771,9,1311730749,1311730776,2,4,27
56416261@N00,3772,11,1304048156,1304048175,3,1,19
56525958@N00,3773,4,1214274268,1214276093,2,3,1825
56525958@N00,3773,13,1214285426,1214296684,3,3,11258
56525958@N00,3773,15,1214285116,1214285372,5,3,256
56641055@N07,3774,11,1401937983,1401938117,2,1,134
56642201@N00,3775,12,1308463521,1308463987,2,2,466
56642201@N00,3775,3,1308465105,1308468453,5,2,3348
56694207@N02,3776,1,1328585082,1328585082,1,1,0
56726532@N06,3777,10,1419820340,1419820340,1,1,0
56795655@N00,3778,10,1296478800,1296478800,1,1,0
56841131@N00,3779,11,1370219222,1370219222,1,1,0
56909601@N00,3780,17,1271916560,1271916603,4,3,43
56909601@N00,3780,12,1271916414,1271916533,8,3,119
56909601@N00,3780,13,1271916547,1271916547,1,3,0
56922122@N03,3781,8,1247986452,1247986452,1,1,0
56922122@N03,3782,8,1249102644,1249102872,2,1,228
56922122@N03,3783,8,1277539748,1277539748,1,1,0
56922122@N03,3784,8,1292051625,1292056104,5,1,4479
56922122@N03,3785,8,1292564199,1292572770,4,1,8571
56922122@N03,3786,1,1299300446,1299300534,2,3,88
56922122@N03,3786,5,1299301260,1299301260,1,3,0
56922122@N03,3786,8,1299303322,1299303844,4,3,522
56922122@N03,3787,8,1301204329,1301204430,2,1,101
56924970@N00,3788,2,1307359282,1307359282,1,2,0
56924970@N00,3788,11,1307371764,1307371764,2,2,0
56972276@N06,3789,6,1246706583,1246706583,1,1,0
57027437@N06,3790,11,1344808557,1344851500,3,6,42943
57027437@N06,3790,5,1344821186,1344821186,1,6,0
57027437@N06,3790,14,1344816339,1344816339,1,6,0
57027437@N06,3790,8,1344823954,1344824079,2,6,125
57027437@N06,3790,9,1344811940,1344811940,1,6,0
57027437@N06,3790,6,1344848849,1344848849,1,6,0
57099981@N05,3791,11,1314511466,1314511466,1,1,0
57169261@N06,3792,11,1449787401,1449787401,1,1,0
57268629@N00,3793,8,1388465276,1388465701,4,4,425
57268629@N00,3793,9,1388480273,1388481033,5,4,760
57268629@N00,3793,5,1388458797,1388462839,8,4,4042
57268629@N00,3793,13,1388486121,1388486121,1,4,0
57283880@N03,3794,13,1332560100,1332560100,1,1,0
57284186@N00,3795,11,1285456751,1285456751,1,1,0
57311596@N05,3796,8,1259561988,1259561988,1,1,0
57382802@N04,3797,11,1335745256,1335745256,1,1,0
57487324@N07,3798,11,1352285368,1352285368,1,1,0
57487324@N07,3799,11,1401072570,1401072570,1,1,0
57507580@N00,3800,9,1336368107,1336368107,1,2,0
57507580@N00,3800,11,1336352817,1336352817,1,2,0
57516324@N03,3801,13,1428228594,1428229692,3,1,1098
57518849@N03,3802,11,1335351255,1335351255,1,1,0
57657053@N00,3803,6,1222498374,1222506855,5,1,8481
57657053@N00,3804,13,1222997105,1223005106,2,1,8001
57657053@N00,3805,8,1241309982,1241311158,3,2,1176
57657053@N00,3805,11,1241325872,1241326159,2,2,287
57657053@N00,3806,5,1243231462,1243231462,1,1,0
57669645@N03,3807,8,1408611940,1408611940,1,1,0
57669645@N03,3808,11,1409065463,1409065463,1,1,0
57736374@N06,3809,11,1444560155,1444560155,1,1,0
57794654@N02,3810,11,1357946399,1357958022,4,1,11623
57794654@N02,3811,11,1358041253,1358041253,1,1,0
57799803@N02,3812,3,1393498276,1393498276,1,1,0
57799803@N02,3813,11,1446150657,1446150657,1,1,0
57812277@N05,3814,1,1298619245,1298619245,1,1,0
57812277@N05,3815,4,1374564490,1374564490,1,1,0
57835821@N00,3816,15,1256360128,1256360321,5,2,193
57835821@N00,3816,11,1256343988,1256362547,2,2,18559
57835821@N00,3817,8,1315731616,1315732369,9,2,753
57835821@N00,3817,13,1315737434,1315737631,4,2,197
57835821@N00,3818,8,1333185458,1333187124,11,8,1666
57835821@N00,3818,11,1333172528,1333172579,3,8,51
57835821@N00,3818,3,1333175646,1333176863,4,8,1217
57835821@N00,3818,12,1333179137,1333179624,6,8,487
57835821@N00,3818,14,1333176624,1333176624,1,8,0
57835821@N00,3818,5,1333184088,1333184127,2,8,39
57835821@N00,3818,16,1333181005,1333181034,3,8,29
57835821@N00,3818,7,1333175622,1333175622,1,8,0
57835821@N00,3819,5,1362360529,1362361498,3,2,969
57835821@N00,3819,1,1362359787,1362359787,1,2,0
57835821@N00,3820,7,1394327408,1394327619,2,9,211
57835821@N00,3820,13,1394343466,1394343904,4,9,438
57835821@N00,3820,5,1394348382,1394348382,1,9,0
57835821@N00,3820,2,1394355790,1394355790,1,9,0
57835821@N00,3820,16,1394351396,1394352355,3,9,959
57835821@N00,3820,11,1394324374,1394357730,4,9,33356
57835821@N00,3820,17,1394346364,1394346364,1,9,0
57835821@N00,3820,3,1394328548,1394328577,2,9,29
57835821@N00,3820,14,1394328395,1394328419,2,9,24
57881215@N00,3821,4,1246266273,1246266332,8,1,59
57881215@N00,3822,4,1247712836,1247712836,1,1,0
57915028@N00,3823,11,1357522506,1357530995,3,1,8489
57915028@N00,3824,1,1357681803,1357681803,1,1,0
57915028@N00,3825,11,1357938486,1357938486,1,1,0
57959349@N00,3826,11,1349068272,1349068272,1,1,0
58013444@N04,3827,8,1285651224,1285651224,1,1,0
58072194@N08,3828,10,1381462856,1381462856,1,3,0
58072194@N08,3828,8,1381470790,1381473214,5,3,2424
58072194@N08,3828,11,1381443689,1381443689,1,3,0
58165404@N05,3829,11,1361265534,1361265534,1,1,0
58210261@N05,3830,5,1316408056,1316408056,1,1,0
58228008@N00,3831,11,1385244581,1385244949,2,6,368
58228008@N00,3831,2,1385250589,1385252258,8,6,1669
58228008@N00,3831,8,1385282301,1385282301,1,6,0
58228008@N00,3831,13,1385263420,1385264108,4,6,688
58228008@N00,3831,17,1385264304,1385278925,5,6,14621
58228008@N00,3831,10,1385264563,1385264625,2,6,62
58289459@N00,3832,8,1226107809,1226107809,1,1,0
58391963@N02,3833,2,1405988438,1405988438,1,2,0
58391963@N02,3833,9,1406006940,1406006940,1,2,0
58428496@N08,3834,11,1288434786,1288434786,1,1,0
58479263@N00,3835,6,1350990093,1350990093,1,1,0
58512585@N00,3836,17,1415780345,1415781588,4,4,1243
58512585@N00,3836,5,1415760479,1415763646,3,4,3167
58512585@N00,3836,3,1415747743,1415749901,2,4,2158
58512585@N00,3836,2,1415753699,1415753699,1,4,0
58556078@N00,3837,11,1322205320,1322205320,1,1,0
58588822@N00,3838,11,1460659316,1460659316,1,1,0
58597001@N08,3839,8,1334991367,1334991371,2,1,4
58755999@N05,3840,11,1400547028,1400547037,2,1,9
58755999@N05,3841,17,1400743772,1400744272,4,1,500
58773023@N00,3842,11,1369640939,1369640939,1,1,0
58887120@N00,3843,17,1330144470,1330144470,1,1,0
58953549@N05,3844,3,1332769426,1332769426,1,4,0
58953549@N05,3844,4,1332744873,1332744873,1,4,0
58953549@N05,3844,14,1332766893,1332770062,5,4,3169
58953549@N05,3844,11,1332731009,1332731009,1,4,0
59045021@N06,3845,13,1288404975,1288404975,1,1,0
59071486@N00,3846,11,1338269734,1338269734,1,1,0
59071486@N00,3847,1,1358661156,1358661156,1,2,0
59071486@N00,3847,11,1358660694,1358663788,3,2,3094
59071486@N00,3848,11,1363397396,1363401285,2,1,3889
59071486@N00,3849,11,1366703383,1366703383,1,1,0
59071486@N00,3850,11,1382766893,1382766893,1,1,0
59071486@N00,3851,15,1383554826,1383554826,1,1,0
59071486@N00,3852,13,1419404041,1419408539,3,1,4498
59288549@N02,3853,8,1347187618,1347187618,1,4,0
59288549@N02,3853,17,1347191026,1347191026,1,4,0
59288549@N02,3853,5,1347186666,1347186666,1,4,0
59288549@N02,3853,2,1347179454,1347179454,1,4,0
59288549@N02,3854,11,1347512013,1347512041,2,3,28
59288549@N02,3854,8,1347519274,1347526254,3,3,6980
59288549@N02,3854,5,1347518796,1347518796,1,3,0
59288549@N02,3855,10,1368095698,1368095698,1,4,0
59288549@N02,3855,15,1368096455,1368096455,1,4,0
59288549@N02,3855,17,1368096151,1368096151,1,4,0
59288549@N02,3855,8,1368084840,1368084840,1,4,0
59364175@N00,3856,1,1330146438,1330148514,2,1,2076
59390981@N04,3857,1,1309672863,1309672863,1,6,0
59390981@N04,3857,11,1309660532,1309667084,4,6,6552
59390981@N04,3857,7,1309660969,1309660999,2,6,30
59390981@N04,3857,2,1309663265,1309663279,2,6,14
59390981@N04,3857,14,1309661587,1309661593,2,6,6
59390981@N04,3857,4,1309663674,1309663690,2,6,16
59390981@N04,3858,8,1309757046,1309757046,1,7,0
59390981@N04,3858,10,1309754105,1309754425,2,7,320
59390981@N04,3858,17,1309771958,1309771958,1,7,0
59390981@N04,3858,6,1309747397,1309747910,5,7,513
59390981@N04,3858,11,1309738289,1309738289,1,7,0
59390981@N04,3858,5,1309756796,1309756796,1,7,0
59390981@N04,3858,1,1309741059,1309741059,1,7,0
59390981@N04,3859,8,1309842227,1309842227,1,2,0
59390981@N04,3859,5,1309840289,1309840381,2,2,92
59390981@N04,3860,9,1310115856,1310115862,2,2,6
59390981@N04,3860,1,1310117301,1310117679,5,2,378
59390981@N04,3861,8,1310207693,1310207952,20,1,259
59471679@N04,3862,11,1404436704,1404455272,2,1,18568
59471679@N04,3863,10,1406193065,1406193065,1,1,0
59471679@N04,3864,16,1419063873,1419063873,1,2,0
59471679@N04,3864,13,1419073830,1419073830,1,2,0
59471679@N04,3865,11,1425357271,1425363686,2,1,6415
59471679@N04,3866,8,1426295769,1426295996,2,3,227
59471679@N04,3866,11,1426302586,1426302586,1,3,0
59471679@N04,3866,13,1426296951,1426296951,1,3,0
59471679@N04,3867,5,1428039798,1428039798,1,1,0
59471679@N04,3868,13,1431821011,1431821011,1,1,0
59471679@N04,3869,2,1432709169,1432709169,1,1,0
59513859@N00,3870,10,1316826768,1316826768,1,2,0
59513859@N00,3870,13,1316829105,1316829105,1,2,0
59566971@N00,3871,11,1339795335,1339795335,1,1,0
59662848@N00,3872,1,1444952277,1444958651,4,2,6374
59662848@N00,3872,11,1444951476,1444951476,1,2,0
59662848@N00,3873,11,1444988416,1444988562,3,1,146
59669438@N05,3874,11,1311387853,1311397301,5,1,9448
59669438@N05,3875,11,1311827304,1311827304,1,2,0
59669438@N05,3875,9,1311828055,1311828055,1,2,0
59669438@N05,3876,11,1353379776,1353379776,1,1,0
59679150@N00,3877,11,1330748802,1330748802,1,1,0
59682384@N03,3878,2,1378771511,1378771511,1,1,0
59733720@N00,3879,11,1352005390,1352005390,1,1,0
59782551@N00,3880,11,1206768834,1206768834,1,1,0
59794429@N07,3881,11,1369133839,1369133839,1,1,0
59805227@N03,3882,11,1300422733,1300422733,1,1,0
59823861@N06,3883,8,1287050372,1287050372,1,2,0
59823861@N06,3883,5,1287048312,1287048312,1,2,0
59887649@N03,3884,11,1376938889,1376938889,1,1,0
59888795@N03,3885,11,1253056464,1253056464,1,1,0
59888795@N03,3886,14,1253147922,1253147922,1,2,0
59888795@N03,3886,3,1253158722,1253158722,1,2,0
59888795@N03,3887,6,1309749348,1309749466,2,1,118
59888795@N03,3888,15,1309818106,1309818133,2,4,27
59888795@N03,3888,17,1309817321,1309817321,1,4,0
59888795@N03,3888,13,1309818196,1309818196,3,4,0
59888795@N03,3888,4,1309816218,1309816218,1,4,0
59888795@N03,3889,11,1309847989,1309847989,1,1,0
59888795@N03,3890,5,1310005029,1310005029,1,1,0
59888795@N03,3891,5,1379381657,1379381657,1,6,0
59888795@N03,3891,15,1379373639,1379373639,1,6,0
59888795@N03,3891,13,1379385733,1379385733,1,6,0
59888795@N03,3891,17,1379385227,1379385227,1,6,0
59888795@N03,3891,11,1379381790,1379381790,1,6,0
59888795@N03,3891,10,1379373956,1379373956,1,6,0
59888795@N03,3892,8,1379487541,1379487541,1,1,0
59888795@N03,3893,17,1379632720,1379632720,1,2,0
59888795@N03,3893,8,1379632501,1379632501,1,2,0
59888795@N03,3894,15,1379716503,1379716708,2,4,205
59888795@N03,3894,4,1379717164,1379717164,1,4,0
59888795@N03,3894,17,1379716708,1379718397,2,4,1689
59888795@N03,3894,13,1379716000,1379719223,2,4,3223
59888795@N03,3895,5,1379895014,1379895073,2,1,59
59888795@N03,3896,5,1431749892,1431749892,1,2,0
59888795@N03,3896,13,1431772566,1431772701,4,2,135
59888795@N03,3897,15,1431815134,1431815134,1,3,0
59888795@N03,3897,17,1431814907,1431814963,2,3,56
59888795@N03,3897,10,1431815398,1431815398,1,3,0
59888795@N03,3898,14,1432003035,1432003035,1,1,0
59888795@N03,3899,13,1432117883,1432117883,1,1,0
59888795@N03,3900,13,1432164197,1432164435,2,2,238
59888795@N03,3900,15,1432165732,1432165732,1,2,0
59888866@N00,3901,11,1216948033,1216954838,25,1,6805
59888866@N00,3902,13,1286416004,1286428964,3,6,12960
59888866@N00,3902,10,1286415052,1286415808,4,6,756
59888866@N00,3902,9,1286414326,1286414484,4,6,158
59888866@N00,3902,5,1286437708,1286438012,4,6,304
59888866@N00,3902,11,1286413456,1286413456,1,6,0
59888866@N00,3902,16,1286413997,1286413997,1,6,0
59888866@N00,3903,9,1317346722,1317346722,1,5,0
59888866@N00,3903,17,1317359505,1317359505,1,5,0
59888866@N00,3903,10,1317347357,1317347357,1,5,0
59888866@N00,3903,11,1317341548,1317341548,1,5,0
59888866@N00,3903,16,1317343135,1317343135,1,5,0
59888866@N00,3904,1,1358069314,1358069314,1,2,0
59888866@N00,3904,11,1358060807,1358060807,1,2,0
59888866@N00,3905,11,1363591579,1363591579,1,2,0
59888866@N00,3905,15,1363586092,1363586092,1,2,0
59888866@N00,3906,11,1369970387,1369970387,1,1,0
59888866@N00,3907,11,1377399343,1377399343,1,1,0
59888866@N00,3908,11,1380356379,1380376133,2,1,19754
59888866@N00,3909,3,1383964601,1383964601,1,1,0
59888866@N00,3910,8,1386380287,1386380287,1,1,0
59888866@N00,3911,11,1388394215,1388394215,1,1,0
59983818@N06,3912,13,1366434343,1366434400,2,7,57
59983818@N06,3912,11,1366448300,1366448300,1,7,0
59983818@N06,3912,1,1366450069,1366450069,1,7,0
59983818@N06,3912,9,1366431202,1366431202,1,7,0
59983818@N06,3912,17,1366432811,1366432811,1,7,0
59983818@N06,3912,2,1366451259,1366451259,1,7,0
59983818@N06,3912,16,1366431011,1366431011,1,7,0
59983818@N06,3913,1,1366532528,1366540871,3,2,8343
59983818@N06,3913,11,1366542012,1366542012,1,2,0
60016896@N06,3914,11,1321091565,1321091565,1,1,0
60054626@N00,3915,4,1196331846,1196331846,1,3,0
60054626@N00,3915,3,1196331855,1196331855,1,3,0
60054626@N00,3915,9,1196331859,1196331867,2,3,8
60054626@N00,3916,2,1201932775,1201939438,5,7,6663
60054626@N00,3916,3,1201933997,1201934201,2,7,204
60054626@N00,3916,9,1201921419,1201923496,6,7,2077
60054626@N00,3916,1,1201927229,1201929567,7,7,2338
60054626@N00,3916,11,1201911849,1201915287,11,7,3438
60054626@N00,3916,5,1201924905,1201926930,3,7,2025
60054626@N00,3916,4,1201932340,1201932340,1,7,0
60054626@N00,3917,11,1245830678,1245831504,4,1,826
60054626@N00,3918,11,1245929505,1245929546,2,1,41
60054626@N00,3919,11,1246182000,1246182101,2,1,101
60054626@N00,3920,5,1246249465,1246249465,1,5,0
60054626@N00,3920,17,1246259057,1246259078,2,5,21
60054626@N00,3920,13,1246239597,1246267837,6,5,28240
60054626@N00,3920,11,1246256863,1246258145,5,5,1282
60054626@N00,3920,15,1246266484,1246266665,3,5,181
60054626@N00,3921,1,1431940423,1431943144,9,5,2721
60054626@N00,3921,7,1431946651,1431947742,4,5,1091
60054626@N00,3921,11,1431938997,1431939167,3,5,170
60054626@N00,3921,2,1431943445,1431943986,2,5,541
60054626@N00,3921,12,1431944740,1431944740,1,5,0
60054626@N00,3922,9,1432174997,1432177633,5,9,2636
60054626@N00,3922,1,1432184286,1432184367,5,9,81
60054626@N00,3922,17,1432190917,1432190917,1,9,0
60054626@N00,3922,14,1432187555,1432187555,1,9,0
60054626@N00,3922,16,1432173417,1432175206,3,9,1789
60054626@N00,3922,15,1432191121,1432191121,1,9,0
60054626@N00,3922,11,1432169792,1432171878,19,9,2086
60054626@N00,3922,5,1432194679,1432201179,11,9,6500
60054626@N00,3922,4,1432180153,1432181236,12,9,1083
60054626@N00,3923,4,1432268408,1432268408,1,3,0
60054626@N00,3923,7,1432271214,1432271214,1,3,0
60054626@N00,3923,6,1432256408,1432256537,2,3,129
60082453@N05,3924,13,1429056110,1429056110,1,6,0
60082453@N05,3924,15,1429077440,1429080588,3,6,3148
60082453@N05,3924,9,1429054096,1429054096,1,6,0
60082453@N05,3924,11,1429051769,1429093006,5,6,41237
60082453@N05,3924,8,1429065402,1429065402,1,6,0
60082453@N05,3924,5,1429066436,1429066436,1,6,0
60220094@N07,3925,13,1388200461,1388205458,3,4,4997
60220094@N07,3925,5,1388224989,1388224989,1,4,0
60220094@N07,3925,15,1388198121,1388198121,1,4,0
60220094@N07,3925,10,1388197317,1388197317,1,4,0
60259592@N03,3926,4,1275314400,1275314400,1,1,0
60272404@N06,3927,8,1409562152,1409562152,1,1,0
60296398@N02,3928,11,1317034809,1317034809,1,1,0
60309882@N00,3929,7,1244374617,1244374648,4,1,31
60385541@N00,3930,11,1380881581,1380881581,2,1,0
60385541@N00,3931,4,1381022957,1381022957,1,2,0
60385541@N00,3931,9,1381027407,1381027423,2,2,16
60385541@N00,3932,11,1412319942,1412322438,2,1,2496
60401103@N04,3933,17,1262924805,1262924805,1,3,0
60401103@N04,3933,8,1262909714,1262910825,2,3,1111
60401103@N04,3933,15,1262924799,1262924898,2,3,99
60474597@N06,3934,11,1340298074,1340298074,1,1,0
60481456@N00,3935,3,1387489137,1387489137,1,2,0
60481456@N00,3935,11,1387487412,1387487504,2,2,92
60504322@N04,3936,11,1372471200,1372471232,19,1,32
60567550@N07,3937,11,1445678572,1445678572,1,1,0
60576452@N08,3938,11,1362520633,1362520680,2,1,47
60628701@N00,3939,11,1417126883,1417126883,1,1,0
60657104@N00,3940,1,1421221711,1421221711,1,1,0
60657104@N00,3941,5,1421291258,1421291258,1,2,0
60657104@N00,3941,11,1421292884,1421292884,1,2,0
60804222@N05,3942,15,1355796789,1355824990,4,9,28201
60804222@N05,3942,17,1355796775,1355827670,16,9,30895
60804222@N05,3942,10,1355797256,1355797286,3,9,30
60804222@N05,3942,8,1355784306,1355791513,16,9,7207
60804222@N05,3942,9,1355819234,1355819767,3,9,533
60804222@N05,3942,5,1355781406,1355781406,1,9,0
60804222@N05,3942,11,1355779675,1355816389,6,9,36714
60804222@N05,3942,13,1355795954,1355796228,5,9,274
60804222@N05,3942,2,1355821879,1355821902,6,9,23
60883477@N00,3943,10,1364720680,1364720680,1,1,0
60897658@N00,3944,12,1211013121,1211014765,2,2,1644
60897658@N00,3944,5,1211001281,1211001281,1,2,0
60956197@N08,3945,8,1451788657,1451790548,2,1,1891
60981140@N03,3946,10,1386298131,1386298131,1,1,0
61083754@N04,3947,11,1199403584,1199404454,2,2,870
61083754@N04,3947,5,1199406113,1199407804,2,2,1691
61083754@N04,3948,2,1252975620,1252988251,29,6,12631
61083754@N04,3948,9,1252990108,1252990132,2,6,24
61083754@N04,3948,11,1252971685,1252971752,6,6,67
61083754@N04,3948,4,1252998422,1252998835,7,6,413
61083754@N04,3948,15,1253008302,1253008302,2,6,0
61083754@N04,3948,5,1253002681,1253002697,3,6,16
61083754@N04,3949,5,1253084472,1253086821,6,1,2349
61083754@N04,3950,5,1254617827,1254617827,1,2,0
61083754@N04,3950,11,1254617593,1254617775,5,2,182
61083754@N04,3951,16,1301999168,1301999168,1,1,0
61102903@N02,3952,11,1347020722,1347020722,1,1,0
61102903@N02,3953,4,1362452480,1362452480,1,1,0
61102903@N02,3954,11,1454628981,1454628981,1,2,0
61102903@N02,3954,4,1454629254,1454629254,1,2,0
61102903@N02,3955,15,1458891998,1458891998,1,2,0
61102903@N02,3955,11,1458899634,1458899634,1,2,0
61102903@N02,3956,11,1458947437,1458947437,1,1,0
61102903@N02,3957,11,1466215249,1466215249,1,1,0
61104413@N00,3958,11,1344280006,1344280006,1,3,0
61104413@N00,3958,5,1344292594,1344292684,3,3,90
61104413@N00,3958,8,1344296640,1344296707,2,3,67
61149901@N06,3959,11,1386470829,1386470829,1,1,0
61176951@N00,3960,11,1344062853,1344062853,1,1,0
61198674@N00,3961,1,1311290285,1311290640,3,6,355
61198674@N00,3961,17,1311304091,1311304854,2,6,763
61198674@N00,3961,8,1311316951,1311316951,1,6,0
61198674@N00,3961,16,1311292359,1311292359,1,6,0
61198674@N00,3961,15,1311284389,1311304870,2,6,20481
61198674@N00,3961,9,1311287600,1311296607,3,6,9007
61207928@N04,3962,11,1436148958,1436148958,1,1,0
61261095@N02,3963,17,1298172186,1298172186,1,1,0
61261095@N02,3964,11,1302675962,1302675962,1,1,0
61261095@N02,3965,9,1334136357,1334136357,1,1,0
61261095@N02,3966,6,1336734673,1336734761,3,1,88
61261095@N02,3967,5,1341396127,1341396127,1,1,0
61285553@N00,3968,8,1196831768,1196832013,6,3,245
61285553@N00,3968,13,1196855030,1196855920,20,3,890
61285553@N00,3968,5,1196823736,1196825584,8,3,1848
61285553@N00,3969,11,1197034986,1197035032,2,6,46
61285553@N00,3969,4,1197012794,1197015277,3,6,2483
61285553@N00,3969,12,1197007149,1197011207,28,6,4058
61285553@N00,3969,3,1197005076,1197005905,20,6,829
61285553@N00,3969,2,1197005931,1197011355,4,6,5424
61285553@N00,3969,16,1197016279,1197016279,1,6,0
61388024@N08,3970,1,1376368773,1376368778,2,1,5
61415829@N08,3971,13,1430379125,1430379125,1,1,0
61525316@N06,3972,11,1356548145,1356548145,1,1,0
61554297@N00,3973,10,1188876962,1188876962,1,1,0
61581248@N04,3974,11,1388439543,1388439543,1,1,0
61644290@N00,3975,9,1286668859,1286671155,3,1,2296
61644290@N00,3976,5,1326671058,1326671058,1,1,0
61644290@N00,3977,11,1358232714,1358232714,1,1,0
61658419@N00,3978,11,1335189602,1335189621,18,1,19
61658419@N00,3979,11,1335233301,1335247855,16,2,14554
61658419@N00,3979,17,1335233301,1335233301,12,2,0
61658419@N00,3980,11,1349924852,1349926572,2,2,1720
61658419@N00,3980,17,1349914796,1349926303,35,2,11507
61658419@N00,3981,17,1350392400,1350392400,17,1,0
61756292@N00,3982,11,1358464848,1358464848,1,1,0
61802935@N08,3983,2,1345086817,1345086817,1,1,0
61826063@N00,3984,13,1316223062,1316223336,5,9,274
61826063@N00,3984,10,1316226132,1316226226,2,9,94
61826063@N00,3984,5,1316214568,1316214774,5,9,206
61826063@N00,3984,9,1316212104,1316212640,3,9,536
61826063@N00,3984,17,1316224994,1316230678,12,9,5684
61826063@N00,3984,11,1316209856,1316210044,3,9,188
61826063@N00,3984,8,1316215942,1316217966,14,9,2024
61826063@N00,3984,1,1316210360,1316211312,4,9,952
61826063@N00,3984,7,1316226820,1316228592,3,9,1772
61897832@N00,3985,11,1260382120,1260396175,16,1,14055
61897832@N00,3986,11,1260704480,1260771613,58,1,67133
61897832@N00,3987,11,1266068405,1266068405,1,1,0
61897832@N00,3988,11,1292109369,1292151589,59,1,42220
61897832@N00,3989,11,1294091156,1294091156,3,1,0
61905010@N03,3990,8,1411196887,1411196887,1,3,0
61905010@N03,3990,17,1411203062,1411203062,1,3,0
61905010@N03,3990,11,1411187782,1411187782,1,3,0
61938758@N08,3991,1,1357526960,1357526960,1,1,0
61990140@N04,3992,11,1353763162,1353763914,7,1,752
62065836@N00,3993,11,1301036988,1301046439,4,2,9451
62065836@N00,3993,4,1301036735,1301036735,1,2,0
62082433@N05,3994,5,1320636865,1320636865,1,1,0
62102776@N02,3995,11,1376002616,1376002616,1,1,0
62102776@N02,3996,11,1376092392,1376092392,1,1,0
62102776@N02,3997,11,1376350573,1376350573,1,1,0
62102776@N02,3998,1,1376550202,1376550202,1,1,0
62102776@N02,3999,11,1376877238,1376877238,1,1,0
62102776@N02,4000,11,1378096065,1378096065,1,1,0
62102776@N02,4001,11,1378466950,1378466950,1,1,0
62121361@N03,4002,2,1308078261,1308078439,2,3,178
62121361@N03,4002,4,1308079694,1308079694,1,3,0
62121361@N03,4002,11,1308055823,1308055823,1,3,0
62121361@N03,4003,11,1309112956,1309112956,1,1,0
62121361@N03,4004,2,1407818026,1407818026,1,3,0
62121361@N03,4004,4,1407818560,1407818560,1,3,0
62121361@N03,4004,11,1407836789,1407836789,1,3,0
62205900@N00,4005,3,1268425551,1268425551,1,13,0
62205900@N00,4005,9,1268426629,1268426655,2,13,26
62205900@N00,4005,2,1268463591,1268463591,1,13,0
62205900@N00,4005,16,1268428195,1268446231,8,13,18036
62205900@N00,4005,4,1268432971,1268463791,2,13,30820
62205900@N00,4005,10,1268433501,1268433507,2,13,6
62205900@N00,4005,7,1268462455,1268462455,1,13,0
62205900@N00,4005,11,1268429900,1268459748,8,13,29848
62205900@N00,4005,1,1268426541,1268426541,1,13,0
62205900@N00,4005,17,1268433644,1268433920,5,13,276
62205900@N00,4005,5,1268444874,1268445263,2,13,389
62205900@N00,4005,13,1268434323,1268439673,25,13,5350
62205900@N00,4005,8,1268443771,1268444035,5,13,264
62205900@N00,4006,2,1269033410,1269034183,7,4,773
62205900@N00,4006,16,1269038492,1269040544,3,4,2052
62205900@N00,4006,1,1269049233,1269049244,2,4,11
62205900@N00,4006,8,1269043648,1269044406,7,4,758
62208823@N00,4007,11,1286579880,1286579880,1,1,0
62208823@N00,4008,3,1332570447,1332570447,1,1,0
62213164@N00,4009,1,1188790800,1188791861,6,5,1061
62213164@N00,4009,2,1188780164,1188784546,8,5,4382
62213164@N00,4009,16,1188787266,1188787266,1,5,0
62213164@N00,4009,14,1188777792,1188779001,5,5,1209
62213164@N00,4009,11,1188772683,1188794584,4,5,21901
62213164@N00,4010,11,1222552462,1222591362,5,4,38900
62213164@N00,4010,13,1222572700,1222573689,4,4,989
62213164@N00,4010,10,1222578974,1222578974,1,4,0
62213164@N00,4010,17,1222596067,1222596606,13,4,539
62221880@N00,4011,17,1307482433,1307484432,5,1,1999
62221880@N00,4012,11,1307519421,1307520721,2,1,1300
62236593@N04,4013,15,1366965921,1366965921,1,2,0
62236593@N04,4013,2,1366955250,1366955250,1,2,0
62236593@N04,4014,13,1385605298,1385605298,1,1,0
62236593@N04,4015,11,1416901734,1416901734,1,1,0
62236593@N04,4016,9,1417081032,1417081032,1,1,0
62236593@N04,4017,5,1417160387,1417160387,1,1,0
62242291@N04,4018,8,1358157255,1358157255,1,1,0
62256889@N05,4019,8,1358736761,1358736761,1,1,0
62307685@N02,4020,17,1437457638,1437457638,1,2,0
62307685@N02,4020,5,1437472407,1437472407,1,2,0
62340971@N04,4021,13,1372572401,1372572401,1,1,0
62372928@N03,4022,11,1256187318,1256187318,1,1,0
62372928@N03,4023,11,1368829675,1368830521,3,1,846
62372928@N03,4024,11,1368912843,1368912843,1,1,0
62372928@N03,4025,17,1369044251,1369044251,1,2,0
62372928@N03,4025,11,1369025627,1369025627,1,2,0
62396405@N03,4026,17,1350044773,1350044773,1,1,0
62460908@N07,4027,11,1351054355,1351054355,1,1,0
62540752@N06,4028,2,1322185010,1322185010,1,1,0
62595633@N06,4029,8,1370409546,1370409585,2,11,39
62595633@N06,4029,3,1370405614,1370405614,1,11,0
62595633@N06,4029,13,1370418049,1370418520,6,11,471
62595633@N06,4029,9,1370388183,1370388717,3,11,534
62595633@N06,4029,11,1370387319,1370425743,4,11,38424
62595633@N06,4029,16,1370391331,1370393220,3,11,1889
62595633@N06,4029,5,1370409277,1370409285,2,11,8
62595633@N06,4029,17,1370418600,1370418738,5,11,138
62595633@N06,4029,10,1370418993,1370421256,5,11,2263
62595633@N06,4029,4,1370396058,1370399658,2,11,3600
62595633@N06,4029,2,1370400344,1370403027,5,11,2683
62598671@N04,4030,11,1210746924,1210746924,1,1,0
62623118@N03,4031,11,1372158650,1372158650,1,1,0
62624768@N02,4032,11,1257552660,1257552660,1,1,0
62624768@N02,4033,16,1352588548,1352588548,1,1,0
62624768@N02,4034,11,1352672917,1352672917,1,2,0
62624768@N02,4034,4,1352675108,1352675108,1,2,0
62704710@N03,4035,4,1348461533,1348461533,1,1,0
62704710@N03,4036,13,1350362495,1350362495,1,1,0
62704710@N03,4037,8,1350991846,1350991846,1,1,0
62704710@N03,4038,1,1362740263,1362740263,1,1,0
62704710@N03,4039,17,1363247765,1363247765,1,1,0
62704710@N03,4040,8,1363324615,1363324615,1,1,0
62705831@N05,4041,5,1259026850,1259026940,2,4,90
62705831@N05,4041,8,1259028260,1259028260,1,4,0
62705831@N05,4041,17,1259038166,1259038166,1,4,0
62705831@N05,4041,13,1259037055,1259037055,1,4,0
62731305@N00,4042,3,1233257956,1233257956,1,1,0
62783804@N05,4043,8,1290070476,1290070476,1,2,0
62783804@N05,4043,11,1290073382,1290073382,1,2,0
62783804@N05,4044,8,1319763468,1319763468,1,1,0
62783804@N05,4045,14,1357462013,1357462013,1,1,0
62823285@N00,4046,11,1311241214,1311241214,1,1,0
62864067@N00,4047,5,1389772740,1389772740,1,1,0
62950363@N05,4048,11,1386319363,1386319393,2,1,30
62950363@N05,4049,11,1386349247,1386349247,1,1,0
62975060@N07,4050,11,1382539096,1382539096,1,1,0
62975060@N07,4051,11,1382871949,1382871949,1,1,0
62975060@N07,4052,13,1382965465,1382965465,1,1,0
62975889@N00,4053,8,1358044954,1358044954,1,1,0
63051331@N00,4054,11,1225397448,1225397448,1,1,0
63084736@N00,4055,1,1438477189,1438494534,6,3,17345
63084736@N00,4055,9,1438491767,1438491767,1,3,0
63084736@N00,4055,11,1438471882,1438471882,1,3,0
63084736@N00,4056,1,1438564678,1438565226,2,2,548
63084736@N00,4056,11,1438567796,1438567796,1,2,0
63193209@N04,4057,10,1305066103,1305066103,1,1,0
63202442@N00,4058,17,1201254388,1201254388,1,1,0
63202442@N00,4059,11,1220598195,1220614253,2,1,16058
63202442@N00,4060,7,1220689760,1220689760,1,2,0
63202442@N00,4060,2,1220686117,1220688715,4,2,2598
63202442@N00,4061,11,1221095354,1221095354,1,1,0
63202442@N00,4062,8,1221212987,1221212987,1,2,0
63202442@N00,4062,4,1221198853,1221198992,2,2,139
63202442@N00,4063,11,1221278669,1221278702,2,1,33
63202442@N00,4064,3,1264833470,1264833470,1,6,0
63202442@N00,4064,10,1264835084,1264835084,1,6,0
63202442@N00,4064,5,1264846223,1264846223,1,6,0
63202442@N00,4064,8,1264845579,1264845579,1,6,0
63202442@N00,4064,4,1264834507,1264834507,1,6,0
63202442@N00,4064,11,1264848415,1264848912,3,6,497
63202442@N00,4065,3,1264987531,1264987776,2,3,245
63202442@N00,4065,1,1264976584,1264976584,1,3,0
63202442@N00,4065,2,1264991654,1264993064,2,3,1410
63202442@N00,4066,9,1265246700,1265246700,1,4,0
63202442@N00,4066,8,1265243354,1265243354,1,4,0
63202442@N00,4066,5,1265241391,1265241391,1,4,0
63202442@N00,4066,1,1265239330,1265239330,1,4,0
63202442@N00,4067,15,1291627550,1291627792,2,1,242
63202442@N00,4068,7,1291756145,1291756145,1,2,0
63202442@N00,4068,12,1291757251,1291757251,1,2,0
63257911@N00,4069,11,1212813780,1212835980,10,4,22200
63257911@N00,4069,4,1212825839,1212826282,6,4,443
63257911@N00,4069,9,1212816323,1212816323,1,4,0
63257911@N00,4069,5,1212835709,1212835709,1,4,0
63257911@N00,4070,5,1229057425,1229062216,16,4,4791
63257911@N00,4070,9,1229073164,1229074349,4,4,1185
63257911@N00,4070,6,1229068849,1229069215,8,4,366
63257911@N00,4070,11,1229054450,1229076036,26,4,21586
63257911@N00,4071,4,1229241568,1229242379,14,4,811
63257911@N00,4071,8,1229247588,1229247588,1,4,0
63257911@N00,4071,11,1229248609,1229250547,11,4,1938
63257911@N00,4071,5,1229243239,1229243239,1,4,0
63257911@N00,4072,8,1277547038,1277547522,2,3,484
63257911@N00,4072,5,1277542287,1277542294,2,3,7
63257911@N00,4072,2,1277536703,1277539352,8,3,2649
63257911@N00,4073,11,1277637139,1277637246,2,1,107
63257911@N00,4074,9,1277868545,1277868545,1,1,0
63257911@N00,4075,9,1308909762,1308909762,1,1,0
63287267@N00,4076,11,1332635152,1332635259,2,1,107
63287267@N00,4077,16,1332996149,1332996149,1,1,0
63287402@N00,4078,1,1257549517,1257550204,2,4,687
63287402@N00,4078,6,1257560349,1257560349,1,4,0
63287402@N00,4078,5,1257564781,1257564781,1,4,0
63287402@N00,4078,11,1257552474,1257553008,2,4,534
63287402@N00,4079,5,1272240193,1272240193,1,4,0
63287402@N00,4079,12,1272247086,1272247086,1,4,0
63287402@N00,4079,1,1272238100,1272239142,2,4,1042
63287402@N00,4079,8,1272244082,1272244082,1,4,0
63287402@N00,4080,14,1272336715,1272336715,1,3,0
63287402@N00,4080,3,1272337031,1272337031,1,3,0
63287402@N00,4080,13,1272359655,1272359655,1,3,0
63287402@N00,4081,7,1272437256,1272437256,1,2,0
63287402@N00,4081,5,1272440133,1272440133,1,2,0
63287402@N00,4082,1,1272523219,1272523219,1,3,0
63287402@N00,4082,11,1272530707,1272530707,1,3,0
63287402@N00,4082,5,1272522762,1272522762,1,3,0
63287402@N00,4083,8,1289182875,1289182875,1,2,0
63287402@N00,4083,12,1289175561,1289175735,2,2,174
63287402@N00,4084,17,1289286671,1289286671,1,2,0
63287402@N00,4084,10,1289286371,1289286371,1,2,0
63287402@N00,4085,15,1289531709,1289531709,1,2,0
63287402@N00,4085,5,1289526014,1289526014,1,2,0
63287402@N00,4086,3,1291935599,1291935599,1,4,0
63287402@N00,4086,12,1291936702,1291936702,1,4,0
63287402@N00,4086,14,1291934953,1291934953,1,4,0
63287402@N00,4086,2,1291935865,1291935865,1,4,0
63287402@N00,4087,1,1301641405,1301641405,1,5,0
63287402@N00,4087,11,1301629511,1301629511,1,5,0
63287402@N00,4087,5,1301637542,1301637542,1,5,0
63287402@N00,4087,14,1301631489,1301631489,1,5,0
63287402@N00,4087,3,1301635306,1301635306,1,5,0
63287402@N00,4088,11,1303983002,1303983002,1,1,0
63287402@N00,4089,8,1306976109,1306976109,1,2,0
63287402@N00,4089,10,1306976109,1306976109,1,2,0
63287402@N00,4090,11,1312452226,1312452226,1,1,0
63311968@N07,4091,12,1373612876,1373612876,1,1,0
63330642@N06,4092,1,1370159121,1370159121,1,1,0
63330642@N06,4093,9,1372837470,1372837470,1,1,0
63330642@N06,4094,11,1373169919,1373170177,3,4,258
63330642@N06,4094,9,1373173505,1373173505,1,4,0
63330642@N06,4094,3,1373175829,1373180559,9,4,4730
63330642@N06,4094,1,1373172931,1373172931,1,4,0
63330642@N06,4095,3,1374305197,1374305197,1,2,0
63330642@N06,4095,1,1374301223,1374301223,1,2,0
63330642@N06,4096,11,1376798307,1376798645,7,4,338
63330642@N06,4096,1,1376801313,1376801540,4,4,227
63330642@N06,4096,9,1376799517,1376799517,1,4,0
63330642@N06,4096,4,1376803407,1376803601,6,4,194
63330642@N06,4097,3,1378019485,1378020542,2,2,1057
63330642@N06,4097,9,1378015957,1378015957,1,2,0
63330642@N06,4098,3,1379228682,1379228682,1,1,0
63330642@N06,4099,1,1379293589,1379293589,1,1,0
63330642@N06,4100,11,1381039065,1381039065,1,1,0
63330642@N06,4101,9,1383374854,1383374854,1,2,0
63330642@N06,4101,11,1383373273,1383374149,2,2,876
63330642@N06,4102,11,1386389185,1386389185,1,1,0
63330642@N06,4103,9,1386999898,1386999898,1,1,0
63330642@N06,4104,8,1388469394,1388469394,1,2,0
63330642@N06,4104,13,1388477848,1388477848,1,2,0
63330642@N06,4105,1,1392614660,1392614660,1,1,0
63330642@N06,4106,11,1393043176,1393043486,7,1,310
63330642@N06,4107,9,1393650910,1393650910,1,2,0
63330642@N06,4107,11,1393650361,1393650361,1,2,0
63330642@N06,4108,1,1394342920,1394342920,1,2,0
63330642@N06,4108,11,1394340787,1394340787,1,2,0
63330642@N06,4109,9,1396158459,1396158459,1,2,0
63330642@N06,4109,1,1396160572,1396160572,1,2,0
63419140@N00,4110,10,1240648720,1240648720,1,1,0
63513545@N00,4111,5,1380101468,1380106157,13,2,4689
63513545@N00,4111,11,1380100489,1380107995,3,2,7506
63513545@N00,4112,2,1380249111,1380249958,6,6,847
63513545@N00,4112,5,1380260076,1380260076,1,6,0
63513545@N00,4112,1,1380243553,1380243553,1,6,0
63513545@N00,4112,12,1380249763,1380249865,3,6,102
63513545@N00,4112,8,1380258032,1380258171,2,6,139
63513545@N00,4112,17,1380251428,1380251428,1,6,0
63513545@N00,4113,13,1380612191,1380612191,1,1,0
63574114@N00,4114,3,1205121115,1205125503,9,1,4388
63618933@N00,4115,10,1359609384,1359609384,1,2,0
63618933@N00,4115,11,1359601204,1359601204,1,2,0
63637045@N07,4116,3,1362210727,1362211376,3,8,649
63637045@N07,4116,15,1362218436,1362218436,1,8,0
63637045@N07,4116,5,1362207915,1362208450,2,8,535
63637045@N07,4116,17,1362187201,1362190298,3,8,3097
63637045@N07,4116,11,1362219995,1362220185,3,8,190
63637045@N07,4116,8,1362205645,1362205645,1,8,0
63637045@N07,4116,7,1362209840,1362209840,1,8,0
63637045@N07,4116,2,1362217573,1362217573,1,8,0
63637045@N07,4117,11,1406985778,1406985966,2,2,188
63637045@N07,4117,17,1406978497,1406978591,2,2,94
63657240@N00,4118,11,1203189721,1203200408,5,1,10687
63657240@N00,4119,11,1203257863,1203257878,2,2,15
63657240@N00,4119,10,1203255880,1203255885,2,2,5
63705158@N02,4120,17,1345374448,1345374448,1,1,0
63786834@N00,4121,11,1298877290,1298877290,1,1,0
63786834@N00,4122,4,1299047693,1299047693,1,1,0
63786834@N00,4123,7,1299112843,1299112843,1,1,0
63812709@N02,4124,11,1306380762,1306395702,77,3,14940
63812709@N02,4124,2,1306392209,1306392209,1,3,0
63812709@N02,4124,7,1306393161,1306398322,11,3,5161
63812709@N02,4125,5,1306550637,1306553109,5,5,2472
63812709@N02,4125,8,1306552727,1306552727,1,5,0
63812709@N02,4125,10,1306559039,1306559039,1,5,0
63812709@N02,4125,11,1306546995,1306559646,39,5,12651
63812709@N02,4125,1,1306549340,1306549363,2,5,23
63812709@N02,4126,10,1306651254,1306655847,2,2,4593
63812709@N02,4126,11,1306645589,1306656635,35,2,11046
63812709@N02,4127,11,1306807815,1306807815,1,1,0
63818228@N03,4128,11,1312927872,1312927872,1,1,0
63846795@N06,4129,4,1194938057,1194938057,1,1,0
63859127@N00,4130,3,1375604885,1375604885,1,2,0
63859127@N00,4130,8,1375613031,1375613042,2,2,11
64111638@N00,4131,11,1382021040,1382021040,1,1,0
64171510@N00,4132,1,1247139609,1247139900,3,5,291
64171510@N00,4132,2,1247145729,1247145849,2,5,120
64171510@N00,4132,3,1247143386,1247143386,1,5,0
64171510@N00,4132,11,1247148725,1247148725,1,5,0
64171510@N00,4132,8,1247133874,1247133874,1,5,0
64220937@N02,4133,11,1323225731,1323225731,1,1,0
64318110@N00,4134,11,1363842940,1363842940,1,1,0
64440833@N05,4135,11,1303801577,1303801593,2,2,16
64440833@N05,4135,10,1303806471,1303811816,2,2,5345
64440833@N05,4136,11,1374908660,1374920294,8,1,11634
64440833@N05,4137,1,1386494056,1386494081,3,1,25
64465885@N03,4138,8,1421130987,1421131000,4,3,13
64465885@N03,4138,11,1421103356,1421133635,7,3,30279
64465885@N03,4138,13,1421116756,1421116970,7,3,214
64466278@N03,4139,3,1327719350,1327719670,4,3,320
64466278@N03,4139,1,1327719421,1327719465,2,3,44
64466278@N03,4139,2,1327719566,1327719566,1,3,0
64466278@N03,4140,12,1343511531,1343511531,1,4,0
64466278@N03,4140,11,1343511446,1343511683,3,4,237
64466278@N03,4140,10,1343511621,1343511621,1,4,0
64466278@N03,4140,2,1343511521,1343511571,3,4,50
64478148@N07,4141,5,1334906281,1334906281,1,3,0
64478148@N07,4141,16,1334904354,1334904454,14,3,100
64478148@N07,4141,1,1334904589,1334904699,6,3,110
64478148@N07,4142,15,1336469015,1336471065,4,1,2050
64478148@N07,4143,6,1336724437,1336725906,5,1,1469
64478148@N07,4144,10,1345003824,1345004013,4,1,189
64478148@N07,4145,6,1349070404,1349070404,1,1,0
64478148@N07,4146,17,1349768217,1349768370,3,3,153
64478148@N07,4146,13,1349769041,1349769096,2,3,55
64478148@N07,4146,10,1349767434,1349767437,2,3,3
64478148@N07,4147,15,1362711101,1362712473,2,9,1372
64478148@N07,4147,5,1362720100,1362720113,5,9,13
64478148@N07,4147,13,1362711204,1362711507,11,9,303
64478148@N07,4147,9,1362705739,1362706210,34,9,471
64478148@N07,4147,8,1362719219,1362719297,3,9,78
64478148@N07,4147,17,1362709924,1362710989,9,9,1065
64478148@N07,4147,16,1362705210,1362706901,6,9,1691
64478148@N07,4147,11,1362704658,1362704658,1,9,0
64478148@N07,4147,1,1362705069,1362707843,8,9,2774
64478148@N07,4148,1,1364006015,1364013889,21,1,7874
64478148@N07,4149,15,1364432005,1364439115,7,3,7110
64478148@N07,4149,13,1364439539,1364439539,1,3,0
64478148@N07,4149,17,1364431935,1364439974,13,3,8039
64478148@N07,4150,15,1365121358,1365121358,1,3,0
64478148@N07,4150,13,1365122608,1365127154,5,3,4546
64478148@N07,4150,17,1365123731,1365123731,1,3,0
64478148@N07,4151,3,1365228699,1365229776,4,1,1077
64478148@N07,4152,13,1369803304,1369803370,8,1,66
64478148@N07,4153,17,1374399064,1374399064,1,1,0
64478148@N07,4154,11,1378620177,1378620177,1,8,0
64478148@N07,4154,1,1378604262,1378604333,5,8,71
64478148@N07,4154,10,1378608139,1378608139,2,8,0
64478148@N07,4154,15,1378607222,1378607700,6,8,478
64478148@N07,4154,13,1378606992,1378607401,5,8,409
64478148@N07,4154,5,1378608477,1378608477,1,8,0
64478148@N07,4154,8,1378605834,1378605961,3,8,127
64478148@N07,4154,17,1378607999,1378607999,1,8,0
64478148@N07,4155,11,1380279639,1380279639,1,1,0
64478148@N07,4156,8,1380596333,1380596580,2,3,247
64478148@N07,4156,13,1380598772,1380598854,3,3,82
64478148@N07,4156,17,1380590199,1380590199,1,3,0
64478148@N07,4157,11,1385863346,1385898328,7,5,34982
64478148@N07,4157,10,1385879443,1385879443,1,5,0
64478148@N07,4157,13,1385877612,1385878179,6,5,567
64478148@N07,4157,5,1385869591,1385889267,2,5,19676
64478148@N07,4157,8,1385870047,1385870538,5,5,491
64478148@N07,4158,11,1392706061,1392706061,1,4,0
64478148@N07,4158,5,1392698289,1392698289,1,4,0
64478148@N07,4158,8,1392698556,1392698556,1,4,0
64478148@N07,4158,17,1392705459,1392705459,1,4,0
64478148@N07,4159,1,1393987652,1393987659,3,10,7
64478148@N07,4159,11,1393983015,1393983023,2,10,8
64478148@N07,4159,9,1393987755,1393988223,3,10,468
64478148@N07,4159,10,1393984729,1393984780,3,10,51
64478148@N07,4159,15,1393985406,1393985410,2,10,4
64478148@N07,4159,13,1393985571,1393985856,9,10,285
64478148@N07,4159,5,1393987300,1393987443,8,10,143
64478148@N07,4159,8,1393987068,1393987087,2,10,19
64478148@N07,4159,16,1393987802,1393987882,3,10,80
64478148@N07,4159,17,1393985230,1393985419,8,10,189
64478148@N07,4160,15,1452585092,1452585125,3,14,33
64478148@N07,4160,10,1452585342,1452585423,4,14,81
64478148@N07,4160,1,1452580148,1452580148,1,14,0
64478148@N07,4160,13,1452584688,1452584823,10,14,135
64478148@N07,4160,3,1452577467,1452577577,5,14,110
64478148@N07,4160,5,1452582128,1452582491,11,14,363
64478148@N07,4160,8,1452582818,1452583256,8,14,438
64478148@N07,4160,11,1452574005,1452574072,3,14,67
64478148@N07,4160,17,1452585027,1452585286,8,14,259
64478148@N07,4160,4,1452577774,1452577850,3,14,76
64478148@N07,4160,2,1452577262,1452577262,1,14,0
64478148@N07,4160,9,1452580039,1452580064,2,14,25
64478148@N07,4160,16,1452579952,1452579952,1,14,0
64478148@N07,4160,7,1452577389,1452577389,1,14,0
64478148@N07,4161,5,1466125054,1466128542,4,2,3488
64478148@N07,4161,8,1466135021,1466154750,11,2,19729
64483093@N04,4162,17,1315438163,1315438163,1,1,0
64542402@N07,4163,9,1355384542,1355384542,1,3,0
64542402@N07,4163,11,1355380539,1355381575,4,3,1036
64542402@N07,4163,1,1355384388,1355384388,1,3,0
64542402@N07,4164,5,1355626033,1355626033,1,4,0
64542402@N07,4164,11,1355650487,1355650487,1,4,0
64542402@N07,4164,13,1355641797,1355641797,1,4,0
64542402@N07,4164,10,1355648376,1355648376,1,4,0
64574649@N00,4165,2,1308387943,1308387943,1,1,0
64654599@N00,4166,11,1327057339,1327057618,3,6,279
64654599@N00,4166,8,1327046969,1327047039,2,6,70
64654599@N00,4166,5,1327047385,1327047385,1,6,0
64654599@N00,4166,17,1327051917,1327051917,1,6,0
64654599@N00,4166,13,1327039357,1327039424,3,6,67
64654599@N00,4166,15,1327037159,1327050680,3,6,13521
64669762@N02,4167,15,1351064754,1351064754,1,1,0
64728178@N00,4168,8,1439888757,1439888757,1,1,0
64759149@N05,4169,11,1360485016,1360485405,2,1,389
64779594@N00,4170,1,1188779298,1188779707,3,1,409
64779594@N00,4171,5,1195210596,1195210596,1,1,0
64779594@N00,4172,16,1204938849,1204938939,2,3,90
64779594@N00,4172,5,1204943610,1204943610,1,3,0
64779594@N00,4172,1,1204972216,1204976850,4,3,4634
64779594@N00,4173,11,1390625113,1390625113,1,1,0
64779594@N00,4174,11,1394840574,1394840598,3,1,24
64779594@N00,4175,3,1454115227,1454115227,1,4,0
64779594@N00,4175,5,1454123054,1454123677,2,4,623
64779594@N00,4175,13,1454121499,1454121499,1,4,0
64779594@N00,4175,17,1454120016,1454120533,2,4,517
64779594@N00,4176,13,1461025527,1461025611,3,4,84
64779594@N00,4176,17,1461026045,1461026084,2,4,39
64779594@N00,4176,15,1461025783,1461026007,3,4,224
64779594@N00,4176,11,1461021524,1461021524,1,4,0
64807684@N07,4177,5,1387163563,1387163563,1,1,0
64834051@N00,4178,8,1421905077,1421905077,1,3,0
64834051@N00,4178,11,1421883104,1421883755,3,3,651
64834051@N00,4178,1,1421901618,1421921483,3,3,19865
64834051@N00,4179,11,1439512309,1439531070,5,3,18761
64834051@N00,4179,1,1439521593,1439521593,1,3,0
64834051@N00,4179,8,1439531917,1439531917,1,3,0
64854604@N07,4180,11,1429106508,1429106508,1,1,0
64907932@N00,4181,11,1443582613,1443582664,2,1,51
64907932@N00,4182,11,1443681665,1443681665,1,1,0
65013125@N06,4183,11,1372380375,1372380375,1,2,0
65013125@N06,4183,8,1372397299,1372397316,2,2,17
65051383@N05,4184,11,1356830647,1356830647,1,1,0
65061709@N00,4185,11,1468717798,1468741516,2,1,23718
65098523@N02,4186,9,1312528317,1312528317,1,1,0
65103228@N02,4187,6,1387140761,1387140761,1,1,0
65103228@N02,4188,6,1387280693,1387280693,1,1,0
65103228@N02,4189,6,1430884883,1430888079,2,1,3196
65105672@N00,4190,11,1379055936,1379055936,1,1,0
65105672@N00,4191,2,1379416282,1379416282,1,2,0
65105672@N00,4191,12,1379415995,1379415995,1,2,0
65105672@N00,4192,11,1379504839,1379504843,2,3,4
65105672@N00,4192,13,1379489657,1379489657,1,3,0
65105672@N00,4192,14,1379485824,1379488181,6,3,2357
65105672@N00,4193,11,1443079294,1443079294,1,1,0
65105672@N00,4194,14,1443501803,1443501803,1,1,0
65105672@N00,4195,4,1443746699,1443746885,3,1,186
65105672@N00,4196,14,1460956377,1460956377,1,1,0
65159120@N05,4197,5,1230346207,1230346207,1,1,0
65184867@N04,4198,11,1393645942,1393645942,1,1,0
65363681@N00,4199,12,1203291335,1203294284,12,2,2949
65363681@N00,4199,16,1203305001,1203305011,2,2,10
65367128@N00,4200,11,1198380824,1198381798,8,1,974
65367128@N00,4201,11,1270511460,1270512747,5,6,1287
65367128@N00,4201,9,1270513211,1270514335,2,6,1124
65367128@N00,4201,13,1270528683,1270528695,2,6,12
65367128@N00,4201,2,1270520219,1270520219,1,6,0
65367128@N00,4201,10,1270527051,1270527411,4,6,360
65367128@N00,4201,15,1270527856,1270527856,1,6,0
65367128@N00,4202,8,1456208058,1456208122,2,2,64
65367128@N00,4202,3,1456188130,1456190276,3,2,2146
65423059@N07,4203,11,1322695659,1322695659,1,1,0
65435894@N02,4204,15,1339472919,1339472919,1,2,0
65435894@N02,4204,4,1339468925,1339468925,1,2,0
65435894@N02,4205,11,1339628392,1339628392,1,1,0
65435894@N02,4206,4,1339807084,1339807121,3,1,37
65516313@N06,4207,17,1357713081,1357713081,1,2,0
65516313@N06,4207,13,1357712509,1357712509,1,2,0
65516313@N06,4208,13,1374048885,1374048885,1,1,0
65519746@N05,4209,11,1398928583,1398928583,1,1,0
65547015@N00,4210,13,1389154197,1389154197,2,4,0
65547015@N00,4210,15,1389158081,1389158081,1,4,0
65547015@N00,4210,9,1389157137,1389157137,1,4,0
65547015@N00,4210,11,1389141188,1389153413,3,4,12225
65547015@N00,4211,11,1392563452,1392563452,1,1,0
65547015@N00,4212,11,1437835777,1437835777,1,1,0
65660483@N06,4213,11,1344878468,1344878468,1,1,0
65778609@N03,4214,8,1408337835,1408337835,1,2,0
65778609@N03,4214,4,1408329294,1408329294,1,2,0
65778609@N03,4215,17,1408421868,1408431575,3,1,9707
65783577@N00,4216,11,1229219181,1229219181,1,1,0
65784570@N00,4217,11,1382405038,1382405038,1,1,0
65825924@N03,4218,11,1363485943,1363485943,1,1,0
65825924@N03,4219,1,1363668804,1363668804,1,1,0
65825924@N03,4220,1,1395383056,1395383056,1,3,0
65825924@N03,4220,6,1395389377,1395389377,1,3,0
65825924@N03,4220,13,1395390488,1395390488,1,3,0
65825924@N03,4221,11,1395740625,1395740625,1,1,0
65825924@N03,4222,6,1418985790,1418986150,3,2,360
65825924@N03,4222,13,1418987231,1418987231,1,2,0
65825924@N03,4223,4,1426059159,1426059159,1,3,0
65825924@N03,4223,10,1426028988,1426028988,1,3,0
65825924@N03,4223,13,1426055939,1426056836,2,3,897
65825924@N03,4224,15,1426226870,1426226870,1,2,0
65825924@N03,4224,13,1426242538,1426243122,2,2,584
65825924@N03,4225,11,1440762063,1440762063,1,1,0
65825924@N03,4226,13,1458199405,1458207833,3,1,8428
65825924@N03,4227,11,1458297088,1458297088,1,2,0
65825924@N03,4227,10,1458295772,1458295772,1,2,0
65987396@N00,4228,8,1308384563,1308384563,1,2,0
65987396@N00,4228,13,1308372936,1308372936,1,2,0
66139507@N05,4229,9,1316161147,1316161147,1,5,0
66139507@N05,4229,2,1316157358,1316157849,6,5,491
66139507@N05,4229,4,1316153828,1316154131,3,5,303
66139507@N05,4229,3,1316156455,1316157203,5,5,748
66139507@N05,4229,17,1316153380,1316153380,1,5,0
66147934@N04,4230,4,1370137036,1370137036,2,1,0
66378762@N04,4231,1,1443936258,1443936258,2,2,0
66378762@N04,4231,11,1443957080,1443957080,1,2,0
66408130@N07,4232,11,1305163372,1305163372,1,1,0
66408130@N07,4233,11,1305203350,1305203350,1,1,0
66408130@N07,4234,15,1418613627,1418613627,1,1,0
66408130@N07,4235,11,1419382579,1419382579,1,3,0
66408130@N07,4235,10,1419407804,1419407804,1,3,0
66408130@N07,4235,15,1419406735,1419406735,1,3,0
66506437@N08,4236,17,1193010599,1193010685,3,3,86
66506437@N08,4236,10,1193022979,1193022979,1,3,0
66506437@N08,4236,15,1193010738,1193010774,2,3,36
66718423@N03,4237,3,1229921244,1229924916,13,3,3672
66718423@N03,4237,1,1229927951,1229928998,6,3,1047
66718423@N03,4237,11,1229936798,1229936973,3,3,175
66718423@N03,4238,5,1287312373,1287312651,6,3,278
66718423@N03,4238,13,1287318048,1287318713,4,3,665
66718423@N03,4238,6,1287318383,1287318777,2,3,394
66718423@N03,4239,17,1287585081,1287587092,5,1,2011
66718423@N03,4240,11,1287886482,1287887761,8,1,1279
66718423@N03,4241,13,1288195515,1288195754,8,1,239
66718423@N03,4242,6,1288332992,1288332992,1,2,0
66718423@N03,4242,17,1288331369,1288331396,2,2,27
66736603@N00,4243,11,1458627364,1458627364,1,1,0
66749627@N00,4244,5,1462695071,1462695071,1,2,0
66749627@N00,4244,1,1462689919,1462689919,1,2,0
66749627@N00,4245,11,1462756387,1462756387,1,1,0
66755680@N06,4246,11,1319936789,1319936799,2,6,10
66755680@N06,4246,9,1319936824,1319936824,1,6,0
66755680@N06,4246,5,1319913854,1319913854,1,6,0
66755680@N06,4246,15,1319913874,1319913882,2,6,8
66755680@N06,4246,1,1319936809,1319936818,2,6,9
66755680@N06,4246,8,1319910504,1319913868,7,6,3364
66825505@N00,4247,13,1279094936,1279094936,1,1,0
66884161@N05,4248,5,1347171168,1347171168,1,1,0
66898369@N04,4249,11,1319895881,1319895881,1,1,0
66898369@N04,4250,11,1320407836,1320408869,2,1,1033
66898369@N04,4251,11,1333072985,1333072985,1,1,0
66985846@N08,4252,11,1470876815,1470876815,1,1,0
67038581@N00,4253,4,1315874762,1315874762,1,2,0
67038581@N00,4253,7,1315870791,1315874173,2,2,3382
67043514@N00,4254,15,1353968334,1353968334,1,1,0
67056982@N00,4255,11,1277077636,1277077636,1,1,0
67062087@N04,4256,11,1337758983,1337765193,3,1,6210
67132721@N03,4257,11,1327111801,1327111801,1,1,0
67157140@N00,4258,15,1360051730,1360051730,1,1,0
67237167@N03,4259,8,1388052528,1388052720,3,5,192
67237167@N03,4259,2,1388040559,1388041373,3,5,814
67237167@N03,4259,10,1388043895,1388043895,1,5,0
67237167@N03,4259,17,1388044284,1388044620,4,5,336
67237167@N03,4259,11,1388031283,1388060895,2,5,29612
67246822@N00,4260,12,1323725171,1323725171,1,3,0
67246822@N00,4260,11,1323718863,1323723387,2,3,4524
67246822@N00,4260,9,1323720170,1323720170,1,3,0
67298936@N05,4261,11,1346740832,1346740832,1,1,0
67298936@N05,4262,11,1377833215,1377853943,11,1,20728
67299437@N06,4263,8,1433058613,1433058613,1,1,0
67299437@N06,4264,11,1433165314,1433173473,9,1,8159
67369636@N00,4265,6,1381992708,1381992718,2,2,10
67369636@N00,4265,5,1381994675,1381994961,2,2,286
67424733@N02,4266,11,1363060686,1363074570,2,1,13884
67489881@N07,4267,5,1318414041,1318414041,1,1,0
67489881@N07,4268,13,1318832318,1318832318,1,1,0
67523854@N07,4269,6,1288013438,1288013438,1,1,0
67527549@N00,4270,7,1294281743,1294281850,4,1,107
67547148@N02,4271,8,1197780519,1197780683,2,1,164
67547148@N02,4272,9,1256672832,1256672832,1,1,0
67547148@N02,4273,15,1256772993,1256772993,1,1,0
67621043@N00,4274,17,1326683251,1326683251,1,1,0
67621043@N00,4275,13,1359937292,1359937292,1,1,0
67621043@N00,4276,17,1444771904,1444771904,1,1,0
67622575@N00,4277,11,1359243439,1359243439,1,2,0
67622575@N00,4277,15,1359250227,1359250227,1,2,0
67700845@N07,4278,5,1340434129,1340436510,2,2,2381
67700845@N07,4278,8,1340436680,1340436680,1,2,0
67733160@N06,4279,8,1354785853,1354785853,1,1,0
67737010@N08,4280,3,1471049128,1471049128,1,1,0
67774977@N00,4281,13,1299740241,1299740389,3,6,148
67774977@N00,4281,10,1299739230,1299739244,2,6,14
67774977@N00,4281,8,1299742594,1299743238,10,6,644
67774977@N00,4281,17,1299739286,1299739889,4,6,603
67774977@N00,4281,5,1299743489,1299744937,7,6,1448
67774977@N00,4281,11,1299738134,1299751428,4,6,13294
67861517@N00,4282,13,1293592604,1293592621,2,1,17
67949678@N00,4283,8,1419931156,1419931160,2,1,4
67949678@N00,4284,5,1420020370,1420024954,3,5,4584
67949678@N00,4284,10,1419995101,1419995101,1,5,0
67949678@N00,4284,15,1420013085,1420013085,1,5,0
67949678@N00,4284,17,1420010942,1420012938,4,5,1996
67949678@N00,4284,13,1420014535,1420014535,1,5,0
67993063@N03,4285,11,1360877888,1360877888,1,1,0
67993371@N05,4286,17,1356907834,1356907834,1,2,0
67993371@N05,4286,5,1356922240,1356922240,1,2,0
68010648@N07,4287,11,1343477779,1343477779,1,1,0
68010648@N07,4288,11,1343605084,1343608426,2,1,3342
68071381@N07,4289,5,1381380753,1381380753,2,1,0
68174416@N00,4290,11,1304492839,1304492868,2,1,29
68235353@N00,4291,17,1328425521,1328425521,1,3,0
68235353@N00,4291,4,1328425768,1328425768,1,3,0
68235353@N00,4291,11,1328425907,1328425907,1,3,0
68311601@N00,4292,8,1245275565,1245275565,1,4,0
68311601@N00,4292,7,1245247717,1245247717,1,4,0
68311601@N00,4292,4,1245244915,1245248179,4,4,3264
68311601@N00,4292,11,1245242297,1245277234,8,4,34937
68350381@N03,4293,5,1369880096,1369880096,1,1,0
68362583@N00,4294,11,1289967357,1289993782,3,1,26425
68362583@N00,4295,11,1290051555,1290057599,4,1,6044
68384069@N05,4296,8,1414208925,1414208925,1,1,0
68549731@N00,4297,17,1260791400,1260791400,1,1,0
68559301@N00,4298,11,1335964350,1335964350,1,1,0
68559301@N00,4299,11,1374480390,1374492387,2,2,11997
68559301@N00,4299,13,1374482532,1374482532,1,2,0
68574102@N00,4300,5,1376969250,1376970889,4,5,1639
68574102@N00,4300,11,1376966723,1376995639,7,5,28916
68574102@N00,4300,13,1376990642,1376990642,1,5,0
68574102@N00,4300,8,1376981557,1376981600,2,5,43
68574102@N00,4300,17,1376992397,1376993646,5,5,1249
68607740@N00,4301,11,1264512938,1264512938,1,1,0
68655192@N08,4302,2,1468715025,1468715025,1,4,0
68655192@N08,4302,17,1468717918,1468717918,1,4,0
68655192@N08,4302,11,1468709987,1468709987,1,4,0
68655192@N08,4302,13,1468718189,1468718189,1,4,0
68655192@N08,4303,11,1469281271,1469281271,1,1,0
68731864@N04,4304,11,1394912748,1394912748,1,1,0
68731864@N04,4305,10,1394953198,1394953229,2,3,31
68731864@N04,4305,8,1394944772,1394944772,1,3,0
68731864@N04,4305,15,1394951868,1394952768,3,3,900
68821991@N03,4306,17,1438833169,1438833169,1,1,0
68846374@N00,4307,4,1281842616,1281842693,2,3,77
68846374@N00,4307,8,1281844825,1281844825,1,3,0
68846374@N00,4307,13,1281843716,1281843716,1,3,0
68941862@N00,4308,11,1383998671,1384014043,20,1,15372
68941862@N00,4309,11,1384202628,1384202628,1,1,0
68945713@N04,4310,14,1328926463,1328926463,1,1,0
68947259@N00,4311,13,1314176579,1314182291,8,1,5712
68997488@N00,4312,11,1379719437,1379719437,1,1,0
68997488@N00,4313,11,1389787421,1389787421,1,1,0
68998347@N00,4314,3,1222993066,1222993066,1,1,0
68998347@N00,4315,8,1290483574,1290485361,2,3,1787
68998347@N00,4315,2,1290477349,1290477349,1,3,0
68998347@N00,4315,4,1290478569,1290478569,1,3,0
68998347@N00,4316,11,1324437758,1324437845,2,1,87
68998347@N00,4317,3,1365213672,1365213672,1,2,0
68998347@N00,4317,9,1365208402,1365208402,1,2,0
68998347@N00,4318,7,1397191795,1397191795,1,3,0
68998347@N00,4318,5,1397207842,1397207842,1,3,0
68998347@N00,4318,11,1397186671,1397186724,2,3,53
68999127@N07,4319,11,1208575133,1208575133,1,1,0
68999275@N00,4320,11,1209518364,1209529357,20,1,10993
69058391@N00,4321,11,1201430555,1201430555,1,1,0
69108709@N07,4322,11,1321095056,1321095056,1,1,0
69108709@N07,4323,11,1321137776,1321137776,1,1,0
69108709@N07,4324,13,1324362489,1324362732,2,2,243
69108709@N07,4324,8,1324351137,1324351423,2,2,286
69108709@N07,4325,15,1334822861,1334822861,1,3,0
69108709@N07,4325,10,1334819529,1334822952,7,3,3423
69108709@N07,4325,11,1334819154,1334819187,2,3,33
69116795@N00,4326,11,1285725453,1285762227,26,1,36774
69121654@N00,4327,13,1265254192,1265254192,1,1,0
69121654@N00,4328,3,1265629857,1265629857,1,2,0
69121654@N00,4328,5,1265629842,1265629842,1,2,0
69161765@N08,4329,13,1352172730,1352172740,3,3,10
69161765@N08,4329,16,1352182810,1352182810,1,3,0
69161765@N08,4329,9,1352182844,1352182863,2,3,19
69206063@N00,4330,3,1307740238,1307740238,1,2,0
69206063@N00,4330,8,1307751021,1307751021,1,2,0
69206063@N00,4331,11,1307927659,1307927806,2,1,147
69226193@N08,4332,15,1328581668,1328581668,1,2,0
69226193@N08,4332,7,1328588399,1328588399,1,2,0
69271250@N00,4333,13,1448705544,1448705544,1,1,0
69277332@N06,4334,11,1437770775,1437770775,1,1,0
69302803@N06,4335,11,1363253755,1363253755,1,1,0
69323198@N00,4336,9,1259642326,1259642504,22,5,178
69323198@N00,4336,11,1259642557,1259642824,6,5,267
69323198@N00,4336,2,1259634117,1259637493,30,5,3376
69323198@N00,4336,7,1259637480,1259639568,31,5,2088
69323198@N00,4336,16,1259642613,1259642853,20,5,240
69323198@N00,4337,5,1260251296,1260251322,2,1,26
69328928@N00,4338,8,1194599890,1194599977,2,1,87
69343619@N08,4339,11,1371162325,1371162325,1,1,0
69343619@N08,4340,5,1371196376,1371196376,1,1,0
69343619@N08,4341,4,1371557788,1371557788,1,2,0
69343619@N08,4341,8,1371552767,1371552767,1,2,0
69377536@N00,4342,2,1339131832,1339131832,1,1,0
69416229@N00,4343,11,1248074499,1248074499,1,4,0
69416229@N00,4343,13,1248057360,1248057360,1,4,0
69416229@N00,4343,8,1248064803,1248064803,1,4,0
69416229@N00,4343,15,1248056616,1248056616,1,4,0
69574134@N00,4344,5,1214834400,1214834400,1,1,0
69574134@N00,4345,5,1216297339,1216301884,12,8,4545
69574134@N00,4345,3,1216287886,1216288196,11,8,310
69574134@N00,4345,12,1216275595,1216276175,8,8,580
69574134@N00,4345,9,1216289204,1216307638,4,8,18434
69574134@N00,4345,14,1216283342,1216287432,4,8,4090
69574134@N00,4345,2,1216274625,1216274625,1,8,0
69574134@N00,4345,11,1216295139,1216295139,1,8,0
69574134@N00,4345,1,1216289785,1216293968,14,8,4183
69574134@N00,4346,11,1234439696,1234439696,1,1,0
69574134@N00,4347,8,1346578498,1346578498,1,4,0
69574134@N00,4347,16,1346555615,1346555615,1,4,0
69574134@N00,4347,11,1346553208,1346553208,1,4,0
69574134@N00,4347,1,1346563002,1346563104,5,4,102
69591415@N02,4348,16,1330152136,1330152183,2,5,47
69591415@N02,4348,2,1330147370,1330147370,1,5,0
69591415@N02,4348,9,1330151778,1330151778,1,5,0
69591415@N02,4348,4,1330147603,1330147603,1,5,0
69591415@N02,4348,11,1330154257,1330154257,1,5,0
69689125@N02,4349,11,1395968076,1395968076,1,2,0
69689125@N02,4349,5,1395967759,1395967759,1,2,0
69735433@N02,4350,11,1376886328,1376886328,1,1,0
69738583@N05,4351,17,1337817451,1337817451,1,3,0
69738583@N05,4351,9,1337824805,1337824805,1,3,0
69738583@N05,4351,11,1337819166,1337819166,1,3,0
69781071@N00,4352,11,1299463571,1299480596,15,1,17025
69784270@N00,4353,16,1193173289,1193177638,2,4,4349
69784270@N00,4353,8,1193188110,1193188402,5,4,292
69784270@N00,4353,11,1193204284,1193204284,1,4,0
69784270@N00,4353,17,1193179148,1193179148,1,4,0
69811005@N00,4354,8,1433375656,1433376535,4,5,879
69811005@N00,4354,4,1433378216,1433382494,4,5,4278
69811005@N00,4354,11,1433395417,1433395417,1,5,0
69811005@N00,4354,5,1433389786,1433391422,2,5,1636
69811005@N00,4354,13,1433384682,1433385906,5,5,1224
69861074@N00,4355,11,1450855696,1450855696,1,1,0
69872692@N07,4356,11,1324713305,1324713305,1,1,0
69872692@N07,4357,5,1348297778,1348297778,1,1,0
69872692@N07,4358,13,1380349007,1380349022,2,2,15
69872692@N07,4358,5,1380341321,1380343925,2,2,2604
69876167@N05,4359,8,1299301140,1299301140,1,1,0
69880349@N08,4360,11,1449001741,1449001741,1,1,0
69882141@N06,4361,9,1294706631,1294706631,1,1,0
69882141@N06,4362,8,1294741074,1294741074,1,1,0
69882141@N06,4363,13,1294968547,1294968547,1,1,0
69882141@N06,4364,8,1375992929,1375992938,2,1,9
69883003@N00,4365,15,1348902196,1348902196,1,1,0
69883003@N00,4366,11,1348954948,1348957069,2,1,2121
69883003@N00,4367,10,1431646119,1431646119,1,3,0
69883003@N00,4367,11,1431646748,1431646764,2,3,16
69883003@N00,4367,9,1431650187,1431650187,1,3,0
69899432@N00,4368,9,1223043677,1223043682,4,5,5
69899432@N00,4368,8,1223043659,1223043659,1,5,0
69899432@N00,4368,13,1223043690,1223043690,1,5,0
69899432@N00,4368,15,1223043685,1223043690,3,5,5
69899432@N00,4368,5,1223043639,1223043643,2,5,4
69904569@N00,4369,11,1219018918,1219018918,1,1,0
69987114@N00,4370,11,1191193417,1191193665,2,4,248
69987114@N00,4370,16,1191206276,1191206276,1,4,0
69987114@N00,4370,3,1191210633,1191210633,1,4,0
69987114@N00,4370,4,1191210582,1191210582,1,4,0
69987114@N00,4371,11,1191239625,1191239774,2,1,149
69987114@N00,4372,16,1222491830,1222491830,1,1,0
69995382@N04,4373,17,1314515126,1314515126,1,1,0
70025073@N00,4374,6,1212664303,1212664313,3,2,10
70025073@N00,4374,11,1212656509,1212659063,3,2,2554
70084804@N00,4375,11,1450256978,1450256978,1,1,0
70265065@N05,4376,6,1219482207,1219482633,2,1,426
70378830@N08,4377,15,1434107344,1434107344,1,1,0
70378830@N08,4378,10,1446274434,1446274434,1,1,0
70378830@N08,4379,13,1447488056,1447488056,1,1,0
70378830@N08,4380,13,1449207684,1449207684,1,1,0
70378830@N08,4381,10,1460186236,1460186236,1,1,0
70378830@N08,4382,10,1469175915,1469175915,1,1,0
70548123@N00,4383,11,1406897528,1406897528,1,1,0
70626136@N00,4384,15,1348396892,1348396892,1,1,0
70626136@N00,4385,11,1348805787,1348805787,1,1,0
70626136@N00,4386,8,1411289684,1411307293,2,1,17609
70832171@N07,4387,16,1324781154,1324781154,1,2,0
70832171@N07,4387,8,1324792689,1324792977,2,2,288
70862502@N00,4388,17,1330699473,1330699473,1,2,0
70862502@N00,4388,11,1330698461,1330698461,1,2,0
70862502@N00,4389,5,1331015493,1331015493,1,2,0
70862502@N00,4389,8,1331018450,1331018450,1,2,0
70862502@N00,4390,13,1331103955,1331103955,1,4,0
70862502@N00,4390,10,1331108480,1331110762,2,4,2282
70862502@N00,4390,4,1331115905,1331116013,2,4,108
70862502@N00,4390,17,1331111673,1331114301,3,4,2628
70862502@N00,4391,11,1331298945,1331298945,1,1,0
70862502@N00,4392,11,1357882626,1357882626,1,1,0
70862502@N00,4393,15,1358237414,1358237414,1,1,0
70862502@N00,4394,11,1384051203,1384051203,1,1,0
70862502@N00,4395,15,1384236564,1384236564,1,1,0
70862502@N00,4396,8,1384580178,1384580178,1,3,0
70862502@N00,4396,5,1384579550,1384579550,1,3,0
70862502@N00,4396,15,1384584703,1384584703,1,3,0
70862502@N00,4397,11,1455774626,1455774626,1,1,0
70926999@N00,4398,10,1406789832,1406789832,1,1,0
70928085@N00,4399,3,1240454766,1240454825,2,3,59
70928085@N00,4399,4,1240456338,1240456338,1,3,0
70928085@N00,4399,11,1240446262,1240447342,4,3,1080
70928085@N00,4400,5,1240485826,1240485826,1,2,0
70928085@N00,4400,11,1240486456,1240486531,2,2,75
70944869@N00,4401,8,1429942755,1429942755,1,3,0
70944869@N00,4401,1,1429946415,1429946415,1,3,0
70944869@N00,4401,9,1429946068,1429946068,1,3,0
71022830@N00,4402,2,1293012534,1293013511,3,10,977
71022830@N00,4402,1,1293003184,1293003184,1,10,0
71022830@N00,4402,14,1292979050,1292979382,5,10,332
71022830@N00,4402,10,1292982723,1292982723,1,10,0
71022830@N00,4402,17,1293016764,1293016764,1,10,0
71022830@N00,4402,15,1292982975,1292982975,1,10,0
71022830@N00,4402,13,1292983446,1293009034,9,10,25588
71022830@N00,4402,5,1292999255,1292999746,2,10,491
71022830@N00,4402,8,1292997285,1292997500,3,10,215
71022830@N00,4402,11,1292972963,1293014938,6,10,41975
71128153@N00,4403,11,1369528275,1369528275,1,1,0
71214537@N00,4404,11,1382257242,1382257242,1,2,0
71214537@N00,4404,10,1382235256,1382235256,1,2,0
71460985@N05,4405,11,1424846525,1424846525,1,1,0
7151738@N03,4406,17,1393142788,1393150220,5,3,7432
7151738@N03,4406,15,1393144189,1393144189,1,3,0
7151738@N03,4406,13,1393144843,1393146649,2,3,1806
7151738@N03,4407,17,1396573750,1396573750,1,1,0
7151738@N03,4408,17,1396681854,1396681958,7,2,104
7151738@N03,4408,15,1396681807,1396681862,4,2,55
7151738@N03,4409,8,1412901740,1412901740,1,3,0
7151738@N03,4409,15,1412899919,1412899977,9,3,58
7151738@N03,4409,5,1412902116,1412902223,2,3,107
71665812@N00,4410,5,1365477781,1365493942,2,4,16161
71665812@N00,4410,13,1365490407,1365490407,1,4,0
71665812@N00,4410,11,1365458091,1365471033,8,4,12942
71665812@N00,4410,4,1365483849,1365483849,1,4,0
71778096@N00,4411,5,1240294699,1240296015,3,7,1316
71778096@N00,4411,10,1240285700,1240285700,1,7,0
71778096@N00,4411,17,1240285880,1240285880,1,7,0
71778096@N00,4411,13,1240286149,1240286149,1,7,0
71778096@N00,4411,9,1240298963,1240300849,2,7,1886
71778096@N00,4411,16,1240292065,1240302993,6,7,10928
71778096@N00,4411,1,1240298486,1240298771,8,7,285
71778096@N00,4412,11,1240564727,1240564832,4,2,105
71778096@N00,4412,4,1240567191,1240567315,3,2,124
71814567@N02,4413,5,1297833903,1297841504,7,1,7601
71814567@N02,4414,5,1298022339,1298022339,1,1,0
71814567@N02,4415,8,1298101111,1298101145,2,1,34
71854985@N00,4416,8,1332645227,1332645227,1,1,0
71854985@N00,4417,8,1332718020,1332718020,1,1,0
71854985@N00,4418,11,1332808976,1332808976,1,2,0
71854985@N00,4418,13,1332816357,1332818406,4,2,2049
71917576@N04,4419,11,1352683344,1352683658,3,1,314
71922377@N00,4420,8,1288837756,1288837756,1,1,0
71922377@N00,4421,8,1383717546,1383717546,1,1,0
71922377@N00,4422,13,1425703817,1425703817,1,1,0
71956836@N00,4423,11,1443740741,1443770203,108,1,29462
71965292@N00,4424,14,1213139035,1213139163,43,1,128
7197250@N06,4425,11,1368452538,1368467542,3,1,15004
7197250@N06,4426,17,1368810093,1368810093,1,2,0
7197250@N06,4426,11,1368804759,1368804759,1,2,0
7197250@N06,4427,15,1369043177,1369043177,1,1,0
71991688@N00,4428,17,1238993646,1238993646,1,1,0
71991688@N00,4429,11,1239317932,1239317932,1,1,0
72043907@N00,4430,6,1266993120,1266993120,1,1,0
72048386@N00,4431,11,1221553929,1221553929,1,1,0
7206981@N03,4432,9,1244601567,1244601567,1,4,0
7206981@N03,4432,3,1244608134,1244608160,4,4,26
7206981@N03,4432,11,1244614687,1244614687,1,4,0
7206981@N03,4432,7,1244608222,1244608222,1,4,0
72092856@N00,4433,1,1288248256,1288248256,1,1,0
72126458@N00,4434,13,1311071085,1311071378,4,3,293
72126458@N00,4434,15,1311072719,1311073827,55,3,1108
72126458@N00,4434,4,1311075081,1311075199,4,3,118
72134509@N00,4435,11,1386318331,1386318331,1,2,0
72134509@N00,4435,13,1386312020,1386312020,1,2,0
72174877@N00,4436,14,1262481806,1262491736,2,3,9930
72174877@N00,4436,9,1262473678,1262473678,1,3,0
72174877@N00,4436,17,1262492250,1262492331,4,3,81
72174877@N00,4437,8,1262749387,1262749387,1,2,0
72174877@N00,4437,11,1262735324,1262762056,2,2,26732
72196320@N00,4438,11,1468454337,1468454337,1,1,0
72303203@N07,4439,16,1293242797,1293242797,1,2,0
72303203@N07,4439,11,1293243457,1293243457,1,2,0
72303203@N07,4440,5,1293486653,1293486653,1,1,0
72303203@N07,4441,11,1293525649,1293525649,1,1,0
72324747@N00,4442,1,1288052690,1288052690,1,1,0
72408746@N08,4443,13,1384048811,1384048811,1,1,0
72449450@N00,4444,17,1194071351,1194071351,1,1,0
72463966@N00,4445,11,1242244971,1242245043,2,6,72
72463966@N00,4445,13,1242258398,1242258398,1,6,0
72463966@N00,4445,8,1242252531,1242252926,3,6,395
72463966@N00,4445,4,1242261162,1242265103,3,6,3941
72463966@N00,4445,1,1242246852,1242246852,1,6,0
72463966@N00,4445,17,1242258534,1242258534,1,6,0
7256454@N05,4446,2,1214170088,1214170088,1,3,0
7256454@N05,4446,14,1214171366,1214176014,11,3,4648
7256454@N05,4446,11,1214168198,1214168198,1,3,0
7256454@N05,4447,15,1214534453,1214534453,1,1,0
7256454@N05,4448,3,1214877998,1214880560,26,1,2562
7256454@N05,4449,14,1239491811,1239491811,1,3,0
7256454@N05,4449,1,1239507573,1239508128,7,3,555
7256454@N05,4449,2,1239494938,1239494945,2,3,7
7256454@N05,4450,13,1245116910,1245116910,1,1,0
7256454@N05,4451,5,1279771615,1279771624,2,3,9
7256454@N05,4451,17,1279767473,1279767511,3,3,38
7256454@N05,4451,14,1279763844,1279763979,4,3,135
7256454@N05,4452,4,1310427456,1310427469,2,3,13
7256454@N05,4452,11,1310421481,1310422174,5,3,693
7256454@N05,4452,3,1310435829,1310439203,32,3,3374
7256454@N05,4453,8,1310959342,1310959362,2,5,20
7256454@N05,4453,11,1310959180,1310959180,1,5,0
7256454@N05,4453,2,1310939092,1310941631,17,5,2539
7256454@N05,4453,6,1310959274,1310959448,2,5,174
7256454@N05,4453,5,1310959287,1310959434,5,5,147
7256454@N05,4454,3,1352610912,1352610912,1,2,0
7256454@N05,4454,14,1352609086,1352609330,12,2,244
7256454@N05,4455,1,1420268857,1420268857,1,1,0
72589879@N00,4456,15,1291534849,1291534849,1,6,0
72589879@N00,4456,5,1291543856,1291543856,1,6,0
72589879@N00,4456,12,1291506086,1291506086,1,6,0
72589879@N00,4456,13,1291531466,1291531572,2,6,106
72589879@N00,4456,8,1291521816,1291543643,6,6,21827
72589879@N00,4456,11,1291500178,1291500214,2,6,36
72589879@N00,4457,8,1348580462,1348582476,2,1,2014
72670227@N06,4458,11,1429840593,1429864051,22,6,23458
72670227@N06,4458,2,1429857001,1429857112,8,6,111
72670227@N06,4458,8,1429862942,1429862942,1,6,0
72670227@N06,4458,5,1429863172,1429863172,2,6,0
72670227@N06,4458,10,1429854743,1429856443,14,6,1700
72670227@N06,4458,7,1429842460,1429842472,4,6,12
72685908@N00,4459,11,1380268057,1380268057,1,1,0
72685908@N00,4460,11,1380545161,1380545451,2,1,290
72844756@N00,4461,13,1249943774,1249943774,1,2,0
72844756@N00,4461,4,1249941307,1249941307,1,2,0
72844756@N00,4462,11,1249984888,1249984888,1,1,0
7286287@N03,4463,7,1341911854,1341911854,1,4,0
7286287@N03,4463,17,1341913028,1341913028,1,4,0
7286287@N03,4463,13,1341913312,1341913312,1,4,0
7286287@N03,4463,2,1341911768,1341911768,1,4,0
7287512@N02,4464,1,1270631987,1270632413,3,2,426
7287512@N02,4464,8,1270637557,1270637633,2,2,76
7287512@N02,4465,2,1270686797,1270686797,1,2,0
7287512@N02,4465,8,1270691830,1270691830,1,2,0
72895281@N03,4466,8,1359790816,1359790889,8,2,73
72895281@N03,4466,5,1359788670,1359788762,12,2,92
72949871@N00,4467,11,1302214921,1302242004,5,1,27083
72977144@N00,4468,1,1210472799,1210472799,1,1,0
7307868@N02,4469,9,1384915056,1384915089,2,5,33
7307868@N02,4469,11,1384900388,1384900388,1,5,0
7307868@N02,4469,17,1384906832,1384906832,1,5,0
7307868@N02,4469,7,1384905955,1384905955,1,5,0
7307868@N02,4469,8,1384908809,1384909087,7,5,278
73105116@N00,4470,11,1242433165,1242433165,1,1,0
73105116@N00,4471,5,1242462541,1242462541,1,1,0
73105116@N00,4472,11,1242779871,1242779871,1,2,0
73105116@N00,4472,12,1242780861,1242780861,1,2,0
73105116@N00,4473,9,1273829597,1273829597,1,2,0
73105116@N00,4473,15,1273827397,1273827397,1,2,0
73114641@N00,4474,2,1330852666,1330852666,1,1,0
73114641@N00,4475,11,1424503493,1424503493,1,5,0
73114641@N00,4475,15,1424510817,1424511339,5,5,522
73114641@N00,4475,9,1424506934,1424507197,2,5,263
73114641@N00,4475,10,1424509615,1424510144,7,5,529
73114641@N00,4475,3,1424504997,1424505897,17,5,900
73114641@N00,4476,15,1427609878,1427609878,1,4,0
73114641@N00,4476,13,1427610315,1427610813,2,4,498
73114641@N00,4476,3,1427598478,1427600095,19,4,1617
73114641@N00,4476,2,1427602251,1427604184,6,4,1933
73114641@N00,4477,11,1447552903,1447552957,2,1,54
73122205@N07,4478,2,1363750281,1363750281,1,3,0
73122205@N07,4478,3,1363750804,1363750804,1,3,0
73122205@N07,4478,10,1363745305,1363745305,1,3,0
73265016@N00,4479,1,1207519620,1207519620,1,1,0
7327560@N06,4480,8,1231837586,1231837586,1,1,0
7327560@N06,4481,9,1231911450,1231911450,1,3,0
7327560@N06,4481,11,1231918676,1231918676,1,3,0
7327560@N06,4481,8,1231922764,1231922764,1,3,0
7327560@N06,4482,11,1232018257,1232018449,2,1,192
73281647@N03,4483,17,1348911228,1348911228,1,1,0
73281647@N03,4484,11,1447373636,1447416222,5,5,42586
73281647@N03,4484,7,1447374332,1447374332,1,5,0
73281647@N03,4484,15,1447400304,1447411848,2,5,11544
73281647@N03,4484,13,1447395129,1447395929,10,5,800
73281647@N03,4484,2,1447379853,1447379853,1,5,0
73287343@N03,4485,13,1360128811,1360129911,3,1,1100
73302443@N05,4486,6,1320089740,1320094411,8,1,4671
73376948@N00,4487,11,1423253891,1423255908,2,1,2017
73397033@N02,4488,17,1350973767,1350973767,1,1,0
73427821@N00,4489,7,1317568277,1317568277,1,2,0
73427821@N00,4489,2,1317571335,1317571445,9,2,110
73427821@N00,4490,7,1332693873,1332694016,2,1,143
73427821@N00,4491,2,1345778905,1345778905,1,5,0
73427821@N00,4491,7,1345776657,1345776955,2,5,298
73427821@N00,4491,13,1345784797,1345788762,4,5,3965
73427821@N00,4491,6,1345793523,1345793523,1,5,0
73427821@N00,4491,17,1345784287,1345784372,2,5,85
73427821@N00,4492,10,1351674798,1351674889,3,1,91
73427821@N00,4493,5,1352440360,1352440372,2,2,12
73427821@N00,4493,10,1352432557,1352433595,17,2,1038
73427821@N00,4494,2,1369458385,1369458422,3,1,37
73451901@N00,4495,5,1300872533,1300872786,3,1,253
73451901@N00,4496,5,1351146653,1351146656,2,3,3
73451901@N00,4496,9,1351146657,1351146657,1,3,0
73451901@N00,4496,11,1351146649,1351146661,2,3,12
73451901@N00,4497,13,1369561791,1369561791,1,1,0
7349370@N04,4498,3,1196812881,1196815118,2,3,2237
7349370@N04,4498,14,1196812834,1196812834,1,3,0
7349370@N04,4498,10,1196840647,1196840647,1,3,0
7349370@N04,4499,15,1241950741,1241951276,2,7,535
7349370@N04,4499,11,1241912720,1241912720,1,7,0
7349370@N04,4499,1,1241924895,1241924895,1,7,0
7349370@N04,4499,16,1241921455,1241921455,1,7,0
7349370@N04,4499,9,1241921872,1241922413,2,7,541
7349370@N04,4499,2,1241916257,1241916257,1,7,0
7349370@N04,4499,13,1241930691,1241930691,1,7,0
7349370@N04,4500,13,1242180506,1242181234,2,4,728
7349370@N04,4500,10,1242189815,1242190950,4,4,1135
7349370@N04,4500,17,1242186479,1242189340,3,4,2861
7349370@N04,4500,8,1242176945,1242176994,2,4,49
7349370@N04,4501,2,1242381000,1242381000,1,2,0
7349370@N04,4501,6,1242371585,1242373850,9,2,2265
7349370@N04,4502,15,1289191248,1289191355,2,6,107
7349370@N04,4502,13,1289191308,1289191496,6,6,188
7349370@N04,4502,10,1289191006,1289192759,4,6,1753
7349370@N04,4502,17,1289191030,1289191269,3,6,239
7349370@N04,4502,11,1289181345,1289181345,1,6,0
7349370@N04,4502,5,1289192500,1289192500,1,6,0
7356139@N05,4503,11,1361943370,1361943370,1,1,0
7357708@N03,4504,11,1319687719,1319687719,1,1,0
73596184@N00,4505,17,1299409346,1299409346,1,1,0
73596184@N00,4506,10,1299632257,1299632257,1,1,0
73596184@N00,4507,11,1307839421,1307840025,4,1,604
73626640@N00,4508,11,1200683476,1200683476,1,3,0
73626640@N00,4508,5,1200680942,1200680942,1,3,0
73626640@N00,4508,8,1200671217,1200675379,4,3,4162
7366969@N02,4509,11,1336003935,1336006600,13,2,2665
7366969@N02,4509,15,1336000499,1336000716,2,2,217
7366969@N02,4510,15,1391470319,1391470319,1,8,0
7366969@N02,4510,2,1391476333,1391476335,3,8,2
7366969@N02,4510,12,1391474345,1391475400,5,8,1055
7366969@N02,4510,8,1391489353,1391489353,1,8,0
7366969@N02,4510,11,1391472906,1391493659,10,8,20753
7366969@N02,4510,17,1391470309,1391470309,1,8,0
7366969@N02,4510,5,1391489527,1391489527,1,8,0
7366969@N02,4510,4,1391470749,1391493630,13,8,22881
7366969@N02,4511,15,1391597186,1391597186,1,4,0
7366969@N02,4511,2,1391591315,1391596480,5,4,5165
7366969@N02,4511,11,1391596762,1391596762,1,4,0
7366969@N02,4511,4,1391596630,1391596805,2,4,175
7366969@N02,4512,1,1391815115,1391815322,4,3,207
7366969@N02,4512,5,1391815530,1391815799,5,3,269
7366969@N02,4512,4,1391820724,1391820724,1,3,0
7366969@N02,4513,2,1392454392,1392454613,3,6,221
7366969@N02,4513,8,1392439386,1392441160,29,6,1774
7366969@N02,4513,14,1392457774,1392457840,3,6,66
7366969@N02,4513,11,1392442838,1392454234,3,6,11396
7366969@N02,4513,5,1392442092,1392442613,8,6,521
7366969@N02,4513,4,1392453131,1392453889,11,6,758
7366969@N02,4514,11,1392547402,1392547402,1,1,0
7367216@N05,4515,4,1348727926,1348727926,1,1,0
7367216@N05,4516,11,1348794967,1348794967,1,1,0
73719225@N00,4517,11,1448691570,1448691570,1,1,0
73783753@N00,4518,6,1299902745,1299902979,8,1,234
73799316@N00,4519,3,1203207617,1203207638,2,6,21
73799316@N00,4519,1,1203201252,1203203394,11,6,2142
73799316@N00,4519,8,1203215682,1203215819,3,6,137
73799316@N00,4519,11,1203230769,1203235710,8,6,4941
73799316@N00,4519,9,1203203815,1203203830,2,6,15
73799316@N00,4519,12,1203210853,1203214087,11,6,3234
73799444@N00,4520,11,1197914899,1197914899,1,3,0
73799444@N00,4520,4,1197892512,1197892730,2,3,218
73799444@N00,4520,8,1197909846,1197909846,1,3,0
7383636@N06,4521,11,1389486450,1389498236,2,1,11786
7383636@N06,4522,2,1396156419,1396156419,1,3,0
7383636@N06,4522,11,1396157181,1396157582,3,3,401
7383636@N06,4522,8,1396145247,1396145247,1,3,0
7383636@N06,4523,17,1428543925,1428543925,1,1,0
7383636@N06,4524,11,1446849446,1446861146,3,1,11700
7385506@N05,4525,11,1458796207,1458796207,1,1,0
7389358@N06,4526,11,1346973139,1346973139,1,1,0
7389358@N06,4527,11,1347166203,1347166203,1,1,0
74089168@N00,4528,11,1447899949,1447899949,1,1,0
74111533@N00,4529,11,1286267842,1286267842,1,1,0
74285955@N00,4530,11,1320433856,1320459015,2,1,25159
74285955@N00,4531,8,1320552960,1320552960,1,1,0
74289372@N00,4532,11,1318916330,1318916602,2,3,272
74289372@N00,4532,8,1318929091,1318929091,1,3,0
74289372@N00,4532,5,1318929170,1318929170,1,3,0
74289372@N00,4533,2,1319006098,1319006098,1,3,0
74289372@N00,4533,11,1319017237,1319017237,1,3,0
74289372@N00,4533,4,1319005098,1319005098,1,3,0
74366817@N06,4534,11,1387683013,1387683013,1,1,0
74366817@N06,4535,11,1391237529,1391238885,2,1,1356
74366817@N06,4536,11,1401077030,1401077030,1,2,0
74366817@N06,4536,8,1401080148,1401080148,1,2,0
74372164@N04,4537,14,1352257687,1352276452,5,2,18765
74372164@N04,4537,11,1352262908,1352278178,3,2,15270
74372164@N04,4538,14,1352345423,1352345548,4,2,125
74372164@N04,4538,11,1352345423,1352345534,2,2,111
74372164@N04,4539,11,1386566292,1386566292,1,1,0
74434146@N04,4540,4,1329444943,1329444943,1,2,0
74434146@N04,4540,12,1329439166,1329439166,1,2,0
74434146@N04,4541,13,1329711858,1329712113,2,2,255
74434146@N04,4541,5,1329706183,1329706183,1,2,0
74453626@N00,4542,15,1449641881,1449653175,3,2,11294
74453626@N00,4542,17,1449648046,1449648046,1,2,0
74461555@N05,4543,11,1336084742,1336093538,5,1,8796
74461555@N05,4544,8,1360410080,1360410375,2,2,295
74461555@N05,4544,11,1360381480,1360381480,2,2,0
74461555@N05,4545,17,1362557781,1362557781,1,2,0
74461555@N05,4545,11,1362553022,1362554619,3,2,1597
74461555@N05,4546,13,1380854661,1380874999,3,1,20338
74476774@N00,4547,11,1382419253,1382419253,1,1,0
7450381@N05,4548,2,1414727463,1414727463,1,1,0
7451382@N03,4549,2,1393648897,1393649995,30,1,1098
7451382@N03,4550,6,1393816823,1393816823,1,2,0
7451382@N03,4550,17,1393837229,1393837326,8,2,97
7451382@N03,4551,7,1393917926,1393922828,67,1,4902
74594191@N07,4552,11,1424203075,1424203075,1,1,0
74689807@N03,4553,11,1392945610,1392945610,1,1,0
74754977@N03,4554,11,1468761240,1468761240,1,1,0
74762998@N08,4555,11,1346352529,1346367528,26,1,14999
74865359@N00,4556,9,1386828596,1386828596,1,3,0
74865359@N00,4556,7,1386829176,1386829197,2,3,21
74865359@N00,4556,11,1386827726,1386827726,1,3,0
74865359@N00,4557,11,1391679075,1391679075,1,3,0
74865359@N00,4557,17,1391667652,1391667652,1,3,0
74865359@N00,4557,16,1391663504,1391663680,2,3,176
74865359@N00,4558,17,1412052355,1412052355,1,1,0
74865359@N00,4559,11,1425273586,1425289045,2,2,15459
74865359@N00,4559,8,1425288301,1425288301,1,2,0
7486728@N03,4560,13,1188081695,1188082117,3,4,422
7486728@N03,4560,11,1188073781,1188073781,1,4,0
7486728@N03,4560,15,1188081160,1188081829,7,4,669
7486728@N03,4560,10,1188080849,1188080962,4,4,113
7486728@N03,4561,11,1188201388,1188201388,1,1,0
7490466@N08,4562,5,1192767919,1192767919,1,1,0
74939715@N05,4563,11,1246138902,1246138902,1,1,0
74939715@N05,4564,11,1364797596,1364797596,1,1,0
74939715@N05,4565,15,1395731925,1395731925,1,1,0
74953875@N00,4566,11,1291963917,1291968811,2,3,4894
74953875@N00,4566,1,1291970343,1291970343,1,3,0
74953875@N00,4566,6,1291962803,1291963150,2,3,347
7515797@N06,4567,11,1276407970,1276407982,2,3,12
7515797@N06,4567,8,1276415039,1276415039,1,3,0
7515797@N06,4567,13,1276412199,1276413091,5,3,892
7526168@N06,4568,11,1361145019,1361165128,3,2,20109
7526168@N06,4568,5,1361147379,1361147844,2,2,465
7527751@N05,4569,11,1290156111,1290171836,4,1,15725
75296851@N06,4570,11,1326456376,1326456376,1,1,0
75338025@N07,4571,1,1383554127,1383555176,5,6,1049
75338025@N07,4571,5,1383540620,1383540620,1,6,0
75338025@N07,4571,11,1383536194,1383559446,3,6,23252
75338025@N07,4571,8,1383540454,1383540454,1,6,0
75338025@N07,4571,2,1383553431,1383553497,3,6,66
75338025@N07,4571,6,1383539947,1383539947,1,6,0
75421381@N00,4572,11,1223528422,1223528422,1,1,0
7552795@N03,4573,11,1373078424,1373078424,1,3,0
7552795@N03,4573,8,1373089098,1373089098,1,3,0
7552795@N03,4573,5,1373081957,1373084201,6,3,2244
7552795@N03,4574,11,1373370006,1373370006,1,1,0
7552795@N03,4575,11,1373433933,1373433933,1,1,0
7552795@N03,4576,8,1373789132,1373789132,1,1,0
75601845@N06,4577,15,1283514413,1283516155,21,1,1742
75601845@N06,4578,4,1284294371,1284299156,69,2,4785
75601845@N06,4578,9,1284292690,1284292988,18,2,298
75601845@N06,4579,1,1284384172,1284384948,17,2,776
75601845@N06,4579,9,1284385361,1284385485,7,2,124
75601845@N06,4580,9,1327716205,1327716229,130,1,24
75663005@N03,4581,16,1356148162,1356148162,1,1,0
75678739@N00,4582,8,1354326151,1354326151,1,2,0
75678739@N00,4582,3,1354318748,1354318748,1,2,0
75678739@N00,4583,17,1358568922,1358568922,1,1,0
75742976@N05,4584,11,1353681007,1353681007,1,3,0
75742976@N05,4584,9,1353696660,1353696660,1,3,0
75742976@N05,4584,2,1353688459,1353688459,1,3,0
75742976@N05,4585,11,1365845234,1365845234,1,1,0
75745610@N00,4586,11,1359280439,1359280439,1,1,0
75806696@N00,4587,13,1383099515,1383099515,1,1,0
75837785@N00,4588,5,1366944600,1366944600,1,2,0
75837785@N00,4588,1,1366939980,1366939980,1,2,0
75837785@N00,4589,11,1366988221,1366988221,1,1,0
75837785@N00,4590,8,1367056154,1367056154,1,3,0
75837785@N00,4590,10,1367055769,1367055769,1,3,0
75837785@N00,4590,5,1367058074,1367058074,1,3,0
75990687@N05,4591,3,1437796341,1437797409,10,5,1068
75990687@N05,4591,14,1437798859,1437798862,2,5,3
75990687@N05,4591,8,1437806114,1437806129,3,5,15
75990687@N05,4591,16,1437780509,1437780613,5,5,104
75990687@N05,4591,2,1437787717,1437787740,2,5,23
75992475@N02,4592,17,1372470033,1372470033,1,1,0
76024515@N07,4593,8,1347529380,1347529380,1,1,0
76024515@N07,4594,2,1347663218,1347663218,1,1,0
76024515@N07,4595,11,1347859094,1347859094,1,1,0
76024515@N07,4596,10,1369454251,1369454251,1,1,0
76059924@N03,4597,11,1296634685,1296634685,1,1,0
76072437@N02,4598,17,1454634522,1454634522,1,1,0
76101503@N00,4599,1,1414983231,1414983231,1,1,0
7612058@N04,4600,8,1254238136,1254238136,1,1,0
76151808@N00,4601,5,1234678539,1234678539,1,2,0
76151808@N00,4601,13,1234667032,1234667032,1,2,0
76151808@N00,4602,2,1235011696,1235011696,1,4,0
76151808@N00,4602,14,1235015570,1235018237,5,4,2667
76151808@N00,4602,11,1235001870,1235001870,1,4,0
76151808@N00,4602,8,1235022555,1235022555,1,4,0
76151808@N00,4603,9,1265958226,1265958226,1,4,0
76151808@N00,4603,4,1265945814,1265946010,2,4,196
76151808@N00,4603,16,1265953233,1265953321,2,4,88
76151808@N00,4603,15,1265962758,1265963247,2,4,489
76151808@N00,4604,2,1266105483,1266105483,1,4,0
76151808@N00,4604,1,1266105414,1266105414,1,4,0
76151808@N00,4604,9,1266107399,1266107399,1,4,0
76151808@N00,4604,11,1266106363,1266106363,1,4,0
76151808@N00,4605,11,1266469962,1266470369,3,1,407
76151808@N00,4606,13,1298013018,1298013492,2,1,474
76151808@N00,4607,11,1298362324,1298362324,1,2,0
76151808@N00,4607,8,1298345402,1298345886,2,2,484
76151808@N00,4608,17,1361593264,1361593264,1,1,0
76151808@N00,4609,11,1424164902,1424164902,1,1,0
76151808@N00,4610,6,1451289395,1451289395,1,1,0
76192008@N07,4611,17,1350391119,1350391119,1,1,0
76193525@N05,4612,8,1328660121,1328660121,1,1,0
76193525@N05,4613,13,1328692721,1328692726,2,2,5
76193525@N05,4613,15,1328692728,1328692728,1,2,0
76193525@N05,4614,17,1329115550,1329115550,1,1,0
76270281@N05,4615,11,1375316242,1375316242,1,2,0
76270281@N05,4615,6,1375323500,1375323500,1,2,0
76343652@N04,4616,11,1462231776,1462231779,2,1,3
76356046@N05,4617,2,1272606949,1272606981,3,3,32
76356046@N05,4617,11,1272614956,1272614956,1,3,0
76356046@N05,4617,1,1272606106,1272606311,2,3,205
7649501@N05,4618,6,1337685054,1337685276,3,1,222
76665138@N00,4619,7,1263170511,1263170511,1,1,0
76665138@N00,4620,5,1263369081,1263369081,1,2,0
76665138@N00,4620,15,1263364691,1263364691,1,2,0
76665138@N00,4621,11,1325834647,1325834647,1,1,0
76665138@N00,4622,11,1325886616,1325886616,1,1,0
76665138@N00,4623,11,1326100505,1326100505,1,1,0
76665138@N00,4624,11,1326276069,1326276922,2,1,853
76665138@N00,4625,13,1326341100,1326343445,5,8,2345
76665138@N00,4625,5,1326334461,1326334625,5,8,164
76665138@N00,4625,3,1326324841,1326326583,2,8,1742
76665138@N00,4625,9,1326327709,1326327709,1,8,0
76665138@N00,4625,11,1326323780,1326323780,1,8,0
76665138@N00,4625,15,1326345068,1326345083,2,8,15
76665138@N00,4625,17,1326344483,1326344837,3,8,354
76665138@N00,4625,4,1326330037,1326330825,2,8,788
76702422@N05,4626,11,1335061404,1335061557,2,1,153
76704164@N00,4627,9,1371523132,1371527193,2,1,4061
76730958@N07,4628,11,1365126529,1365126529,1,1,0
7675784@N04,4629,11,1376197762,1376197762,1,1,0
76765378@N00,4630,4,1388876736,1388876736,1,1,0
76766156@N06,4631,8,1391267683,1391268961,10,7,1278
76766156@N06,4631,4,1391246030,1391249142,3,7,3112
76766156@N06,4631,2,1391220048,1391245812,6,7,25764
76766156@N06,4631,17,1391249685,1391249764,3,7,79
76766156@N06,4631,15,1391250514,1391250584,2,7,70
76766156@N06,4631,11,1391215679,1391272619,4,7,56940
76766156@N06,4631,9,1391238683,1391238683,1,7,0
76795008@N04,4632,13,1267695610,1267695610,1,1,0
76795008@N04,4633,5,1268967589,1268967589,1,1,0
76795008@N04,4634,15,1273761515,1273762382,3,1,867
7682911@N05,4635,15,1303309005,1303309074,2,1,69
76830337@N07,4636,8,1333180992,1333180992,1,1,0
76830337@N07,4637,11,1408741204,1408741207,4,3,3
76830337@N07,4637,10,1408741200,1408741200,1,3,0
76830337@N07,4637,4,1408741202,1408741202,1,3,0
76860021@N05,4638,11,1345169604,1345181815,3,1,12211
76860021@N05,4639,11,1345496636,1345496636,1,1,0
76954449@N08,4640,11,1354328429,1354328429,1,1,0
76954449@N08,4641,11,1355225239,1355225239,1,1,0
76985374@N00,4642,11,1300578648,1300603646,27,1,24998
76991932@N00,4643,2,1433839250,1433839250,1,1,0
76991932@N00,4644,11,1461297748,1461297748,1,1,0
77000749@N08,4645,11,1389231248,1389231248,1,1,0
7704455@N02,4646,6,1254214737,1254222636,14,2,7899
7704455@N02,4646,11,1254204772,1254217355,2,2,12583
77099055@N08,4647,3,1298073596,1298073596,1,1,0
77105859@N02,4648,9,1336441275,1336441275,1,4,0
77105859@N02,4648,5,1336445171,1336445171,1,4,0
77105859@N02,4648,1,1336448818,1336448818,1,4,0
77105859@N02,4648,2,1336451043,1336451043,1,4,0
77179348@N00,4649,11,1342001650,1342005711,26,5,4061
77179348@N00,4649,1,1342003291,1342003312,2,5,21
77179348@N00,4649,8,1342001213,1342001213,1,5,0
77179348@N00,4649,13,1342000684,1342000690,2,5,6
77179348@N00,4649,5,1342001369,1342004246,7,5,2877
77179348@N00,4650,7,1342257016,1342257054,2,14,38
77179348@N00,4650,2,1342256123,1342256767,15,14,644
77179348@N00,4650,10,1342266963,1342267087,3,14,124
77179348@N00,4650,5,1342260585,1342260634,4,14,49
77179348@N00,4650,9,1342258607,1342259283,9,14,676
77179348@N00,4650,16,1342260059,1342260093,4,14,34
77179348@N00,4650,14,1342257310,1342257533,12,14,223
77179348@N00,4650,11,1342255729,1342255878,2,14,149
77179348@N00,4650,8,1342260883,1342260883,1,14,0
77179348@N00,4650,17,1342266846,1342266854,3,14,8
77179348@N00,4650,3,1342257056,1342258086,27,14,1030
77179348@N00,4650,12,1342256858,1342256858,1,14,0
77179348@N00,4650,1,1342258557,1342260225,10,14,1668
77179348@N00,4650,13,1342266657,1342266657,1,14,0
77179348@N00,4651,10,1442479281,1442488705,31,14,9424
77179348@N00,4651,13,1442467552,1442486726,9,14,19174
77179348@N00,4651,5,1442461854,1442466366,46,14,4512
77179348@N00,4651,9,1442474467,1442475616,11,14,1149
77179348@N00,4651,11,1442461346,1442467198,13,14,5852
77179348@N00,4651,4,1442478778,1442481738,37,14,2960
77179348@N00,4651,16,1442475637,1442478334,62,14,2697
77179348@N00,4651,2,1442472410,1442473882,12,14,1472
77179348@N00,4651,17,1442467425,1442487063,3,14,19638
77179348@N00,4651,7,1442469554,1442469706,4,14,152
77179348@N00,4651,15,1442486996,1442486996,1,14,0
77179348@N00,4651,3,1442469578,1442479185,8,14,9607
77179348@N00,4651,12,1442467222,1442467225,2,14,3
77179348@N00,4651,1,1442474279,1442483382,14,14,9103
77219100@N03,4652,4,1375322893,1375322893,1,1,0
77219100@N03,4653,4,1375353471,1375353471,1,1,0
77260531@N03,4654,6,1199364744,1199364877,2,1,133
77260531@N03,4655,11,1364545300,1364545300,1,1,0
77265242@N00,4656,17,1356406847,1356406847,1,1,0
7732814@N08,4657,9,1346297125,1346297125,1,1,0
77382220@N08,4658,11,1365298898,1365298898,1,1,0
77395664@N00,4659,8,1412499718,1412499805,3,1,87
77395664@N00,4660,13,1412574275,1412574275,1,1,0
77437178@N00,4661,1,1248663490,1248663490,1,4,0
77437178@N00,4661,11,1248666453,1248666638,2,4,185
77437178@N00,4661,5,1248668939,1248668939,1,4,0
77437178@N00,4661,17,1248661452,1248679149,2,4,17697
77437178@N00,4662,11,1273239893,1273239893,1,2,0
77437178@N00,4662,15,1273226941,1273226941,1,2,0
77437178@N00,4663,11,1316851396,1316851396,1,2,0
77437178@N00,4663,9,1316839292,1316839292,1,2,0
77437178@N00,4664,8,1332565248,1332565248,1,2,0
77437178@N00,4664,4,1332580164,1332580164,1,2,0
77463997@N03,4665,8,1359108714,1359108714,1,1,0
77463997@N03,4666,17,1427060774,1427060774,1,1,0
77463997@N03,4667,4,1427351860,1427351860,1,1,0
77503031@N00,4668,11,1261512523,1261512523,1,1,0
77512391@N02,4669,11,1391105553,1391115832,2,1,10279
77545914@N00,4670,4,1268096015,1268096015,1,5,0
77545914@N00,4670,11,1268102104,1268102104,1,5,0
77545914@N00,4670,2,1268102068,1268102090,2,5,22
77545914@N00,4670,9,1268101503,1268101521,2,5,18
77545914@N00,4670,15,1268119859,1268119887,2,5,28
77545914@N00,4671,11,1268271766,1268271766,1,1,0
77692940@N00,4672,2,1367207030,1367211339,2,1,4309
77744839@N00,4673,16,1389418140,1389418140,1,3,0
77744839@N00,4673,11,1389414278,1389414278,1,3,0
77744839@N00,4673,9,1389417412,1389417412,1,3,0
77744839@N00,4674,11,1389464031,1389464031,1,1,0
77744839@N00,4675,16,1389502858,1389502858,1,3,0
77744839@N00,4675,5,1389508440,1389508440,1,3,0
77744839@N00,4675,1,1389505920,1389507745,2,3,1825
77890545@N08,4676,11,1360158611,1360181764,44,1,23153
77932199@N07,4677,11,1333945921,1333945921,1,2,0
77932199@N07,4677,10,1333951198,1333951530,6,2,332
77932199@N07,4678,16,1334029274,1334029274,1,1,0
77932199@N07,4679,5,1340783008,1340783176,5,3,168
77932199@N07,4679,11,1340798636,1340798649,2,3,13
77932199@N07,4679,16,1340784098,1340784358,3,3,260
77932199@N07,4680,17,1341211812,1341211812,1,4,0
77932199@N07,4680,10,1341209977,1341211741,13,4,1764
77932199@N07,4680,13,1341212159,1341212182,2,4,23
77932199@N07,4680,11,1341200540,1341200540,1,4,0
77979716@N02,4681,11,1455973200,1455973200,2,1,0
77979716@N02,4682,6,1456040009,1456040091,5,1,82
7804123@N08,4683,4,1410188254,1410188254,1,1,0
78046504@N07,4684,11,1336387618,1336387618,1,1,0
7807827@N04,4685,11,1271241212,1271241212,1,1,0
78079154@N08,4686,11,1351054869,1351054869,1,1,0
78089576@N06,4687,11,1333097677,1333097677,2,1,0
78132024@N00,4688,8,1389147789,1389147789,1,1,0
78147513@N00,4689,1,1271139761,1271139761,1,1,0
78166585@N05,4690,8,1414642528,1414642528,1,1,0
78299922@N08,4691,11,1282176359,1282176359,1,1,0
78299922@N08,4692,11,1282217684,1282217684,1,1,0
7830943@N03,4693,1,1381741507,1381741507,1,1,0
78319592@N00,4694,16,1281760974,1281766815,3,3,5841
78319592@N00,4694,3,1281773901,1281773901,1,3,0
78319592@N00,4694,8,1281780061,1281780061,2,3,0
78345092@N07,4695,5,1372585418,1372585418,1,4,0
78345092@N07,4695,11,1372562117,1372588165,2,4,26048
78345092@N07,4695,4,1372580950,1372580950,1,4,0
78345092@N07,4695,16,1372569513,1372569513,1,4,0
78364960@N04,4696,15,1333776447,1333776447,1,3,0
78364960@N04,4696,16,1333770057,1333770057,1,3,0
78364960@N04,4696,2,1333773025,1333773025,1,3,0
78364960@N04,4697,11,1339932181,1339932181,1,1,0
78364960@N04,4698,8,1342176401,1342176401,1,2,0
78364960@N04,4698,11,1342166073,1342166073,1,2,0
78364960@N04,4699,11,1344667809,1344684690,2,3,16881
78364960@N04,4699,8,1344678774,1344678815,2,3,41
78364960@N04,4699,5,1344683213,1344683460,3,3,247
78364960@N04,4700,11,1348219566,1348219566,1,1,0
78364960@N04,4701,4,1350803440,1350803440,1,3,0
78364960@N04,4701,8,1350795767,1350795767,1,3,0
78364960@N04,4701,11,1350807117,1350807117,1,3,0
78364960@N04,4702,11,1354871330,1354871330,1,2,0
78364960@N04,4702,17,1354874392,1354874392,1,2,0
78364960@N04,4703,13,1356000085,1356000085,1,1,0
78364960@N04,4704,8,1356941277,1356942763,2,2,1486
78364960@N04,4704,1,1356951096,1356951300,2,2,204
78364960@N04,4705,14,1358663212,1358663212,1,4,0
78364960@N04,4705,17,1358650725,1358650725,1,4,0
78364960@N04,4705,16,1358651691,1358653525,2,4,1834
78364960@N04,4705,2,1358658558,1358659012,3,4,454
78364960@N04,4706,8,1362822396,1362822396,1,6,0
78364960@N04,4706,15,1362804302,1362804302,1,6,0
78364960@N04,4706,5,1362819994,1362819994,1,6,0
78364960@N04,4706,11,1362797444,1362809134,2,6,11690
78364960@N04,4706,13,1362804118,1362804118,1,6,0
78364960@N04,4706,17,1362803550,1362816806,2,6,13256
78364960@N04,4707,5,1363918636,1363918636,1,2,0
78364960@N04,4707,11,1363925233,1363925233,1,2,0
78364960@N04,4708,4,1365313703,1365313703,1,3,0
78364960@N04,4708,8,1365321462,1365321462,1,3,0
78364960@N04,4708,17,1365327502,1365327502,1,3,0
78364960@N04,4709,8,1372503981,1372504372,2,2,391
78364960@N04,4709,5,1372502234,1372502234,1,2,0
78364960@N04,4710,17,1380888382,1380888482,2,2,100
78364960@N04,4710,11,1380890796,1380890796,1,2,0
78364960@N04,4711,15,1382526062,1382526062,1,5,0
78364960@N04,4711,16,1382485942,1382485942,1,5,0
78364960@N04,4711,11,1382488596,1382532482,3,5,43886
78364960@N04,4711,17,1382521843,1382522937,3,5,1094
78364960@N04,4711,1,1382503013,1382503013,1,5,0
78364960@N04,4712,4,1386244387,1386244387,1,1,0
78364960@N04,4713,11,1396154675,1396154675,1,1,0
78364960@N04,4714,17,1411812428,1411812428,1,1,0
78364960@N04,4715,11,1441540027,1441540027,1,1,0
78364960@N04,4716,11,1445085356,1445085971,2,2,615
78364960@N04,4716,10,1445081378,1445081378,1,2,0
78364960@N04,4717,11,1449123718,1449123718,1,1,0
78364960@N04,4718,8,1451560068,1451560068,1,2,0
78364960@N04,4718,5,1451561662,1451561662,1,2,0
78364960@N04,4719,5,1455866455,1455866455,1,1,0
78364960@N04,4720,8,1466569611,1466569887,7,1,276
78364960@N04,4721,16,1467621967,1467621967,1,1,0
7838453@N07,4722,11,1337790676,1337790676,1,1,0
78493611@N00,4723,11,1383728473,1383728473,1,1,0
7849988@N04,4724,1,1429235441,1429235441,1,5,0
7849988@N04,4724,10,1429245518,1429245857,4,5,339
7849988@N04,4724,17,1429248133,1429248135,2,5,2
7849988@N04,4724,5,1429269510,1429269854,3,5,344
7849988@N04,4724,11,1429272734,1429272807,8,5,73
7849988@N04,4725,2,1466381970,1466382065,2,2,95
7849988@N04,4725,13,1466400907,1466402355,2,2,1448
7849988@N04,4726,8,1466579438,1466583706,19,4,4268
7849988@N04,4726,17,1466565130,1466565145,3,4,15
7849988@N04,4726,5,1466587375,1466587503,3,4,128
7849988@N04,4726,13,1466571746,1466571746,1,4,0
78562800@N05,4727,10,1355274086,1355274142,4,3,56
78562800@N05,4727,17,1355275655,1355275655,1,3,0
78562800@N05,4727,15,1355275417,1355275417,1,3,0
78562800@N05,4728,11,1362634787,1362634787,1,1,0
7856853@N02,4729,11,1311811721,1311811721,1,1,0
78569471@N00,4730,8,1202953947,1202954402,4,1,455
78569471@N00,4731,11,1209174893,1209179221,13,1,4328
78569471@N00,4732,2,1214481469,1214482730,13,1,1261
78672040@N00,4733,4,1357433047,1357433047,1,1,0
78743109@N00,4734,13,1325734755,1325734755,1,7,0
78743109@N00,4734,11,1325722372,1325722372,1,7,0
78743109@N00,4734,5,1325741621,1325741640,3,7,19
78743109@N00,4734,15,1325736558,1325737001,2,7,443
78743109@N00,4734,8,1325723309,1325727059,4,7,3750
78743109@N00,4734,12,1325753995,1325754997,2,7,1002
78743109@N00,4734,4,1325746990,1325746990,1,7,0
78779574@N00,4735,4,1336026565,1336026565,1,12,0
78779574@N00,4735,3,1336029990,1336030229,7,12,239
78779574@N00,4735,17,1336014564,1336034500,7,12,19936
78779574@N00,4735,8,1336009749,1336020847,10,12,11098
78779574@N00,4735,5,1336009409,1336019378,5,12,9969
78779574@N00,4735,15,1336014503,1336034566,7,12,20063
78779574@N00,4735,10,1336017956,1336017956,1,12,0
78779574@N00,4735,7,1336028720,1336030831,2,12,2111
78779574@N00,4735,14,1336029853,1336029862,2,12,9
78779574@N00,4735,13,1336015964,1336042916,9,12,26952
78779574@N00,4735,11,1336002315,1336044737,5,12,42422
78779574@N00,4735,2,1336004887,1336030843,9,12,25956
7883384@N04,4736,11,1189030912,1189030912,1,1,0
7886635@N06,4737,8,1424489255,1424489255,1,3,0
7886635@N06,4737,11,1424476066,1424511346,8,3,35280
7886635@N06,4737,17,1424489121,1424489121,1,3,0
7886635@N06,4738,11,1424935412,1424935412,1,1,0
7886635@N06,4739,11,1425287402,1425288936,5,2,1534
7886635@N06,4739,17,1425282211,1425282211,1,2,0
7886635@N06,4740,13,1425536056,1425536262,4,3,206
7886635@N06,4740,11,1425521835,1425521844,2,3,9
7886635@N06,4740,10,1425513536,1425513545,3,3,9
79023626@N00,4741,8,1314352495,1314352495,1,1,0
79023626@N00,4742,11,1327568209,1327568209,1,1,0
79023626@N00,4743,17,1336662672,1336662672,1,1,0
79023626@N00,4744,17,1336811619,1336812921,2,2,1302
79023626@N00,4744,11,1336811002,1336817532,2,2,6530
79023626@N00,4745,11,1345715020,1345715020,1,1,0
79023626@N00,4746,15,1348820679,1348820679,1,1,0
79023626@N00,4747,15,1354012171,1354012171,1,1,0
79023626@N00,4748,17,1354066697,1354066697,1,1,0
79023626@N00,4749,1,1354776829,1354776829,1,1,0
79023626@N00,4750,1,1368944255,1368944255,1,1,0
79024147@N00,4751,6,1385251370,1385251399,4,1,29
79092915@N00,4752,15,1280401618,1280401618,1,1,0
79092915@N00,4753,11,1289000135,1289000135,1,1,0
7911596@N06,4754,5,1324625593,1324626342,2,1,749
79121533@N00,4755,7,1333257276,1333257276,1,3,0
79121533@N00,4755,3,1333255876,1333255876,1,3,0
79121533@N00,4755,4,1333262611,1333262640,2,3,29
7915108@N06,4756,8,1286609530,1286609530,1,1,0
79172203@N00,4757,9,1291496697,1291496697,1,9,0
79172203@N00,4757,2,1291502871,1291504638,2,9,1767
79172203@N00,4757,5,1291522640,1291522998,4,9,358
79172203@N00,4757,10,1291505160,1291505579,10,9,419
79172203@N00,4757,11,1291523481,1291535778,3,9,12297
79172203@N00,4757,12,1291503948,1291504255,2,9,307
79172203@N00,4757,13,1291508718,1291540379,7,9,31661
79172203@N00,4757,8,1291520916,1291521118,7,9,202
79172203@N00,4757,15,1291506086,1291506142,3,9,56
79172203@N00,4758,11,1291873209,1291874381,4,3,1172
79172203@N00,4758,17,1291883509,1291888374,25,3,4865
79172203@N00,4758,5,1291875250,1291875898,2,3,648
79172203@N00,4759,12,1291969792,1291973555,7,1,3763
79172203@N00,4760,10,1292029803,1292030153,8,4,350
79172203@N00,4760,13,1292036519,1292036519,1,4,0
79172203@N00,4760,15,1292030272,1292030531,8,4,259
79172203@N00,4760,11,1292027279,1292038035,2,4,10756
79172203@N00,4761,13,1399182087,1399182087,1,3,0
79172203@N00,4761,11,1399157980,1399157980,1,3,0
79172203@N00,4761,8,1399168178,1399168231,3,3,53
79172203@N00,4762,10,1399504537,1399504979,24,8,442
79172203@N00,4762,13,1399506973,1399517771,41,8,10798
79172203@N00,4762,15,1399505296,1399515297,38,8,10001
79172203@N00,4762,5,1399511626,1399511760,7,8,134
79172203@N00,4762,9,1399503568,1399503600,3,8,32
79172203@N00,4762,1,1399503666,1399503666,1,8,0
79172203@N00,4762,11,1399502851,1399503083,10,8,232
79172203@N00,4762,8,1399510533,1399521055,14,8,10522
79344793@N02,4763,11,1330744398,1330744398,1,1,0
79433444@N07,4764,10,1355065851,1355065851,1,1,0
7945368@N05,4765,11,1341641193,1341641193,1,1,0
7945637@N07,4766,3,1205551378,1205551378,1,1,0
7945637@N07,4767,11,1217132938,1217133959,2,2,1021
7945637@N07,4767,8,1217123505,1217123505,1,2,0
7945637@N07,4768,13,1231649039,1231649039,1,2,0
7945637@N07,4768,8,1231642560,1231642889,2,2,329
7945637@N07,4769,4,1234435278,1234435278,1,1,0
7945637@N07,4770,13,1243160793,1243160793,1,1,0
7945637@N07,4771,15,1246696580,1246696580,1,1,0
7945637@N07,4772,11,1253781797,1253781797,1,1,0
7945637@N07,4773,16,1254469256,1254469256,1,1,0
7945637@N07,4774,11,1266565647,1266578335,2,3,12688
7945637@N07,4774,9,1266567209,1266567209,1,3,0
7945637@N07,4774,3,1266575284,1266575284,1,3,0
7945637@N07,4775,10,1268540812,1268540812,1,1,0
7945637@N07,4776,10,1269674227,1269674227,1,2,0
7945637@N07,4776,11,1269675245,1269675245,1,2,0
7945637@N07,4777,13,1279966255,1279966255,1,1,0
7945637@N07,4778,9,1284717040,1284717540,3,2,500
7945637@N07,4778,10,1284722079,1284722079,1,2,0
7945637@N07,4779,9,1298785626,1298785626,1,1,0
7945637@N07,4780,10,1300589918,1300589918,1,2,0
7945637@N07,4780,5,1300594004,1300594004,1,2,0
7945637@N07,4781,8,1313890742,1313890742,1,1,0
79498503@N03,4782,13,1315630779,1315630779,1,1,0
79535868@N00,4783,17,1282609016,1282609016,1,4,0
79535868@N00,4783,8,1282599652,1282599652,1,4,0
79535868@N00,4783,10,1282608673,1282608673,1,4,0
79535868@N00,4783,13,1282609204,1282609204,1,4,0
79551604@N00,4784,9,1251020074,1251020074,1,1,0
79551604@N00,4785,17,1293954259,1293954259,1,1,0
7955606@N05,4786,11,1215426383,1215429079,2,2,2696
7955606@N05,4786,13,1215419092,1215419102,2,2,10
79577915@N00,4787,15,1290058572,1290058572,1,1,0
79577915@N00,4788,14,1290405590,1290406741,2,3,1151
79577915@N00,4788,9,1290403179,1290403179,1,3,0
79577915@N00,4788,1,1290398938,1290398938,1,3,0
79665856@N08,4789,11,1429624800,1429624800,1,1,0
7973770@N05,4790,8,1217924122,1217929481,2,5,5359
7973770@N05,4790,5,1217923386,1217923392,2,5,6
7973770@N05,4790,15,1217910173,1217910173,1,5,0
7973770@N05,4790,2,1217906338,1217909288,2,5,2950
7973770@N05,4790,13,1217922032,1217922035,2,5,3
79743365@N00,4791,11,1292102719,1292103547,4,7,828
79743365@N00,4791,4,1292122529,1292122529,1,7,0
79743365@N00,4791,12,1292104536,1292106570,3,7,2034
79743365@N00,4791,3,1292108584,1292108584,1,7,0
79743365@N00,4791,17,1292123644,1292131473,3,7,7829
79743365@N00,4791,15,1292123921,1292132081,2,7,8160
79743365@N00,4791,2,1292107276,1292117041,5,7,9765
79743365@N00,4792,11,1292535396,1292538002,4,1,2606
79761301@N00,4793,17,1188219791,1188219791,1,1,0
79761301@N00,4794,8,1287743559,1287743931,6,5,372
79761301@N00,4794,7,1287736848,1287738029,4,5,1181
79761301@N00,4794,11,1287733602,1287734567,5,5,965
79761301@N00,4794,4,1287735130,1287735867,5,5,737
79761301@N00,4794,17,1287755111,1287755229,3,5,118
79761301@N00,4795,5,1287940418,1287940742,3,3,324
79761301@N00,4795,11,1287943881,1287943912,3,3,31
79761301@N00,4795,8,1287939262,1287939262,1,3,0
79761301@N00,4796,13,1288191920,1288192130,2,7,210
79761301@N00,4796,8,1288186078,1288186714,5,7,636
79761301@N00,4796,9,1288181487,1288182908,3,7,1421
79761301@N00,4796,11,1288178209,1288179124,6,7,915
79761301@N00,4796,5,1288183528,1288184740,7,7,1212
79761301@N00,4796,2,1288176473,1288177895,5,7,1422
79761301@N00,4796,17,1288193995,1288195252,7,7,1257
79761301@N00,4797,11,1402219537,1402219537,1,7,0
79761301@N00,4797,5,1402192424,1402192499,4,7,75
79761301@N00,4797,15,1402215493,1402215500,2,7,7
79761301@N00,4797,8,1402194975,1402196376,5,7,1401
79761301@N00,4797,13,1402199393,1402214823,5,7,15430
79761301@N00,4797,10,1402215903,1402215903,1,7,0
79761301@N00,4797,17,1402205346,1402215797,5,7,10451
79761301@N00,4798,11,1402310724,1402310724,1,3,0
79761301@N00,4798,13,1402308809,1402308809,1,3,0
79761301@N00,4798,5,1402304364,1402304364,1,3,0
79761301@N00,4799,8,1402374508,1402374508,1,3,0
79761301@N00,4799,5,1402374678,1402374678,1,3,0
79761301@N00,4799,3,1402367889,1402376314,3,3,8425
79767616@N02,4800,11,1373516527,1373516527,1,1,0
79871648@N04,4801,11,1379302807,1379302807,1,1,0
7988769@N08,4802,11,1425693914,1425693914,1,1,0
79939076@N02,4803,13,1342342681,1342342908,2,4,227
79939076@N02,4803,17,1342342552,1342342552,1,4,0
79939076@N02,4803,5,1342333634,1342333634,1,4,0
79939076@N02,4803,4,1342318008,1342318008,1,4,0
79959485@N00,4804,2,1219306458,1219306458,1,2,0
79959485@N00,4804,11,1219294638,1219306303,4,2,11665
79959485@N00,4805,8,1219575222,1219576386,79,6,1164
79959485@N00,4805,5,1219561911,1219562414,4,6,503
79959485@N00,4805,9,1219554710,1219554710,1,6,0
79959485@N00,4805,4,1219561053,1219561053,1,6,0
79959485@N00,4805,11,1219553062,1219569560,2,6,16498
79959485@N00,4805,7,1219561027,1219561027,1,6,0
79959485@N00,4806,8,1225973626,1225973626,1,3,0
79959485@N00,4806,5,1225973641,1225973641,1,3,0
79959485@N00,4806,11,1225973633,1225973633,1,3,0
79959485@N00,4807,8,1230552808,1230552821,3,1,13
79959485@N00,4808,3,1331682114,1331699071,13,6,16957
79959485@N00,4808,8,1331706916,1331706936,3,6,20
79959485@N00,4808,5,1331708474,1331710783,3,6,2309
79959485@N00,4808,12,1331695487,1331695709,7,6,222
79959485@N00,4808,4,1331689236,1331689236,1,6,0
79959485@N00,4808,11,1331676611,1331714722,37,6,38111
79959485@N00,4809,5,1331869065,1331869065,1,4,0
79959485@N00,4809,9,1331872819,1331872819,1,4,0
79959485@N00,4809,11,1331876574,1331878236,7,4,1662
79959485@N00,4809,16,1331875760,1331875794,3,4,34
79959485@N00,4810,5,1331948625,1331949981,2,3,1356
79959485@N00,4810,11,1331935701,1331935749,3,3,48
79959485@N00,4810,17,1331939628,1331945509,11,3,5881
79959485@N00,4811,2,1332124293,1332125142,2,3,849
79959485@N00,4811,11,1332120684,1332125639,3,3,4955
79959485@N00,4811,16,1332122642,1332122728,6,3,86
80050541@N06,4812,13,1298360007,1298360007,1,1,0
80081080@N00,4813,11,1445492070,1445492070,1,1,0
80081080@N00,4814,11,1445764175,1445770369,9,1,6194
80081080@N00,4815,11,1445824757,1445825468,6,1,711
80084904@N00,4816,4,1200866051,1200866051,1,1,0
80172766@N04,4817,9,1338018724,1338018724,1,1,0
8021465@N08,4818,11,1288785450,1288785450,1,1,0
8021465@N08,4819,5,1288856041,1288856041,1,1,0
8021465@N08,4820,8,1317364220,1317364220,1,1,0
8028661@N05,4821,11,1208787819,1208787819,1,1,0
80304458@N00,4822,15,1419479330,1419479330,1,1,0
80446452@N00,4823,17,1302322469,1302322534,7,2,65
80446452@N00,4823,15,1302322404,1302322404,1,2,0
80446452@N00,4824,3,1367033450,1367033643,14,5,193
80446452@N00,4824,13,1367043090,1367043160,11,5,70
80446452@N00,4824,11,1367025257,1367025330,5,5,73
80446452@N00,4824,8,1367048996,1367049004,4,5,8
80446452@N00,4824,14,1367033398,1367033433,5,5,35
80446452@N00,4825,12,1457049100,1457049100,1,1,0
80521687@N00,4826,15,1349409350,1349410195,11,6,845
80521687@N00,4826,13,1349411248,1349412648,4,6,1400
80521687@N00,4826,5,1349421249,1349421614,2,6,365
80521687@N00,4826,8,1349419181,1349420328,7,6,1147
80521687@N00,4826,11,1349406814,1349406814,1,6,0
80521687@N00,4826,14,1349407954,1349407954,1,6,0
8054352@N06,4827,11,1354943541,1354943541,1,1,0
8054352@N06,4828,9,1355648360,1355648360,1,1,0
8054352@N06,4829,11,1363302003,1363302003,1,1,0
8054352@N06,4830,11,1373601351,1373601351,1,1,0
80558292@N00,4831,1,1379029213,1379029213,1,1,0
80558292@N00,4832,15,1380254561,1380254561,1,1,0
80558292@N00,4833,15,1382685771,1382685771,1,1,0
80558292@N00,4834,5,1382767556,1382767556,1,1,0
80580684@N06,4835,11,1317819600,1317819600,1,1,0
8066628@N02,4836,11,1189579589,1189611409,36,1,31820
8066628@N02,4837,11,1190278356,1190291360,7,1,13004
8066628@N02,4838,11,1230695917,1230734507,8,1,38590
8066628@N02,4839,11,1231233005,1231233074,4,1,69
8066628@N02,4840,11,1287035491,1287061354,32,2,25863
8066628@N02,4840,2,1287044044,1287044078,2,2,34
8066628@N02,4841,11,1343078741,1343078804,5,1,63
8068421@N07,4842,5,1192263880,1192263880,1,2,0
8068421@N07,4842,10,1192258847,1192259901,2,2,1054
8068421@N07,4843,13,1200813091,1200813091,1,2,0
8068421@N07,4843,11,1200791164,1200791164,1,2,0
8068421@N07,4844,17,1200986812,1200996831,4,1,10019
8068421@N07,4845,11,1209684860,1209684860,1,1,0
8068421@N07,4846,10,1210309442,1210309442,1,1,0
8068421@N07,4847,11,1222503681,1222515779,2,1,12098
8068421@N07,4848,8,1267088224,1267088224,1,1,0
8068421@N07,4849,5,1295787647,1295795571,2,1,7924
8068421@N07,4850,13,1296198651,1296198651,1,2,0
8068421@N07,4850,10,1296211802,1296211802,1,2,0
8068421@N07,4851,16,1337322749,1337322749,1,2,0
8068421@N07,4851,15,1337332990,1337332990,1,2,0
8068421@N07,4852,13,1349154182,1349154182,1,6,0
8068421@N07,4852,8,1349150304,1349155636,2,6,5332
8068421@N07,4852,10,1349149472,1349149472,1,6,0
8068421@N07,4852,5,1349150089,1349150874,2,6,785
8068421@N07,4852,17,1349149267,1349153058,2,6,3791
8068421@N07,4852,15,1349153267,1349153598,2,6,331
8068835@N04,4853,2,1333062656,1333064681,46,10,2025
8068835@N04,4853,3,1333062221,1333062500,5,10,279
8068835@N04,4853,1,1333069276,1333069755,20,10,479
8068835@N04,4853,5,1333069885,1333071151,26,10,1266
8068835@N04,4853,10,1333075003,1333075015,5,10,12
8068835@N04,4853,16,1333066596,1333066621,7,10,25
8068835@N04,4853,13,1333074615,1333074679,5,10,64
8068835@N04,4853,9,1333069191,1333069212,6,10,21
8068835@N04,4853,11,1333075571,1333075912,17,10,341
8068835@N04,4853,8,1333071492,1333072886,51,10,1394
8068835@N04,4854,15,1333601806,1333609376,47,5,7570
8068835@N04,4854,13,1333608519,1333608987,31,5,468
8068835@N04,4854,11,1333597032,1333612402,72,5,15370
8068835@N04,4854,4,1333597965,1333598003,6,5,38
8068835@N04,4854,10,1333599892,1333599910,6,5,18
8068835@N04,4855,15,1333864397,1333864415,6,2,18
8068835@N04,4855,13,1333859568,1333864269,18,2,4701
8068835@N04,4856,5,1409898252,1409898300,6,4,48
8068835@N04,4856,9,1409898648,1409898648,3,4,0
8068835@N04,4856,11,1409883845,1409899281,29,4,15436
8068835@N04,4856,13,1409891771,1409894619,39,4,2848
8074702@N06,4857,11,1371601791,1371601791,1,1,0
80775532@N06,4858,9,1442744272,1442745772,4,8,1500
80775532@N06,4858,8,1442739723,1442739987,7,8,264
80775532@N06,4858,11,1442709680,1442747212,11,8,37532
80775532@N06,4858,15,1442741197,1442741197,1,8,0
80775532@N06,4858,4,1442743202,1442743202,1,8,0
80775532@N06,4858,13,1442740980,1442741068,3,8,88
80775532@N06,4858,1,1442714425,1442714725,4,8,300
80775532@N06,4858,10,1442741444,1442741504,4,8,60
80777965@N00,4859,11,1338279172,1338279172,1,1,0
80777965@N00,4860,11,1338564724,1338564724,1,1,0
80784859@N00,4861,11,1308043027,1308043027,1,1,0
8078549@N07,4862,11,1255561659,1255561659,1,1,0
8078549@N07,4863,11,1402112759,1402130197,10,1,17438
8078549@N07,4864,11,1402275191,1402283534,34,1,8343
80848604@N02,4865,11,1329962654,1329962654,1,1,0
80848604@N02,4866,11,1340686192,1340691038,7,1,4846
80848604@N02,4867,11,1340773151,1340783556,15,1,10405
80852176@N00,4868,5,1430900861,1430900861,1,1,0
80874876@N07,4869,11,1471746628,1471762061,28,1,15433
80874876@N07,4870,11,1471838144,1471838144,1,1,0
8095506@N07,4871,1,1285471130,1285497338,61,1,26208
8095506@N07,4872,1,1285993904,1286007674,17,1,13770
8095506@N07,4873,11,1381449941,1381474111,47,1,24170
8095506@N07,4874,11,1382064002,1382086826,34,1,22824
80987905@N00,4875,4,1210503139,1210503139,1,1,0
8100133@N05,4876,11,1413425642,1413425642,1,3,0
8100133@N05,4876,9,1413441184,1413441184,1,3,0
8100133@N05,4876,8,1413432942,1413432942,1,3,0
81066829@N00,4877,11,1300244614,1300244802,4,1,188
81077186@N00,4878,11,1335592968,1335593067,2,1,99
8109191@N05,4879,11,1393486136,1393486136,1,1,0
8110876@N06,4880,12,1414887363,1414887832,11,1,469
81118280@N00,4881,5,1317981331,1317981331,1,1,0
81167176@N00,4882,11,1342712578,1342712578,1,1,0
8116972@N07,4883,4,1417832199,1417832199,1,1,0
8116972@N07,4884,5,1417937759,1417937759,1,1,0
8124939@N07,4885,5,1200193842,1200194089,4,4,247
8124939@N07,4885,4,1200178724,1200178724,1,4,0
8124939@N07,4885,6,1200193769,1200193769,1,4,0
8124939@N07,4885,13,1200180196,1200180205,2,4,9
8128484@N02,4886,6,1423283617,1423283678,5,1,61
8128484@N02,4887,8,1423946960,1423947637,2,1,677
8128484@N02,4888,8,1428394544,1428394544,1,1,0
81291546@N02,4889,4,1357886415,1357886415,1,2,0
81291546@N02,4889,8,1357879287,1357879509,2,2,222
81291546@N02,4890,8,1358067003,1358067003,1,2,0
81291546@N02,4890,11,1358077657,1358077657,1,2,0
81291546@N02,4891,13,1382182828,1382182828,1,2,0
81291546@N02,4891,16,1382156047,1382156047,1,2,0
81291546@N02,4892,2,1382484208,1382484208,1,1,0
81291546@N02,4893,13,1423436447,1423436447,1,1,0
81292745@N00,4894,9,1305245953,1305245953,1,1,0
81322238@N00,4895,13,1273976262,1273977711,10,11,1449
81322238@N00,4895,17,1273976847,1274006811,7,11,29964
81322238@N00,4895,9,1273963358,1273987872,26,11,24514
81322238@N00,4895,1,1273963352,1273986350,4,11,22998
81322238@N00,4895,11,1273968422,1273968444,2,11,22
81322238@N00,4895,2,1273988441,1273992106,4,11,3665
81322238@N00,4895,8,1273970204,1273973135,31,11,2931
81322238@N00,4895,4,1273981220,1273981220,1,11,0
81322238@N00,4895,5,1273969788,1273971203,3,11,1415
81322238@N00,4895,16,1273983242,1273986344,10,11,3102
81322238@N00,4895,10,1273979224,1273980692,7,11,1468
81383122@N05,4896,13,1298421816,1298443943,2,3,22127
81383122@N05,4896,15,1298421455,1298421489,2,3,34
81383122@N05,4896,11,1298446889,1298446889,1,3,0
81483739@N00,4897,11,1398424568,1398424568,1,1,0
81546947@N00,4898,13,1193290859,1193290859,1,1,0
81713706@N05,4899,3,1399094315,1399094320,2,3,5
81713706@N05,4899,2,1399084188,1399084420,4,3,232
81713706@N05,4899,11,1399091274,1399091274,1,3,0
81713706@N05,4900,2,1399617036,1399617042,3,1,6
81713774@N03,4901,8,1445835653,1445835653,1,1,0
81714212@N05,4902,9,1386995444,1386995444,1,1,0
81723626@N00,4903,11,1451263503,1451286250,2,1,22747
81734534@N05,4904,10,1420280126,1420280126,1,1,0
81810968@N02,4905,5,1342855278,1342855282,2,4,4
81810968@N02,4905,8,1342858305,1342858432,3,4,127
81810968@N02,4905,15,1342849278,1342854021,2,4,4743
81810968@N02,4905,13,1342855481,1342855682,7,4,201
81834077@N00,4906,11,1213938142,1213938142,1,1,0
81834077@N00,4907,11,1214190624,1214235383,7,6,44759
81834077@N00,4907,7,1214192159,1214192159,1,6,0
81834077@N00,4907,2,1214197510,1214197605,2,6,95
81834077@N00,4907,4,1214211741,1214214168,3,6,2427
81834077@N00,4907,17,1214225245,1214225245,1,6,0
81834077@N00,4907,8,1214218295,1214220278,3,6,1983
81834077@N00,4908,11,1214540421,1214574123,6,2,33702
81834077@N00,4908,8,1214553823,1214553823,1,2,0
81855582@N00,4909,7,1255150234,1255150234,1,1,0
81855582@N00,4910,1,1255217175,1255220660,3,2,3485
81855582@N00,4910,5,1255227732,1255227732,1,2,0
82031849@N00,4911,10,1357272522,1357272522,1,1,0
82031849@N00,4912,5,1357639244,1357639901,36,1,657
82031849@N00,4913,1,1363575705,1363575725,2,2,20
82031849@N00,4913,16,1363576029,1363576029,1,2,0
82109786@N06,4914,11,1430694923,1430694923,1,1,0
82109786@N06,4915,8,1430874300,1430874300,1,2,0
82109786@N06,4915,17,1430878939,1430880300,2,2,1361
82109786@N06,4916,6,1445056732,1445056732,1,1,0
82109786@N06,4917,2,1461978142,1461979627,2,1,1485
82211889@N00,4918,3,1326360712,1326360712,1,1,0
82211889@N00,4919,2,1326530348,1326531716,5,1,1368
82211889@N00,4920,17,1458986435,1458987108,15,2,673
82211889@N00,4920,3,1458963336,1458964385,11,2,1049
82211889@N00,4921,13,1459060814,1459060815,2,1,1
82211889@N00,4922,3,1459287207,1459290386,13,2,3179
82211889@N00,4922,14,1459290113,1459290116,2,2,3
82211889@N00,4923,17,1459376489,1459376489,1,1,0
82211889@N00,4924,15,1459421056,1459421097,2,1,41
82211889@N00,4925,10,1459509366,1459509366,1,1,0
82335642@N00,4926,8,1258798325,1258798325,1,3,0
82335642@N00,4926,5,1258797446,1258797538,3,3,92
82335642@N00,4926,11,1258795560,1258795560,1,3,0
82335642@N00,4927,13,1258959588,1258959588,1,2,0
82335642@N00,4927,6,1258963234,1258974827,9,2,11593
82418556@N00,4928,5,1357958132,1357959762,4,5,1630
82418556@N00,4928,11,1357913340,1357964732,7,5,51392
82418556@N00,4928,12,1357941218,1357941218,1,5,0
82418556@N00,4928,4,1357947088,1357948983,2,5,1895
82418556@N00,4928,9,1357957719,1357957852,3,5,133
82418556@N00,4929,11,1358000843,1358000843,1,2,0
82418556@N00,4929,13,1358024957,1358024957,1,2,0
82418556@N00,4930,11,1380871165,1380872548,2,1,1383
82432080@N00,4931,3,1269646820,1269646820,1,4,0
82432080@N00,4931,11,1269650419,1269650419,1,4,0
82432080@N00,4931,4,1269647552,1269647552,1,4,0
82432080@N00,4931,14,1269646250,1269646522,2,4,272
82432080@N00,4932,17,1272484360,1272484360,1,1,0
8245538@N06,4933,8,1405743199,1405743199,1,6,0
8245538@N06,4933,5,1405738330,1405738330,1,6,0
8245538@N06,4933,15,1405755649,1405755673,2,6,24
8245538@N06,4933,17,1405755471,1405755652,3,6,181
8245538@N06,4933,11,1405731731,1405765478,6,6,33747
8245538@N06,4933,10,1405756381,1405756395,2,6,14
82484061@N00,4934,15,1224382437,1224382437,1,5,0
82484061@N00,4934,4,1224375170,1224375170,1,5,0
82484061@N00,4934,8,1224390600,1224390600,1,5,0
82484061@N00,4934,11,1224378049,1224403615,2,5,25566
82484061@N00,4934,9,1224375817,1224375817,1,5,0
82507219@N08,4935,2,1377504261,1377504261,1,1,0
82541612@N00,4936,11,1395210879,1395210879,1,1,0
82590976@N06,4937,17,1379164410,1379164410,1,1,0
82619708@N00,4938,11,1364598678,1364598678,1,1,0
82651370@N03,4939,2,1381811999,1381811999,1,1,0
82651989@N00,4940,11,1321495834,1321495834,1,2,0
82651989@N00,4940,9,1321502370,1321502370,1,2,0
82651989@N00,4941,11,1321550882,1321550882,1,1,0
8270001@N04,4942,11,1269531667,1269544198,5,1,12531
82746306@N00,4943,15,1247729498,1247729498,1,2,0
82746306@N00,4943,11,1247716053,1247754538,6,2,38485
8274992@N02,4944,11,1204692745,1204712847,34,1,20102
8280384@N03,4945,15,1300077327,1300077327,1,2,0
8280384@N03,4945,17,1300070178,1300070178,1,2,0
8280384@N03,4946,13,1300178741,1300178741,1,4,0
8280384@N03,4946,15,1300160313,1300160313,1,4,0
8280384@N03,4946,17,1300160558,1300160558,1,4,0
8280384@N03,4946,11,1300183557,1300183557,1,4,0
82841979@N04,4947,9,1344134858,1344134858,1,1,0
82898228@N00,4948,1,1471653293,1471653293,1,1,0
82939271@N00,4949,11,1279686091,1279686091,1,1,0
83028497@N00,4950,5,1415331156,1415331156,1,1,0
83035350@N06,4951,11,1362815740,1362815740,1,2,0
83035350@N06,4951,13,1362797576,1362797576,1,2,0
83038235@N08,4952,11,1444729639,1444731006,2,1,1367
83055639@N00,4953,11,1293828327,1293839657,2,1,11330
83106697@N00,4954,13,1354931180,1354931180,1,1,0
8311873@N03,4955,11,1350422171,1350423412,2,1,1241
8311873@N03,4956,14,1351480990,1351480990,1,3,0
8311873@N03,4956,11,1351481265,1351481265,1,3,0
8311873@N03,4956,4,1351481145,1351481145,1,3,0
8311873@N03,4957,5,1363726926,1363726926,1,1,0
8311873@N03,4958,17,1423284204,1423284204,1,1,0
83133472@N05,4959,11,1372415716,1372415716,1,1,0
83133472@N05,4960,8,1374989277,1374989277,1,1,0
83133472@N05,4961,8,1376821034,1376821034,1,1,0
83133472@N05,4962,11,1394189445,1394189445,1,1,0
8313989@N05,4963,11,1194523581,1194523581,1,1,0
83167112@N06,4964,11,1389239226,1389239226,1,1,0
83167112@N06,4965,11,1416209331,1416209331,1,1,0
83167112@N06,4966,11,1462874575,1462874575,1,1,0
83206670@N05,4967,11,1314744342,1314744487,2,2,145
83206670@N05,4967,16,1314749414,1314749443,2,2,29
8327824@N05,4968,1,1354781795,1354787090,11,1,5295
8327824@N05,4969,1,1356667726,1356667726,1,1,0
83286805@N00,4970,5,1320732752,1320732752,1,1,0
83286805@N00,4971,11,1321750051,1321750051,1,1,0
83302510@N05,4972,13,1356419127,1356423123,3,1,3996
83400109@N08,4973,12,1464161433,1464161468,2,7,35
83400109@N08,4973,9,1464143902,1464143932,2,7,30
83400109@N08,4973,3,1464142453,1464142453,1,7,0
83400109@N08,4973,1,1464159937,1464159937,1,7,0
83400109@N08,4973,5,1464152398,1464152398,1,7,0
83400109@N08,4973,2,1464164513,1464164545,2,7,32
83400109@N08,4973,4,1464137151,1464137151,1,7,0
8348059@N02,4974,15,1300754962,1300754962,1,12,0
8348059@N02,4974,13,1300755206,1300759847,10,12,4641
8348059@N02,4974,4,1300751975,1300752110,2,12,135
8348059@N02,4974,2,1300750756,1300751064,3,12,308
8348059@N02,4974,7,1300749612,1300749612,1,12,0
8348059@N02,4974,5,1300764400,1300765638,3,12,1238
8348059@N02,4974,11,1300744439,1300770779,10,12,26340
8348059@N02,4974,14,1300744860,1300749072,2,12,4212
8348059@N02,4974,10,1300753744,1300753810,2,12,66
8348059@N02,4974,3,1300747370,1300747558,5,12,188
8348059@N02,4974,8,1300762957,1300763733,6,12,776
8348059@N02,4974,17,1300753416,1300755115,6,12,1699
83657528@N00,4975,3,1299973864,1299973864,1,2,0
83657528@N00,4975,11,1299967156,1299967156,1,2,0
8373144@N05,4976,13,1201917043,1201917619,2,2,576
8373144@N05,4976,11,1201911082,1201913830,3,2,2748
83794242@N07,4977,2,1435736250,1435736250,1,2,0
83794242@N07,4977,9,1435739932,1435739932,1,2,0
83794242@N07,4978,11,1449359678,1449359678,1,1,0
83794242@N07,4979,11,1449408887,1449409059,2,1,172
83806278@N00,4980,9,1316664557,1316664557,1,1,0
83825280@N06,4981,8,1348561796,1348561796,1,1,0
83825280@N06,4982,1,1354484386,1354485440,2,1,1054
83825280@N06,4983,17,1363247373,1363247373,1,1,0
83825280@N06,4984,6,1365243331,1365243331,1,1,0
8384026@N07,4985,6,1288938600,1288938600,1,1,0
83848625@N00,4986,5,1456044091,1456044091,1,2,0
83848625@N00,4986,17,1456049069,1456049069,1,2,0
83848625@N00,4987,1,1456181168,1456181168,1,3,0
83848625@N00,4987,17,1456193650,1456194073,3,3,423
83848625@N00,4987,2,1456187696,1456187696,1,3,0
84013956@N00,4988,11,1325074549,1325074549,1,1,0
84013956@N00,4989,13,1358060311,1358060311,1,2,0
84013956@N00,4989,17,1358059967,1358059973,2,2,6
8404074@N04,4990,11,1215214604,1215214604,1,1,0
84087186@N00,4991,11,1361998342,1361998342,1,1,0
84108876@N00,4992,17,1193978006,1193978006,1,3,0
84108876@N00,4992,11,1193985738,1193986230,4,3,492
84108876@N00,4992,5,1193972104,1193972104,1,3,0
84108876@N00,4993,1,1209368062,1209368062,1,2,0
84108876@N00,4993,11,1209370896,1209370902,2,2,6
84108876@N00,4994,16,1255468606,1255468606,1,1,0
84108876@N00,4995,16,1255518590,1255518766,2,1,176
84169004@N00,4996,1,1228439040,1228439040,1,1,0
84169004@N00,4997,1,1228700940,1228700940,1,1,0
84169004@N00,4998,16,1228870980,1228871520,4,1,540
84169004@N00,4999,5,1386068694,1386068694,1,1,0
84221632@N00,5000,5,1381916036,1381916036,1,1,0
84221632@N00,5001,11,1382006174,1382006174,1,3,0
84221632@N00,5001,8,1382010375,1382010490,2,3,115
84221632@N00,5001,5,1382008888,1382008888,1,3,0
84221632@N00,5002,11,1382286527,1382286588,2,1,61
84221632@N00,5003,11,1423021545,1423021545,1,1,0
84221632@N00,5004,17,1423489008,1423489008,1,1,0
84227486@N02,5005,16,1354831410,1354831410,1,3,0
84227486@N02,5005,1,1354831644,1354837952,14,3,6308
84227486@N02,5005,5,1354839968,1354839968,1,3,0
84227486@N02,5006,13,1354926753,1354926753,1,1,0
84227486@N02,5007,2,1365982597,1365982597,1,5,0
84227486@N02,5007,17,1365987350,1365987350,1,5,0
84227486@N02,5007,1,1365987940,1365987946,2,5,6
84227486@N02,5007,5,1365988022,1365988022,1,5,0
84227486@N02,5007,8,1365990865,1365990865,1,5,0
84227486@N02,5008,13,1366371525,1366371530,2,1,5
84227486@N02,5009,8,1374482418,1374482646,2,1,228
84227486@N02,5010,1,1428911728,1428911728,1,1,0
84531937@N00,5011,5,1309411054,1309411054,1,1,0
8459320@N03,5012,2,1246434511,1246434511,1,1,0
8459320@N03,5013,2,1246495037,1246507350,2,3,12313
8459320@N03,5013,11,1246535060,1246537773,2,3,2713
8459320@N03,5013,5,1246508185,1246508355,2,3,170
8459320@N03,5014,13,1246872537,1246873503,2,1,966
84697271@N00,5015,11,1294359622,1294364979,2,4,5357
84697271@N00,5015,13,1294363483,1294364129,3,4,646
84697271@N00,5015,10,1294362841,1294362841,1,4,0
84697271@N00,5015,17,1294363161,1294363167,2,4,6
84697271@N00,5016,11,1389509276,1389509276,1,1,0
8472024@N08,5017,11,1230535161,1230535161,1,1,0
84765974@N00,5018,11,1464588641,1464588641,1,1,0
84861343@N00,5019,11,1370512077,1370512501,2,1,424
84861343@N00,5020,8,1423472166,1423472166,1,1,0
84861343@N00,5021,15,1423546600,1423546600,1,1,0
84861343@N00,5022,11,1423717433,1423717433,1,1,0
84897223@N00,5023,5,1434016152,1434016318,2,1,166
84968958@N00,5024,3,1298410462,1298410462,1,1,0
84987970@N00,5025,14,1226645781,1226645781,1,4,0
84987970@N00,5025,8,1226651783,1226651797,2,4,14
84987970@N00,5025,4,1226650414,1226650932,5,4,518
84987970@N00,5025,11,1226638881,1226662049,23,4,23168
8502118@N08,5026,10,1419986594,1419986594,1,2,0
8502118@N08,5026,13,1419988648,1419988648,1,2,0
85095974@N05,5027,2,1374659976,1374663769,8,1,3793
85095974@N05,5028,11,1402669095,1402669101,2,1,6
85095974@N05,5029,11,1470482069,1470482069,1,1,0
85095974@N05,5030,13,1470538786,1470538838,3,5,52
85095974@N05,5030,11,1470527307,1470528126,29,5,819
85095974@N05,5030,3,1470524255,1470524255,1,5,0
85095974@N05,5030,5,1470533302,1470537060,20,5,3758
85095974@N05,5030,7,1470524127,1470524133,2,5,6
85095974@N05,5031,13,1470711424,1470711445,3,4,21
85095974@N05,5031,17,1470710138,1470710138,1,4,0
85095974@N05,5031,3,1470697320,1470698795,17,4,1475
85095974@N05,5031,1,1470705259,1470705259,1,4,0
85095974@N05,5032,10,1470901762,1470901772,2,4,10
85095974@N05,5032,11,1470898780,1470898805,2,4,25
85095974@N05,5032,2,1470900644,1470900656,4,4,12
85095974@N05,5032,4,1470901548,1470901844,14,4,296
85121305@N08,5033,13,1355986499,1355986690,2,3,191
85121305@N08,5033,5,1355988825,1355988825,1,3,0
85121305@N08,5033,11,1355975441,1355975441,1,3,0
85121305@N08,5034,4,1356077332,1356077332,1,3,0
85121305@N08,5034,11,1356076307,1356076444,2,3,137
85121305@N08,5034,10,1356056453,1356056453,1,3,0
85121305@N08,5035,15,1358163800,1358163800,1,1,0
85121305@N08,5036,2,1359370078,1359370078,1,1,0
8526081@N08,5037,2,1278050763,1278050763,1,3,0
8526081@N08,5037,11,1278028585,1278028585,1,3,0
8526081@N08,5037,7,1278029507,1278029507,1,3,0
8526919@N08,5038,11,1461757127,1461757127,1,1,0
85288320@N00,5039,17,1312181207,1312181269,2,6,62
85288320@N00,5039,9,1312191500,1312192321,3,6,821
85288320@N00,5039,3,1312186347,1312186488,4,6,141
85288320@N00,5039,2,1312187186,1312187186,1,6,0
85288320@N00,5039,15,1312181297,1312181297,1,6,0
85288320@N00,5039,4,1312182478,1312185350,3,6,2872
8530749@N08,5040,11,1349273702,1349273702,1,1,0
85433978@N00,5041,11,1449989500,1449989500,1,1,0
85485667@N00,5042,8,1242300986,1242300986,1,1,0
85509341@N00,5043,4,1392779321,1392779321,1,2,0
85509341@N00,5043,11,1392773304,1392809809,5,2,36505
85509341@N00,5044,1,1435741307,1435741307,1,5,0
85509341@N00,5044,2,1435729519,1435729552,2,5,33
85509341@N00,5044,11,1435715044,1435753968,3,5,38924
85509341@N00,5044,9,1435736801,1435736801,1,5,0
85509341@N00,5044,5,1435750012,1435750860,2,5,848
85509341@N00,5045,9,1435916147,1435916147,1,1,0
85543411@N08,5046,1,1426473347,1426473347,1,1,0
8556323@N05,5047,11,1471836125,1471856044,4,1,19919
8562768@N07,5048,2,1351239036,1351239037,3,1,1
85631149@N00,5049,11,1393307954,1393325418,5,4,17464
85631149@N00,5049,1,1393299726,1393299740,2,4,14
85631149@N00,5049,13,1393291019,1393291019,1,4,0
85631149@N00,5049,17,1393291211,1393291700,2,4,489
85632208@N03,5050,13,1329237564,1329237564,1,2,0
85632208@N03,5050,1,1329229050,1329229170,2,2,120
85639028@N02,5051,8,1386132411,1386132411,1,2,0
85639028@N02,5051,11,1386158557,1386159418,2,2,861
85639028@N02,5052,11,1414191141,1414191141,1,1,0
85644119@N00,5053,11,1198963981,1199008627,5,3,44646
85644119@N00,5053,16,1198966112,1198966135,2,3,23
85644119@N00,5053,8,1198988495,1198988495,1,3,0
85644119@N00,5054,11,1213135651,1213180507,6,7,44856
85644119@N00,5054,2,1213155283,1213155283,1,7,0
85644119@N00,5054,4,1213153560,1213153560,1,7,0
85644119@N00,5054,10,1213174857,1213174857,1,7,0
85644119@N00,5054,5,1213150855,1213150855,1,7,0
85644119@N00,5054,13,1213173709,1213174178,2,7,469
85644119@N00,5054,8,1213162260,1213163897,4,7,1637
85644119@N00,5055,11,1228272654,1228272654,1,1,0
85644119@N00,5056,11,1228800581,1228800581,1,1,0
85644119@N00,5057,11,1242341670,1242341670,1,1,0
85644119@N00,5058,11,1261912542,1261912542,1,9,0
85644119@N00,5058,15,1261875648,1261875648,1,9,0
85644119@N00,5058,2,1261865414,1261869455,2,9,4041
85644119@N00,5058,16,1261891948,1261891948,1,9,0
85644119@N00,5058,7,1261866195,1261866195,1,9,0
85644119@N00,5058,4,1261893706,1261893706,1,9,0
85644119@N00,5058,10,1261906917,1261906917,1,9,0
85644119@N00,5058,5,1261897992,1261897992,1,9,0
85644119@N00,5058,13,1261876112,1261876710,2,9,598
85644119@N00,5059,3,1270076700,1270076700,1,1,0
85644119@N00,5060,11,1307574529,1307574692,4,6,163
85644119@N00,5060,13,1307599120,1307600104,2,6,984
85644119@N00,5060,16,1307592834,1307592842,2,6,8
85644119@N00,5060,17,1307617591,1307617720,2,6,129
85644119@N00,5060,8,1307611785,1307611927,2,6,142
85644119@N00,5060,4,1307579997,1307579997,1,6,0
85644119@N00,5061,16,1324249842,1324249842,1,10,0
85644119@N00,5061,13,1324278349,1324278506,2,10,157
85644119@N00,5061,8,1324264680,1324265245,3,10,565
85644119@N00,5061,9,1324245131,1324245131,1,10,0
85644119@N00,5061,11,1324243333,1324286010,5,10,42677
85644119@N00,5061,1,1324244780,1324244780,1,10,0
85644119@N00,5061,4,1324255237,1324255533,2,10,296
85644119@N00,5061,10,1324276494,1324276494,1,10,0
85644119@N00,5061,3,1324258094,1324258094,1,10,0
85644119@N00,5061,5,1324262617,1324274197,4,10,11580
85644119@N00,5062,9,1337039014,1337039014,1,1,0
85644119@N00,5063,8,1465442507,1465442507,1,1,0
8567104@N05,5064,11,1271379925,1271395010,3,1,15085
85722662@N00,5065,2,1298883866,1298883866,1,1,0
85744958@N00,5066,6,1235911320,1235911320,1,1,0
85744958@N00,5067,6,1236067114,1236070855,3,1,3741
85744958@N00,5068,6,1236137714,1236152946,3,1,15232
85744958@N00,5069,6,1236230437,1236230585,4,1,148
85744958@N00,5070,6,1286011731,1286012138,5,2,407
85744958@N00,5070,8,1286031606,1286031632,2,2,26
85744958@N00,5071,6,1305527310,1305546037,5,1,18727
85744958@N00,5072,6,1305795277,1305797574,8,1,2297
85744958@N00,5073,6,1319268856,1319270528,7,2,1672
85744958@N00,5073,15,1319276157,1319278383,3,2,2226
85744958@N00,5074,8,1328089636,1328089636,1,1,0
85744958@N00,5075,15,1328136634,1328140026,4,1,3392
85744958@N00,5076,9,1328172037,1328172037,1,2,0
85744958@N00,5076,1,1328175083,1328175083,1,2,0
85744958@N00,5077,4,1359337895,1359337895,1,1,0
8576764@N02,5078,11,1409711453,1409711453,1,4,0
8576764@N02,5078,5,1409723419,1409723854,13,4,435
8576764@N02,5078,3,1409734416,1409740766,29,4,6350
8576764@N02,5078,2,1409731281,1409731288,3,4,7
85813749@N00,5079,10,1418902080,1418903228,6,5,1148
85813749@N00,5079,13,1418884109,1418884109,1,5,0
85813749@N00,5079,15,1418874371,1418874371,1,5,0
85813749@N00,5079,11,1418860783,1418899214,4,5,38431
85813749@N00,5079,8,1418879886,1418879969,2,5,83
85843151@N00,5080,8,1360320151,1360320151,1,7,0
85843151@N00,5080,13,1360322208,1360322208,1,7,0
85843151@N00,5080,11,1360276723,1360292795,2,7,16072
85843151@N00,5080,16,1360298176,1360298176,1,7,0
85843151@N00,5080,17,1360319437,1360319437,1,7,0
85843151@N00,5080,5,1360278363,1360278363,1,7,0
85843151@N00,5080,6,1360318178,1360318178,1,7,0
85855667@N00,5081,10,1309401902,1309401902,1,2,0
85855667@N00,5081,2,1309393945,1309393945,1,2,0
85856616@N05,5082,7,1354188728,1354188728,1,6,0
85856616@N05,5082,11,1354175562,1354176696,7,6,1134
85856616@N05,5082,17,1354191832,1354191832,1,6,0
85856616@N05,5082,2,1354185769,1354188827,4,6,3058
85856616@N05,5082,13,1354192035,1354192035,2,6,0
85856616@N05,5082,12,1354185758,1354188211,15,6,2453
85859494@N02,5083,13,1369478127,1369478223,3,1,96
85859494@N02,5084,7,1369702659,1369702683,4,1,24
85864407@N08,5085,13,1384514631,1384516757,3,2,2126
85864407@N08,5085,15,1384517646,1384517646,1,2,0
85864407@N08,5086,4,1384911976,1384911976,1,3,0
85864407@N08,5086,8,1384917398,1384932471,3,3,15073
85864407@N08,5086,7,1384904939,1384904939,1,3,0
85879323@N08,5087,8,1450432472,1450432652,2,1,180
85882671@N00,5088,15,1225609203,1225609203,1,1,0
85882671@N00,5089,2,1308028884,1308028884,1,1,0
85882671@N00,5090,15,1317113202,1317113202,1,1,0
85882671@N00,5091,15,1356299016,1356299016,1,1,0
85882671@N00,5092,13,1356683145,1356683195,2,1,50
85882671@N00,5093,17,1356841334,1356844685,6,3,3351
85882671@N00,5093,13,1356839717,1356852983,11,3,13266
85882671@N00,5093,15,1356841884,1356841986,7,3,102
85882671@N00,5094,13,1356936766,1356936863,6,1,97
85882671@N00,5095,13,1388817310,1388817345,2,1,35
85893846@N06,5096,5,1345880854,1345880854,1,1,0
85912588@N00,5097,7,1353482617,1353482617,1,1,0
8592217@N08,5098,2,1237866099,1237866099,1,3,0
8592217@N08,5098,11,1237861529,1237884470,2,3,22941
8592217@N08,5098,3,1237872590,1237872590,1,3,0
85977134@N00,5099,11,1356766898,1356766898,1,1,0
85979850@N00,5100,5,1243472059,1243472059,1,6,0
85979850@N00,5100,11,1243458899,1243459538,5,6,639
85979850@N00,5100,1,1243459758,1243459939,5,6,181
85979850@N00,5100,17,1243461088,1243461126,3,6,38
85979850@N00,5100,15,1243461306,1243461447,3,6,141
85979850@N00,5100,8,1243471292,1243471391,4,6,99
86001309@N00,5101,11,1335787366,1335827278,26,1,39912
86001309@N00,5102,11,1359193036,1359193036,1,2,0
86001309@N00,5102,9,1359195664,1359195664,1,2,0
86061580@N00,5103,13,1290767775,1290768469,12,1,694
86061580@N00,5104,11,1290820071,1290820071,1,1,0
86111910@N03,5105,11,1348217443,1348224885,2,1,7442
86275327@N00,5106,12,1209534525,1209534525,1,1,0
86275327@N00,5107,11,1209798231,1209798231,1,1,0
86285103@N00,5108,13,1260596597,1260599525,8,3,2928
86285103@N00,5108,12,1260587058,1260587112,6,3,54
86285103@N00,5108,11,1260595711,1260595725,4,3,14
86285103@N00,5109,17,1260931631,1260931631,2,3,0
86285103@N00,5109,5,1260931829,1260934229,6,3,2400
86285103@N00,5109,8,1260935749,1260936112,12,3,363
8638605@N02,5110,6,1188456206,1188456206,1,1,0
8638605@N02,5111,4,1275725570,1275726324,15,7,754
8638605@N02,5111,11,1275729521,1275730735,8,7,1214
8638605@N02,5111,14,1275727684,1275728817,22,7,1133
8638605@N02,5111,15,1275722622,1275722622,1,7,0
8638605@N02,5111,13,1275722865,1275722865,1,7,0
8638605@N02,5111,5,1275724262,1275724911,17,7,649
8638605@N02,5111,2,1275726638,1275727363,5,7,725
8638605@N02,5112,15,1275806958,1275809240,10,4,2282
8638605@N02,5112,1,1275819140,1275820423,21,4,1283
8638605@N02,5112,11,1275805994,1275821444,6,4,15450
8638605@N02,5112,8,1275815412,1275815412,1,4,0
8638605@N02,5113,5,1275897094,1275897094,1,4,0
8638605@N02,5113,11,1275887023,1275897884,3,4,10861
8638605@N02,5113,16,1275887611,1275890623,11,4,3012
8638605@N02,5113,13,1275892730,1275893341,3,4,611
8638605@N02,5114,15,1275962991,1275963423,2,2,432
8638605@N02,5114,11,1275961639,1275961667,2,2,28
86434226@N00,5115,5,1360635062,1360635062,1,1,0
86434226@N00,5116,1,1458968253,1458968253,1,1,0
86459399@N00,5117,2,1255485456,1255485461,2,1,5
86459399@N00,5118,2,1275209641,1275209907,3,1,266
86459399@N00,5119,4,1275285465,1275291283,2,1,5818
86459399@N00,5120,2,1291599670,1291627223,10,1,27553
86459399@N00,5121,1,1296366780,1296369118,4,1,2338
86459399@N00,5122,2,1318742771,1318742777,2,4,6
86459399@N00,5122,1,1318734603,1318736285,2,4,1682
86459399@N00,5122,5,1318756054,1318756054,1,4,0
86459399@N00,5122,13,1318758683,1318758685,2,4,2
86459399@N00,5123,1,1318833358,1318833358,1,1,0
86459399@N00,5124,17,1319096575,1319097368,2,3,793
86459399@N00,5124,15,1319097719,1319097722,2,3,3
86459399@N00,5124,11,1319093036,1319093044,3,3,8
86459399@N00,5125,13,1350281697,1350281700,2,1,3
86459399@N00,5126,1,1350464327,1350464327,1,1,0
86459399@N00,5127,1,1367026023,1367026023,2,1,0
86459399@N00,5128,13,1367145892,1367145899,4,1,7
86476099@N00,5129,13,1261305123,1261305123,1,1,0
86476099@N00,5130,12,1261352310,1261352310,1,4,0
86476099@N00,5130,11,1261356279,1261356397,2,4,118
86476099@N00,5130,14,1261348461,1261348461,1,4,0
86476099@N00,5130,13,1261338972,1261338972,1,4,0
86482004@N00,5131,11,1337582781,1337582927,7,2,146
86482004@N00,5131,2,1337589148,1337589148,1,2,0
86482004@N00,5132,6,1337742118,1337742118,1,4,0
86482004@N00,5132,17,1337737701,1337737879,6,4,178
86482004@N00,5132,13,1337740355,1337740503,6,4,148
86482004@N00,5132,10,1337737595,1337737634,2,4,39
86493735@N00,5133,11,1298466001,1298466001,1,1,0
8657772@N03,5134,8,1353060077,1353060077,1,1,0
86660260@N03,5135,2,1406085649,1406085649,1,1,0
86684413@N00,5136,14,1451002526,1451002535,2,14,9
86684413@N00,5136,5,1451014199,1451014339,2,14,140
86684413@N00,5136,13,1451020937,1451021061,2,14,124
86684413@N00,5136,3,1451002254,1451037929,8,14,35675
86684413@N00,5136,17,1451021322,1451021637,2,14,315
86684413@N00,5136,10,1451022529,1451022585,4,14,56
86684413@N00,5136,8,1451014678,1451014840,2,14,162
86684413@N00,5136,1,1451009164,1451013052,8,14,3888
86684413@N00,5136,2,1450999038,1450999878,5,14,840
86684413@N00,5136,6,1451018088,1451018088,1,14,0
86684413@N00,5136,15,1451021849,1451021849,1,14,0
86684413@N00,5136,9,1451009848,1451009848,1,14,0
86684413@N00,5136,11,1451007120,1451007120,1,14,0
86684413@N00,5136,4,1451034926,1451035260,4,14,334
86694404@N00,5137,17,1244688381,1244688381,1,3,0
86694404@N00,5137,11,1244675570,1244680219,2,3,4649
86694404@N00,5137,1,1244677216,1244677216,1,3,0
86719158@N00,5138,11,1298699903,1298699903,1,4,0
86719158@N00,5138,17,1298701073,1298708236,7,4,7163
86719158@N00,5138,15,1298701329,1298701799,5,4,470
86719158@N00,5138,13,1298701868,1298702064,4,4,196
86719158@N00,5139,11,1299123651,1299123651,1,2,0
86719158@N00,5139,5,1299134326,1299134974,4,2,648
86787360@N00,5140,11,1412896577,1412897305,4,5,728
86787360@N00,5140,17,1412902873,1412904949,9,5,2076
86787360@N00,5140,5,1412909053,1412909125,4,5,72
86787360@N00,5140,4,1412907052,1412907231,4,5,179
86787360@N00,5140,2,1412897716,1412899279,7,5,1563
86864767@N00,5141,1,1210789412,1210789412,1,1,0
86881825@N00,5142,12,1212046148,1212046148,1,1,0
86881825@N00,5143,8,1227067135,1227067135,1,2,0
86881825@N00,5143,5,1227067738,1227067738,1,2,0
86932086@N00,5144,11,1450936258,1450950198,3,1,13940
86965856@N00,5145,3,1190987724,1190991150,3,1,3426
86965856@N00,5146,3,1191039524,1191040476,4,1,952
86965856@N00,5147,3,1207453066,1207466077,10,1,13011
86965856@N00,5148,3,1217749015,1217749015,1,1,0
86965856@N00,5149,3,1273328730,1273334042,2,1,5312
86965856@N00,5150,3,1304685970,1304699157,5,1,13187
86965856@N00,5151,3,1305014004,1305014031,2,1,27
8713148@N03,5152,11,1190956999,1190956999,1,1,0
87167216@N00,5153,9,1210065238,1210065932,5,1,694
87167216@N00,5154,9,1210313287,1210313287,1,2,0
87167216@N00,5154,16,1210312826,1210312826,1,2,0
87173471@N00,5155,16,1323218913,1323218913,1,5,0
87173471@N00,5155,3,1323218863,1323218863,1,5,0
87173471@N00,5155,11,1323219033,1323219033,1,5,0
87173471@N00,5155,12,1323218855,1323218855,1,5,0
87173471@N00,5155,17,1323219060,1323219114,3,5,54
8721758@N06,5156,11,1273882788,1273882788,1,1,0
8721758@N06,5157,1,1274016815,1274016815,1,1,0
87261736@N00,5158,10,1443583820,1443583820,1,1,0
87266192@N00,5159,3,1228288303,1228288331,2,2,28
87266192@N00,5159,7,1228277658,1228286271,4,2,8613
87267387@N00,5160,15,1230716335,1230716335,1,1,0
8729032@N06,5161,7,1258330072,1258330769,3,7,697
8729032@N06,5161,17,1258334067,1258334394,8,7,327
8729032@N06,5161,13,1258334524,1258334524,1,7,0
8729032@N06,5161,3,1258327824,1258328446,26,7,622
8729032@N06,5161,2,1258331658,1258331780,5,7,122
8729032@N06,5161,11,1258326786,1258326839,3,7,53
8729032@N06,5161,8,1258346997,1258347274,4,7,277
8729032@N06,5162,7,1258590716,1258590987,7,4,271
8729032@N06,5162,11,1258608011,1258608011,1,4,0
8729032@N06,5162,13,1258595274,1258598933,10,4,3659
8729032@N06,5162,3,1258587155,1258587165,2,4,10
8729032@N06,5163,4,1287960352,1287960352,1,3,0
8729032@N06,5163,3,1287959300,1287959306,2,3,6
8729032@N06,5163,7,1287959318,1287960285,22,3,967
8729032@N06,5164,1,1288220800,1288220930,6,5,130
8729032@N06,5164,5,1288226916,1288227618,19,5,702
8729032@N06,5164,4,1288224752,1288224801,3,5,49
8729032@N06,5164,8,1288227737,1288230758,29,5,3021
8729032@N06,5164,11,1288216568,1288216926,6,5,358
8729032@N06,5165,1,1363884941,1363888703,5,1,3762
8729032@N06,5166,14,1373242063,1373242096,2,4,33
8729032@N06,5166,7,1373241907,1373242597,11,4,690
8729032@N06,5166,11,1373238527,1373238803,2,4,276
8729032@N06,5166,3,1373242025,1373242572,14,4,547
8729032@N06,5167,4,1387152597,1387152612,2,7,15
8729032@N06,5167,15,1387157961,1387158410,5,7,449
8729032@N06,5167,11,1387145271,1387146056,5,7,785
8729032@N06,5167,17,1387158292,1387158318,4,7,26
8729032@N06,5167,3,1387148422,1387148432,2,7,10
8729032@N06,5167,13,1387158260,1387163086,34,7,4826
8729032@N06,5167,6,1387180633,1387184250,21,7,3617
8729032@N06,5168,14,1387408699,1387409457,32,5,758
8729032@N06,5168,11,1387429325,1387429328,3,5,3
8729032@N06,5168,17,1387427190,1387429307,10,5,2117
8729032@N06,5168,3,1387406813,1387410465,26,5,3652
8729032@N06,5168,8,1387414340,1387425989,66,5,11649
8729032@N06,5169,1,1418168882,1418168906,3,9,24
8729032@N06,5169,15,1418177462,1418181181,4,9,3719
8729032@N06,5169,17,1418177335,1418181236,32,9,3901
8729032@N06,5169,2,1418168530,1418168585,8,9,55
8729032@N06,5169,13,1418178664,1418187644,13,9,8980
8729032@N06,5169,16,1418168729,1418174773,23,9,6044
8729032@N06,5169,6,1418203564,1418207348,9,9,3784
8729032@N06,5169,3,1418163306,1418168485,23,9,5179
8729032@N06,5169,9,1418169078,1418171215,27,9,2137
8729032@N06,5170,5,1418258859,1418265457,72,6,6598
8729032@N06,5170,9,1418253929,1418254912,6,6,983
8729032@N06,5170,1,1418251887,1418258578,29,6,6691
8729032@N06,5170,8,1418260428,1418267625,69,6,7197
8729032@N06,5170,14,1418272378,1418272627,36,6,249
8729032@N06,5170,11,1418251897,1418252000,7,6,103
8729032@N06,5171,13,1430021545,1430021551,2,2,6
8729032@N06,5171,1,1430021141,1430021145,2,2,4
87415005@N02,5172,17,1417500885,1417500982,9,5,97
87415005@N02,5172,10,1417501402,1417501408,3,5,6
87415005@N02,5172,11,1417477738,1417477739,2,5,1
87415005@N02,5172,2,1417482643,1417482643,1,5,0
87415005@N02,5172,15,1417500518,1417500758,2,5,240
87506761@N00,5173,9,1336202457,1336202457,1,5,0
87506761@N00,5173,8,1336205685,1336207389,3,5,1704
87506761@N00,5173,11,1336200776,1336213829,3,5,13053
87506761@N00,5173,13,1336212286,1336212286,1,5,0
87506761@N00,5173,5,1336204280,1336204280,1,5,0
87507703@N04,5174,11,1356576545,1356577714,6,7,1169
87507703@N04,5174,8,1356584361,1356587626,15,7,3265
87507703@N04,5174,13,1356591197,1356591988,6,7,791
87507703@N04,5174,17,1356592286,1356592306,2,7,20
87507703@N04,5174,9,1356579707,1356579707,1,7,0
87507703@N04,5174,15,1356592393,1356592393,1,7,0
87507703@N04,5174,5,1356582646,1356582826,2,7,180
87521042@N00,5175,4,1363133302,1363133302,1,1,0
87549191@N00,5176,11,1339114990,1339114990,1,1,0
8756721@N06,5177,16,1301723552,1301723552,1,1,0
8760137@N08,5178,14,1189555714,1189569194,6,1,13480
8760137@N08,5179,14,1190892372,1190892372,1,1,0
87635169@N02,5180,11,1330125144,1330125144,1,1,0
87635169@N02,5181,11,1457757013,1457757013,1,1,0
87652302@N00,5182,16,1255462978,1255462978,1,1,0
8769311@N02,5183,2,1304555300,1304555300,1,1,0
8769311@N02,5184,2,1379896824,1379896824,1,1,0
87725544@N08,5185,13,1347853324,1347853324,1,2,0
87725544@N08,5185,8,1347851846,1347851846,1,2,0
8773866@N07,5186,15,1232847985,1232847985,1,1,0
87782851@N05,5187,16,1353724647,1353724647,1,1,0
87822393@N03,5188,2,1371044195,1371044195,1,1,0
87854506@N04,5189,13,1355483157,1355483406,4,1,249
87895332@N08,5190,11,1407961151,1407961151,1,1,0
87895332@N08,5191,6,1413964532,1413964532,1,2,0
87895332@N08,5191,17,1413961806,1413961806,1,2,0
87953089@N04,5192,15,1390562520,1390562520,1,2,0
87953089@N04,5192,10,1390562508,1390562512,2,2,4
87962106@N00,5193,8,1322030400,1322030400,1,1,0
8803306@N02,5194,13,1235881329,1235881329,1,5,0
8803306@N02,5194,11,1235861965,1235861965,1,5,0
8803306@N02,5194,15,1235877304,1235877304,1,5,0
8803306@N02,5194,8,1235890646,1235890646,1,5,0
8803306@N02,5194,2,1235868308,1235868308,1,5,0
8803306@N02,5195,12,1265504821,1265504821,1,1,0
8803306@N02,5196,11,1331095166,1331095166,1,2,0
8803306@N02,5196,1,1331084109,1331084109,1,2,0
88095899@N05,5197,10,1335223894,1335223894,1,2,0
88095899@N05,5197,9,1335228768,1335228768,1,2,0
88095899@N05,5198,9,1363389937,1363390208,2,2,271
88095899@N05,5198,11,1363388170,1363388552,4,2,382
88095899@N05,5199,13,1366171422,1366171422,1,1,0
88095899@N05,5200,8,1392783685,1392783685,1,2,0
88095899@N05,5200,10,1392773516,1392773553,2,2,37
88095899@N05,5201,13,1394763326,1394763326,1,1,0
88097009@N07,5202,11,1418383055,1418383055,1,1,0
88097009@N07,5203,17,1418607374,1418607374,1,2,0
88097009@N07,5203,8,1418604499,1418604628,3,2,129
88158593@N00,5204,2,1305699843,1305699843,1,5,0
88158593@N00,5204,1,1305695335,1305723542,2,5,28207
88158593@N00,5204,11,1305689962,1305721349,5,5,31387
88158593@N00,5204,9,1305706395,1305706514,2,5,119
88158593@N00,5204,5,1305718778,1305718778,1,5,0
88158593@N00,5205,4,1334558424,1334558424,1,3,0
88158593@N00,5205,11,1334548105,1334572124,3,3,24019
88158593@N00,5205,15,1334564718,1334564718,1,3,0
88172175@N00,5206,11,1219375704,1219393083,94,1,17379
88172175@N00,5207,11,1219544950,1219544950,1,1,0
88201963@N00,5208,17,1444984173,1444984231,4,3,58
88201963@N00,5208,8,1444970286,1444971211,2,3,925
88201963@N00,5208,11,1444964350,1444990777,3,3,26427
88264442@N00,5209,11,1321436665,1321436665,1,1,0
88322185@N00,5210,4,1195719641,1195719951,2,1,310
8838492@N05,5211,15,1198132901,1198132901,1,5,0
8838492@N05,5211,8,1198135587,1198138173,8,5,2586
8838492@N05,5211,5,1198136543,1198136543,1,5,0
8838492@N05,5211,13,1198133238,1198133238,1,5,0
8838492@N05,5211,17,1198132382,1198132531,5,5,149
88504071@N00,5212,15,1211428681,1211428681,1,2,0
88504071@N00,5212,10,1211429039,1211429039,1,2,0
88504071@N00,5213,11,1222327531,1222327531,1,1,0
88504071@N00,5214,8,1222395523,1222397007,2,3,1484
88504071@N00,5214,16,1222392593,1222392593,1,3,0
88504071@N00,5214,15,1222407619,1222407619,1,3,0
88521516@N05,5215,2,1465429946,1465429946,1,1,0
8854930@N07,5216,11,1449459241,1449474042,2,1,14801
88564171@N02,5217,11,1411020188,1411020188,1,2,0
88564171@N02,5217,8,1411020174,1411020174,1,2,0
88653431@N00,5218,11,1338070939,1338070939,1,2,0
88653431@N00,5218,1,1338081639,1338081639,1,2,0
88669269@N06,5219,9,1446168153,1446168153,1,1,0
88669269@N06,5220,16,1446259590,1446259590,1,2,0
88669269@N06,5220,9,1446260668,1446260668,1,2,0
88669269@N06,5221,9,1446354285,1446354285,1,1,0
88711965@N00,5222,11,1380458695,1380458695,1,1,0
88740729@N02,5223,13,1470551882,1470551882,1,2,0
88740729@N02,5223,11,1470537228,1470553049,2,2,15821
88785574@N00,5224,2,1340109600,1340109600,1,1,0
88859710@N03,5225,6,1361245944,1361247486,2,2,1542
88859710@N03,5225,4,1361246241,1361246637,2,2,396
88859710@N03,5226,1,1365579556,1365579556,1,1,0
88859710@N03,5227,17,1366349797,1366350333,2,3,536
88859710@N03,5227,13,1366350735,1366350735,1,3,0
88859710@N03,5227,10,1366349209,1366349209,1,3,0
88859710@N03,5228,6,1367808649,1367808649,1,1,0
88859710@N03,5229,11,1371534968,1371534968,1,1,0
88859710@N03,5230,11,1381896447,1381896447,1,1,0
88859710@N03,5231,11,1382000047,1382000047,1,1,0
88859710@N03,5232,11,1384732785,1384732785,1,1,0
88959316@N00,5233,3,1193384525,1193385461,4,4,936
88959316@N00,5233,16,1193371765,1193371950,2,4,185
88959316@N00,5233,2,1193379815,1193379815,1,4,0
88959316@N00,5233,11,1193388771,1193389014,2,4,243
88959316@N00,5234,3,1193470729,1193470729,1,1,0
88971823@N06,5235,17,1363135809,1363136211,3,1,402
88984016@N00,5236,12,1349017219,1349017219,1,2,0
88984016@N00,5236,2,1349017216,1349017216,1,2,0
88984016@N00,5237,11,1349129279,1349129280,3,3,1
88984016@N00,5237,15,1349124206,1349124206,1,3,0
88984016@N00,5237,13,1349111028,1349111028,1,3,0
88987422@N07,5238,11,1300598904,1300598993,2,2,89
88987422@N07,5238,15,1300599588,1300614846,27,2,15258
88994581@N00,5239,13,1351232217,1351232217,1,1,0
88996132@N00,5240,11,1198781571,1198781571,1,1,0
89099232@N03,5241,16,1204604850,1204604850,1,1,0
89117836@N08,5242,11,1387452145,1387452145,1,1,0
89138020@N00,5243,16,1241233311,1241233758,4,8,447
89138020@N00,5243,2,1241240572,1241245756,8,8,5184
89138020@N00,5243,3,1241254236,1241254476,2,8,240
89138020@N00,5243,9,1241234104,1241235571,2,8,1467
89138020@N00,5243,1,1241249576,1241249576,1,8,0
89138020@N00,5243,10,1241257150,1241257150,1,8,0
89138020@N00,5243,11,1241222903,1241227041,15,8,4138
89138020@N00,5243,4,1241246578,1241246578,1,8,0
89138020@N00,5244,5,1241752298,1241753018,5,6,720
89138020@N00,5244,2,1241744071,1241747416,2,6,3345
89138020@N00,5244,13,1241763232,1241763271,3,6,39
89138020@N00,5244,16,1241748610,1241751470,3,6,2860
89138020@N00,5244,8,1241755310,1241759158,4,6,3848
89138020@N00,5244,11,1241743722,1241743749,2,6,27
89241972@N00,5245,5,1268204734,1268204927,2,7,193
89241972@N00,5245,16,1268184098,1268184596,2,7,498
89241972@N00,5245,2,1268185563,1268185652,2,7,89
89241972@N00,5245,1,1268184024,1268184024,1,7,0
89241972@N00,5245,13,1268189282,1268189282,1,7,0
89241972@N00,5245,3,1268196501,1268196749,3,7,248
89241972@N00,5245,11,1268222343,1268222343,1,7,0
89334444@N08,5246,13,1392351447,1392351447,1,1,0
8938418@N03,5247,11,1389416925,1389416925,1,2,0
8938418@N03,5247,17,1389404224,1389404224,1,2,0
89388234@N00,5248,5,1371895577,1371895577,1,1,0
89388234@N00,5249,10,1371960291,1371960291,1,3,0
89388234@N00,5249,13,1371960715,1371960715,1,3,0
89388234@N00,5249,15,1371960478,1371960478,1,3,0
89403129@N08,5250,11,1450984830,1450997287,3,1,12457
8944312@N05,5251,5,1330204598,1330204598,1,1,0
89451823@N08,5252,5,1379066912,1379066912,1,3,0
89451823@N08,5252,15,1379064253,1379064253,1,3,0
89451823@N08,5252,8,1379066475,1379066475,2,3,0
89451823@N08,5253,13,1379127120,1379127120,1,2,0
89451823@N08,5253,17,1379122099,1379126596,3,2,4497
8949620@N08,5254,11,1209477606,1209484430,2,5,6824
8949620@N08,5254,13,1209484391,1209484391,1,5,0
8949620@N08,5254,7,1209484614,1209484614,1,5,0
8949620@N08,5254,8,1209477600,1209477823,7,5,223
8949620@N08,5254,9,1209477640,1209484575,3,5,6935
8949620@N08,5255,5,1209563719,1209563719,1,3,0
8949620@N08,5255,11,1209524251,1209563455,4,3,39204
8949620@N08,5255,8,1209563384,1209563418,2,3,34
8949620@N08,5256,8,1209631807,1209632129,10,1,322
8949620@N08,5257,11,1209822880,1209822956,2,1,76
8949620@N08,5258,2,1209893944,1209893944,1,5,0
8949620@N08,5258,15,1209898730,1209898730,1,5,0
8949620@N08,5258,10,1209894240,1209894240,1,5,0
8949620@N08,5258,17,1209898767,1209898767,1,5,0
8949620@N08,5258,12,1209893907,1209894163,5,5,256
8949620@N08,5259,12,1243692000,1243692002,3,1,2
89522530@N00,5260,8,1332133019,1332133980,3,8,961
89522530@N00,5260,11,1332106389,1332144343,7,8,37954
89522530@N00,5260,5,1332134933,1332134933,1,8,0
89522530@N00,5260,13,1332119128,1332119128,1,8,0
89522530@N00,5260,2,1332115053,1332115109,3,8,56
89522530@N00,5260,17,1332118465,1332144080,8,8,25615
89522530@N00,5260,4,1332115614,1332116010,3,8,396
89522530@N00,5260,1,1332111388,1332111684,4,8,296
89634087@N00,5261,11,1298880872,1298883017,4,3,2145
89634087@N00,5261,4,1298882976,1298882976,1,3,0
89634087@N00,5261,8,1298880803,1298880803,1,3,0
89658123@N07,5262,11,1359946648,1359946648,1,1,0
8980678@N03,5263,11,1191057095,1191057095,1,1,0
8980678@N03,5264,11,1242433596,1242433596,1,1,0
8980678@N03,5265,5,1251609616,1251609729,3,2,113
8980678@N03,5265,2,1251601512,1251601941,2,2,429
8980678@N03,5266,5,1268284622,1268288642,2,1,4020
8980678@N03,5267,11,1296083015,1296083015,1,2,0
8980678@N03,5267,4,1296087553,1296087884,2,2,331
8980678@N03,5268,4,1299206609,1299209018,5,1,2409
8980678@N03,5269,2,1308724522,1308724964,4,1,442
8980678@N03,5270,11,1323677160,1323677160,1,1,0
8980678@N03,5271,11,1335325666,1335347890,3,1,22224
8980678@N03,5272,11,1350117867,1350117867,1,1,0
8980678@N03,5273,8,1353904833,1353908851,9,1,4018
8980678@N03,5274,1,1368237331,1368237331,1,1,0
8980678@N03,5275,4,1424492482,1424492482,1,1,0
8980678@N03,5276,11,1425507675,1425507675,1,2,0
8980678@N03,5276,9,1425508369,1425508369,1,2,0
89938050@N07,5277,5,1350209549,1350209561,2,1,12
89938050@N07,5278,9,1350270293,1350270350,4,1,57
89939063@N03,5279,10,1369290190,1369290254,3,1,64
8996989@N02,5280,13,1238113790,1238113790,1,1,0
89975165@N07,5281,13,1368559439,1368559439,1,1,0
90008840@N00,5282,13,1397877035,1397877035,1,1,0
90008840@N00,5283,5,1440472572,1440472572,1,1,0
90067442@N03,5284,11,1376879952,1376879952,1,1,0
90067442@N03,5285,11,1400459642,1400459642,1,1,0
90067442@N03,5286,13,1400579606,1400579606,1,1,0
90067442@N03,5287,8,1400923336,1400923336,1,1,0
90081836@N00,5288,8,1312086346,1312086346,1,1,0
90123960@N00,5289,11,1266885732,1266885799,2,1,67
90226138@N02,5290,11,1437133028,1437133028,1,1,0
9027452@N07,5291,4,1201302613,1201327982,3,1,25369
90279255@N08,5292,9,1435047814,1435047814,1,1,0
90311139@N00,5293,11,1229242468,1229242468,1,1,0
90315279@N00,5294,10,1368955952,1368955952,2,3,0
90315279@N00,5294,15,1368955389,1368955389,2,3,0
90315279@N00,5294,11,1368964498,1368964498,2,3,0
90315279@N00,5295,13,1369297396,1369297696,6,4,300
90315279@N00,5295,2,1369279037,1369279037,1,4,0
90315279@N00,5295,7,1369280270,1369280270,1,4,0
90315279@N00,5295,3,1369281567,1369281583,2,4,16
90347114@N05,5296,13,1397534480,1397534481,3,5,1
90347114@N05,5296,5,1397530896,1397530896,2,5,0
90347114@N05,5296,16,1397528375,1397528375,1,5,0
90347114@N05,5296,9,1397525585,1397527899,11,5,2314
90347114@N05,5296,11,1397524344,1397525108,18,5,764
90351516@N00,5297,5,1452385966,1452385987,2,1,21
9036688@N06,5298,5,1317379340,1317379340,2,1,0
9036688@N06,5299,2,1317440018,1317440018,1,3,0
9036688@N06,5299,11,1317434332,1317434478,3,3,146
9036688@N06,5299,10,1317434422,1317434422,1,3,0
90367727@N00,5300,4,1366254938,1366254938,1,1,0
9036889@N06,5301,10,1385092790,1385092790,1,2,0
9036889@N06,5301,1,1385086658,1385086661,2,2,3
9036889@N06,5302,1,1417833214,1417833214,1,1,0
90370508@N02,5303,11,1436229693,1436229695,2,1,2
90474234@N08,5304,17,1396679784,1396679784,1,1,0
90496636@N05,5305,7,1425526975,1425526975,1,1,0
9051885@N06,5306,17,1278320069,1278321870,4,1,1801
90533800@N00,5307,11,1329730744,1329730744,1,1,0
90562571@N00,5308,11,1406588017,1406588017,2,1,0
90562571@N00,5309,5,1406624079,1406624096,3,1,17
90603065@N06,5310,11,1452324569,1452324569,1,2,0
90603065@N06,5310,10,1452323660,1452323660,1,2,0
90642923@N00,5311,11,1205497034,1205497034,1,1,0
90642923@N00,5312,4,1213592069,1213592069,1,1,0
90642923@N00,5313,11,1262221095,1262221095,1,7,0
90642923@N00,5313,17,1262234443,1262234443,1,7,0
90642923@N00,5313,6,1262255799,1262255799,1,7,0
90642923@N00,5313,10,1262233902,1262245897,2,7,11995
90642923@N00,5313,4,1262223602,1262224261,4,7,659
90642923@N00,5313,7,1262224476,1262224476,1,7,0
90642923@N00,5313,8,1262231267,1262262582,10,7,31315
9070451@N03,5314,8,1400797083,1400797083,1,4,0
9070451@N03,5314,9,1400790870,1400790870,1,4,0
9070451@N03,5314,11,1400802353,1400802353,1,4,0
9070451@N03,5314,5,1400793872,1400793872,1,4,0
90728477@N00,5315,4,1369471545,1369471545,1,4,0
90728477@N00,5315,11,1369472652,1369472652,1,4,0
90728477@N00,5315,5,1369468329,1369468329,1,4,0
90728477@N00,5315,13,1369461462,1369461462,1,4,0
90728477@N00,5316,3,1369525171,1369525171,1,1,0
90728477@N00,5317,11,1371976083,1371977025,11,3,942
90728477@N00,5317,2,1371967284,1371968029,2,3,745
90728477@N00,5317,13,1371955568,1371955568,1,3,0
90755543@N00,5318,8,1396582793,1396582793,1,1,0
91032493@N00,5319,17,1438320385,1438320385,1,1,0
91033481@N00,5320,3,1349816945,1349816945,1,1,0
91092205@N07,5321,10,1367984691,1368009791,18,2,25100
91092205@N07,5321,17,1368009111,1368011368,53,2,2257
91110029@N02,5322,5,1414619277,1414619277,1,3,0
91110029@N02,5322,11,1414619178,1414619304,4,3,126
91110029@N02,5322,8,1414619296,1414619296,1,3,0
91129684@N00,5323,8,1364629143,1364629143,1,1,0
91132397@N08,5324,15,1417921560,1417921560,1,3,0
91132397@N08,5324,3,1417941149,1417942993,6,3,1844
91132397@N08,5324,11,1417909687,1417909687,1,3,0
91132397@N08,5325,11,1424758122,1424758122,1,1,0
91144647@N06,5326,15,1333855929,1333855929,1,4,0
91144647@N06,5326,1,1333854770,1333854781,2,4,11
91144647@N06,5326,17,1333855863,1333855875,2,4,12
91144647@N06,5326,9,1333844635,1333844635,1,4,0
91207697@N08,5327,11,1413499324,1413499716,2,1,392
91220827@N02,5328,9,1376889252,1376889252,1,3,0
91220827@N02,5328,11,1376864880,1376907537,2,3,42657
91220827@N02,5328,10,1376898193,1376898193,1,3,0
91227166@N06,5329,15,1399161677,1399161677,1,2,0
91227166@N06,5329,11,1399157765,1399157765,1,2,0
91227690@N08,5330,16,1459750990,1459751175,7,4,185
91227690@N08,5330,9,1459748557,1459750422,14,4,1865
91227690@N08,5330,1,1459750946,1459750946,1,4,0
91227690@N08,5330,7,1459745787,1459746823,6,4,1036
91227690@N08,5331,12,1460094695,1460094901,14,4,206
91227690@N08,5331,4,1460095405,1460095460,4,4,55
91227690@N08,5331,2,1460093807,1460095061,15,4,1254
91227690@N08,5331,1,1460091726,1460091755,5,4,29
91227690@N08,5332,16,1460610283,1460610283,1,2,0
91227690@N08,5332,4,1460610961,1460611363,2,2,402
91227690@N08,5333,11,1460871870,1460872128,3,4,258
91227690@N08,5333,9,1460870995,1460871041,2,4,46
91227690@N08,5333,16,1460871106,1460871512,3,4,406
91227690@N08,5333,1,1460870775,1460870926,2,4,151
91227690@N08,5334,12,1461390087,1461390221,5,2,134
91227690@N08,5334,2,1461389830,1461390659,9,2,829
91256618@N07,5335,13,1383468747,1383468747,1,2,0
91256618@N07,5335,2,1383461082,1383461082,1,2,0
91256618@N07,5336,11,1383626869,1383626869,1,2,0
91256618@N07,5336,3,1383629624,1383629624,1,2,0
91256618@N07,5337,8,1383799315,1383800627,4,1,1312
91258390@N05,5338,5,1365235616,1365235616,1,1,0
91259577@N07,5339,17,1372219384,1372219384,1,1,0
91315857@N02,5340,9,1377412542,1377412542,1,1,0
91315857@N02,5341,4,1377899945,1377899945,1,2,0
91315857@N02,5341,3,1377896790,1377896790,1,2,0
91315857@N02,5342,5,1377933409,1377933409,1,1,0
91315857@N02,5343,13,1382415649,1382415649,1,3,0
91315857@N02,5343,11,1382411443,1382411443,1,3,0
91315857@N02,5343,1,1382411482,1382411482,1,3,0
91315857@N02,5344,11,1443990519,1443990519,1,1,0
91363409@N07,5345,11,1415739454,1415739454,1,3,0
91363409@N07,5345,1,1415743512,1415746056,2,3,2544
91363409@N07,5345,10,1415749037,1415749037,1,3,0
91372718@N04,5346,9,1374378735,1374378735,1,8,0
91372718@N04,5346,8,1374383787,1374389792,10,8,6005
91372718@N04,5346,10,1374400642,1374400658,2,8,16
91372718@N04,5346,4,1374371669,1374371822,3,8,153
91372718@N04,5346,11,1374401712,1374403550,3,8,1838
91372718@N04,5346,15,1374400083,1374400083,1,8,0
91372718@N04,5346,17,1374400267,1374400495,7,8,228
91372718@N04,5346,16,1374368043,1374368043,1,8,0
91407288@N07,5347,17,1352244408,1352244451,3,1,43
91409399@N07,5348,10,1379410236,1379416576,3,2,6340
91409399@N07,5348,9,1379398219,1379398219,1,2,0
91409399@N07,5349,3,1379560097,1379560214,4,5,117
91409399@N07,5349,5,1379564707,1379564707,1,5,0
91409399@N07,5349,1,1379562765,1379562765,1,5,0
91409399@N07,5349,11,1379584083,1379584083,1,5,0
91409399@N07,5349,16,1379555863,1379556067,4,5,204
91409399@N07,5350,13,1379992239,1379997028,8,1,4789
91435349@N03,5351,11,1381294207,1381294207,1,1,0
91446813@N03,5352,11,1368491421,1368506765,29,1,15344
91446813@N03,5353,11,1368710483,1368710483,1,1,0
91456744@N00,5354,5,1322552294,1322552294,1,2,0
91456744@N00,5354,11,1322548973,1322548973,1,2,0
91496554@N04,5355,15,1469781234,1469781246,2,7,12
91496554@N04,5355,4,1469757645,1469757645,1,7,0
91496554@N04,5355,13,1469763595,1469763595,1,7,0
91496554@N04,5355,11,1469749840,1469788141,8,7,38301
91496554@N04,5355,9,1469785753,1469785753,1,7,0
91496554@N04,5355,16,1469787560,1469787689,5,7,129
91496554@N04,5355,8,1469774305,1469774347,5,7,42
91501015@N07,5356,11,1357614800,1357614800,1,1,0
91501015@N07,5357,17,1357699632,1357699632,1,4,0
91501015@N07,5357,5,1357701591,1357701682,2,4,91
91501015@N07,5357,8,1357699170,1357699175,2,4,5
91501015@N07,5357,11,1357683023,1357703953,29,4,20930
91534967@N00,5358,5,1364639280,1364639280,1,1,0
91569514@N05,5359,11,1432855449,1432902365,19,2,46916
91569514@N05,5359,3,1432872903,1432875013,10,2,2110
91621746@N00,5360,17,1330314234,1330314274,2,3,40
91621746@N00,5360,13,1330313537,1330313881,3,3,344
91621746@N00,5360,11,1330306371,1330306427,2,3,56
91634060@N02,5361,11,1356230021,1356230021,1,1,0
91703770@N00,5362,11,1225585723,1225620641,31,9,34918
91703770@N00,5362,9,1225588501,1225591720,38,9,3219
91703770@N00,5362,14,1225617215,1225617692,2,9,477
91703770@N00,5362,16,1225591866,1225592199,6,9,333
91703770@N00,5362,8,1225609198,1225609198,1,9,0
91703770@N00,5362,1,1225595456,1225597721,10,9,2265
91703770@N00,5362,15,1225615038,1225615423,8,9,385
91703770@N00,5362,5,1225599637,1225603021,14,9,3384
91703770@N00,5362,17,1225615503,1225615697,7,9,194
91723305@N00,5363,16,1337077740,1337077740,1,1,0
91761857@N00,5364,11,1396524667,1396525081,11,2,414
91761857@N00,5364,2,1396518123,1396523161,9,2,5038
91761857@N00,5365,1,1419667374,1419667374,1,1,0
9176927@N08,5366,11,1239266055,1239272692,3,4,6637
9176927@N08,5366,1,1239267326,1239267362,2,4,36
9176927@N08,5366,16,1239265370,1239265370,1,4,0
9176927@N08,5366,5,1239270311,1239270319,2,4,8
91831221@N00,5367,5,1325487529,1325487529,1,2,0
91831221@N00,5367,11,1325493091,1325494339,2,2,1248
91847136@N03,5368,1,1388191561,1388194174,2,4,2613
91847136@N03,5368,15,1388212508,1388212508,1,4,0
91847136@N03,5368,10,1388211452,1388211457,2,4,5
91847136@N03,5368,9,1388188861,1388188861,1,4,0
91859523@N00,5369,11,1303699543,1303699680,3,3,137
91859523@N00,5369,15,1303718633,1303718633,1,3,0
91859523@N00,5369,10,1303725633,1303725633,1,3,0
9191162@N05,5370,10,1225592982,1225592982,1,1,0
9197147@N03,5371,11,1400327887,1400327887,1,1,0
92005509@N02,5372,2,1463992087,1464004195,3,1,12108
92009229@N05,5373,9,1365496170,1365496183,2,2,13
92009229@N05,5373,10,1365505587,1365505604,4,2,17
9201618@N02,5374,6,1403003543,1403003543,1,1,0
92026547@N05,5375,5,1410498063,1410498063,1,2,0
92026547@N05,5375,11,1410493591,1410510600,2,2,17009
92026547@N05,5376,11,1410861724,1410861724,1,1,0
92026547@N05,5377,1,1414280402,1414280402,1,2,0
92026547@N05,5377,11,1414276923,1414289674,2,2,12751
92114370@N02,5378,1,1397274242,1397274242,1,1,0
92114370@N02,5379,1,1397545047,1397545047,1,1,0
92144729@N07,5380,2,1398169906,1398169906,1,1,0
92155161@N00,5381,17,1414731699,1414731699,1,1,0
92174097@N02,5382,16,1268583837,1268583837,1,1,0
9228491@N06,5383,11,1267338160,1267352675,5,3,14515
9228491@N06,5383,10,1267346293,1267346293,1,3,0
9228491@N06,5383,16,1267339722,1267339830,2,3,108
9228491@N06,5384,3,1267427793,1267427793,1,5,0
9228491@N06,5384,11,1267413048,1267413048,1,5,0
9228491@N06,5384,13,1267420227,1267420260,3,5,33
9228491@N06,5384,12,1267415417,1267416096,6,5,679
9228491@N06,5384,2,1267416724,1267416724,1,5,0
9228491@N06,5385,8,1267490859,1267490941,3,1,82
9228491@N06,5386,3,1267792358,1267792358,1,1,0
9228491@N06,5387,9,1267852604,1267852604,1,6,0
9228491@N06,5387,1,1267852128,1267852128,1,6,0
9228491@N06,5387,16,1267852349,1267852349,1,6,0
9228491@N06,5387,5,1267847908,1267851719,7,6,3811
9228491@N06,5387,17,1267827038,1267827038,1,6,0
9228491@N06,5387,11,1267853028,1267854131,5,6,1103
9228491@N06,5388,11,1267946579,1267946579,1,3,0
9228491@N06,5388,16,1267929181,1267929186,2,3,5
9228491@N06,5388,5,1267936817,1267943596,2,3,6779
9228491@N06,5389,8,1268022776,1268022776,1,2,0
9228491@N06,5389,15,1268018676,1268018713,2,2,37
9228491@N06,5390,11,1323170951,1323170951,1,1,0
92286879@N00,5391,11,1445476833,1445476833,1,1,0
9230719@N05,5392,17,1292653636,1292653636,1,1,0
9230719@N05,5393,4,1295052102,1295052102,1,2,0
9230719@N05,5393,11,1295049266,1295049266,1,2,0
9230719@N05,5394,13,1306707448,1306707448,1,1,0
9233146@N03,5395,8,1208691477,1208691477,6,1,0
9233146@N03,5396,4,1208962806,1208963390,4,1,584
92496162@N08,5397,17,1446096382,1446096382,1,2,0
92496162@N08,5397,11,1446085493,1446113188,2,2,27695
92533979@N00,5398,13,1359937590,1359969456,3,7,31866
92533979@N00,5398,2,1359946702,1359946702,1,7,0
92533979@N00,5398,1,1359934810,1359934822,2,7,12
92533979@N00,5398,17,1359970245,1359973048,2,7,2803
92533979@N00,5398,8,1359960316,1359960845,2,7,529
92533979@N00,5398,9,1359933512,1359933997,2,7,485
92533979@N00,5398,12,1359946780,1359946780,1,7,0
92577424@N06,5399,8,1208760444,1208760444,1,1,0
92595189@N00,5400,14,1223250396,1223285769,7,1,35373
92617440@N08,5401,4,1413348767,1413348767,1,1,0
92622262@N08,5402,11,1369553682,1369553689,2,1,7
92622262@N08,5403,1,1370656056,1370656056,1,3,0
92622262@N08,5403,11,1370658081,1370658083,2,3,2
92622262@N08,5403,5,1370648828,1370654539,11,3,5711
92622262@N08,5404,2,1400906144,1400906459,4,2,315
92622262@N08,5404,10,1400898939,1400901219,3,2,2280
92622262@N08,5405,1,1402739706,1402739706,1,1,0
92712863@N03,5406,11,1361145908,1361163322,11,1,17414
9274852@N08,5407,17,1349510224,1349510224,1,1,0
92859253@N04,5408,3,1379732884,1379732884,1,1,0
92877887@N00,5409,1,1443937326,1443937326,1,1,0
9292159@N06,5410,5,1449562944,1449565282,2,1,2338
9292159@N06,5411,15,1449648333,1449648912,7,1,579
92931591@N05,5412,14,1377328270,1377328270,1,1,0
92931591@N05,5413,8,1441102698,1441102737,2,1,39
93003498@N05,5414,11,1335505504,1335505504,1,1,0
93003498@N05,5415,6,1354914519,1354914519,1,1,0
93003498@N05,5416,11,1360629802,1360629802,1,1,0
93003498@N05,5417,11,1363229761,1363229761,1,1,0
93003498@N05,5418,11,1364773964,1364773964,1,1,0
93003498@N05,5419,5,1365308998,1365309277,3,1,279
93003498@N05,5420,11,1365562847,1365562847,1,1,0
93074386@N00,5421,11,1444696678,1444696678,1,1,0
93081598@N05,5422,8,1365753335,1365753335,1,2,0
93081598@N05,5422,5,1365756898,1365756898,1,2,0
93086051@N00,5423,4,1357446233,1357446233,1,1,0
93086051@N00,5424,10,1397901146,1397901146,1,1,0
93086051@N00,5425,4,1399185469,1399185469,1,1,0
93086051@N00,5426,3,1399698316,1399698316,1,1,0
93086051@N00,5427,8,1441526686,1441526686,1,1,0
93086051@N00,5428,11,1443311048,1443311048,1,1,0
93105948@N06,5429,11,1263861496,1263903325,27,1,41829
93105948@N06,5430,11,1280308526,1280308526,1,1,0
93105948@N06,5431,11,1360485106,1360485131,2,1,25
93117900@N03,5432,11,1383118469,1383118469,1,1,0
93126204@N00,5433,2,1368489940,1368489940,1,3,0
93126204@N00,5433,11,1368489148,1368489148,1,3,0
93126204@N00,5433,8,1368496656,1368496656,1,3,0
93150071@N06,5434,11,1363816490,1363816490,1,1,0
93182963@N00,5435,16,1285030404,1285030404,1,1,0
93260943@N08,5436,11,1360910149,1360910149,1,1,0
93260943@N08,5437,8,1377935654,1377935654,1,1,0
93283041@N00,5438,11,1229401852,1229415108,3,4,13256
93283041@N00,5438,5,1229408615,1229411507,7,4,2892
93283041@N00,5438,1,1229403586,1229412396,3,4,8810
93283041@N00,5438,16,1229404814,1229404814,1,4,0
93283041@N00,5439,4,1229554047,1229561805,2,6,7758
93283041@N00,5439,15,1229554440,1229555110,11,6,670
93283041@N00,5439,11,1229547342,1229547342,1,6,0
93283041@N00,5439,17,1229554217,1229554226,2,6,9
93283041@N00,5439,2,1229551515,1229551951,4,6,436
93283041@N00,5439,7,1229548475,1229552289,16,6,3814
93283041@N00,5440,11,1229652868,1229652868,1,7,0
93283041@N00,5440,5,1229653685,1229680326,6,7,26641
93283041@N00,5440,8,1229655233,1229657084,10,7,1851
93283041@N00,5440,13,1229666000,1229667856,2,7,1856
93283041@N00,5440,6,1229664614,1229664614,1,7,0
93283041@N00,5440,17,1229670349,1229671993,2,7,1644
93283041@N00,5440,4,1229672231,1229672231,1,7,0
93283041@N00,5441,2,1229835372,1229836895,8,4,1523
93283041@N00,5441,1,1229822471,1229822471,1,4,0
93283041@N00,5441,9,1229822157,1229822332,3,4,175
93283041@N00,5441,4,1229825916,1229829216,4,4,3300
93283041@N00,5442,1,1272696386,1272696622,7,8,236
93283041@N00,5442,15,1272691177,1272691467,5,8,290
93283041@N00,5442,17,1272690756,1272691366,9,8,610
93283041@N00,5442,16,1272680571,1272681402,17,8,831
93283041@N00,5442,13,1272691554,1272692102,5,8,548
93283041@N00,5442,8,1272694180,1272694441,4,8,261
93283041@N00,5442,9,1272682763,1272682763,1,8,0
93283041@N00,5442,11,1272676336,1272700460,3,8,24124
93283041@N00,5443,8,1282286988,1282287071,2,2,83
93283041@N00,5443,6,1282285524,1282286711,2,2,1187
93283041@N00,5444,16,1287181217,1287181360,3,2,143
93283041@N00,5444,8,1287183400,1287183400,1,2,0
93283041@N00,5445,5,1301790373,1301790373,1,6,0
93283041@N00,5445,15,1301801918,1301801918,1,6,0
93283041@N00,5445,1,1301787158,1301787297,2,6,139
93283041@N00,5445,11,1301777792,1301805595,3,6,27803
93283041@N00,5445,16,1301786796,1301786859,2,6,63
93283041@N00,5445,8,1301791329,1301792021,9,6,692
93283041@N00,5446,5,1332028526,1332028571,2,4,45
93283041@N00,5446,1,1332033923,1332034051,3,4,128
93283041@N00,5446,11,1332045630,1332045630,1,4,0
93283041@N00,5446,16,1332029097,1332031684,2,4,2587
93284303@N04,5447,13,1361764575,1361764575,1,1,0
93294943@N08,5448,8,1363145505,1363147006,4,2,1501
93294943@N08,5448,17,1363154796,1363154804,2,2,8
93294943@N08,5449,4,1404220285,1404220285,1,1,0
9329633@N04,5450,11,1353803528,1353817413,2,2,13885
9329633@N04,5450,5,1353822186,1353822186,1,2,0
9329633@N04,5451,11,1354152577,1354152577,1,1,0
93334382@N02,5452,4,1376008635,1376008635,1,1,0
93334382@N02,5453,13,1384827865,1384827987,2,1,122
93334382@N02,5454,5,1405416427,1405416427,1,1,0
93347972@N00,5455,17,1200636443,1200636455,2,2,12
93347972@N00,5455,10,1200640031,1200640031,1,2,0
93371661@N08,5456,15,1360291569,1360291569,1,6,0
93371661@N08,5456,7,1360288598,1360288655,3,6,57
93371661@N08,5456,3,1360288543,1360288543,1,6,0
93371661@N08,5456,4,1360288779,1360289045,2,6,266
93371661@N08,5456,1,1360273966,1360294192,4,6,20226
93371661@N08,5456,11,1360273094,1360278423,2,6,5329
9349788@N07,5457,4,1364039099,1364059073,2,1,19974
93538524@N06,5458,4,1375079736,1375080181,3,9,445
93538524@N06,5458,11,1375063843,1375063843,1,9,0
93538524@N06,5458,9,1375065299,1375066100,8,9,801
93538524@N06,5458,15,1375075974,1375075974,1,9,0
93538524@N06,5458,17,1375076445,1375076687,5,9,242
93538524@N06,5458,5,1375068069,1375068832,17,9,763
93538524@N06,5458,10,1375077733,1375078037,4,9,304
93538524@N06,5458,13,1375075837,1375075837,1,9,0
93538524@N06,5458,8,1375069673,1375069968,3,9,295
93629101@N05,5459,2,1430558918,1430560484,25,13,1566
93629101@N05,5459,11,1430528164,1430565876,39,13,37712
93629101@N05,5459,1,1430552354,1430552870,7,13,516
93629101@N05,5459,17,1430553514,1430553982,6,13,468
93629101@N05,5459,13,1430545219,1430545222,2,13,3
93629101@N05,5459,10,1430533934,1430554148,6,13,20214
93629101@N05,5459,15,1430553881,1430553882,2,13,1
93629101@N05,5459,9,1430552528,1430552617,3,13,89
93629101@N05,5459,3,1430561005,1430561005,1,13,0
93629101@N05,5459,5,1430555117,1430557506,26,13,2389
93629101@N05,5459,4,1430532929,1430534568,43,13,1639
93629101@N05,5459,8,1430554754,1430554911,2,13,157
93629101@N05,5459,7,1430561018,1430561018,1,13,0
93629101@N05,5460,13,1430603115,1430603125,2,1,10
93645801@N07,5461,11,1313045426,1313060927,2,1,15501
93678083@N08,5462,1,1336708704,1336708704,2,3,0
93678083@N08,5462,16,1336709031,1336709031,1,3,0
93678083@N08,5462,15,1336726205,1336726249,5,3,44
93728052@N05,5463,11,1359615276,1359615276,1,1,0
93851844@N00,5464,11,1218757198,1218757856,3,2,658
93851844@N00,5464,5,1218773470,1218773470,1,2,0
93897867@N00,5465,11,1295514152,1295514152,1,1,0
94083192@N00,5466,11,1394152869,1394187289,16,1,34420
94126498@N00,5467,11,1445828400,1445828400,1,3,0
94126498@N00,5467,17,1445835600,1445835600,1,3,0
94126498@N00,5467,13,1445824467,1445824467,1,3,0
94128388@N07,5468,15,1322288440,1322288440,1,1,0
94128388@N07,5469,15,1322781324,1322781324,1,1,0
94128388@N07,5470,1,1414277752,1414277752,1,1,0
94155755@N00,5471,5,1385440245,1385440245,1,1,0
94155755@N00,5472,11,1460728236,1460728236,1,1,0
94199138@N00,5473,11,1366889304,1366889304,1,1,0
94322044@N04,5474,11,1368149336,1368149336,1,1,0
94386117@N07,5475,11,1370016816,1370016816,1,1,0
94436430@N00,5476,10,1360306677,1360306677,1,1,0
9449875@N03,5477,5,1361169420,1361169420,1,5,0
9449875@N03,5477,12,1361157051,1361159064,14,5,2013
9449875@N03,5477,8,1361161395,1361161395,1,5,0
9449875@N03,5477,4,1361150927,1361150958,5,5,31
9449875@N03,5477,11,1361146987,1361147401,2,5,414
94511303@N04,5478,1,1414199071,1414199071,1,2,0
94511303@N04,5478,5,1414202737,1414202737,1,2,0
94512378@N00,5479,11,1336523948,1336523948,1,1,0
9456601@N03,5480,2,1308300232,1308300232,1,7,0
9456601@N03,5480,14,1308274559,1308274587,3,7,28
9456601@N03,5480,5,1308283306,1308283957,2,7,651
9456601@N03,5480,8,1308280520,1308280801,3,7,281
9456601@N03,5480,3,1308274773,1308274877,2,7,104
9456601@N03,5480,1,1308285383,1308286391,3,7,1008
9456601@N03,5480,12,1308299510,1308299736,5,7,226
94571531@N00,5481,17,1304568400,1304576771,2,2,8371
94571531@N00,5481,13,1304571688,1304571688,1,2,0
9459256@N05,5482,5,1202867907,1202867907,1,1,0
9461342@N03,5483,11,1397084073,1397084073,1,1,0
9461342@N03,5484,11,1459939896,1459939896,1,1,0
94681905@N04,5485,11,1417861302,1417861302,1,1,0
94697173@N00,5486,13,1443426358,1443431853,11,2,5495
94697173@N00,5486,11,1443434605,1443434605,1,2,0
94697173@N00,5487,8,1443519663,1443519676,3,3,13
94697173@N00,5487,15,1443508893,1443509208,3,3,315
94697173@N00,5487,6,1443512754,1443512769,2,3,15
94697173@N00,5488,8,1443588760,1443588760,1,1,0
94697173@N00,5489,8,1443831051,1443831051,1,2,0
94697173@N00,5489,13,1443830429,1443830429,1,2,0
94697173@N00,5490,11,1454636790,1454666116,3,5,29326
94697173@N00,5490,5,1454637669,1454638204,6,5,535
94697173@N00,5490,1,1454638168,1454638175,2,5,7
94697173@N00,5490,13,1454644892,1454644900,4,5,8
94697173@N00,5490,15,1454645009,1454645025,2,5,16
94738051@N05,5491,12,1375578065,1375578065,1,1,0
94749819@N03,5492,11,1465461749,1465461749,1,1,0
94817984@N02,5493,11,1391502935,1391502935,1,1,0
94817984@N02,5494,5,1406080162,1406080162,1,1,0
94817984@N02,5495,15,1414801022,1414801022,1,2,0
94817984@N02,5495,8,1414803148,1414803148,1,2,0
94938844@N06,5496,17,1356079385,1356079385,1,2,0
94938844@N06,5496,13,1356080797,1356080797,1,2,0
95095552@N02,5497,11,1400980464,1400980464,1,1,0
95145503@N04,5498,2,1364348690,1364348690,1,1,0
95198134@N00,5499,8,1191227298,1191235370,7,14,8072
95198134@N00,5499,13,1191203618,1191203751,2,14,133
95198134@N00,5499,10,1191202490,1191202595,4,14,105
95198134@N00,5499,1,1191217518,1191223133,5,14,5615
95198134@N00,5499,17,1191202743,1191202983,5,14,240
95198134@N00,5499,7,1191195076,1191195076,1,14,0
95198134@N00,5499,3,1191195134,1191195223,2,14,89
95198134@N00,5499,9,1191216102,1191217352,4,14,1250
95198134@N00,5499,4,1191197590,1191199379,4,14,1789
95198134@N00,5499,2,1191211077,1191211213,4,14,136
95198134@N00,5499,12,1191212223,1191212271,2,14,48
95198134@N00,5499,11,1191194178,1191210427,2,14,16249
95198134@N00,5499,5,1191228264,1191229461,5,14,1197
95198134@N00,5499,16,1191219639,1191219700,2,14,61
95258067@N00,5500,11,1386717934,1386717934,1,6,0
95258067@N00,5500,13,1386758173,1386759055,3,6,882
95258067@N00,5500,8,1386746514,1386746514,1,6,0
95258067@N00,5500,3,1386720653,1386720653,1,6,0
95258067@N00,5500,2,1386724191,1386727103,2,6,2912
95258067@N00,5500,10,1386732954,1386732954,1,6,0
95258067@N00,5501,11,1386912742,1386912774,3,3,32
95258067@N00,5501,5,1386895995,1386895995,1,3,0
95258067@N00,5501,8,1386905487,1386905487,1,3,0
95341382@N05,5502,11,1443402254,1443402390,2,1,136
95356654@N00,5503,8,1223238540,1223239646,2,1,1106
95356654@N00,5504,11,1223505351,1223505351,1,1,0
95356654@N00,5505,11,1223569699,1223569699,1,1,0
95356654@N00,5506,11,1327899787,1327899787,1,1,0
95356654@N00,5507,11,1390542113,1390543364,3,3,1251
95356654@N00,5507,5,1390545856,1390550252,4,3,4396
95356654@N00,5507,1,1390558428,1390558428,1,3,0
95356654@N00,5508,11,1431510507,1431513965,6,1,3458
95356654@N00,5509,11,1431750690,1431750695,2,1,5
95356654@N00,5510,1,1432285085,1432287438,4,1,2353
9540001@N06,5511,6,1201423794,1201423794,1,1,0
95400328@N03,5512,1,1371684146,1371684146,1,1,0
95400328@N03,5513,11,1371811531,1371811531,1,1,0
95413039@N00,5514,3,1201992932,1202002234,31,1,9302
95415594@N00,5515,10,1267657701,1267657701,1,1,0
95454502@N06,5516,11,1433126884,1433126884,1,1,0
9549670@N05,5517,5,1467859135,1467859387,4,10,252
9549670@N05,5517,8,1467857785,1467859783,2,10,1998
9549670@N05,5517,11,1467850184,1467873824,3,10,23640
9549670@N05,5517,7,1467850573,1467850957,6,10,384
9549670@N05,5517,15,1467852092,1467865758,14,10,13666
9549670@N05,5517,13,1467852764,1467865863,5,10,13099
9549670@N05,5517,10,1467865664,1467865664,1,10,0
9549670@N05,5517,4,1467850984,1467850984,1,10,0
9549670@N05,5517,17,1467851387,1467862868,8,10,11481
9549670@N05,5517,6,1467852727,1467852727,1,10,0
95555783@N05,5518,7,1365498724,1365498724,1,1,0
95559818@N00,5519,11,1190507723,1190507889,2,2,166
95559818@N00,5519,2,1190511443,1190511443,1,2,0
95559818@N00,5520,11,1304667339,1304667339,1,2,0
95559818@N00,5520,2,1304669761,1304669761,1,2,0
95559818@N00,5521,11,1333358895,1333358895,1,1,0
95559818@N00,5522,5,1333675405,1333675405,1,1,0
95608654@N04,5523,11,1363857061,1363857141,4,3,80
95608654@N04,5523,8,1363859054,1363859160,2,3,106
95608654@N04,5523,4,1363857058,1363857058,1,3,0
95611942@N00,5524,11,1382075607,1382075607,1,2,0
95611942@N00,5524,2,1382059638,1382068801,13,2,9163
95611942@N00,5525,2,1468296189,1468296189,1,9,0
95611942@N00,5525,8,1468277810,1468278295,5,9,485
95611942@N00,5525,12,1468293318,1468295788,4,9,2470
95611942@N00,5525,5,1468272600,1468277577,6,9,4977
95611942@N00,5525,10,1468299628,1468299628,1,9,0
95611942@N00,5525,13,1468290185,1468301846,2,9,11661
95611942@N00,5525,11,1468271690,1468318460,2,9,46770
95611942@N00,5525,15,1468300007,1468300007,1,9,0
95611942@N00,5525,9,1468307668,1468307668,1,9,0
95646877@N00,5526,11,1273889310,1273889310,1,1,0
95653839@N03,5527,11,1416122089,1416122089,1,1,0
95653839@N03,5528,1,1416301289,1416301289,1,2,0
95653839@N03,5528,13,1416306506,1416306506,1,2,0
95653839@N03,5529,8,1416480318,1416480318,1,2,0
95653839@N03,5529,5,1416480752,1416480752,1,2,0
95694198@N00,5530,11,1362969568,1362999231,7,3,29663
95694198@N00,5530,4,1362992934,1362994333,3,3,1399
95694198@N00,5530,10,1362992138,1362992736,4,3,598
95694198@N00,5531,11,1363240559,1363240634,9,4,75
95694198@N00,5531,1,1363212478,1363212478,1,4,0
95694198@N00,5531,17,1363213183,1363213455,2,4,272
95694198@N00,5531,9,1363216414,1363218734,6,4,2320
95694198@N00,5532,4,1363495725,1363495725,1,1,0
95736828@N07,5533,2,1370394555,1370396702,6,1,2147
95769700@N00,5534,15,1380958579,1380958579,1,3,0
95769700@N00,5534,11,1380939605,1380955115,3,3,15510
95769700@N00,5534,10,1380958155,1380958155,1,3,0
95773887@N00,5535,16,1254045763,1254045763,1,2,0
95773887@N00,5535,11,1254073539,1254073539,1,2,0
95778894@N00,5536,17,1457152270,1457161915,4,5,9645
95778894@N00,5536,8,1457173733,1457173733,1,5,0
95778894@N00,5536,10,1457186013,1457186013,1,5,0
95778894@N00,5536,13,1457150701,1457150794,3,5,93
95778894@N00,5536,5,1457178597,1457178597,1,5,0
95782054@N05,5537,10,1382803215,1382803656,8,4,441
95782054@N05,5537,11,1382801771,1382802142,8,4,371
95782054@N05,5537,17,1382804069,1382806930,5,4,2861
95782054@N05,5537,15,1382806990,1382807254,4,4,264
95821525@N08,5538,2,1382139421,1382139421,1,2,0
95821525@N08,5538,11,1382122193,1382122193,1,2,0
95911107@N02,5539,11,1442966588,1442966588,1,5,0
95911107@N02,5539,2,1442973794,1442973815,3,5,21
95911107@N02,5539,10,1442986061,1442986061,1,5,0
95911107@N02,5539,3,1442978546,1442978546,1,5,0
95911107@N02,5539,17,1442986044,1442986044,1,5,0
95928504@N03,5540,4,1428373492,1428373492,1,1,0
95999793@N00,5541,4,1369209619,1369209619,1,1,0
96023438@N05,5542,11,1378688758,1378688856,3,1,98
96062950@N02,5543,10,1385969720,1385969720,1,6,0
96062950@N02,5543,3,1385942035,1385946412,4,6,4377
96062950@N02,5543,11,1385941333,1385941341,2,6,8
96062950@N02,5543,17,1385969174,1385969174,1,6,0
96062950@N02,5543,1,1385970785,1385974015,6,6,3230
96062950@N02,5543,8,1385947513,1385958986,9,6,11473
96062950@N02,5544,11,1386048746,1386048746,1,3,0
96062950@N02,5544,5,1386061689,1386061689,1,3,0
96062950@N02,5544,13,1386053879,1386053879,1,3,0
96062950@N02,5545,11,1386475140,1386475181,2,5,41
96062950@N02,5545,3,1386480216,1386480216,1,5,0
96062950@N02,5545,1,1386493148,1386496526,2,5,3378
96062950@N02,5545,10,1386485160,1386485160,1,5,0
96062950@N02,5545,2,1386482005,1386482507,4,5,502
96074685@N04,5546,17,1374113661,1374116091,6,1,2430
96077153@N00,5547,4,1291983042,1291983042,1,2,0
96077153@N00,5547,11,1291987629,1291987976,2,2,347
96077153@N00,5548,5,1295086120,1295086120,1,1,0
96077153@N00,5549,10,1303462597,1303462597,1,4,0
96077153@N00,5549,11,1303451019,1303461770,2,4,10751
96077153@N00,5549,1,1303430126,1303430126,1,4,0
96077153@N00,5549,4,1303453488,1303453488,1,4,0
96077153@N00,5550,16,1305264629,1305264629,1,1,0
96084178@N00,5551,17,1257914862,1257914862,1,3,0
96084178@N00,5551,8,1257903090,1257905718,8,3,2628
96084178@N00,5551,15,1257913803,1257914347,4,3,544
96084178@N00,5552,5,1368341368,1368341368,1,3,0
96084178@N00,5552,8,1368336305,1368339496,7,3,3191
96084178@N00,5552,11,1368332812,1368343332,6,3,10520
96084178@N00,5553,15,1395382507,1395382507,1,2,0
96084178@N00,5553,10,1395381397,1395381397,1,2,0
96088830@N07,5554,2,1298770276,1298770276,1,3,0
96088830@N07,5554,4,1298777567,1298778924,4,3,1357
96088830@N07,5554,17,1298767508,1298776881,2,3,9373
9611843@N04,5555,11,1193860840,1193860840,1,1,0
9611843@N04,5556,5,1229444674,1229444674,1,1,0
9611843@N04,5557,8,1266034579,1266034579,1,1,0
9611843@N04,5558,5,1295428257,1295428257,1,1,0
9611843@N04,5559,3,1295488554,1295488554,1,4,0
9611843@N04,5559,8,1295487671,1295487671,1,4,0
9611843@N04,5559,11,1295480864,1295480864,1,4,0
9611843@N04,5559,17,1295474552,1295474552,1,4,0
9611843@N04,5560,2,1317369085,1317369085,1,2,0
9611843@N04,5560,1,1317366669,1317366669,1,2,0
9611843@N04,5561,9,1319030488,1319030488,1,1,0
9611843@N04,5562,17,1328346441,1328346441,1,2,0
9611843@N04,5562,13,1328332615,1328332615,1,2,0
9611843@N04,5563,1,1328506474,1328506474,1,1,0
9611843@N04,5564,7,1328577216,1328577216,1,1,0
9611843@N04,5565,4,1330864197,1330864197,1,1,0
9611843@N04,5566,11,1350110274,1350110274,1,1,0
9611843@N04,5567,3,1350513172,1350513172,1,1,0
96128002@N00,5568,13,1225151373,1225151373,1,2,0
96128002@N00,5568,15,1225151292,1225151292,1,2,0
96129398@N05,5569,11,1456038483,1456038483,1,1,0
96196973@N02,5570,11,1363919096,1363919096,1,3,0
96196973@N02,5570,17,1363921945,1363921945,1,3,0
96196973@N02,5570,15,1363922250,1363922250,1,3,0
9621505@N08,5571,10,1411111433,1411111433,1,2,0
9621505@N08,5571,11,1411119730,1411119883,3,2,153
96258832@N08,5572,10,1457676852,1457676852,1,4,0
96258832@N08,5572,13,1457677554,1457677610,2,4,56
96258832@N08,5572,5,1457680769,1457680769,1,4,0
96258832@N08,5572,17,1457677148,1457677166,2,4,18
96274088@N05,5573,10,1356145860,1356145885,2,1,25
96274088@N05,5574,1,1356414616,1356414616,1,3,0
96274088@N05,5574,17,1356426101,1356429445,7,3,3344
96274088@N05,5574,13,1356424524,1356424524,1,3,0
96274088@N05,5575,6,1356480719,1356480719,1,3,0
96274088@N05,5575,13,1356514904,1356514904,2,3,0
96274088@N05,5575,11,1356509467,1356509467,2,3,0
96312503@N08,5576,11,1369738278,1369738278,1,1,0
96312503@N08,5577,17,1382523014,1382523014,1,1,0
96312503@N08,5578,11,1382873657,1382873657,1,2,0
96312503@N08,5578,4,1382861609,1382861609,1,2,0
96312503@N08,5579,10,1401107331,1401107331,1,1,0
96331620@N03,5580,10,1328332753,1328332754,2,1,1
96331620@N03,5581,17,1328517252,1328517268,2,1,16
96333180@N05,5582,11,1269650208,1269650208,1,1,0
9639902@N04,5583,5,1240448293,1240448293,1,1,0
9639902@N04,5584,11,1240626496,1240626972,2,3,476
9639902@N04,5584,13,1240629924,1240629924,1,3,0
9639902@N04,5584,10,1240635224,1240635224,1,3,0
96402848@N00,5585,11,1301562471,1301562471,1,1,0
96430093@N05,5586,15,1370158967,1370158967,1,1,0
96430093@N05,5587,15,1370258866,1370258866,1,1,0
96430093@N05,5588,15,1370342027,1370342027,1,1,0
96430093@N05,5589,13,1372559027,1372559027,1,1,0
96430093@N05,5590,8,1380170289,1380170289,1,1,0
96430093@N05,5591,8,1380239720,1380239720,1,1,0
96430093@N05,5592,17,1382484945,1382485385,2,2,440
96430093@N05,5592,13,1382488629,1382488772,2,2,143
96430093@N05,5593,13,1382566020,1382566020,1,2,0
96430093@N05,5593,1,1382589958,1382589958,1,2,0
96430093@N05,5594,7,1382762139,1382762747,3,1,608
96430093@N05,5595,15,1390011570,1390011570,1,1,0
96430093@N05,5596,8,1391639654,1391639654,1,1,0
96430093@N05,5597,9,1395005761,1395013799,3,2,8038
96430093@N05,5597,2,1395020479,1395022045,2,2,1566
96430093@N05,5598,13,1395104693,1395104693,1,2,0
96430093@N05,5598,5,1395128688,1395128688,1,2,0
96430093@N05,5599,3,1395278403,1395278707,2,1,304
96430093@N05,5600,9,1395365401,1395367097,2,2,1696
96430093@N05,5600,5,1395359722,1395360310,2,2,588
96430093@N05,5601,13,1395620222,1395620222,1,2,0
96430093@N05,5601,5,1395615869,1395615869,1,2,0
96430093@N05,5602,3,1401332950,1401333029,2,1,79
96430093@N05,5603,5,1401773616,1401773616,1,1,0
96430093@N05,5604,13,1405745534,1405745534,1,1,0
96430093@N05,5605,13,1411001200,1411002281,2,1,1081
96430093@N05,5606,9,1411100203,1411100203,1,1,0
96430093@N05,5607,13,1411354015,1411354015,1,2,0
96430093@N05,5607,5,1411338777,1411338777,1,2,0
96430093@N05,5608,13,1412223771,1412223771,1,1,0
96430093@N05,5609,9,1412645104,1412645287,2,1,183
96430093@N05,5610,9,1413253813,1413253813,1,1,0
96430093@N05,5611,3,1414452701,1414453241,2,2,540
96430093@N05,5611,13,1414481922,1414481922,1,2,0
96430093@N05,5612,9,1414535354,1414535354,1,3,0
96430093@N05,5612,16,1414552632,1414553491,2,3,859
96430093@N05,5612,5,1414538611,1414564684,4,3,26073
96430093@N05,5613,5,1415059325,1415060439,2,1,1114
96430093@N05,5614,1,1425593582,1425593582,1,2,0
96430093@N05,5614,13,1425597901,1425599863,3,2,1962
96430093@N05,5615,5,1429160739,1429161056,2,1,317
96430093@N05,5616,17,1430001240,1430002211,4,1,971
96430093@N05,5617,5,1430363494,1430363859,2,2,365
96430093@N05,5617,13,1430357387,1430357387,1,2,0
96430093@N05,5618,17,1433466929,1433467151,2,1,222
96430093@N05,5619,17,1437534509,1437534509,1,1,0
96430093@N05,5620,3,1453874063,1453874130,2,1,67
96430093@N05,5621,11,1456434403,1456451756,3,1,17353
96430093@N05,5622,11,1456793426,1456802253,3,1,8827
96430093@N05,5623,11,1457386584,1457386584,1,1,0
96430093@N05,5624,13,1459207615,1459207797,2,1,182
96430093@N05,5625,13,1459758710,1459758710,1,1,0
96430093@N05,5626,17,1460160997,1460160997,1,1,0
96430093@N05,5627,13,1460764378,1460766104,5,1,1726
96430093@N05,5628,3,1461448055,1461448055,1,1,0
96430093@N05,5629,13,1463974886,1463975436,2,3,550
96430093@N05,5629,8,1463965735,1463965735,1,3,0
96430093@N05,5629,4,1463955488,1463955488,1,3,0
9644199@N02,5630,10,1214924778,1214924778,1,3,0
9644199@N02,5630,8,1214925162,1214925701,3,3,539
9644199@N02,5630,16,1214924154,1214924272,3,3,118
9644199@N02,5631,1,1227715786,1227715786,1,2,0
9644199@N02,5631,13,1227710369,1227710416,2,2,47
9644199@N02,5632,10,1227808706,1227814487,3,2,5781
9644199@N02,5632,13,1227789329,1227789329,1,2,0
9644199@N02,5633,11,1230058829,1230058926,5,1,97
9644199@N02,5634,6,1310001705,1310001705,1,1,0
9644199@N02,5635,13,1337571629,1337571629,1,2,0
9644199@N02,5635,17,1337571628,1337571629,2,2,1
9644199@N02,5636,5,1339800759,1339800759,1,3,0
9644199@N02,5636,11,1339801570,1339801570,1,3,0
9644199@N02,5636,8,1339800323,1339800323,1,3,0
9644199@N02,5637,11,1389768727,1389768727,2,2,0
9644199@N02,5637,8,1389768837,1389768854,2,2,17
9644199@N02,5638,11,1392448279,1392448279,1,1,0
96466494@N00,5639,9,1470652204,1470652204,1,1,0
96525092@N00,5640,16,1191188753,1191188834,4,1,81
96525092@N00,5641,16,1191250318,1191252182,11,2,1864
96525092@N00,5641,1,1191247875,1191247875,1,2,0
96525092@N00,5642,16,1195178683,1195178683,1,1,0
96525092@N00,5643,16,1195985922,1195985922,1,1,0
96525092@N00,5644,8,1197681725,1197681725,1,1,0
96525092@N00,5645,16,1205496675,1205496675,1,1,0
96525092@N00,5646,6,1220010784,1220010784,1,1,0
96525092@N00,5647,4,1222554571,1222554571,1,1,0
96525092@N00,5648,11,1236595404,1236595404,1,1,0
96525092@N00,5649,8,1254446756,1254446756,1,2,0
96525092@N00,5649,16,1254437966,1254437966,1,2,0
96525092@N00,5650,13,1254534184,1254534184,1,4,0
96525092@N00,5650,16,1254527093,1254530768,2,4,3675
96525092@N00,5650,11,1254570477,1254570738,3,4,261
96525092@N00,5650,17,1254547344,1254547344,1,4,0
96525092@N00,5651,8,1255702530,1255702530,1,1,0
96525092@N00,5652,8,1255812751,1255812751,1,1,0
96525092@N00,5653,11,1257398746,1257398746,1,1,0
96525092@N00,5654,4,1257548503,1257548503,1,2,0
96525092@N00,5654,11,1257567483,1257567483,1,2,0
96525092@N00,5655,13,1258451931,1258451931,1,1,0
96525092@N00,5656,4,1263217671,1263217671,1,1,0
96525092@N00,5657,9,1263989040,1263989040,1,1,0
96525092@N00,5658,17,1267774029,1267774029,1,2,0
96525092@N00,5658,8,1267757845,1267760595,3,2,2750
96525092@N00,5659,15,1289130423,1289130423,1,1,0
96525092@N00,5660,7,1320708093,1320708093,1,3,0
96525092@N00,5660,3,1320708902,1320708902,1,3,0
96525092@N00,5660,11,1320705590,1320705590,1,3,0
96525092@N00,5661,11,1352155016,1352155016,1,1,0
9653109@N04,5662,11,1252495810,1252495810,1,1,0
9653109@N04,5663,4,1277368239,1277368239,1,1,0
9653109@N04,5664,16,1285128019,1285128019,1,1,0
9653109@N04,5665,5,1285750014,1285750014,1,3,0
9653109@N04,5665,1,1285748190,1285748190,1,3,0
9653109@N04,5665,8,1285752409,1285752419,2,3,10
96548081@N07,5666,11,1460572407,1460572825,2,1,418
96548081@N07,5667,8,1460603487,1460603487,1,1,0
96559463@N00,5668,11,1268905021,1268905021,1,2,0
96559463@N00,5668,8,1268885191,1268885191,1,2,0
96618039@N00,5669,10,1329308795,1329308795,1,1,0
96628420@N00,5670,11,1194992755,1195018521,19,2,25766
96628420@N00,5670,10,1195005969,1195006741,7,2,772
9663436@N03,5671,5,1396129929,1396129929,1,6,0
9663436@N03,5671,17,1396142220,1396142959,11,6,739
9663436@N03,5671,8,1396129658,1396129751,3,6,93
9663436@N03,5671,10,1396141789,1396141867,4,6,78
9663436@N03,5671,15,1396142821,1396143050,5,6,229
9663436@N03,5671,13,1396143164,1396143290,5,6,126
9664341@N05,5672,8,1215156744,1215162358,2,1,5614
96678288@N02,5673,11,1370496182,1370496182,2,1,0
96678288@N02,5674,11,1377678702,1377678702,1,4,0
96678288@N02,5674,5,1377683894,1377683936,3,4,42
96678288@N02,5674,1,1377681438,1377683044,13,4,1606
96678288@N02,5674,9,1377678745,1377678783,2,4,38
96678288@N02,5675,17,1380970733,1380971194,13,4,461
96678288@N02,5675,10,1380971261,1380971261,1,4,0
96678288@N02,5675,13,1380970357,1380970699,6,4,342
96678288@N02,5675,11,1380974638,1380974926,13,4,288
96678288@N02,5676,3,1382515627,1382515639,2,4,12
96678288@N02,5676,1,1382513921,1382516507,16,4,2586
96678288@N02,5676,6,1382518144,1382519884,17,4,1740
96678288@N02,5676,11,1382511445,1382511601,7,4,156
96678288@N02,5677,7,1386755677,1386755918,5,2,241
96678288@N02,5677,11,1386745802,1386760274,2,2,14472
96678288@N02,5678,11,1386835837,1386836667,3,2,830
96678288@N02,5678,6,1386828518,1386830895,2,2,2377
96678288@N02,5679,8,1388217664,1388217664,1,6,0
96678288@N02,5679,1,1388228329,1388229899,4,6,1570
96678288@N02,5679,6,1388210889,1388213442,13,6,2553
96678288@N02,5679,5,1388230961,1388230980,2,6,19
96678288@N02,5679,11,1388220357,1388232345,4,6,11988
96678288@N02,5679,16,1388219430,1388219430,1,6,0
96678288@N02,5680,13,1392797326,1392800564,22,5,3238
96678288@N02,5680,15,1392796190,1392797314,8,5,1124
96678288@N02,5680,17,1392796970,1392796970,1,5,0
96678288@N02,5680,11,1392805757,1392805757,1,5,0
96678288@N02,5680,3,1392802680,1392804836,5,5,2156
96678288@N02,5681,13,1395396129,1395396784,8,4,655
96678288@N02,5681,10,1395397634,1395397648,2,4,14
96678288@N02,5681,17,1395397617,1395397617,1,4,0
96678288@N02,5681,11,1395386508,1395386859,9,4,351
96678288@N02,5682,15,1397294869,1397294869,1,3,0
96678288@N02,5682,1,1397292049,1397292049,1,3,0
96678288@N02,5682,13,1397295384,1397295384,1,3,0
96678288@N02,5683,8,1410944075,1410946729,5,1,2654
96678288@N02,5684,1,1419749865,1419749865,1,2,0
96678288@N02,5684,4,1419763788,1419763788,1,2,0
96678288@N02,5685,13,1425459159,1425459159,1,2,0
96678288@N02,5685,8,1425466177,1425466177,1,2,0
96678288@N02,5686,11,1429692248,1429692248,1,1,0
96678288@N02,5687,2,1441970632,1441970632,1,1,0
96678288@N02,5688,11,1450430310,1450430310,1,1,0
96678288@N02,5689,11,1454307248,1454320985,3,2,13737
96678288@N02,5689,4,1454302823,1454305121,2,2,2298
96678288@N02,5690,11,1456114500,1456137275,4,3,22775
96678288@N02,5690,1,1456114609,1456135711,3,3,21102
96678288@N02,5690,5,1456127177,1456127177,1,3,0
96678288@N02,5691,8,1458543976,1458543976,1,2,0
96678288@N02,5691,11,1458532591,1458554583,2,2,21992
96678288@N02,5692,11,1461042464,1461076669,4,1,34205
96678288@N02,5693,11,1464070755,1464070755,1,2,0
96678288@N02,5693,2,1464069343,1464069343,1,2,0
96678288@N02,5694,3,1465880972,1465880972,1,2,0
96678288@N02,5694,11,1465880359,1465883533,3,2,3174
96678288@N02,5695,11,1466492134,1466492134,1,2,0
96678288@N02,5695,3,1466484662,1466485838,2,2,1176
96678288@N02,5696,11,1467597639,1467636578,4,1,38939
96678288@N02,5697,11,1468909265,1468930000,6,2,20735
96678288@N02,5697,1,1468902486,1468930886,3,2,28400
96801778@N00,5698,11,1382670414,1382697775,2,5,27361
96801778@N00,5698,2,1382690711,1382690711,1,5,0
96801778@N00,5698,5,1382676099,1382676099,1,5,0
96801778@N00,5698,15,1382688304,1382688304,1,5,0
96801778@N00,5698,16,1382670008,1382670008,1,5,0
96882800@N08,5699,10,1275026576,1275026576,1,1,0
96889906@N00,5700,11,1270639544,1270641617,2,2,2073
96889906@N00,5700,8,1270640822,1270640822,1,2,0
96899238@N00,5701,8,1451524732,1451540119,16,1,15387
96913191@N00,5702,11,1299747499,1299760782,3,1,13283
96913191@N00,5703,8,1329900891,1329900891,1,1,0
96926231@N00,5704,11,1341210973,1341210979,2,1,6
96991828@N07,5705,17,1324614627,1324614645,2,1,18
97019381@N00,5706,8,1217846979,1217846979,1,3,0
97019381@N00,5706,5,1217839504,1217840552,7,3,1048
97019381@N00,5706,11,1217866354,1217866354,1,3,0
97023479@N08,5707,17,1444107729,1444107729,1,6,0
97023479@N08,5707,2,1444086867,1444089245,2,6,2378
97023479@N08,5707,10,1444107121,1444107121,1,6,0
97023479@N08,5707,11,1444082687,1444127187,2,6,44500
97023479@N08,5707,8,1444117895,1444117895,1,6,0
97023479@N08,5707,9,1444100755,1444100755,1,6,0
97064780@N06,5708,8,1426653780,1426654470,9,1,690
9708101@N02,5709,2,1219303603,1219305554,3,1,1951
9708101@N02,5710,11,1219391168,1219391168,1,1,0
97108343@N06,5711,15,1433470540,1433470579,4,2,39
97108343@N06,5711,17,1433469748,1433469775,5,2,27
97137858@N00,5712,10,1261563310,1261563310,1,9,0
97137858@N00,5712,11,1261553214,1261553441,3,9,227
97137858@N00,5712,5,1261573498,1261575016,2,9,1518
97137858@N00,5712,13,1261564214,1261578437,5,9,14223
97137858@N00,5712,12,1261557749,1261562570,3,9,4821
97137858@N00,5712,17,1261563477,1261563735,4,9,258
97137858@N00,5712,8,1261571009,1261572612,3,9,1603
97137858@N00,5712,15,1261564037,1261564133,2,9,96
97137858@N00,5712,3,1261554772,1261554772,1,9,0
97174119@N07,5713,1,1405827677,1405838651,2,5,10974
97174119@N07,5713,3,1405824276,1405824276,1,5,0
97174119@N07,5713,16,1405825326,1405825326,1,5,0
97174119@N07,5713,9,1405827366,1405827366,1,5,0
97174119@N07,5713,11,1405847472,1405847472,1,5,0
97316061@N05,5714,13,1426727295,1426727295,1,5,0
97316061@N05,5714,8,1426736647,1426736647,1,5,0
97316061@N05,5714,11,1426722141,1426722585,2,5,444
97316061@N05,5714,10,1426724052,1426724052,1,5,0
97316061@N05,5714,17,1426726417,1426726417,1,5,0
97321472@N00,5715,11,1308308019,1308308019,1,1,0
97408089@N00,5716,1,1362864879,1362864886,6,2,7
97408089@N00,5716,11,1362863222,1362863222,2,2,0
97413516@N00,5717,17,1286939893,1286939893,1,1,0
97477255@N00,5718,13,1359784708,1359784738,3,1,30
97477255@N00,5719,11,1423053364,1423053387,3,6,23
97477255@N00,5719,5,1423046899,1423052353,14,6,5454
97477255@N00,5719,8,1423036491,1423039061,6,6,2570
97477255@N00,5719,17,1423035270,1423035296,2,6,26
97477255@N00,5719,9,1423020107,1423020107,1,6,0
97477255@N00,5719,3,1423023714,1423023714,1,6,0
97477255@N00,5720,10,1423640904,1423640950,2,4,46
97477255@N00,5720,4,1423610044,1423611985,3,4,1941
97477255@N00,5720,9,1423621262,1423621271,2,4,9
97477255@N00,5720,2,1423615288,1423615293,2,4,5
97486802@N08,5721,15,1310708197,1310708197,1,1,0
97489023@N00,5722,11,1323073963,1323073963,1,1,0
97543060@N07,5723,11,1357851600,1357851604,5,1,4
97543060@N07,5724,11,1357945200,1357945210,11,1,10
97543060@N07,5725,11,1358042400,1358042409,9,1,9
97550352@N08,5726,11,1381612312,1381612312,1,1,0
97550352@N08,5727,11,1387582675,1387582675,1,1,0
97580930@N04,5728,11,1469375642,1469375642,1,1,0
97721343@N08,5729,16,1420156699,1420156699,1,2,0
97721343@N08,5729,15,1420164737,1420166001,4,2,1264
97721343@N08,5730,11,1439103350,1439103350,1,1,0
9774336@N08,5731,11,1286680631,1286680631,1,1,0
97790328@N02,5732,11,1469438920,1469438920,1,1,0
97838235@N00,5733,8,1381194649,1381194649,1,5,0
97838235@N00,5733,6,1381184580,1381184580,1,5,0
97838235@N00,5733,11,1381224525,1381224533,2,5,8
97838235@N00,5733,3,1381182855,1381182855,1,5,0
97838235@N00,5733,17,1381216999,1381216999,1,5,0
97838235@N00,5734,13,1381284094,1381284124,3,2,30
97838235@N00,5734,4,1381274250,1381274269,6,2,19
9790304@N07,5735,9,1363827132,1363827188,2,6,56
9790304@N07,5735,12,1363820190,1363820190,1,6,0
9790304@N07,5735,1,1363827023,1363827023,1,6,0
9790304@N07,5735,8,1363852780,1363852780,1,6,0
9790304@N07,5735,11,1363817196,1363817210,2,6,14
9790304@N07,5735,5,1363854613,1363856171,2,6,1558
97964364@N00,5736,15,1191730248,1191730259,2,2,11
97964364@N00,5736,11,1191710591,1191710591,1,2,0
98052801@N03,5737,11,1418030446,1418030446,1,1,0
98066314@N07,5738,11,1361754431,1361766959,3,1,12528
98109106@N00,5739,11,1246327515,1246338969,3,4,11454
98109106@N00,5739,2,1246339392,1246339392,1,4,0
98109106@N00,5739,5,1246328066,1246346678,5,4,18612
98109106@N00,5739,16,1246336940,1246336940,1,4,0
98109106@N00,5740,8,1247065208,1247067556,13,1,2348
98109106@N00,5741,8,1247132865,1247134514,7,7,1649
98109106@N00,5741,14,1247120120,1247120120,1,7,0
98109106@N00,5741,4,1247141887,1247144508,2,7,2621
98109106@N00,5741,7,1247117168,1247120513,2,7,3345
98109106@N00,5741,2,1247121348,1247122699,5,7,1351
98109106@N00,5741,11,1247115912,1247127521,2,7,11609
98109106@N00,5741,17,1247152682,1247155403,4,7,2721
9813050@N08,5742,15,1257065841,1257066304,11,1,463
9813050@N08,5743,8,1257152087,1257153826,25,2,1739
9813050@N08,5743,11,1257149464,1257150850,11,2,1386
9813050@N08,5744,11,1257221249,1257221421,9,5,172
9813050@N08,5744,12,1257225211,1257226812,27,5,1601
9813050@N08,5744,4,1257227319,1257227526,9,5,207
9813050@N08,5744,9,1257228965,1257229197,5,5,232
9813050@N08,5744,7,1257221589,1257225056,68,5,3467
9813050@N08,5745,8,1257336000,1257336313,11,5,313
9813050@N08,5745,11,1257329736,1257329743,2,5,7
9813050@N08,5745,10,1257333328,1257333439,4,5,111
9813050@N08,5745,1,1257330139,1257331945,18,5,1806
9813050@N08,5745,13,1257334916,1257335032,2,5,116
9813050@N08,5746,11,1257398823,1257398823,1,6,0
9813050@N08,5746,8,1257390923,1257402566,47,6,11643
9813050@N08,5746,7,1257398835,1257399387,10,6,552
9813050@N08,5746,12,1257400655,1257400659,2,6,4
9813050@N08,5746,16,1257391436,1257391445,3,6,9
9813050@N08,5746,13,1257404445,1257410705,13,6,6260
98153629@N00,5747,8,1321674771,1321692931,4,10,18160
98153629@N00,5747,1,1321654040,1321654359,2,10,319
98153629@N00,5747,11,1321653035,1321688606,4,10,35571
98153629@N00,5747,10,1321687300,1321687633,2,10,333
98153629@N00,5747,13,1321694396,1321694577,2,10,181
98153629@N00,5747,14,1321656449,1321657188,5,10,739
98153629@N00,5747,9,1321654577,1321654577,1,10,0
98153629@N00,5747,17,1321695241,1321697562,15,10,2321
98153629@N00,5747,5,1321673010,1321692666,5,10,19656
98153629@N00,5747,12,1321657953,1321658502,2,10,549
9820882@N06,5748,4,1347062262,1347062262,1,1,0
98223232@N00,5749,6,1255420767,1255420835,7,1,68
98223232@N00,5750,11,1255511940,1255511948,2,1,8
98223232@N00,5751,15,1255653403,1255653434,6,1,31
98224622@N00,5752,10,1348561265,1348561265,1,2,0
98224622@N00,5752,5,1348546118,1348546118,1,2,0
98278617@N06,5753,11,1397877973,1397878027,6,1,54
98297562@N04,5754,11,1395299404,1395299404,1,1,0
98305332@N00,5755,11,1189403150,1189403948,2,1,798
98326469@N00,5756,11,1428570523,1428570523,1,1,0
9838181@N04,5757,8,1439628066,1439628066,1,1,0
98387918@N07,5758,11,1417068339,1417076168,2,1,7829
98388332@N00,5759,8,1338097135,1338097218,4,8,83
98388332@N00,5759,11,1338118707,1338119168,2,8,461
98388332@N00,5759,5,1338094463,1338094949,2,8,486
98388332@N00,5759,4,1338076486,1338084184,23,8,7698
98388332@N00,5759,17,1338112463,1338117609,29,8,5146
98388332@N00,5759,2,1338119093,1338119093,1,8,0
98388332@N00,5759,13,1338109238,1338109996,6,8,758
98388332@N00,5759,10,1338112906,1338117833,4,8,4927
98438392@N04,5760,11,1337058187,1337058187,1,1,0
98474523@N00,5761,5,1322711407,1322711646,3,2,239
98474523@N00,5761,11,1322707088,1322708501,5,2,1413
98474523@N00,5762,5,1322875833,1322875833,1,5,0
98474523@N00,5762,3,1322864312,1322870232,10,5,5920
98474523@N00,5762,2,1322868969,1322868969,1,5,0
98474523@N00,5762,11,1322863187,1322890205,8,5,27018
98474523@N00,5762,8,1322899208,1322899220,2,5,12
98474523@N00,5763,9,1323142329,1323142329,1,3,0
98474523@N00,5763,11,1323129963,1323129963,1,3,0
98474523@N00,5763,4,1323133315,1323133315,1,3,0
98474523@N00,5764,9,1323212112,1323212285,5,4,173
98474523@N00,5764,3,1323209037,1323209098,4,4,61
98474523@N00,5764,2,1323214018,1323214031,4,4,13
98474523@N00,5764,11,1323223518,1323223709,2,4,191
98497282@N00,5765,17,1370227667,1370227667,1,2,0
98497282@N00,5765,12,1370217869,1370217869,1,2,0
9858951@N03,5766,11,1274255312,1274255375,9,1,63
9860213@N08,5767,4,1342919236,1342919236,1,1,0
9860213@N08,5768,8,1343273253,1343273253,1,1,0
9860213@N08,5769,5,1441592426,1441592441,3,4,15
9860213@N08,5769,17,1441604523,1441604532,3,4,9
9860213@N08,5769,11,1441618352,1441622094,4,4,3742
9860213@N08,5769,16,1441609488,1441609488,1,4,0
98657360@N02,5770,2,1375139600,1375139600,1,1,0
98676873@N07,5771,17,1388472991,1388472991,2,1,0
98676873@N07,5772,13,1388567682,1388567682,1,1,0
98767429@N00,5773,8,1197341505,1197352199,4,5,10694
98767429@N00,5773,17,1197354585,1197360436,2,5,5851
98767429@N00,5773,1,1197340858,1197340874,4,5,16
98767429@N00,5773,11,1197319802,1197361470,8,5,41668
98767429@N00,5773,2,1197321336,1197334599,16,5,13263
98801696@N02,5774,11,1423003988,1423003988,1,1,0
98801696@N02,5775,8,1423362724,1423362724,1,1,0
98801696@N02,5776,10,1458529366,1458530169,2,1,803
98840716@N08,5777,8,1426231416,1426231416,1,1,0
98847194@N02,5778,15,1377073994,1377073994,1,2,0
98847194@N02,5778,1,1377078449,1377078449,1,2,0
98870304@N08,5779,5,1374919716,1374919724,3,1,8
98870304@N08,5780,11,1401337733,1401337733,1,1,0
98876406@N00,5781,11,1356667503,1356667503,1,1,0
98889314@N02,5782,13,1403746404,1403759549,8,11,13145
98889314@N02,5782,11,1403761010,1403761707,2,11,697
98889314@N02,5782,7,1403742830,1403742857,3,11,27
98889314@N02,5782,10,1403745893,1403759736,8,11,13843
98889314@N02,5782,5,1403752689,1403760569,10,11,7880
98889314@N02,5782,16,1403756616,1403756829,5,11,213
98889314@N02,5782,8,1403752437,1403752519,2,11,82
98889314@N02,5782,1,1403753501,1403756266,11,11,2765
98889314@N02,5782,15,1403746246,1403746343,4,11,97
98889314@N02,5782,17,1403746016,1403759727,9,11,13711
98889314@N02,5782,2,1403745628,1403745628,1,11,0
99015631@N00,5783,11,1370840439,1370840439,1,1,0
9907136@N02,5784,9,1333768710,1333768710,1,1,0
99119735@N06,5785,15,1382775625,1382775625,1,5,0
99119735@N06,5785,5,1382749456,1382782693,3,5,33237
99119735@N06,5785,8,1382755024,1382755024,1,5,0
99119735@N06,5785,2,1382745077,1382747884,3,5,2807
99119735@N06,5785,11,1382743474,1382777149,2,5,33675
99119735@N06,5786,11,1383293741,1383293741,1,1,0
99129452@N08,5787,11,1421826445,1421826445,1,1,0
99146615@N07,5788,11,1384166507,1384166507,1,1,0
99183660@N06,5789,10,1417631722,1417631722,1,1,0
99199321@N07,5790,15,1420934422,1420934422,1,1,0
99219204@N00,5791,11,1359097232,1359097232,1,3,0
99219204@N00,5791,10,1359083088,1359083088,1,3,0
99219204@N00,5791,7,1359100565,1359100565,1,3,0
9926279@N03,5792,15,1460677323,1460677428,2,5,105
9926279@N03,5792,13,1460677838,1460677838,1,5,0
9926279@N03,5792,8,1460687862,1460687977,3,5,115
9926279@N03,5792,17,1460677080,1460683118,4,5,6038
9926279@N03,5792,5,1460678704,1460678704,1,5,0
99385068@N00,5793,5,1258968376,1258968376,1,1,0
99385068@N00,5794,5,1259040313,1259040313,1,1,0
99385068@N00,5795,8,1259211060,1259211095,2,1,35
99385068@N00,5796,2,1383455309,1383459401,4,1,4092
99385068@N00,5797,5,1383628863,1383628882,4,4,19
99385068@N00,5797,17,1383643503,1383643503,1,4,0
99385068@N00,5797,3,1383611193,1383611193,1,4,0
99385068@N00,5797,2,1383608201,1383608581,7,4,380
99385068@N00,5798,5,1383816656,1383817109,20,1,453
99422834@N05,5799,13,1331703527,1331703669,7,1,142
99467063@N06,5800,17,1376105608,1376105608,1,3,0
99467063@N06,5800,6,1376103445,1376103449,2,3,4
99467063@N06,5800,1,1376125062,1376125062,1,3,0
99471343@N00,5801,17,1365980535,1365980560,2,5,25
99471343@N00,5801,2,1365986968,1365988994,3,5,2026
99471343@N00,5801,13,1366014310,1366014310,1,5,0
99471343@N00,5801,5,1365998493,1365998493,1,5,0
99471343@N00,5801,14,1365983852,1365983852,1,5,0
99471343@N00,5802,17,1366326216,1366326216,1,4,0
99471343@N00,5802,11,1366327571,1366349894,2,4,22323
99471343@N00,5802,10,1366326336,1366326336,1,4,0
99471343@N00,5802,13,1366338417,1366340295,4,4,1878
99502551@N08,5803,11,1406015076,1406015076,1,3,0
99502551@N08,5803,5,1406010482,1406011263,2,3,781
99502551@N08,5803,1,1406014190,1406014190,1,3,0
99502551@N08,5804,3,1406191849,1406193639,3,5,1790
99502551@N08,5804,2,1406194028,1406194028,1,5,0
99502551@N08,5804,10,1406189317,1406189394,2,5,77
99502551@N08,5804,13,1406187013,1406187013,1,5,0
99502551@N08,5804,17,1406189174,1406221676,2,5,32502
99502551@N08,5805,11,1406939554,1406939554,1,1,0
99519033@N04,5806,14,1291934953,1291934953,1,1,0
99519033@N04,5807,11,1301563304,1301563304,1,1,0
99544917@N00,5808,8,1406507194,1406507751,2,5,557
99544917@N00,5808,3,1406494650,1406495898,2,5,1248
99544917@N00,5808,10,1406502152,1406502152,1,5,0
99544917@N00,5808,13,1406514229,1406514229,1,5,0
99544917@N00,5808,5,1406506249,1406506249,1,5,0
99555157@N07,5809,11,1452808629,1452808629,1,1,0
99698221@N00,5810,8,1352043843,1352044108,2,1,265
9977376@N05,5811,17,1382164538,1382164538,1,2,0
9977376@N05,5811,10,1382178834,1382178834,1,2,0
9979792@N04,5812,13,1318205054,1318206341,3,2,1287
9979792@N04,5812,16,1318218769,1318220198,3,2,1429
99829373@N00,5813,2,1254007310,1254007350,3,1,40
9984610@N02,5814,4,1437130407,1437130408,3,1,1
9984610@N02,5815,4,1437955936,1437955936,1,1,0
99929871@N00,5816,9,1294702257,1294702257,1,2,0
99929871@N00,5816,11,1294708234,1294724429,2,2,16195
