userID,trajID,poiID,startTime,endTime,#photo,trajLen,poiDuration
10004778@N07,1,26,1308270702,1308270702,1,2,0
10004778@N07,1,6,1308262550,1308262550,1,2,0
10004778@N07,2,6,1308631356,1308631356,1,1,0
10004778@N07,3,26,1355568624,1355568624,1,1,0
10004778@N07,4,29,1373030964,1373030964,1,1,0
10024109@N08,5,26,1283735402,1283753756,4,1,18354
100373287@N02,6,18,1407460054,1407461026,3,9,972
100373287@N02,6,6,1407461671,1407461671,1,9,0
100373287@N02,6,28,1407459897,1407459908,4,9,11
100373287@N02,6,21,1407462056,1407462072,3,9,16
100373287@N02,6,24,1407472411,1407472439,3,9,28
100373287@N02,6,20,1407460984,1407460984,1,9,0
100373287@N02,6,26,1407461302,1407477602,3,9,16300
100373287@N02,6,3,1407461827,1407461850,2,9,23
100373287@N02,6,30,1407463402,1407463463,2,9,61
100432722@N02,7,30,1379584100,1379589530,4,1,5430
100432722@N02,8,26,1431822642,1431822642,1,1,0
100432722@N02,9,21,1440162999,1440162999,1,1,0
100432722@N02,10,26,1447828035,1447828106,2,1,71
100448554@N06,11,29,1356064526,1356064526,1,6,0
100448554@N06,11,13,1356057534,1356058016,2,6,482
100448554@N06,11,19,1356064531,1356064695,4,6,164
100448554@N06,11,3,1356058289,1356058289,1,6,0
100448554@N06,11,20,1356066458,1356066462,2,6,4
100448554@N06,11,26,1356054155,1356054155,1,6,0
100448554@N06,12,20,1356176141,1356176141,1,2,0
100448554@N06,12,1,1356148029,1356148029,1,2,0
10055157@N02,13,26,1357819661,1357819661,1,3,0
10055157@N02,13,25,1357818322,1357818322,1,3,0
10055157@N02,13,29,1357819349,1357819349,1,3,0
10055157@N02,14,26,1389172537,1389172537,1,1,0
10055157@N02,15,7,1400213093,1400213093,1,1,0
10055157@N02,16,3,1462847579,1462847579,1,2,0
10055157@N02,16,5,1462857781,1462857781,1,2,0
10055157@N02,17,5,1462947575,1462947575,1,1,0
10062483@N05,18,15,1219741081,1219741081,1,1,0
10062483@N05,19,25,1260255084,1260255084,1,2,0
10062483@N05,19,28,1260257114,1260257114,1,2,0
10062483@N05,20,12,1336354341,1336354415,2,1,74
10062483@N05,21,15,1348450174,1348450174,1,2,0
10062483@N05,21,28,1348450175,1348450175,1,2,0
100632664@N02,22,26,1466604771,1466604771,1,1,0
100822654@N07,23,1,1389218207,1389218207,1,9,0
100822654@N07,23,14,1389213887,1389214140,3,9,253
100822654@N07,23,30,1389214040,1389214040,1,9,0
100822654@N07,23,28,1389218195,1389218195,1,9,0
100822654@N07,23,18,1389213977,1389213977,1,9,0
100822654@N07,23,17,1389214080,1389214080,1,9,0
100822654@N07,23,29,1389213960,1389214031,2,9,71
100822654@N07,23,20,1389213878,1389213987,2,9,109
100822654@N07,23,27,1389213865,1389213865,1,9,0
10084893@N02,24,27,1207731367,1207731367,1,2,0
10084893@N02,24,28,1207728112,1207728181,4,2,69
10084893@N02,25,28,1208051831,1208051834,2,1,3
100939753@N04,26,27,1392960174,1392960174,1,1,0
101006095@N07,27,29,1379392716,1379392716,1,1,0
10104403@N00,28,10,1252651318,1252685518,44,1,34200
10104403@N00,29,10,1252749467,1252758303,42,2,8836
10104403@N00,29,29,1252758364,1252758933,10,2,569
10104403@N00,30,18,1446047022,1446047022,1,1,0
10104914@N07,31,28,1191396957,1191396957,1,2,0
10104914@N07,31,23,1191397107,1191397107,1,2,0
101055171@N03,32,26,1401581906,1401622225,5,13,40319
101055171@N03,32,13,1401586727,1401586727,1,13,0
101055171@N03,32,27,1401578962,1401579038,2,13,76
101055171@N03,32,7,1401593786,1401593786,1,13,0
101055171@N03,32,28,1401621266,1401621273,3,13,7
101055171@N03,32,1,1401576129,1401582343,5,13,6214
101055171@N03,32,16,1401622216,1401622392,19,13,176
101055171@N03,32,5,1401581109,1401581109,1,13,0
101055171@N03,32,21,1401580251,1401593047,7,13,12796
101055171@N03,32,20,1401597658,1401597658,1,13,0
101055171@N03,32,14,1401601114,1401601114,1,13,0
101055171@N03,32,8,1401581573,1401581573,1,13,0
101055171@N03,32,29,1401596876,1401597647,2,13,771
101055171@N03,33,26,1403675021,1403675032,2,8,11
101055171@N03,33,13,1403674943,1403674969,3,8,26
101055171@N03,33,27,1403675015,1403675015,1,8,0
101055171@N03,33,22,1403674849,1403674849,1,8,0
101055171@N03,33,28,1403675040,1403675074,4,8,34
101055171@N03,33,1,1403675076,1403675093,3,8,17
101055171@N03,33,25,1403674930,1403674930,1,8,0
101055171@N03,33,5,1403674995,1403674995,1,8,0
10106605@N07,34,28,1338536422,1338537126,27,1,704
10106605@N07,35,28,1347425519,1347425526,2,4,7
10106605@N07,35,18,1347423143,1347423213,2,4,70
10106605@N07,35,1,1347435538,1347435538,1,4,0
10106605@N07,35,15,1347419486,1347419486,1,4,0
10106605@N07,36,12,1351658756,1351659875,2,4,1119
10106605@N07,36,20,1351653488,1351653554,2,4,66
10106605@N07,36,13,1351660496,1351661494,10,4,998
10106605@N07,36,15,1351658783,1351659848,4,4,1065
10106605@N07,37,31,1358129217,1358130879,7,4,1662
10106605@N07,37,29,1358130242,1358130242,1,4,0
10106605@N07,37,27,1358122555,1358122555,1,4,0
10106605@N07,37,30,1358124403,1358131074,20,4,6671
101075959@N06,38,18,1376179097,1376186526,4,18,7429
101075959@N06,38,24,1376199686,1376203546,2,18,3860
101075959@N06,38,16,1376190902,1376190902,1,18,0
101075959@N06,38,23,1376179703,1376179978,3,18,275
101075959@N06,38,12,1376196041,1376196041,1,18,0
101075959@N06,38,26,1376190729,1376190809,3,18,80
101075959@N06,38,29,1376179204,1376187100,9,18,7896
101075959@N06,38,31,1376187184,1376187811,3,18,627
101075959@N06,38,21,1376201625,1376202215,16,18,590
101075959@N06,38,28,1376178140,1376186641,6,18,8501
101075959@N06,38,13,1376197129,1376197837,11,18,708
101075959@N06,38,19,1376179170,1376180061,6,18,891
101075959@N06,38,20,1376184507,1376184507,1,18,0
101075959@N06,38,14,1376185497,1376185497,1,18,0
101075959@N06,38,22,1376185320,1376185929,2,18,609
101075959@N06,38,30,1376186988,1376186988,1,18,0
101075959@N06,38,17,1376191557,1376195215,3,18,3658
101075959@N06,38,15,1376198979,1376198989,2,18,10
101200606@N03,39,1,1402019649,1402019649,1,1,0
101208631@N08,40,1,1381456540,1381456540,1,3,0
101208631@N08,40,26,1381459199,1381459199,1,3,0
101208631@N08,40,28,1381456799,1381456799,1,3,0
10129939@N08,41,1,1335659579,1335659579,1,3,0
10129939@N08,41,7,1335661871,1335661961,5,3,90
10129939@N08,41,13,1335670164,1335671490,3,3,1326
10129939@N08,42,30,1335760009,1335760009,1,6,0
10129939@N08,42,16,1335762810,1335762810,1,6,0
10129939@N08,42,1,1335746882,1335746882,1,6,0
10129939@N08,42,29,1335761924,1335761956,2,6,32
10129939@N08,42,15,1335747832,1335755648,5,6,7816
10129939@N08,42,23,1335764441,1335764441,1,6,0
10129939@N08,43,1,1336110665,1336110867,5,5,202
10129939@N08,43,14,1336122615,1336122631,2,5,16
10129939@N08,43,10,1336121219,1336121219,1,5,0
10129939@N08,43,26,1336128680,1336128680,1,5,0
10129939@N08,43,31,1336109171,1336109171,1,5,0
10129939@N08,44,8,1336367190,1336367190,1,1,0
101316071@N05,45,14,1396843805,1396843805,1,4,0
101316071@N05,45,23,1396849660,1396849663,2,4,3
101316071@N05,45,17,1396833995,1396833997,2,4,2
101316071@N05,45,26,1396830761,1396834490,5,4,3729
101334634@N07,46,1,1383998200,1383998200,1,1,0
101355699@N08,47,26,1407761349,1407761349,1,1,0
10136713@N00,48,24,1202718639,1202718639,1,3,0
10136713@N00,48,27,1202716036,1202716036,1,3,0
10136713@N00,48,23,1202725765,1202725965,2,3,200
10136713@N00,49,22,1202788480,1202788480,1,4,0
10136713@N00,49,29,1202795017,1202795017,1,4,0
10136713@N00,49,9,1202770126,1202770126,1,4,0
10136713@N00,49,26,1202769754,1202769754,1,4,0
10136713@N00,50,28,1202892551,1202892551,1,3,0
10136713@N00,50,1,1202893005,1202893005,1,3,0
10136713@N00,50,21,1202889498,1202889498,1,3,0
10136713@N00,51,26,1202941800,1202941800,1,1,0
10136713@N00,52,24,1202979369,1202979369,1,1,0
10136713@N00,53,12,1203037972,1203037972,1,1,0
101434518@N03,54,19,1369739428,1369739428,1,1,0
10143946@N07,55,26,1205975722,1205975722,1,1,0
101445497@N05,56,26,1419806489,1419835049,6,10,28560
101445497@N05,56,28,1419805836,1419830248,6,10,24412
101445497@N05,56,17,1419813737,1419813737,1,10,0
101445497@N05,56,12,1419811749,1419811781,2,10,32
101445497@N05,56,11,1419822563,1419824826,2,10,2263
101445497@N05,56,13,1419821166,1419821923,5,10,757
101445497@N05,56,27,1419813903,1419813903,1,10,0
101445497@N05,56,9,1419827215,1419827215,1,10,0
101445497@N05,56,16,1419827983,1419828069,2,10,86
101445497@N05,56,24,1419812356,1419813130,3,10,774
10152427@N08,57,24,1250499503,1250499503,1,1,0
10152427@N08,58,31,1250610898,1250610898,1,1,0
10152427@N08,59,21,1250901566,1250901566,1,1,0
101538895@N08,60,8,1423380893,1423380893,1,12,0
101538895@N08,60,28,1423367557,1423391714,3,12,24157
101538895@N08,60,27,1423379321,1423379321,1,12,0
101538895@N08,60,18,1423368404,1423368409,2,12,5
101538895@N08,60,16,1423382203,1423382374,5,12,171
101538895@N08,60,3,1423380898,1423381093,2,12,195
101538895@N08,60,1,1423367428,1423392101,4,12,24673
101538895@N08,60,21,1423382799,1423382799,1,12,0
101538895@N08,60,29,1423369156,1423377971,12,12,8815
101538895@N08,60,20,1423372295,1423372580,4,12,285
101538895@N08,60,17,1423378858,1423390023,2,12,11165
101538895@N08,60,19,1423369751,1423388895,8,12,19144
101538895@N08,61,24,1423553956,1423554036,2,4,80
101538895@N08,61,28,1423558155,1423558155,1,4,0
101538895@N08,61,27,1423547925,1423549088,3,4,1163
101538895@N08,61,17,1423549460,1423551439,5,4,1979
101577379@N06,62,28,1384513173,1384513173,1,1,0
101577901@N07,63,28,1332451811,1332452122,5,2,311
101577901@N07,63,1,1332452122,1332452122,1,2,0
101593101@N02,64,17,1465254621,1465271971,2,5,17350
101593101@N02,64,29,1465252676,1465280226,2,5,27550
101593101@N02,64,7,1465255794,1465256168,3,5,374
101593101@N02,64,15,1465265066,1465265066,1,5,0
101593101@N02,64,12,1465287435,1465287435,1,5,0
101599161@N06,65,30,1418288798,1418288798,1,1,0
10167516@N04,66,26,1198853840,1198853993,7,3,153
10167516@N04,66,28,1198854008,1198854307,6,3,299
10167516@N04,66,21,1198852618,1198853133,24,3,515
10182231@N00,67,3,1196382109,1196382109,1,7,0
10182231@N00,67,25,1196388315,1196388367,4,7,52
10182231@N00,67,15,1196373851,1196374090,4,7,239
10182231@N00,67,24,1196385976,1196386359,7,7,383
10182231@N00,67,6,1196374737,1196375937,3,7,1200
10182231@N00,67,20,1196368683,1196368683,1,7,0
10182231@N00,67,26,1196374661,1196374661,1,7,0
10182842@N08,68,26,1308354024,1308366293,11,10,12269
10182842@N08,68,9,1308355448,1308355486,3,10,38
10182842@N08,68,6,1308354452,1308355693,5,10,1241
10182842@N08,68,1,1308359596,1308369957,3,10,10361
10182842@N08,68,13,1308356729,1308358069,10,10,1340
10182842@N08,68,15,1308359141,1308359141,1,10,0
10182842@N08,68,29,1308360454,1308364808,12,10,4354
10182842@N08,68,21,1308358404,1308359032,3,10,628
10182842@N08,68,28,1308365223,1308369424,6,10,4201
10182842@N08,68,3,1308356270,1308358467,5,10,2197
10182842@N08,69,30,1308974592,1308974604,2,11,12
10182842@N08,69,20,1308958238,1308976441,4,11,18203
10182842@N08,69,26,1308959786,1308972465,16,11,12679
10182842@N08,69,17,1308962455,1308962455,1,11,0
10182842@N08,69,25,1308958815,1308958815,1,11,0
10182842@N08,69,29,1308975686,1308998096,15,11,22410
10182842@N08,69,16,1308959954,1308959954,1,11,0
10182842@N08,69,24,1308961988,1308973259,2,11,11271
10182842@N08,69,23,1308972501,1308972501,1,11,0
10182842@N08,69,18,1308974792,1308975587,3,11,795
10182842@N08,69,28,1308959771,1308999603,44,11,39832
10182842@N08,70,23,1309573124,1309594799,5,13,21675
10182842@N08,70,24,1309598041,1309598873,5,13,832
10182842@N08,70,18,1309573067,1309577851,13,13,4784
10182842@N08,70,21,1309565777,1309600029,5,13,34252
10182842@N08,70,27,1309595167,1309595167,1,13,0
10182842@N08,70,30,1309594594,1309594722,2,13,128
10182842@N08,70,28,1309567670,1309578364,29,13,10694
10182842@N08,70,8,1309566850,1309566929,2,13,79
10182842@N08,70,26,1309567152,1309600179,15,13,33027
10182842@N08,70,1,1309591761,1309591808,2,13,47
10182842@N08,70,31,1309600515,1309600515,1,13,0
10182842@N08,70,12,1309562292,1309567047,6,13,4755
10182842@N08,70,29,1309573158,1309600883,14,13,27725
10182842@N08,71,28,1309769771,1309770049,3,1,278
10182842@N08,72,4,1310084902,1310084970,3,12,68
10182842@N08,72,20,1310092561,1310095572,3,12,3011
10182842@N08,72,21,1310082174,1310084853,5,12,2679
10182842@N08,72,18,1310088056,1310096215,6,12,8159
10182842@N08,72,30,1310086560,1310087272,3,12,712
10182842@N08,72,3,1310082071,1310083765,2,12,1694
10182842@N08,72,22,1310086873,1310086873,1,12,0
10182842@N08,72,28,1310096500,1310096628,3,12,128
10182842@N08,72,11,1310085073,1310085360,2,12,287
10182842@N08,72,25,1310084760,1310084760,1,12,0
10182842@N08,72,12,1310081866,1310081866,1,12,0
10182842@N08,72,29,1310086457,1310096057,13,12,9600
10182842@N08,73,15,1310770533,1310770533,1,11,0
10182842@N08,73,24,1310769114,1310770644,22,11,1530
10182842@N08,73,30,1310774222,1310791969,3,11,17747
10182842@N08,73,27,1310782573,1310782625,4,11,52
10182842@N08,73,22,1310774729,1310776828,27,11,2099
10182842@N08,73,28,1310768743,1310768743,1,11,0
10182842@N08,73,9,1310773496,1310773496,1,11,0
10182842@N08,73,20,1310776928,1310790220,2,11,13292
10182842@N08,73,26,1310773235,1310773335,5,11,100
10182842@N08,73,12,1310770679,1310770745,2,11,66
10182842@N08,73,29,1310777115,1310791841,7,11,14726
10182842@N08,74,13,1310889377,1310889377,1,3,0
10182842@N08,74,24,1310893355,1310894722,9,3,1367
10182842@N08,74,25,1310889440,1310889461,2,3,21
10182842@N08,75,23,1311814430,1311818385,2,6,3955
10182842@N08,75,20,1311813790,1311813790,1,6,0
10182842@N08,75,18,1311818227,1311818227,1,6,0
10182842@N08,75,25,1311808940,1311810117,26,6,1177
10182842@N08,75,1,1311813310,1311813507,3,6,197
10182842@N08,75,29,1311814544,1311818161,2,6,3617
10182842@N08,76,30,1312591045,1312593071,6,8,2026
10182842@N08,76,27,1312588387,1312606028,4,8,17641
10182842@N08,76,18,1312595499,1312595499,1,8,0
10182842@N08,76,22,1312591427,1312592060,10,8,633
10182842@N08,76,28,1312604783,1312604812,2,8,29
10182842@N08,76,29,1312592615,1312592615,1,8,0
10182842@N08,76,16,1312604917,1312605518,6,8,601
10182842@N08,76,24,1312586197,1312586568,3,8,371
10182842@N08,77,30,1313303252,1313303252,1,4,0
10182842@N08,77,11,1313303083,1313303083,1,4,0
10182842@N08,77,12,1313302849,1313302875,2,4,26
10182842@N08,77,29,1313303928,1313306771,5,4,2843
10182842@N08,78,23,1314407355,1314407355,1,11,0
10182842@N08,78,13,1314402581,1314404703,10,11,2122
10182842@N08,78,24,1314400905,1314400905,1,11,0
10182842@N08,78,27,1314400405,1314411993,7,11,11588
10182842@N08,78,28,1314414127,1314414127,1,11,0
10182842@N08,78,11,1314405500,1314408741,4,11,3241
10182842@N08,78,21,1314402564,1314404789,2,11,2225
10182842@N08,78,25,1314402679,1314402875,3,11,196
10182842@N08,78,26,1314411576,1314411671,4,11,95
10182842@N08,78,17,1314401065,1314401065,1,11,0
10182842@N08,78,29,1314407504,1314411262,6,11,3758
10182842@N08,79,24,1315649502,1315650094,3,8,592
10182842@N08,79,3,1315648609,1315648698,3,8,89
10182842@N08,79,30,1315646200,1315646200,1,8,0
10182842@N08,79,22,1315645425,1315645921,2,8,496
10182842@N08,79,9,1315647048,1315648050,7,8,1002
10182842@N08,79,20,1315642839,1315645509,5,8,2670
10182842@N08,79,4,1315648516,1315648516,1,8,0
10182842@N08,79,16,1315650500,1315650500,1,8,0
10182842@N08,80,1,1316485287,1316497671,2,5,12384
10182842@N08,80,28,1316485598,1316497368,4,5,11770
10182842@N08,80,13,1316487333,1316489139,6,5,1806
10182842@N08,80,15,1316491040,1316494744,9,5,3704
10182842@N08,80,26,1316485818,1316496427,12,5,10609
10182842@N08,81,24,1317412532,1317414086,5,1,1554
10182842@N08,82,28,1317467743,1317467743,1,2,0
10182842@N08,82,24,1317456778,1317466842,33,2,10064
10182842@N08,83,21,1318062290,1318062290,1,9,0
10182842@N08,83,1,1318054192,1318054354,2,9,162
10182842@N08,83,28,1318064576,1318065569,4,9,993
10182842@N08,83,4,1318060963,1318062102,6,9,1139
10182842@N08,83,20,1318058468,1318058468,1,9,0
10182842@N08,83,22,1318058812,1318059275,4,9,463
10182842@N08,83,30,1318059804,1318059804,1,9,0
10182842@N08,83,24,1318063973,1318063989,2,9,16
10182842@N08,83,31,1318058429,1318058429,1,9,0
10182842@N08,84,1,1318555089,1318555089,1,8,0
10182842@N08,84,11,1318550156,1318550168,2,8,12
10182842@N08,84,4,1318549555,1318549955,4,8,400
10182842@N08,84,20,1318544079,1318544132,4,8,53
10182842@N08,84,22,1318545690,1318546440,4,8,750
10182842@N08,84,30,1318550867,1318550867,1,8,0
10182842@N08,84,26,1318549290,1318549408,6,8,118
10182842@N08,84,31,1318546610,1318553802,8,8,7192
10182842@N08,85,1,1320115136,1320115136,1,6,0
10182842@N08,85,28,1320114882,1320115000,2,6,118
10182842@N08,85,23,1320107395,1320107395,1,6,0
10182842@N08,85,27,1320110160,1320110264,2,6,104
10182842@N08,85,26,1320106693,1320111758,2,6,5065
10182842@N08,85,24,1320106083,1320106083,1,6,0
10182842@N08,86,1,1321074694,1321074694,1,8,0
10182842@N08,86,28,1321074845,1321074845,1,8,0
10182842@N08,86,13,1321078955,1321078955,1,8,0
10182842@N08,86,20,1321076401,1321078615,5,8,2214
10182842@N08,86,30,1321075660,1321075660,1,8,0
10182842@N08,86,26,1321075466,1321075466,1,8,0
10182842@N08,86,24,1321079571,1321079591,2,8,20
10182842@N08,86,29,1321075909,1321076331,4,8,422
10182842@N08,87,21,1324105870,1324105950,3,6,80
10182842@N08,87,1,1324097435,1324097435,1,6,0
10182842@N08,87,20,1324103347,1324103347,1,6,0
10182842@N08,87,25,1324098903,1324102228,14,6,3325
10182842@N08,87,26,1324105309,1324105573,3,6,264
10182842@N08,87,29,1324105102,1324105102,1,6,0
10182842@N08,88,21,1326522550,1326522550,1,13,0
10182842@N08,88,28,1326515755,1326525645,4,13,9890
10182842@N08,88,11,1326520167,1326520421,2,13,254
10182842@N08,88,4,1326515796,1326515796,1,13,0
10182842@N08,88,13,1326520868,1326520868,1,13,0
10182842@N08,88,23,1326516051,1326516051,1,13,0
10182842@N08,88,22,1326518938,1326518938,1,13,0
10182842@N08,88,15,1326534736,1326534736,1,13,0
10182842@N08,88,26,1326515769,1326526027,4,13,10258
10182842@N08,88,24,1326530856,1326533563,23,13,2707
10182842@N08,88,29,1326516035,1326522855,10,13,6820
10182842@N08,88,9,1326520407,1326520407,1,13,0
10182842@N08,88,25,1326529478,1326529486,2,13,8
10182842@N08,89,28,1327135804,1327136747,8,2,943
10182842@N08,89,29,1327132849,1327132980,2,2,131
10182842@N08,90,30,1330709521,1330710498,2,14,977
10182842@N08,90,22,1330709609,1330709837,3,14,228
10182842@N08,90,29,1330710081,1330710081,1,14,0
10182842@N08,90,26,1330714215,1330714511,3,14,296
10182842@N08,90,24,1330713872,1330728830,7,14,14958
10182842@N08,90,3,1330711799,1330712267,6,14,468
10182842@N08,90,12,1330713681,1330713784,2,14,103
10182842@N08,90,28,1330714440,1330714746,4,14,306
10182842@N08,90,11,1330711047,1330711119,3,14,72
10182842@N08,90,4,1330711238,1330711790,6,14,552
10182842@N08,90,25,1330712381,1330712381,1,14,0
10182842@N08,90,13,1330713012,1330713274,4,14,262
10182842@N08,90,15,1330713975,1330713975,1,14,0
10182842@N08,90,20,1330708780,1330708780,1,14,0
10182842@N08,91,30,1331465982,1331466600,2,8,618
10182842@N08,91,29,1331485687,1331486959,6,8,1272
10182842@N08,91,15,1331466677,1331469751,3,8,3074
10182842@N08,91,26,1331465041,1331485221,3,8,20180
10182842@N08,91,24,1331467209,1331467209,1,8,0
10182842@N08,91,28,1331483064,1331483072,2,8,8
10182842@N08,91,1,1331495919,1331495919,1,8,0
10182842@N08,91,17,1331467916,1331469824,2,8,1908
10182842@N08,92,27,1333242900,1333276500,5,8,33600
10182842@N08,92,30,1333247369,1333248033,9,8,664
10182842@N08,92,29,1333254029,1333256250,3,8,2221
10182842@N08,92,26,1333244470,1333256945,8,8,12475
10182842@N08,92,17,1333250330,1333251987,3,8,1657
10182842@N08,92,16,1333253030,1333253030,1,8,0
10182842@N08,92,28,1333273470,1333273470,1,8,0
10182842@N08,92,23,1333244792,1333245282,4,8,490
10182842@N08,93,29,1333333385,1333333385,1,6,0
10182842@N08,93,26,1333307068,1333339551,7,6,32483
10182842@N08,93,24,1333311690,1333326936,24,6,15246
10182842@N08,93,12,1333340036,1333340193,3,6,157
10182842@N08,93,28,1333311161,1333338177,6,6,27016
10182842@N08,93,20,1333333869,1333336860,3,6,2991
10182842@N08,94,27,1334404627,1334404627,1,12,0
10182842@N08,94,30,1334406850,1334411734,6,12,4884
10182842@N08,94,22,1334408378,1334409158,5,12,780
10182842@N08,94,29,1334405243,1334409914,13,12,4671
10182842@N08,94,26,1334404834,1334412077,8,12,7243
10182842@N08,94,21,1334405779,1334405784,2,12,5
10182842@N08,94,31,1334408304,1334408304,1,12,0
10182842@N08,94,7,1334406515,1334406515,1,12,0
10182842@N08,94,3,1334405710,1334405822,3,12,112
10182842@N08,94,16,1334404721,1334404721,1,12,0
10182842@N08,94,28,1334412150,1334412432,2,12,282
10182842@N08,94,11,1334406111,1334407072,5,12,961
10182842@N08,95,9,1335510101,1335510184,3,7,83
10182842@N08,95,26,1335510313,1335511171,12,7,858
10182842@N08,95,24,1335480668,1335518968,25,7,38300
10182842@N08,95,1,1335507982,1335507982,1,7,0
10182842@N08,95,3,1335509009,1335509256,4,7,247
10182842@N08,95,12,1335508682,1335508864,2,7,182
10182842@N08,95,11,1335509591,1335509808,3,7,217
10182842@N08,96,22,1336293280,1336293785,6,4,505
10182842@N08,96,29,1336291361,1336295124,2,4,3763
10182842@N08,96,31,1336295094,1336295094,1,4,0
10182842@N08,96,28,1336291051,1336291051,1,4,0
10182842@N08,97,30,1336712883,1336712883,1,8,0
10182842@N08,97,29,1336712933,1336714083,3,8,1150
10182842@N08,97,9,1336712501,1336712513,2,8,12
10182842@N08,97,26,1336688983,1336712718,7,8,23735
10182842@N08,97,24,1336710618,1336731176,5,8,20558
10182842@N08,97,21,1336711539,1336712275,2,8,736
10182842@N08,97,1,1336710324,1336710324,1,8,0
10182842@N08,97,13,1336710919,1336711015,2,8,96
10182842@N08,98,30,1338162801,1338163350,3,9,549
10182842@N08,98,22,1338161485,1338162402,15,9,917
10182842@N08,98,29,1338160560,1338160961,4,9,401
10182842@N08,98,26,1338160221,1338163742,3,9,3521
10182842@N08,98,1,1338163993,1338163993,1,9,0
10182842@N08,98,17,1338158085,1338158085,1,9,0
10182842@N08,98,16,1338160061,1338160070,2,9,9
10182842@N08,98,28,1338157677,1338163987,3,9,6310
10182842@N08,98,23,1338160306,1338160786,2,9,480
10182842@N08,99,15,1339089107,1339089107,1,7,0
10182842@N08,99,26,1339085770,1339090627,2,7,4857
10182842@N08,99,16,1339086074,1339086074,1,7,0
10182842@N08,99,12,1339088416,1339088614,2,7,198
10182842@N08,99,28,1339085138,1339090739,8,7,5601
10182842@N08,99,11,1339087902,1339087902,1,7,0
10182842@N08,99,4,1339087650,1339087889,2,7,239
10182842@N08,100,26,1339911703,1339911703,1,3,0
10182842@N08,100,28,1339911456,1339911456,1,3,0
10182842@N08,100,3,1339911921,1339911948,2,3,27
10182842@N08,101,23,1341367633,1341367635,3,10,2
10182842@N08,101,26,1341361444,1341363378,9,10,1934
10182842@N08,101,1,1341361743,1341361743,1,10,0
10182842@N08,101,25,1341365465,1341366688,3,10,1223
10182842@N08,101,30,1341367106,1341367162,3,10,56
10182842@N08,101,12,1341365155,1341365232,2,10,77
10182842@N08,101,28,1341370227,1341370431,3,10,204
10182842@N08,101,3,1341363522,1341366765,3,10,3243
10182842@N08,101,13,1341365875,1341366519,5,10,644
10182842@N08,101,29,1341369668,1341369878,4,10,210
10182842@N08,102,23,1343465508,1343465744,2,3,236
10182842@N08,102,16,1343465020,1343465020,1,3,0
10182842@N08,102,30,1343463667,1343464657,7,3,990
10182842@N08,103,21,1346060347,1346060400,2,3,53
10182842@N08,103,12,1346060598,1346060598,1,3,0
10182842@N08,103,13,1346059498,1346059979,5,3,481
10182842@N08,104,26,1348120907,1348121009,2,3,102
10182842@N08,104,28,1348114674,1348122703,2,3,8029
10182842@N08,104,29,1348115520,1348119045,3,3,3525
10182842@N08,105,24,1348909917,1348915368,10,1,5451
10182842@N08,106,16,1351405640,1351405640,1,2,0
10182842@N08,106,3,1351406403,1351406403,1,2,0
10182842@N08,107,24,1352019807,1352026929,5,1,7122
10182842@N08,108,26,1352593043,1352593477,3,1,434
10182842@N08,109,26,1355883487,1355883487,1,4,0
10182842@N08,109,28,1355882347,1355905572,3,4,23225
10182842@N08,109,4,1355883921,1355883921,1,4,0
10182842@N08,109,29,1355884866,1355887858,2,4,2992
10182842@N08,110,4,1357345064,1357345064,1,3,0
10182842@N08,110,26,1357344528,1357344619,2,3,91
10182842@N08,110,28,1357348022,1357348022,1,3,0
10182842@N08,111,26,1359874884,1359874932,2,1,48
10182842@N08,112,30,1364423263,1364423263,1,10,0
10182842@N08,112,4,1364422424,1364422424,1,10,0
10182842@N08,112,12,1364419874,1364419874,1,10,0
10182842@N08,112,13,1364421470,1364421519,2,10,49
10182842@N08,112,26,1364422724,1364430013,5,10,7289
10182842@N08,112,21,1364419956,1364421788,3,10,1832
10182842@N08,112,29,1364427176,1364427420,2,10,244
10182842@N08,112,1,1364431401,1364431401,1,10,0
10182842@N08,112,28,1364430689,1364430689,1,10,0
10182842@N08,112,24,1364419604,1364419604,1,10,0
10182842@N08,113,12,1365112791,1365112791,1,1,0
10182842@N08,114,29,1365199244,1365199244,1,3,0
10182842@N08,114,17,1365198284,1365198284,1,3,0
10182842@N08,114,22,1365200868,1365200868,1,3,0
10182842@N08,115,5,1368257310,1368257310,1,3,0
10182842@N08,115,1,1368259202,1368259202,1,3,0
10182842@N08,115,28,1368254140,1368254609,4,3,469
10182842@N08,116,24,1370686363,1370693432,5,2,7069
10182842@N08,116,28,1370697053,1370697053,1,2,0
10182842@N08,117,4,1386487865,1386487865,1,3,0
10182842@N08,117,13,1386486029,1386486226,2,3,197
10182842@N08,117,3,1386487996,1386488022,2,3,26
10182842@N08,118,26,1391164282,1391164282,1,2,0
10182842@N08,118,16,1391163928,1391163928,1,2,0
10182842@N08,119,4,1391922999,1391922999,1,5,0
10182842@N08,119,9,1391922892,1391922892,1,5,0
10182842@N08,119,30,1391923641,1391923641,1,5,0
10182842@N08,119,26,1391920395,1391922904,4,5,2509
10182842@N08,119,28,1391924927,1391924927,1,5,0
10182842@N08,120,3,1396162180,1396162652,3,8,472
10182842@N08,120,30,1396161377,1396161400,2,8,23
10182842@N08,120,13,1396158932,1396159091,2,8,159
10182842@N08,120,29,1396160197,1396160197,1,8,0
10182842@N08,120,12,1396162200,1396162200,1,8,0
10182842@N08,120,26,1396162440,1396162556,2,8,116
10182842@N08,120,20,1396158582,1396158667,2,8,85
10182842@N08,120,1,1396158041,1396158041,1,8,0
10182842@N08,121,24,1401613631,1401613631,1,1,0
10182842@N08,122,24,1402048291,1402049686,7,1,1395
10182842@N08,123,25,1405171216,1405171216,1,1,0
10182842@N08,124,1,1406998695,1406999131,10,1,436
10182842@N08,125,30,1409069333,1409069333,1,1,0
10182842@N08,126,3,1410565560,1410565560,1,10,0
10182842@N08,126,30,1410564694,1410564747,2,10,53
10182842@N08,126,24,1410566791,1410566889,2,10,98
10182842@N08,126,29,1410563221,1410563535,4,10,314
10182842@N08,126,31,1410563547,1410564329,2,10,782
10182842@N08,126,12,1410567028,1410567028,1,10,0
10182842@N08,126,26,1410561901,1410562115,3,10,214
10182842@N08,126,23,1410563007,1410563007,1,10,0
10182842@N08,126,22,1410563902,1410564075,2,10,173
10182842@N08,126,1,1410561649,1410561649,1,10,0
10182842@N08,127,24,1417674134,1417674371,2,6,237
10182842@N08,127,31,1417667830,1417667830,1,6,0
10182842@N08,127,1,1417664364,1417664364,1,6,0
10182842@N08,127,28,1417664569,1417686758,4,6,22189
10182842@N08,127,26,1417680959,1417686327,2,6,5368
10182842@N08,127,23,1417667220,1417667220,1,6,0
10182842@N08,128,26,1422167166,1422167166,1,1,0
10182842@N08,129,26,1424340775,1424340775,1,1,0
10182842@N08,130,28,1425013435,1425015180,3,1,1745
10185356@N05,131,27,1377224819,1377224819,1,1,0
10185356@N05,132,13,1377295783,1377295783,1,1,0
10196023@N00,133,1,1188080222,1188080222,1,2,0
10196023@N00,133,28,1188087629,1188087629,1,2,0
10196023@N00,134,8,1188899133,1188899133,1,1,0
10196023@N00,135,28,1191026782,1191028103,2,1,1321
10196023@N00,136,26,1194040265,1194046831,2,3,6566
10196023@N00,136,16,1194039905,1194039905,1,3,0
10196023@N00,136,29,1194048205,1194048205,1,3,0
10196023@N00,137,26,1196298262,1196298262,1,2,0
10196023@N00,137,29,1196296088,1196296088,1,2,0
10196023@N00,138,26,1199231284,1199231284,1,1,0
10196023@N00,139,29,1200185798,1200185798,1,1,0
10196023@N00,140,15,1203131096,1203131096,1,1,0
10196023@N00,141,28,1203719350,1203719397,2,3,47
10196023@N00,141,21,1203722435,1203722435,1,3,0
10196023@N00,141,26,1203719569,1203719569,1,3,0
10196023@N00,142,1,1204769348,1204769348,1,1,0
10196023@N00,143,11,1205565211,1205565211,1,1,0
10196023@N00,144,26,1209178338,1209178338,1,1,0
10196023@N00,145,28,1215811965,1215811965,1,3,0
10196023@N00,145,13,1215821586,1215822054,2,3,468
10196023@N00,145,24,1215812840,1215813866,2,3,1026
10196023@N00,146,30,1215906481,1215907057,2,2,576
10196023@N00,146,28,1215898955,1215898955,1,2,0
10196023@N00,147,30,1215957180,1215957180,1,5,0
10196023@N00,147,28,1215938963,1215960475,5,5,21512
10196023@N00,147,16,1215954569,1215959032,3,5,4463
10196023@N00,147,26,1215955969,1215958509,2,5,2540
10196023@N00,147,29,1215957462,1215957462,1,5,0
10196023@N00,148,30,1219451666,1219451666,1,1,0
10196023@N00,149,31,1225507133,1225507133,1,3,0
10196023@N00,149,17,1225505561,1225505561,1,3,0
10196023@N00,149,26,1225491774,1225491865,2,3,91
10196023@N00,150,14,1225932922,1225932922,1,3,0
10196023@N00,150,29,1225931264,1225931264,1,3,0
10196023@N00,150,24,1225936035,1225936035,1,3,0
10196023@N00,151,11,1227315315,1227315315,1,1,0
10196023@N00,152,26,1229811944,1229814957,2,1,3013
10196023@N00,153,16,1232159453,1232159527,2,1,74
10196023@N00,154,26,1233367924,1233367924,1,1,0
10196023@N00,155,25,1235172549,1235172937,9,2,388
10196023@N00,155,18,1235180236,1235180236,1,2,0
10196023@N00,156,23,1245461496,1245463009,3,1,1513
10196023@N00,157,1,1247410386,1247410386,1,1,0
10196023@N00,158,24,1256946444,1256946444,1,1,0
10196023@N00,159,26,1257027579,1257027579,1,1,0
10196023@N00,160,26,1259398996,1259398996,1,1,0
10196023@N00,161,16,1259557306,1259557306,1,1,0
10196023@N00,162,29,1261451475,1261451475,1,1,0
10196023@N00,163,24,1278212958,1278212958,1,1,0
10196023@N00,164,30,1341141625,1341141625,1,1,0
10196023@N00,165,16,1356303917,1356303917,1,1,0
10196023@N00,166,15,1371864669,1371864669,1,2,0
10196023@N00,166,3,1371860913,1371860913,1,2,0
10196023@N00,167,20,1380935918,1380935918,1,1,0
10196023@N00,168,13,1409057115,1409057115,1,1,0
10196023@N00,169,28,1436656797,1436656797,1,1,0
10204545@N02,170,26,1350937837,1350937953,2,1,116
10206042@N07,171,6,1366703496,1366703496,1,4,0
10206042@N07,171,7,1366705634,1366705634,1,4,0
10206042@N07,171,26,1366709995,1366709995,1,4,0
10206042@N07,171,12,1366697316,1366697316,1,4,0
102237062@N02,172,17,1451358366,1451359510,6,10,1144
102237062@N02,172,20,1451340255,1451340810,10,10,555
102237062@N02,172,22,1451361339,1451363076,3,10,1737
102237062@N02,172,23,1451336477,1451339448,8,10,2971
102237062@N02,172,8,1451335241,1451335725,4,10,484
102237062@N02,172,12,1451343205,1451355632,16,10,12427
102237062@N02,172,6,1451333472,1451333781,3,10,309
102237062@N02,172,29,1451340389,1451363456,2,10,23067
102237062@N02,172,24,1451345543,1451346727,2,10,1184
102237062@N02,172,30,1451350290,1451351586,5,10,1296
102237062@N02,173,17,1451519240,1451520397,4,9,1157
102237062@N02,173,15,1451515992,1451516099,2,9,107
102237062@N02,173,26,1451522914,1451523219,7,9,305
102237062@N02,173,6,1451522657,1451522739,4,9,82
102237062@N02,173,13,1451512598,1451514684,14,9,2086
102237062@N02,173,28,1451523643,1451523643,1,9,0
102237062@N02,173,1,1451516192,1451516614,3,9,422
102237062@N02,173,25,1451510942,1451517505,17,9,6563
102237062@N02,173,21,1451520836,1451520957,4,9,121
102249118@N03,174,26,1368598280,1368598280,1,1,0
10245245@N07,175,29,1330695205,1330695205,1,1,0
10259824@N06,176,29,1224410819,1224410819,1,1,0
10259875@N03,177,28,1342781284,1342798842,4,11,17558
10259875@N03,177,16,1342788790,1342795283,3,11,6493
10259875@N03,177,11,1342761912,1342761912,1,11,0
10259875@N03,177,27,1342792625,1342792625,1,11,0
10259875@N03,177,26,1342754326,1342796385,5,11,42059
10259875@N03,177,12,1342760017,1342760017,1,11,0
10259875@N03,177,31,1342756676,1342756676,1,11,0
10259875@N03,177,7,1342754408,1342754408,1,11,0
10259875@N03,177,23,1342761565,1342786057,4,11,24492
10259875@N03,177,5,1342796178,1342796178,1,11,0
10259875@N03,177,1,1342746605,1342781680,3,11,35075
10259875@N03,178,28,1455758586,1455808332,5,11,49746
10259875@N03,178,4,1455790019,1455790019,1,11,0
10259875@N03,178,11,1455780678,1455780678,1,11,0
10259875@N03,178,24,1455778030,1455778030,1,11,0
10259875@N03,178,29,1455792949,1455792949,1,11,0
10259875@N03,178,21,1455782265,1455804148,10,11,21883
10259875@N03,178,26,1455758878,1455805049,6,11,46171
10259875@N03,178,23,1455807642,1455807642,1,11,0
10259875@N03,178,13,1455790912,1455791842,3,11,930
10259875@N03,178,1,1455758458,1455773459,4,11,15001
10259875@N03,178,25,1455791999,1455791999,1,11,0
102667810@N03,179,27,1366435865,1366435865,1,6,0
102667810@N03,179,17,1366435751,1366442452,7,6,6701
102667810@N03,179,30,1366439359,1366439372,2,6,13
102667810@N03,179,31,1366419826,1366425995,3,6,6169
102667810@N03,179,29,1366417565,1366424169,6,6,6604
102667810@N03,179,1,1366417527,1366442328,8,6,24801
102667810@N03,180,17,1366511088,1366511088,1,1,0
10274899@N06,181,5,1248758614,1248758614,1,5,0
10274899@N06,181,24,1248772343,1248775221,3,5,2878
10274899@N06,181,27,1248777611,1248780681,2,5,3070
10274899@N06,181,16,1248775960,1248775960,1,5,0
10274899@N06,181,12,1248771739,1248771783,2,5,44
10274899@N06,182,1,1248833586,1248833796,2,1,210
10274899@N06,183,21,1248922880,1248922880,1,1,0
10285746@N06,184,1,1374627124,1374627124,1,1,0
10290887@N03,185,6,1289039670,1289039670,1,1,0
10295241@N02,186,25,1353156103,1353156791,2,3,688
10295241@N02,186,26,1353153883,1353153883,1,3,0
10295241@N02,186,28,1353135926,1353135926,1,3,0
10295241@N02,187,11,1366426815,1366438998,3,10,12183
10295241@N02,187,16,1366428736,1366428736,1,10,0
10295241@N02,187,27,1366439152,1366439211,2,10,59
10295241@N02,187,19,1366431872,1366462252,5,10,30380
10295241@N02,187,31,1366422564,1366459231,5,10,36667
10295241@N02,187,29,1366421503,1366461309,3,10,39806
10295241@N02,187,1,1366438652,1366438652,1,10,0
10295241@N02,187,26,1366429684,1366430716,4,10,1032
10295241@N02,187,23,1366457446,1366458435,5,10,989
10295241@N02,187,28,1366421041,1366463769,2,10,42728
10295241@N02,188,31,1366507644,1366507660,2,2,16
10295241@N02,188,20,1366508122,1366508122,1,2,0
10295241@N02,189,9,1425033266,1425033266,1,1,0
10295241@N02,190,1,1425095052,1425095052,1,2,0
10295241@N02,190,15,1425098564,1425098564,1,2,0
10295241@N02,191,26,1431053415,1431053415,1,1,0
10295241@N02,192,20,1431153312,1431153312,1,1,0
10295241@N02,193,19,1441510103,1441510103,1,1,0
10295241@N02,194,26,1441601877,1441601921,2,1,44
102953813@N07,195,29,1270260878,1270260878,1,1,0
102953813@N07,196,16,1284273748,1284273797,2,1,49
102953813@N07,197,26,1288330919,1288330919,2,1,0
102953813@N07,198,16,1296963800,1296963800,1,1,0
102953813@N07,199,25,1365758041,1365758061,2,7,20
102953813@N07,199,14,1365751665,1365751978,3,7,313
102953813@N07,199,21,1365756693,1365756693,1,7,0
102953813@N07,199,1,1365749473,1365758427,12,7,8954
102953813@N07,199,22,1365751351,1365751351,1,7,0
102953813@N07,199,12,1365749991,1365749991,1,7,0
102953813@N07,199,29,1365753203,1365754197,4,7,994
102953813@N07,200,28,1365942301,1365942313,2,1,12
102953813@N07,201,31,1367558188,1367559531,2,6,1343
102953813@N07,201,23,1367560821,1367560821,1,6,0
102953813@N07,201,29,1367555152,1367555152,1,6,0
102953813@N07,201,16,1367573015,1367573015,1,6,0
102953813@N07,201,18,1367561170,1367563328,3,6,2158
102953813@N07,201,25,1367556036,1367556036,1,6,0
102953813@N07,202,29,1371359752,1371359752,1,3,0
102953813@N07,202,15,1371358533,1371358533,1,3,0
102953813@N07,202,24,1371357845,1371357845,1,3,0
102953813@N07,203,30,1371979301,1371979590,2,4,289
102953813@N07,203,29,1371971004,1371971181,2,4,177
102953813@N07,203,22,1371975016,1371975016,1,4,0
102953813@N07,203,1,1371969480,1371969480,1,4,0
102953813@N07,204,26,1374037664,1374038111,2,3,447
102953813@N07,204,5,1374038739,1374038739,1,3,0
102953813@N07,204,28,1374036421,1374036421,1,3,0
102953813@N07,205,27,1374914563,1374917254,2,13,2691
102953813@N07,205,4,1374909674,1374909674,1,13,0
102953813@N07,205,12,1374910277,1374910277,1,13,0
102953813@N07,205,3,1374909868,1374909868,1,13,0
102953813@N07,205,17,1374910505,1374910505,1,13,0
102953813@N07,205,29,1374904304,1374904461,2,13,157
102953813@N07,205,22,1374902757,1374902757,1,13,0
102953813@N07,205,16,1374912946,1374917287,3,13,4341
102953813@N07,205,24,1374910165,1374910165,1,13,0
102953813@N07,205,1,1374905828,1374917788,2,13,11960
102953813@N07,205,11,1374909509,1374909599,2,13,90
102953813@N07,205,18,1374894967,1374899291,7,13,4324
102953813@N07,205,28,1374883200,1374936449,6,13,53249
102953813@N07,206,28,1378806549,1378806549,1,1,0
102953813@N07,207,3,1379064440,1379064922,2,7,482
102953813@N07,207,17,1379056395,1379056395,2,7,0
102953813@N07,207,13,1379065768,1379065768,1,7,0
102953813@N07,207,24,1379059364,1379060116,3,7,752
102953813@N07,207,1,1379055558,1379055638,2,7,80
102953813@N07,207,11,1379061424,1379061836,4,7,412
102953813@N07,207,15,1379059138,1379060042,3,7,904
102953813@N07,208,22,1379221294,1379221294,1,3,0
102953813@N07,208,13,1379223892,1379223892,1,3,0
102953813@N07,208,11,1379223052,1379223052,1,3,0
102953813@N07,209,26,1379929087,1379930029,2,4,942
102953813@N07,209,12,1379927786,1379927786,1,4,0
102953813@N07,209,28,1379923034,1379923034,1,4,0
102953813@N07,209,21,1379927968,1379927968,1,4,0
102953813@N07,210,25,1382689538,1382689538,1,1,0
102953813@N07,211,16,1385885417,1385885417,1,7,0
102953813@N07,211,28,1385889430,1385889800,3,7,370
102953813@N07,211,1,1385882397,1385882397,1,7,0
102953813@N07,211,25,1385886967,1385887086,2,7,119
102953813@N07,211,27,1385884805,1385884805,1,7,0
102953813@N07,211,26,1385886035,1385886035,1,7,0
102953813@N07,211,7,1385886218,1385886218,1,7,0
102953813@N07,212,1,1386748574,1386748574,1,1,0
102953813@N07,213,28,1387263241,1387275538,3,5,12297
102953813@N07,213,8,1387274626,1387274626,1,5,0
102953813@N07,213,1,1387262392,1387262392,1,5,0
102953813@N07,213,26,1387274844,1387274942,2,5,98
102953813@N07,213,13,1387271616,1387271616,1,5,0
10299767@N08,214,6,1224456217,1224456217,1,1,0
10299767@N08,215,12,1224544197,1224544197,1,1,0
10299767@N08,216,23,1258857215,1258857215,1,1,0
10299767@N08,217,16,1258932130,1258932231,4,1,101
10299767@N08,218,16,1259031962,1259031962,1,2,0
10299767@N08,218,30,1259022238,1259022238,1,2,0
10299767@N08,219,1,1303026695,1303026695,1,1,0
10299767@N08,220,30,1400141069,1400141069,1,1,0
10299767@N08,221,16,1400241654,1400241654,1,2,0
10299767@N08,221,15,1400227239,1400227239,1,2,0
10299767@N08,222,30,1400284781,1400284781,1,1,0
10302113@N02,223,13,1258098861,1258098878,2,6,17
10302113@N02,223,1,1258079350,1258080249,3,6,899
10302113@N02,223,28,1258076127,1258078285,3,6,2158
10302113@N02,223,16,1258077602,1258088698,11,6,11096
10302113@N02,223,27,1258086726,1258087607,3,6,881
10302113@N02,223,21,1258090168,1258102289,16,6,12121
10304915@N00,224,10,1335688736,1335688736,1,1,0
10304915@N00,225,26,1426840464,1426840464,1,1,0
10304915@N00,226,18,1435621852,1435621852,1,1,0
103109013@N07,227,18,1395024508,1395024513,2,3,5
103109013@N07,227,26,1395028512,1395028513,2,3,1
103109013@N07,227,14,1395027761,1395027761,1,3,0
10317486@N06,228,12,1230863169,1230863169,1,1,0
103297030@N03,229,13,1388294070,1388294092,2,1,22
10339790@N07,230,7,1371297905,1371297909,2,1,4
103400918@N03,231,17,1375573219,1375573219,1,1,0
10352809@N08,232,1,1329808682,1329808692,4,3,10
10352809@N08,232,25,1329787052,1329787087,4,3,35
10352809@N08,232,26,1329809156,1329809200,9,3,44
103564614@N04,233,18,1452271104,1452271463,2,1,359
10358880@N05,234,26,1205812949,1205812949,1,1,0
10358880@N05,235,12,1223787704,1223787704,1,1,0
10358880@N05,236,1,1224048674,1224048674,1,3,0
10358880@N05,236,26,1224049901,1224049901,1,3,0
10358880@N05,236,6,1224051061,1224051061,1,3,0
10358880@N05,237,26,1241425118,1241425118,1,1,0
10358880@N05,238,13,1242085080,1242085820,2,1,740
10358880@N05,239,3,1245811469,1245811469,1,5,0
10358880@N05,239,28,1245811827,1245811827,1,5,0
10358880@N05,239,23,1245803216,1245803216,1,5,0
10358880@N05,239,29,1245802593,1245802593,1,5,0
10358880@N05,239,7,1245830400,1245830400,1,5,0
103708587@N06,240,26,1388447532,1388447532,1,1,0
10382366@N03,241,4,1348853586,1348853586,1,1,0
10414404@N08,242,29,1374140646,1374147413,2,1,6767
10414404@N08,243,29,1374204805,1374204805,1,1,0
10420619@N06,244,26,1355650808,1355654063,6,1,3255
10420619@N06,245,29,1365923380,1365923394,2,1,14
10448821@N00,246,6,1196896847,1196908555,18,1,11708
10448821@N00,247,6,1196992665,1197015840,6,1,23175
10448821@N00,248,26,1197073462,1197073462,1,2,0
10448821@N00,248,6,1197065344,1197086312,13,2,20968
10448821@N00,249,28,1327993888,1327993888,1,2,0
10448821@N00,249,1,1327993900,1327993900,1,2,0
10450800@N03,250,29,1302662318,1302669736,12,1,7418
10450800@N03,251,31,1306068552,1306068552,2,2,0
10450800@N03,251,29,1306059593,1306060037,2,2,444
10450800@N03,252,20,1318124858,1318124923,5,1,65
10450800@N03,253,23,1321172705,1321172705,1,3,0
10450800@N03,253,24,1321177894,1321177894,1,3,0
10450800@N03,253,17,1321176408,1321176408,1,3,0
10450800@N03,254,6,1323567477,1323567477,1,1,0
10450800@N03,255,17,1359887620,1359887620,1,1,0
10450800@N03,256,23,1370180322,1370180349,3,5,27
10450800@N03,256,24,1370176842,1370176842,1,5,0
10450800@N03,256,18,1370180184,1370180184,1,5,0
10450800@N03,256,26,1370176323,1370176334,2,5,11
10450800@N03,256,17,1370177134,1370177134,1,5,0
10450800@N03,257,23,1383965106,1383965106,1,2,0
10450800@N03,257,29,1383962549,1383962549,1,2,0
10450800@N03,258,26,1389494946,1389495021,4,2,75
10450800@N03,258,1,1389494627,1389494627,1,2,0
10450800@N03,259,17,1389525694,1389525694,1,1,0
10450800@N03,260,26,1395983389,1395983389,1,1,0
10450800@N03,261,18,1400387407,1400387407,1,2,0
10450800@N03,261,14,1400390505,1400390505,1,2,0
10450800@N03,262,30,1408874111,1408874203,3,3,92
10450800@N03,262,27,1408877260,1408879743,2,3,2483
10450800@N03,262,19,1408856303,1408856303,1,3,0
10450858@N02,263,26,1262993560,1262993560,1,1,0
10463848@N00,264,26,1295701912,1295701912,1,1,0
10463848@N00,265,26,1296207996,1296207996,1,1,0
104708298@N06,266,30,1458807567,1458810295,3,4,2728
104708298@N06,266,4,1458781587,1458781655,2,4,68
104708298@N06,266,28,1458812250,1458813294,4,4,1044
104708298@N06,266,26,1458790440,1458792686,4,4,2246
104708298@N06,267,26,1458882548,1458882548,1,1,0
104785013@N07,268,1,1362607377,1362607377,1,2,0
104785013@N07,268,21,1362609506,1362609506,1,2,0
104785013@N07,269,30,1453032102,1453032102,1,2,0
104785013@N07,269,21,1453033266,1453033270,2,2,4
104785013@N07,270,29,1453167647,1453167647,1,2,0
104785013@N07,270,19,1453165015,1453165026,2,2,11
10485586@N05,271,18,1435896054,1435896054,1,1,0
10495641@N00,272,3,1368793481,1368793481,1,4,0
10495641@N00,272,25,1368781062,1368781062,1,4,0
10495641@N00,272,13,1368793565,1368793565,1,4,0
10495641@N00,272,12,1368781299,1368781299,1,4,0
10504927@N08,273,1,1372216425,1372216425,1,1,0
10528164@N08,274,26,1245414973,1245414973,1,2,0
10528164@N08,274,28,1245390993,1245391922,7,2,929
10528164@N08,275,23,1245460399,1245460575,4,1,176
10528164@N08,276,31,1245501119,1245502265,8,1,1146
10528164@N08,277,28,1245587000,1245587000,1,2,0
10528164@N08,277,29,1245587582,1245588523,3,2,941
105291794@N04,278,18,1440858445,1440858445,1,1,0
105307408@N06,279,1,1394579384,1394579384,1,1,0
105307408@N06,280,19,1403134086,1403134086,1,1,0
105307408@N06,281,18,1423945029,1423945029,1,1,0
10569110@N08,282,28,1337437437,1337437437,1,1,0
10572043@N03,283,26,1289565922,1289565922,1,1,0
10572043@N03,284,21,1299243454,1299243454,1,1,0
10572043@N03,285,29,1359181514,1359181514,1,1,0
105745254@N04,286,12,1198157182,1198175206,2,1,18024
105745254@N04,287,26,1235759814,1235759814,1,1,0
105745254@N04,288,18,1350698125,1350698125,1,1,0
105745254@N04,289,9,1360372706,1360372706,1,2,0
105745254@N04,289,22,1360374840,1360374840,1,2,0
105745254@N04,290,19,1363405898,1363405949,2,1,51
105745254@N04,291,19,1382830383,1382830383,1,3,0
105745254@N04,291,29,1382830399,1382830399,1,3,0
105745254@N04,291,18,1382830459,1382830459,1,3,0
105745254@N04,292,12,1398483772,1398483772,1,1,0
105745254@N04,293,18,1405744131,1405744131,1,1,0
105745254@N04,294,5,1410506474,1410506474,1,1,0
105745254@N04,295,27,1459499643,1459499643,1,6,0
105745254@N04,295,15,1459506218,1459506477,2,6,259
105745254@N04,295,16,1459499632,1459503668,2,6,4036
105745254@N04,295,3,1459507373,1459507373,1,6,0
105745254@N04,295,9,1459501887,1459501892,2,6,5
105745254@N04,295,6,1459502168,1459502623,2,6,455
105745254@N04,296,26,1459543519,1459543742,3,1,223
105745254@N04,297,25,1459588804,1459588804,1,2,0
105745254@N04,297,4,1459588279,1459588645,9,2,366
10577654@N00,298,18,1447731325,1447731325,1,1,0
10577654@N00,299,18,1447762238,1447762238,1,1,0
105959704@N07,300,18,1444008089,1444008089,1,1,0
105959704@N07,301,26,1466676843,1466676843,1,1,0
105986324@N04,302,17,1400290921,1400290921,1,1,0
105986324@N04,303,27,1401507893,1401507893,1,1,0
106153498@N08,304,26,1295825967,1295853769,12,2,27802
106153498@N08,304,16,1295820573,1295820573,1,2,0
106187463@N02,305,30,1380939923,1380939923,1,2,0
106187463@N02,305,26,1380925718,1380925718,1,2,0
106228936@N07,306,28,1301181934,1301191192,17,2,9258
106228936@N07,306,1,1301181428,1301191442,42,2,10014
106228936@N07,307,11,1301707795,1301707800,4,3,5
106228936@N07,307,21,1301707792,1301707793,2,3,1
106228936@N07,307,13,1301707782,1301707791,4,3,9
106228936@N07,308,13,1311738105,1311738166,5,1,61
106228936@N07,309,13,1313829008,1313829008,1,1,0
106228936@N07,310,22,1318034716,1318034719,3,3,3
106228936@N07,310,29,1318052291,1318052292,2,3,1
106228936@N07,310,31,1318034652,1318034672,5,3,20
10632018@N00,311,25,1275114357,1275114357,1,1,0
10635134@N00,312,26,1187931271,1187931271,1,3,0
10635134@N00,312,28,1187940196,1187940196,1,3,0
10635134@N00,312,10,1187925966,1187925966,1,3,0
10635134@N00,313,31,1338354047,1338354047,1,1,0
10635276@N00,314,27,1348194223,1348194223,1,1,0
10635276@N00,315,31,1348227515,1348227515,1,1,0
10651907@N02,316,1,1191484711,1191484990,10,1,279
10651907@N02,317,30,1191546864,1191547181,10,2,317
10651907@N02,317,14,1191547244,1191554184,56,2,6940
10651907@N02,318,16,1191663359,1191663359,1,3,0
10651907@N02,318,26,1191663286,1191663334,2,3,48
10651907@N02,318,12,1191657856,1191658027,4,3,171
106602685@N05,319,15,1451145262,1451145625,8,5,363
106602685@N05,319,26,1451152343,1451152412,5,5,69
106602685@N05,319,3,1451147216,1451147216,1,5,0
106602685@N05,319,1,1451134823,1451137097,80,5,2274
106602685@N05,319,13,1451147664,1451148152,10,5,488
106809490@N03,320,21,1261118720,1261118720,1,1,0
10681948@N00,321,13,1295814342,1295814342,1,1,0
10720724@N06,322,19,1416732837,1416732837,1,1,0
10725686@N00,323,22,1208240876,1208240876,1,1,0
10725686@N00,324,17,1208906575,1208906575,1,1,0
107339849@N03,325,28,1384412716,1384412716,1,2,0
107339849@N03,325,1,1384384157,1384406762,5,2,22605
107339849@N03,326,1,1384477573,1384511093,14,1,33520
107339849@N03,327,1,1384557318,1384557318,1,1,0
107339849@N03,328,1,1384662642,1384662642,1,1,0
107379654@N04,329,19,1437558887,1437558887,1,6,0
107379654@N04,329,3,1437537017,1437537088,2,6,71
107379654@N04,329,1,1437528373,1437528373,1,6,0
107379654@N04,329,7,1437540507,1437540735,3,6,228
107379654@N04,329,16,1437535047,1437536154,4,6,1107
107379654@N04,329,25,1437549433,1437549959,2,6,526
107470608@N03,330,14,1227482019,1227482019,1,1,0
107470608@N03,331,15,1273409239,1273409239,1,2,0
107470608@N03,331,16,1273412726,1273412942,3,2,216
107470608@N03,332,15,1290564319,1290564319,1,8,0
107470608@N03,332,29,1290554076,1290554076,1,8,0
107470608@N03,332,14,1290555066,1290555066,1,8,0
107470608@N03,332,17,1290561799,1290562789,3,8,990
107470608@N03,332,20,1290556182,1290556182,1,8,0
107470608@N03,332,18,1290551940,1290551940,1,8,0
107470608@N03,332,31,1290554570,1290554570,1,8,0
107470608@N03,332,16,1290555578,1290563812,3,8,8234
107470608@N03,333,26,1290650490,1290658775,7,15,8285
107470608@N03,333,29,1290645832,1290645856,3,15,24
107470608@N03,333,28,1290651238,1290651255,2,15,17
107470608@N03,333,6,1290649367,1290649686,3,15,319
107470608@N03,333,10,1290647860,1290647864,2,15,4
107470608@N03,333,20,1290643126,1290643315,4,15,189
107470608@N03,333,11,1290663534,1290663534,1,15,0
107470608@N03,333,19,1290643007,1290667417,8,15,24410
107470608@N03,333,12,1290659571,1290659951,11,15,380
107470608@N03,333,18,1290643046,1290671859,5,15,28813
107470608@N03,333,27,1290682006,1290682006,1,15,0
107470608@N03,333,16,1290649116,1290683344,11,15,34228
107470608@N03,333,1,1290641687,1290651105,2,15,9418
107470608@N03,333,8,1290650642,1290661402,4,15,10760
107470608@N03,333,30,1290646849,1290670701,14,15,23852
107470608@N03,334,26,1319159681,1319167188,3,6,7507
107470608@N03,334,28,1319186286,1319186286,1,6,0
107470608@N03,334,3,1319158730,1319174916,4,6,16186
107470608@N03,334,15,1319159966,1319159966,1,6,0
107470608@N03,334,18,1319166464,1319166464,1,6,0
107470608@N03,334,1,1319151107,1319183067,2,6,31960
107470608@N03,335,26,1319260804,1319260804,1,4,0
107470608@N03,335,14,1319267785,1319267831,2,4,46
107470608@N03,335,3,1319268785,1319282320,4,4,13535
107470608@N03,335,9,1319282347,1319282443,3,4,96
107470608@N03,336,26,1319330188,1319330188,1,4,0
107470608@N03,336,15,1319328473,1319328477,2,4,4
107470608@N03,336,16,1319324216,1319324216,1,4,0
107470608@N03,336,7,1319330299,1319330299,1,4,0
10752753@N05,337,17,1406203099,1406203099,1,5,0
10752753@N05,337,28,1406202786,1406202786,1,5,0
10752753@N05,337,24,1406206053,1406206053,1,5,0
10752753@N05,337,26,1406204038,1406204038,1,5,0
10752753@N05,337,1,1406202592,1406202592,1,5,0
107585607@N06,338,1,1383469162,1383485325,5,1,16163
10782040@N07,339,13,1324688596,1324688596,1,1,0
107987296@N07,340,15,1400920317,1400920317,1,3,0
107987296@N07,340,28,1400900729,1400901116,3,3,387
107987296@N07,340,26,1400902863,1400903849,4,3,986
10805559@N02,341,26,1291707391,1291707391,1,1,0
108118224@N04,342,4,1408273525,1408274360,3,9,835
108118224@N04,342,25,1408273006,1408273092,2,9,86
108118224@N04,342,11,1408274577,1408274577,1,9,0
108118224@N04,342,26,1408277459,1408277459,1,9,0
108118224@N04,342,21,1408273261,1408273261,1,9,0
108118224@N04,342,28,1408272133,1408272133,1,9,0
108118224@N04,342,16,1408277745,1408277745,1,9,0
108118224@N04,342,19,1408277138,1408277138,1,9,0
108118224@N04,342,20,1408276953,1408276980,2,9,27
108118224@N04,343,26,1408615622,1408615622,1,2,0
108118224@N04,343,29,1408620466,1408620544,3,2,78
108118224@N04,344,4,1408797243,1408797243,1,1,0
10834229@N03,345,26,1238154052,1238154052,1,1,0
10837440@N03,346,27,1316332916,1316333303,3,1,387
108376534@N04,347,17,1385627810,1385627858,2,2,48
108376534@N04,347,16,1385627929,1385627929,1,2,0
108403902@N02,348,27,1424109162,1424112780,5,6,3618
108403902@N02,348,25,1424115632,1424115632,1,6,0
108403902@N02,348,16,1424105517,1424105517,1,6,0
108403902@N02,348,29,1424126469,1424126872,3,6,403
108403902@N02,348,3,1424115927,1424115927,1,6,0
108403902@N02,348,26,1424121044,1424121044,1,6,0
108403902@N02,349,29,1424174411,1424174411,1,1,0
108411475@N04,350,17,1445734478,1445734478,1,1,0
10858077@N00,351,21,1205042651,1205042651,1,2,0
10858077@N00,351,31,1205039087,1205040242,4,2,1155
10858077@N00,352,18,1207619771,1207619771,1,1,0
10858077@N00,353,24,1218939519,1218939519,1,3,0
10858077@N00,353,16,1218951555,1218951555,1,3,0
10858077@N00,353,15,1218939240,1218939240,1,3,0
10858077@N00,354,21,1237966050,1237966050,1,2,0
10858077@N00,354,25,1237967237,1237967237,1,2,0
10858077@N00,355,21,1327226297,1327232465,5,1,6168
10858077@N00,356,28,1328359396,1328359396,1,1,0
10858077@N00,357,29,1328961071,1328961125,2,1,54
10858077@N00,358,1,1333266556,1333266556,1,1,0
10858077@N00,359,29,1355540134,1355540134,1,1,0
108599313@N07,360,6,1394685409,1394685409,1,1,0
108599313@N07,361,26,1394765098,1394765098,1,1,0
10874966@N06,362,28,1253422158,1253422158,1,1,0
10910455@N04,363,18,1307413137,1307413137,1,2,0
10910455@N04,363,28,1307411406,1307411406,1,2,0
10925918@N03,364,22,1229224168,1229224168,1,1,0
10925918@N03,365,18,1243356681,1243356681,1,12,0
10925918@N03,365,29,1243434420,1243434420,1,12,0
10925918@N03,365,24,1243412588,1243412588,1,12,0
10925918@N03,365,1,1243341093,1243341093,1,12,0
10925918@N03,365,13,1243443895,1243445005,3,12,1110
10925918@N03,365,26,1243325848,1243325913,2,12,65
10925918@N03,365,28,1243447241,1243453021,2,12,5780
10925918@N03,365,30,1243341485,1243341485,1,12,0
10925918@N03,365,14,1243350534,1243350534,1,12,0
10925918@N03,365,12,1243323645,1243385367,3,12,61722
10925918@N03,365,27,1243296321,1243412021,3,12,115700
10925918@N03,365,31,1243316299,1243316299,1,12,0
10925918@N03,366,22,1436327045,1436327045,1,1,0
10925918@N03,367,17,1436537481,1436537481,1,1,0
10947824@N07,368,13,1379482203,1379482203,1,1,0
109478840@N03,369,18,1427495657,1427508319,2,1,12662
109478840@N03,370,20,1434528250,1434528250,1,1,0
109524982@N04,371,26,1393740714,1393740714,1,1,0
109524982@N04,372,26,1393824431,1393824431,1,1,0
109524982@N04,373,13,1395297674,1395297674,1,2,0
109524982@N04,373,29,1395298435,1395298435,1,2,0
109582237@N03,374,13,1372600800,1372600800,2,1,0
109641355@N04,375,3,1425804414,1425804414,1,1,0
10967865@N04,376,26,1272119334,1272119334,1,2,0
10967865@N04,376,28,1272117936,1272118341,2,2,405
10967865@N04,377,26,1327828794,1327828794,1,3,0
10967865@N04,377,20,1327825055,1327825230,2,3,175
10967865@N04,377,28,1327819535,1327840790,6,3,21255
10967865@N04,378,26,1347585313,1347585313,1,1,0
10967865@N04,379,27,1382964919,1382964919,1,1,0
10967865@N04,380,28,1436193009,1436193009,1,1,0
10970592@N04,381,15,1388905035,1388915130,2,6,10095
10970592@N04,381,17,1388877924,1388877924,1,6,0
10970592@N04,381,29,1388887720,1388887720,1,6,0
10970592@N04,381,1,1388874807,1388874807,1,6,0
10970592@N04,381,27,1388875276,1388875276,1,6,0
10970592@N04,381,14,1388915007,1388915007,1,6,0
10974344@N00,382,30,1436609838,1436610056,4,1,218
10989907@N07,383,25,1337563799,1337564930,5,12,1131
10989907@N07,383,16,1337558101,1337558101,1,12,0
10989907@N07,383,20,1337568190,1337568190,1,12,0
10989907@N07,383,17,1337558410,1337558415,2,12,5
10989907@N07,383,27,1337558258,1337561975,3,12,3717
10989907@N07,383,28,1337557166,1337557166,1,12,0
10989907@N07,383,23,1337582136,1337583010,4,12,874
10989907@N07,383,1,1337557006,1337557006,1,12,0
10989907@N07,383,13,1337567807,1337573185,5,12,5378
10989907@N07,383,21,1337565440,1337565440,1,12,0
10989907@N07,383,15,1337559267,1337561075,4,12,1808
10989907@N07,383,26,1337557734,1337557734,1,12,0
10990739@N05,384,22,1259021168,1259021721,2,1,553
10990739@N05,385,26,1259050777,1259050777,1,2,0
10990739@N05,385,28,1259064001,1259067598,3,2,3597
110010883@N02,386,26,1405215331,1405216454,5,1,1123
11013574@N07,387,17,1349493197,1349493197,1,1,0
11025175@N06,388,1,1385676742,1385676742,1,1,0
110286494@N07,389,13,1396740690,1396742152,5,5,1462
110286494@N07,389,30,1396745977,1396745977,1,5,0
110286494@N07,389,26,1396721899,1396721899,1,5,0
110286494@N07,389,25,1396741841,1396741841,1,5,0
110286494@N07,389,28,1396718220,1396762413,4,5,44193
110286494@N07,390,28,1396800404,1396803977,4,1,3573
11033661@N08,391,26,1363322105,1363349284,4,1,27179
11033661@N08,392,27,1409354494,1409354494,1,1,0
11033661@N08,393,18,1454814392,1454814392,1,1,0
11042293@N04,394,1,1282270122,1282282294,13,1,12172
110424783@N05,395,26,1389088679,1389088679,1,1,0
110565084@N04,396,20,1386074459,1386074459,1,2,0
110565084@N04,396,26,1386074452,1386074951,3,2,499
110565084@N04,397,12,1391497869,1391497882,3,4,13
110565084@N04,397,15,1391497930,1391497936,2,4,6
110565084@N04,397,24,1391498230,1391498230,1,4,0
110565084@N04,397,28,1391497855,1391497855,1,4,0
11058168@N04,398,28,1338383502,1338383502,1,1,0
11058168@N04,399,28,1338716437,1338716437,1,1,0
110647128@N03,400,1,1387799215,1387799215,1,1,0
11071376@N07,401,13,1243999217,1244001048,6,4,1831
11071376@N07,401,7,1243985804,1244026517,4,4,40713
11071376@N07,401,18,1243983362,1243985471,6,4,2109
11071376@N07,401,26,1244004976,1244004976,1,4,0
11085764@N05,402,29,1343320452,1343320452,1,1,0
110888119@N08,403,28,1388659666,1388659666,1,1,0
110888119@N08,404,26,1392695904,1392695904,1,1,0
110968252@N02,405,15,1431238503,1431238503,1,1,0
11126361@N06,406,30,1262308223,1262356612,88,1,48389
11126361@N06,407,30,1293848955,1293848955,1,1,0
11126361@N06,408,30,1293895186,1293895282,10,1,96
11130549@N08,409,26,1243822199,1243865415,16,1,43216
11130549@N08,410,26,1243929668,1243946007,19,1,16339
111329164@N07,411,25,1416037394,1416037394,1,1,0
11136593@N05,412,26,1195685670,1195685670,1,1,0
11166803@N05,413,26,1296989629,1296989629,1,1,0
111750816@N06,414,18,1432514622,1432514622,1,1,0
111750816@N06,415,3,1432894469,1432894469,1,1,0
111750816@N06,416,25,1434501978,1434501978,1,1,0
111750816@N06,417,26,1436577290,1436577290,1,1,0
111750816@N06,418,29,1437742612,1437742612,1,2,0
111750816@N06,418,26,1437732547,1437732547,1,2,0
111750816@N06,419,25,1440448583,1440448583,1,1,0
111750816@N06,420,18,1441149017,1441149017,1,1,0
111750816@N06,421,28,1441414547,1441414547,1,1,0
111750816@N06,422,18,1441547087,1441547087,1,1,0
111750816@N06,423,18,1441719730,1441719730,1,1,0
111750816@N06,424,25,1441966452,1441966452,1,1,0
111750816@N06,425,18,1442018401,1442018401,1,2,0
111750816@N06,425,1,1442022306,1442022306,1,2,0
111750816@N06,426,25,1443175697,1443175697,1,1,0
111750816@N06,427,26,1445324188,1445324188,1,1,0
111750816@N06,428,4,1445755925,1445755925,1,1,0
111750816@N06,429,18,1445924120,1445924120,1,1,0
111750816@N06,430,21,1446527201,1446527201,1,1,0
111750816@N06,431,25,1447744302,1447746668,2,1,2366
111750816@N06,432,18,1448955585,1448955585,1,1,0
111750816@N06,433,25,1450913197,1450913197,1,1,0
111750816@N06,434,12,1455863283,1455863283,1,1,0
111750816@N06,435,28,1457498825,1457498825,1,1,0
111750816@N06,436,25,1457572909,1457572909,1,1,0
111750816@N06,437,27,1458644351,1458644965,2,1,614
111750816@N06,438,7,1459055363,1459055363,1,1,0
111750816@N06,439,26,1459847299,1459847299,1,1,0
111750816@N06,440,25,1460198316,1460198316,1,2,0
111750816@N06,440,4,1460187783,1460187783,1,2,0
111750816@N06,441,25,1463294201,1463294201,1,1,0
111750816@N06,442,26,1463467437,1463467437,1,1,0
111750816@N06,443,25,1463896914,1463896914,1,1,0
111750816@N06,444,30,1464763944,1464763944,1,2,0
111750816@N06,444,22,1464767593,1464767593,1,2,0
111750816@N06,445,28,1465538881,1465538881,1,2,0
111750816@N06,445,26,1465539578,1465539578,1,2,0
111750816@N06,446,26,1467098213,1467098213,1,1,0
111750816@N06,447,1,1467618018,1467618018,1,1,0
11216630@N00,448,25,1259658590,1259658603,2,1,13
112167218@N08,449,1,1419927880,1419927911,4,5,31
112167218@N08,449,27,1419930019,1419930037,2,5,18
112167218@N08,449,24,1419933816,1419933816,1,5,0
112167218@N08,449,26,1419933821,1419934048,10,5,227
112167218@N08,449,28,1419928139,1419934475,7,5,6336
112298613@N07,450,22,1409102858,1409104606,5,4,1748
112298613@N07,450,14,1409105223,1409109714,6,4,4491
112298613@N07,450,19,1409101362,1409101362,1,4,0
112298613@N07,450,28,1409100276,1409100276,1,4,0
11260538@N06,451,7,1360627179,1360627179,1,3,0
11260538@N06,451,17,1360624615,1360624615,1,3,0
11260538@N06,451,5,1360625932,1360625932,1,3,0
11260538@N06,452,29,1361436121,1361436121,1,1,0
11260538@N06,453,28,1361539500,1361539500,1,1,0
112627165@N06,454,19,1408805773,1408805773,1,1,0
112659844@N02,455,16,1407897737,1407897737,1,1,0
112711747@N06,456,26,1398815980,1398815980,1,3,0
112711747@N06,456,19,1398821545,1398821545,1,3,0
112711747@N06,456,29,1398828340,1398828340,1,3,0
112721782@N02,457,1,1464776851,1464776851,1,1,0
11276497@N00,458,26,1296801189,1296801189,1,1,0
112828108@N08,459,29,1409319685,1409320917,4,3,1232
112828108@N08,459,23,1409316172,1409316172,1,3,0
112828108@N08,459,18,1409316770,1409321524,3,3,4754
112828108@N08,460,3,1410486685,1410486685,1,5,0
112828108@N08,460,18,1410512466,1410512466,1,5,0
112828108@N08,460,25,1410488994,1410489580,3,5,586
112828108@N08,460,30,1410486116,1410486116,1,5,0
112828108@N08,460,12,1410487581,1410487581,1,5,0
112828108@N08,461,30,1428402245,1428402774,3,1,529
112828108@N08,462,16,1442996213,1442998667,3,1,2454
112828108@N08,463,20,1443915780,1443918532,3,2,2752
112828108@N08,463,16,1443919613,1443919613,1,2,0
112828108@N08,464,17,1444178425,1444178425,1,3,0
112828108@N08,464,25,1444183914,1444183914,1,3,0
112828108@N08,464,22,1444183530,1444183530,1,3,0
112828108@N08,465,16,1451890356,1451890356,1,3,0
112828108@N08,465,21,1451893922,1451903732,7,3,9810
112828108@N08,465,13,1451904249,1451904249,1,3,0
112828108@N08,466,28,1452034978,1452034978,1,3,0
112828108@N08,466,24,1452040878,1452040878,1,3,0
112828108@N08,466,30,1452044563,1452044563,1,3,0
112828108@N08,467,16,1452077821,1452077821,1,1,0
112828108@N08,468,16,1458027933,1458031189,2,2,3256
112828108@N08,468,26,1458011665,1458011960,2,2,295
112920986@N06,469,28,1384754618,1384754621,2,2,3
112920986@N06,469,16,1384751593,1384751598,2,2,5
11312146@N04,470,18,1441481479,1441481479,1,1,0
113144149@N03,471,1,1388919064,1388919064,1,1,0
113224973@N02,472,1,1452921098,1452921098,1,1,0
113224973@N02,473,26,1453344675,1453344675,1,1,0
11331418@N00,474,16,1360407446,1360407446,2,1,0
11331418@N00,475,7,1362473496,1362473496,1,1,0
11331418@N00,476,12,1365411686,1365411686,1,1,0
11331418@N00,477,7,1370381129,1370381129,1,1,0
11331418@N00,478,27,1370780934,1370780934,1,1,0
11351590@N00,479,1,1229169818,1229169818,1,1,0
11351590@N00,480,1,1229822644,1229843003,64,1,20359
11355999@N08,481,10,1206591891,1206601500,41,1,9609
11355999@N08,482,15,1279599738,1279599738,1,1,0
11355999@N08,483,24,1318412552,1318412552,1,1,0
11355999@N08,484,26,1321260444,1321260444,1,1,0
11355999@N08,485,1,1374018101,1374018101,1,1,0
11374644@N06,486,26,1226120760,1226157090,39,10,36330
11374644@N06,486,28,1226105914,1226158722,14,10,52808
11374644@N06,486,29,1226115307,1226120563,2,10,5256
11374644@N06,486,13,1226111715,1226114176,36,10,2461
11374644@N06,486,6,1226114658,1226114658,1,10,0
11374644@N06,486,22,1226118132,1226120349,12,10,2217
11374644@N06,486,1,1226105540,1226105669,4,10,129
11374644@N06,486,14,1226118543,1226120101,28,10,1558
11374644@N06,486,31,1226114937,1226114946,2,10,9
11374644@N06,486,24,1226109563,1226110673,8,10,1110
11374644@N06,487,26,1226196807,1226204221,31,6,7414
11374644@N06,487,28,1226196477,1226232618,16,6,36141
11374644@N06,487,6,1226197290,1226197290,1,6,0
11374644@N06,487,22,1226199926,1226201699,2,6,1773
11374644@N06,487,1,1226203000,1226203091,6,6,91
11374644@N06,487,30,1226201647,1226201647,1,6,0
11374644@N06,488,26,1226965689,1226979103,17,5,13414
11374644@N06,488,28,1226965082,1226981462,4,5,16380
11374644@N06,488,22,1226974043,1226974043,1,5,0
11374644@N06,488,1,1226964998,1226964998,1,5,0
11374644@N06,488,14,1226973048,1226973339,22,5,291
11374644@N06,489,26,1228256800,1228256800,1,4,0
11374644@N06,489,13,1228257125,1228257486,3,4,361
11374644@N06,489,22,1228257609,1228257609,1,4,0
11374644@N06,489,14,1228257751,1228259064,3,4,1313
11374644@N06,490,13,1383702871,1383706390,18,15,3519
11374644@N06,490,6,1383699766,1383699766,1,15,0
11374644@N06,490,22,1383711954,1383712830,2,15,876
11374644@N06,490,14,1383711233,1383712310,18,15,1077
11374644@N06,490,30,1383708204,1383708365,3,15,161
11374644@N06,490,3,1383700363,1383702094,2,15,1731
11374644@N06,490,31,1383710222,1383710222,1,15,0
11374644@N06,490,21,1383700527,1383706962,11,15,6435
11374644@N06,490,4,1383701647,1383701825,2,15,178
11374644@N06,490,29,1383710288,1383713017,2,15,2729
11374644@N06,490,11,1383701679,1383701749,3,15,70
11374644@N06,490,20,1383710292,1383710292,1,15,0
11374644@N06,490,26,1383698939,1383699922,10,15,983
11374644@N06,490,1,1383698241,1383715487,2,15,17246
11374644@N06,490,28,1383698446,1383715454,15,15,17008
11374644@N06,491,13,1383785202,1383785285,10,10,83
11374644@N06,491,6,1383786916,1383786916,1,10,0
11374644@N06,491,19,1383781515,1383781673,3,10,158
11374644@N06,491,18,1383780263,1383781463,5,10,1200
11374644@N06,491,29,1383781540,1383781540,1,10,0
11374644@N06,491,11,1383784453,1383784453,1,10,0
11374644@N06,491,23,1383782263,1383782263,1,10,0
11374644@N06,491,26,1383780056,1383787235,9,10,7179
11374644@N06,491,1,1383778902,1383778902,1,10,0
11374644@N06,491,28,1383779462,1383790167,10,10,10705
11374644@N06,492,28,1383890746,1383890746,1,2,0
11374644@N06,492,1,1383892272,1383893683,27,2,1411
11387250@N02,493,29,1215922947,1215922947,1,1,0
11393022@N00,494,27,1319411280,1319411280,1,1,0
11401724@N05,495,18,1434238738,1434238738,1,1,0
11401724@N05,496,18,1434595280,1434595280,1,1,0
11401724@N05,497,18,1446350613,1446379105,3,1,28492
11401724@N05,498,27,1462852681,1462852681,1,1,0
11405513@N06,499,17,1419302615,1419302615,1,1,0
11429691@N03,500,29,1299925599,1299925716,2,3,117
11429691@N03,500,24,1299925726,1299925726,1,3,0
11429691@N03,500,30,1299925732,1299925732,1,3,0
114343416@N06,501,26,1364159644,1364159644,1,1,0
11434691@N07,502,28,1366724192,1366724274,5,5,82
11434691@N07,502,17,1366735478,1366735478,1,5,0
11434691@N07,502,1,1366704844,1366725145,3,5,20301
11434691@N07,502,27,1366732289,1366732744,2,5,455
11434691@N07,502,18,1366725128,1366725128,1,5,0
11438926@N00,503,28,1275794651,1275794651,1,1,0
11438926@N00,504,30,1292243447,1292243447,1,8,0
11438926@N00,504,20,1292243113,1292243113,1,8,0
11438926@N00,504,7,1292245226,1292245274,2,8,48
11438926@N00,504,12,1292244410,1292244424,2,8,14
11438926@N00,504,1,1292239826,1292239826,1,8,0
11438926@N00,504,28,1292240122,1292245793,7,8,5671
11438926@N00,504,19,1292243301,1292243301,1,8,0
11438926@N00,504,21,1292244033,1292245064,7,8,1031
11438926@N00,505,17,1317429382,1317432908,4,1,3526
11438926@N00,506,29,1319176697,1319176697,1,1,0
11438926@N00,507,13,1323771903,1323773989,6,5,2086
11438926@N00,507,30,1323767732,1323767732,1,5,0
11438926@N00,507,29,1323771007,1323771007,1,5,0
11438926@N00,507,23,1323767005,1323767005,1,5,0
11438926@N00,507,28,1323765705,1323765796,3,5,91
11438926@N00,508,31,1331544345,1331544345,1,1,0
11438926@N00,509,14,1370430016,1370432120,11,2,2104
11438926@N00,509,20,1370432693,1370433101,2,2,408
11441631@N00,510,28,1349487234,1349487555,2,3,321
11441631@N00,510,29,1349494386,1349494386,1,3,0
11441631@N00,510,20,1349494359,1349494783,2,3,424
11441631@N00,511,28,1351290290,1351290290,1,2,0
11441631@N00,511,29,1351307359,1351307359,1,2,0
11441631@N00,512,28,1352524144,1352524144,1,1,0
11441631@N00,513,1,1355985604,1355985604,1,1,0
11441631@N00,514,28,1358060577,1358060577,1,2,0
11441631@N00,514,1,1358059417,1358059417,1,2,0
11441631@N00,515,25,1389498194,1389498194,1,3,0
11441631@N00,515,18,1389502155,1389502155,1,3,0
11441631@N00,515,1,1389486807,1389486807,1,3,0
11441631@N00,516,1,1391899377,1391900255,2,1,878
114698947@N03,517,27,1467712609,1467712609,1,5,0
114698947@N03,517,23,1467719063,1467719069,4,5,6
114698947@N03,517,1,1467698216,1467698377,2,5,161
114698947@N03,517,26,1467698598,1467718262,4,5,19664
114698947@N03,517,28,1467698477,1467698477,1,5,0
114818743@N02,518,18,1393026916,1393064387,24,2,37471
114818743@N02,518,29,1393026813,1393037359,2,2,10546
11495990@N00,519,6,1321241606,1321241606,1,1,0
11504096@N08,520,10,1310895022,1310896614,2,15,1592
11504096@N08,520,16,1310873531,1310886977,5,15,13446
11504096@N08,520,14,1310875692,1310876901,11,15,1209
11504096@N08,520,11,1310890063,1310891535,4,15,1472
11504096@N08,520,12,1310901703,1310901943,4,15,240
11504096@N08,520,27,1310882305,1310882919,3,15,614
11504096@N08,520,22,1310873293,1310908928,10,15,35635
11504096@N08,520,21,1310887782,1310894281,16,15,6499
11504096@N08,520,30,1310896504,1310897381,7,15,877
11504096@N08,520,28,1310883745,1310909779,10,15,26034
11504096@N08,520,8,1310904002,1310904008,2,15,6
11504096@N08,520,20,1310877318,1310904991,7,15,27673
11504096@N08,520,26,1310875313,1310875313,1,15,0
11504096@N08,520,7,1310889563,1310889582,2,15,19
11504096@N08,520,13,1310891832,1310895644,9,15,3812
115142813@N02,521,26,1403432559,1403432559,1,2,0
115142813@N02,521,1,1403431818,1403431818,1,2,0
115142813@N02,522,26,1405844555,1405844653,3,1,98
115142813@N02,523,26,1413702372,1413702372,3,1,0
115142813@N02,524,26,1421620925,1421620993,4,2,68
115142813@N02,524,25,1421624767,1421624767,1,2,0
115142813@N02,525,6,1421653988,1421653988,1,1,0
11518890@N00,526,26,1458412294,1458412294,1,1,0
11518890@N00,527,26,1467340728,1467340728,1,1,0
11520748@N06,528,7,1313277452,1313277452,1,2,0
11520748@N06,528,4,1313277268,1313277268,1,2,0
115291928@N03,529,28,1389260367,1389260499,4,5,132
115291928@N03,529,13,1389256093,1389256093,1,5,0
115291928@N03,529,1,1389260350,1389260350,1,5,0
115291928@N03,529,21,1389252410,1389252433,2,5,23
115291928@N03,529,6,1389258366,1389258366,1,5,0
11531429@N07,530,26,1297988053,1297988053,1,1,0
11531429@N07,531,29,1298071772,1298071772,1,1,0
115394627@N08,532,7,1393122518,1393122518,1,4,0
115394627@N08,532,3,1393118469,1393118469,1,4,0
115394627@N08,532,1,1393116995,1393116995,1,4,0
115394627@N08,532,13,1393123894,1393123894,1,4,0
11541209@N06,533,28,1189327098,1189327098,1,1,0
11541209@N06,534,26,1190215013,1190215060,5,2,47
11541209@N06,534,20,1190215100,1190215100,1,2,0
11541209@N06,535,28,1190794027,1190794027,1,2,0
11541209@N06,535,26,1190794021,1190794021,1,2,0
11541209@N06,536,26,1194644715,1194668637,6,1,23922
11541209@N06,537,26,1195238164,1195245751,6,1,7587
11541209@N06,538,28,1221226291,1221226291,1,2,0
11541209@N06,538,26,1221223649,1221224077,3,2,428
11541209@N06,539,22,1221826755,1221826755,1,1,0
11541209@N06,540,26,1222947652,1222947652,1,1,0
11541209@N06,541,3,1226244838,1226244838,1,1,0
11541209@N06,542,28,1226705773,1226705773,1,1,0
11541209@N06,543,25,1227170269,1227170269,1,1,0
11541209@N06,544,26,1227304875,1227304875,1,1,0
11541209@N06,545,25,1228139115,1228139115,1,1,0
11541209@N06,546,25,1233828676,1233851520,4,1,22844
11541209@N06,547,23,1236680184,1236680184,1,2,0
11541209@N06,547,30,1236680090,1236680090,1,2,0
11541209@N06,548,29,1243642253,1243642253,1,3,0
11541209@N06,548,30,1243641177,1243641177,1,3,0
11541209@N06,548,31,1243640076,1243640152,2,3,76
11541209@N06,549,26,1243826281,1243826281,1,1,0
11541209@N06,550,30,1244204059,1244205191,2,1,1132
11541209@N06,551,30,1244616826,1244616826,1,1,0
11541209@N06,552,26,1244808592,1244808592,1,2,0
11541209@N06,552,16,1244809214,1244816369,4,2,7155
11541209@N06,553,20,1249042619,1249042619,1,1,0
11541209@N06,554,30,1251873187,1251873187,1,1,0
11541209@N06,555,1,1261390290,1261390290,1,1,0
11541209@N06,556,28,1263875940,1263875940,1,2,0
11541209@N06,556,26,1263876821,1263876821,1,2,0
11541209@N06,557,13,1265703310,1265704684,4,1,1374
11541209@N06,558,26,1304921140,1304926511,3,2,5371
11541209@N06,558,1,1304927047,1304927047,1,2,0
11541209@N06,559,26,1309230118,1309230118,1,1,0
11541209@N06,560,26,1309530380,1309530380,1,1,0
11541209@N06,561,26,1322474588,1322476565,2,1,1977
11541209@N06,562,29,1322561516,1322561516,1,2,0
11541209@N06,562,25,1322560699,1322560699,1,2,0
11541209@N06,563,3,1329292310,1329292310,1,3,0
11541209@N06,563,8,1329291852,1329291852,1,3,0
11541209@N06,563,22,1329294334,1329294334,1,3,0
11541209@N06,564,20,1353680629,1353680629,1,4,0
11541209@N06,564,25,1353679251,1353679251,1,4,0
11541209@N06,564,26,1353682275,1353682275,1,4,0
11541209@N06,564,28,1353682655,1353682655,1,4,0
11541209@N06,565,29,1353755876,1353755876,1,1,0
11543886@N00,566,18,1450823229,1450823341,2,2,112
11543886@N00,566,22,1450832669,1450832669,1,2,0
11566207@N08,567,29,1419934404,1419934406,2,2,2
11566207@N08,567,31,1419913089,1419913089,1,2,0
11566207@N08,568,11,1434879823,1434879831,2,3,8
11566207@N08,568,29,1434860122,1434860146,2,3,24
11566207@N08,568,4,1434879815,1434879815,1,3,0
11566207@N08,569,29,1449301023,1449301023,1,3,0
11566207@N08,569,17,1449284299,1449284299,1,3,0
11566207@N08,569,14,1449290691,1449290691,1,3,0
11566207@N08,570,17,1451088970,1451088970,1,1,0
11566207@N08,571,29,1455419076,1455419079,2,1,3
11566531@N05,572,26,1336131078,1336131078,1,1,0
11613283@N00,573,30,1212539972,1212539972,1,1,0
11613408@N05,574,17,1281916771,1281916771,1,1,0
116142246@N08,575,1,1388880102,1388880102,1,1,0
11631833@N00,576,24,1369546480,1369546480,1,1,0
11640161@N03,577,20,1365028013,1365028013,1,1,0
11640161@N03,578,12,1365057563,1365057569,2,1,6
116696583@N07,579,13,1402639576,1402640524,4,1,948
116696583@N07,580,25,1415403153,1415403538,3,2,385
116696583@N07,580,20,1415408631,1415412660,2,2,4029
116915458@N03,581,7,1401190179,1401190179,1,1,0
116915458@N03,582,1,1402310108,1402310108,1,1,0
116915458@N03,583,1,1402364507,1402364507,1,1,0
11712374@N03,584,24,1234313366,1234313767,2,1,401
11712374@N03,585,6,1238668363,1238668363,1,1,0
11712374@N03,586,12,1240538265,1240538265,1,3,0
11712374@N03,586,17,1240537350,1240537350,1,3,0
11712374@N03,586,22,1240537526,1240537526,1,3,0
11734370@N06,587,26,1276311126,1276311126,1,3,0
11734370@N06,587,23,1276317565,1276317565,1,3,0
11734370@N06,587,16,1276311367,1276311749,2,3,382
117406028@N08,588,17,1329713425,1329713425,1,1,0
11769292@N00,589,16,1387781057,1387781057,1,1,0
117714299@N03,590,7,1395035010,1395035010,1,1,0
117714299@N03,591,16,1395354523,1395354523,1,2,0
117714299@N03,591,30,1395356847,1395356847,1,2,0
117714299@N03,592,27,1397002936,1397002936,1,2,0
117714299@N03,592,30,1396999875,1396999875,1,2,0
117714299@N03,593,26,1398121361,1398121361,1,1,0
117714299@N03,594,27,1413011507,1413011507,1,2,0
117714299@N03,594,17,1413006868,1413006868,1,2,0
117931874@N07,595,21,1357779054,1357779054,1,1,0
118043454@N05,596,1,1395408026,1395408026,1,1,0
118043454@N05,597,4,1403582498,1403582498,1,1,0
118043454@N05,598,1,1406470913,1406470913,1,1,0
118043454@N05,599,1,1408073926,1408073926,1,1,0
118043454@N05,600,1,1413628698,1413628698,1,1,0
11805483@N00,601,29,1355662623,1355662623,1,1,0
11806003@N05,602,23,1445092133,1445092133,1,3,0
11806003@N05,602,22,1445055084,1445055084,1,3,0
11806003@N05,602,18,1445050925,1445088780,4,3,37855
118143585@N05,603,27,1316737145,1316737145,1,2,0
118143585@N05,603,16,1316739219,1316739219,1,2,0
11825945@N00,604,29,1391911793,1391911793,1,1,0
11836258@N05,605,25,1293459783,1293459783,1,3,0
11836258@N05,605,27,1293439649,1293440109,7,3,460
11836258@N05,605,26,1293455129,1293458060,5,3,2931
11840939@N06,606,27,1380434467,1380434467,1,3,0
11840939@N06,606,16,1380434483,1380434538,2,3,55
11840939@N06,606,28,1380434503,1380434524,2,3,21
11840939@N06,607,27,1382926951,1382926951,1,3,0
11840939@N06,607,16,1382927036,1382929653,2,3,2617
11840939@N06,607,28,1382927193,1382927193,1,3,0
118425217@N03,608,17,1388704503,1388704598,2,1,95
11844862@N00,609,17,1359437241,1359437241,1,1,0
11844862@N00,610,12,1359591242,1359591242,1,2,0
11844862@N00,610,15,1359595074,1359595074,1,2,0
118478058@N08,611,16,1374370116,1374370125,2,2,9
118478058@N08,611,13,1374388665,1374388665,2,2,0
11849171@N00,612,15,1214978098,1214978098,1,2,0
11849171@N00,612,26,1215001246,1215002413,3,2,1167
11849171@N00,613,15,1216643724,1216643724,1,2,0
11849171@N00,613,28,1216643756,1216643756,1,2,0
11855439@N00,614,3,1227351109,1227351109,1,1,0
11855439@N00,615,3,1227833790,1227833790,1,1,0
11855439@N00,616,28,1239932786,1239932824,3,3,38
11855439@N00,616,14,1239931666,1239931666,1,3,0
11855439@N00,616,1,1239932525,1239932525,1,3,0
11855439@N00,617,10,1245415330,1245415330,1,1,0
11855439@N00,618,26,1306283736,1306298914,2,5,15178
11855439@N00,618,28,1306283613,1306283613,1,5,0
11855439@N00,618,19,1306292058,1306292058,1,5,0
11855439@N00,618,30,1306286669,1306286669,1,5,0
11855439@N00,618,1,1306283379,1306283379,1,5,0
118814458@N03,619,29,1392959569,1392959569,1,1,0
11901577@N03,620,29,1360385046,1360385046,1,3,0
11901577@N03,620,17,1360392473,1360392473,1,3,0
11901577@N03,620,28,1360394075,1360394075,1,3,0
11901577@N03,621,27,1366096996,1366096996,1,3,0
11901577@N03,621,15,1366095805,1366095805,1,3,0
11901577@N03,621,28,1366093033,1366093033,1,3,0
11901577@N03,622,1,1370816125,1370816125,1,1,0
11901577@N03,623,27,1399191443,1399195338,2,2,3895
11901577@N03,623,16,1399200418,1399200418,1,2,0
11901577@N03,624,26,1399860176,1399860176,1,1,0
11901577@N03,625,24,1401693364,1401693364,1,1,0
11901577@N03,626,1,1402842465,1402842465,1,2,0
11901577@N03,626,19,1402834898,1402834898,1,2,0
11901577@N03,627,19,1413529270,1413529270,1,1,0
11901577@N03,628,30,1413621908,1413621908,1,3,0
11901577@N03,628,17,1413637363,1413637363,1,3,0
11901577@N03,628,19,1413594843,1413631907,3,3,37064
11901577@N03,629,30,1414028512,1414028512,1,1,0
11901577@N03,630,19,1414660672,1414660672,1,1,0
11901577@N03,631,19,1415254345,1415262016,2,1,7671
11901577@N03,632,19,1417676110,1417676110,1,1,0
11901577@N03,633,30,1424607196,1424607196,1,2,0
11901577@N03,633,20,1424607557,1424607557,1,2,0
11901577@N03,634,27,1426159783,1426159783,1,1,0
11901577@N03,635,30,1427722448,1427722448,1,1,0
11901577@N03,636,1,1428241567,1428241567,1,1,0
11901577@N03,637,17,1429084129,1429084129,1,2,0
11901577@N03,637,18,1429076803,1429076803,1,2,0
11901577@N03,638,18,1431871003,1431871003,1,1,0
11901577@N03,639,30,1434977605,1434977605,1,1,0
11901577@N03,640,18,1436177169,1436177169,1,1,0
11901577@N03,641,18,1438179911,1438179911,1,1,0
11901577@N03,642,18,1442753352,1442753352,1,1,0
11909642@N05,643,20,1208563694,1208564557,2,16,863
11909642@N05,643,31,1208565115,1208565197,5,16,82
11909642@N05,643,4,1208566382,1208566382,1,16,0
11909642@N05,643,1,1208559119,1208559119,1,16,0
11909642@N05,643,29,1208561896,1208563295,12,16,1399
11909642@N05,643,26,1208565820,1208566756,8,16,936
11909642@N05,643,28,1208559225,1208559225,1,16,0
11909642@N05,643,16,1208566725,1208569712,2,16,2987
11909642@N05,643,22,1208551327,1208551327,1,16,0
11909642@N05,643,21,1208566369,1208566369,1,16,0
11909642@N05,643,30,1208565398,1208565420,2,16,22
11909642@N05,643,19,1208560216,1208566949,7,16,6733
11909642@N05,643,23,1208559481,1208565331,3,16,5850
11909642@N05,643,18,1208559436,1208559633,3,16,197
11909642@N05,643,12,1208573347,1208573347,1,16,0
11909642@N05,643,17,1208572614,1208572614,1,16,0
11930160@N07,644,28,1196470071,1196470071,1,1,0
11949829@N04,645,28,1187967270,1187967270,1,1,0
11949829@N04,646,28,1188304780,1188304780,1,1,0
11949829@N04,647,13,1191552703,1191552703,1,2,0
11949829@N04,647,26,1191545470,1191545470,1,2,0
11949829@N04,648,30,1194241824,1194242197,4,2,373
11949829@N04,648,26,1194242055,1194242055,1,2,0
11949829@N04,649,26,1195734875,1195736751,2,1,1876
11949829@N04,650,26,1197066253,1197071556,7,2,5303
11949829@N04,650,18,1197090318,1197090318,1,2,0
11949829@N04,651,28,1198243759,1198243759,1,1,0
11949829@N04,652,25,1200820243,1200820243,1,1,0
11949829@N04,653,16,1201931455,1201936498,3,1,5043
11949829@N04,654,28,1204872052,1204889784,3,1,17732
11949829@N04,655,17,1214111513,1214111866,3,1,353
11949829@N04,656,13,1216263625,1216264268,3,1,643
11949829@N04,657,13,1216307715,1216308113,3,4,398
11949829@N04,657,29,1216308142,1216308160,2,4,18
11949829@N04,657,1,1216308125,1216308127,2,4,2
11949829@N04,657,24,1216308180,1216308230,4,4,50
11949829@N04,658,28,1224930356,1224930356,1,3,0
11949829@N04,658,30,1224932599,1224932599,1,3,0
11949829@N04,658,24,1224938946,1224938946,1,3,0
11949829@N04,659,13,1227265129,1227265129,1,1,0
11949829@N04,660,26,1227940210,1227965192,6,4,24982
11949829@N04,660,28,1227966039,1227966405,3,4,366
11949829@N04,660,25,1227960504,1227961640,2,4,1136
11949829@N04,660,1,1227952630,1227952642,2,4,12
11949829@N04,661,16,1229772861,1229772869,2,1,8
11949829@N04,662,29,1230030487,1230030487,1,1,0
11949829@N04,663,15,1230381355,1230381355,1,4,0
11949829@N04,663,29,1230385691,1230385691,1,4,0
11949829@N04,663,31,1230385674,1230385674,1,4,0
11949829@N04,663,1,1230381354,1230381354,1,4,0
11949829@N04,664,26,1230730983,1230730983,1,2,0
11949829@N04,664,16,1230740733,1230740733,1,2,0
11949829@N04,665,14,1249304531,1249304531,1,1,0
11949829@N04,666,11,1262256413,1262256413,1,3,0
11949829@N04,666,21,1262254605,1262254605,1,3,0
11949829@N04,666,28,1262261891,1262262646,3,3,755
11985480@N04,667,28,1319805564,1319805564,1,2,0
11985480@N04,667,17,1319805430,1319805430,1,2,0
11985480@N04,668,4,1326768620,1326768620,1,1,0
11985480@N04,669,27,1330514288,1330514288,1,1,0
11985480@N04,670,27,1330634782,1330634782,1,1,0
11985480@N04,671,16,1334319474,1334319474,1,1,0
119864842@N02,672,28,1313295691,1313295691,2,1,0
11996697@N00,673,31,1252799832,1252811605,7,4,11773
11996697@N00,673,14,1252799850,1252799850,1,4,0
11996697@N00,673,18,1252795880,1252795880,1,4,0
11996697@N00,673,13,1252817020,1252820583,5,4,3563
120024993@N07,674,25,1388475072,1388475108,2,1,36
120040317@N03,675,21,1403343854,1403343854,1,4,0
120040317@N03,675,22,1403334623,1403334716,2,4,93
120040317@N03,675,1,1403323989,1403324332,2,4,343
120040317@N03,675,12,1403344560,1403344560,1,4,0
120236135@N07,676,19,1432683723,1432683723,1,1,0
12027145@N00,677,26,1218672083,1218692647,8,2,20564
12027145@N00,677,22,1218688144,1218688144,1,2,0
12027145@N00,678,26,1219729613,1219729774,2,2,161
12027145@N00,678,31,1219728404,1219728404,1,2,0
12037949644@N01,679,28,1236210514,1236210514,1,1,0
12037949644@N01,680,3,1264564092,1264564092,1,1,0
12037949644@N01,681,30,1321139713,1321139713,1,2,0
12037949644@N01,681,12,1321140802,1321140802,1,2,0
120533378@N03,682,26,1295389744,1295389744,1,1,0
120533378@N03,683,26,1413271937,1413272303,10,1,366
120533378@N03,684,26,1413325275,1413387878,81,1,62603
120533378@N03,685,26,1413446399,1413476321,36,1,29922
12083014@N05,686,21,1209564000,1209564000,1,1,0
12083014@N05,687,22,1211736998,1211736998,1,1,0
12083014@N05,688,26,1220191200,1220191200,1,1,0
12083014@N05,689,28,1277800013,1277800013,1,2,0
12083014@N05,689,31,1277807280,1277807280,1,2,0
121145663@N04,690,18,1441255883,1441255883,1,1,0
121145663@N04,691,18,1441315483,1441315483,1,1,0
12119240@N07,692,28,1391582035,1391582035,1,1,0
12119240@N07,693,28,1391945965,1391945965,1,1,0
12119240@N07,694,20,1393146059,1393146059,1,1,0
12119240@N07,695,28,1410487314,1410487314,1,2,0
12119240@N07,695,19,1410483511,1410485546,2,2,2035
121202058@N03,696,1,1349448731,1349448731,1,1,0
12143630@N05,697,28,1291161901,1291162791,2,1,890
121577955@N05,698,20,1366690643,1366690643,1,2,0
121577955@N05,698,6,1366686506,1366686506,1,2,0
121634217@N06,699,28,1419740663,1419752692,8,4,12029
121634217@N06,699,29,1419722516,1419722516,1,4,0
121634217@N06,699,26,1419727868,1419727868,1,4,0
121634217@N06,699,18,1419742547,1419742547,1,4,0
121634217@N06,700,13,1419910794,1419910794,1,4,0
121634217@N06,700,16,1419901654,1419901654,1,4,0
121634217@N06,700,20,1419897552,1419897552,1,4,0
121634217@N06,700,25,1419909878,1419910598,2,4,720
12172123@N00,701,27,1319834482,1319834482,1,1,0
12172123@N00,702,28,1320542024,1320542024,1,1,0
12189282@N00,703,28,1323559955,1323559955,1,1,0
12189282@N00,704,1,1368222111,1368222111,1,1,0
12197663@N02,705,17,1428112736,1428112736,1,1,0
122315583@N05,706,18,1440493531,1440493531,1,1,0
122360115@N05,707,1,1396625399,1396625399,1,1,0
122360115@N05,708,1,1396674771,1396674828,2,1,57
122360115@N05,709,27,1396769520,1396769520,1,1,0
122360115@N05,710,1,1396861857,1396865432,4,1,3575
122360115@N05,711,1,1396937309,1396941680,6,1,4371
122360115@N05,712,16,1397025400,1397028468,3,1,3068
122360115@N05,713,25,1397097110,1397097110,1,1,0
122360115@N05,714,1,1397519212,1397519212,1,1,0
122360115@N05,715,16,1397708532,1397708532,1,2,0
122360115@N05,715,30,1397725547,1397725547,1,2,0
122360115@N05,716,7,1397804925,1397804925,1,1,0
122360115@N05,717,5,1397870825,1397919552,4,1,48727
122360115@N05,718,5,1397953244,1397953244,1,1,0
122360115@N05,719,22,1398421821,1398421821,1,1,0
122360115@N05,720,30,1398640774,1398640774,1,2,0
122360115@N05,720,7,1398655713,1398655713,1,2,0
122360115@N05,721,9,1398839468,1398839468,1,2,0
122360115@N05,721,30,1398814790,1398814790,1,2,0
122360115@N05,722,9,1398913722,1398913722,1,1,0
122360115@N05,723,29,1399011709,1399011709,1,2,0
122360115@N05,723,26,1399007290,1399018903,2,2,11613
122360115@N05,724,20,1399109891,1399109891,1,1,0
122360115@N05,725,1,1399428511,1399428511,1,1,0
122360115@N05,726,24,1400023769,1400023769,1,1,0
122360115@N05,727,28,1400145933,1400145933,1,1,0
122360115@N05,728,1,1400384678,1400384678,1,1,0
122360115@N05,729,17,1400469292,1400495107,7,1,25815
122360115@N05,730,17,1400552159,1400567472,4,1,15313
122360115@N05,731,1,1400638726,1400639096,4,1,370
122360115@N05,732,1,1400724738,1400740132,5,2,15394
122360115@N05,732,20,1400725198,1400725198,1,2,0
122360115@N05,733,1,1400817363,1400817363,1,1,0
122360115@N05,734,26,1400937783,1400940416,2,2,2633
122360115@N05,734,17,1400937576,1400937576,1,2,0
122360115@N05,735,30,1400987638,1400987638,1,1,0
122360115@N05,736,26,1401017165,1401017165,1,1,0
122360115@N05,737,1,1401171898,1401171898,1,1,0
122360115@N05,738,7,1401343834,1401343834,1,1,0
122360115@N05,739,26,1401411815,1401439266,2,1,27451
122360115@N05,740,16,1401781144,1401781144,1,1,0
122360115@N05,741,1,1401966540,1401966540,1,1,0
122360115@N05,742,16,1402563626,1402563626,1,1,0
122360115@N05,743,19,1402732077,1402737258,2,1,5181
122360115@N05,744,19,1402786873,1402786873,1,1,0
122360115@N05,745,18,1403072768,1403072768,1,2,0
122360115@N05,745,19,1403060288,1403072896,4,2,12608
122360115@N05,746,19,1403139403,1403159005,2,1,19602
122360115@N05,747,21,1403321524,1403321524,1,2,0
122360115@N05,747,19,1403321348,1403321348,1,2,0
122360115@N05,748,26,1403417859,1403417859,1,1,0
122360115@N05,749,19,1403513183,1403513183,1,1,0
122360115@N05,750,19,1403674093,1403674093,1,1,0
122360115@N05,751,19,1403833953,1403833953,1,2,0
122360115@N05,751,23,1403833913,1403833913,1,2,0
122360115@N05,752,26,1403867167,1403867167,1,1,0
122360115@N05,753,19,1403949506,1403949607,2,2,101
122360115@N05,753,28,1403949548,1403949548,1,2,0
122360115@N05,754,30,1404118486,1404118486,1,1,0
122360115@N05,755,19,1404205103,1404205103,1,1,0
122360115@N05,756,20,1404290383,1404290383,1,1,0
122360115@N05,757,28,1404463167,1404463167,1,2,0
122360115@N05,757,19,1404467259,1404467259,1,2,0
122360115@N05,758,19,1404714639,1404714639,1,1,0
122360115@N05,759,19,1404896180,1404896180,1,1,0
122360115@N05,760,17,1405410930,1405410930,1,1,0
122360115@N05,761,19,1405667242,1405667242,1,2,0
122360115@N05,761,30,1405657256,1405657256,1,2,0
122360115@N05,762,23,1405755166,1405755166,1,1,0
122360115@N05,763,19,1405905715,1405905715,1,1,0
122360115@N05,764,29,1406711096,1406711096,1,1,0
122360115@N05,765,19,1406796479,1406796479,1,1,0
122360115@N05,766,20,1406877858,1406877858,1,2,0
122360115@N05,766,19,1406865033,1406865033,1,2,0
122360115@N05,767,19,1406956625,1406956625,1,1,0
122360115@N05,768,23,1407143209,1407143209,1,1,0
122360115@N05,769,19,1407470813,1407470813,1,1,0
122360115@N05,770,17,1407546467,1407546467,1,2,0
122360115@N05,770,19,1407546373,1407546373,1,2,0
122360115@N05,771,26,1407923370,1407923370,1,1,0
122360115@N05,772,19,1408686119,1408720712,4,1,34593
122360115@N05,773,19,1408751324,1408751324,1,1,0
122360115@N05,774,30,1408957378,1408957428,2,2,50
122360115@N05,774,19,1408934663,1408957542,2,2,22879
122360115@N05,775,19,1409019261,1409019261,1,1,0
122360115@N05,776,30,1409183721,1409183721,1,1,0
122360115@N05,777,19,1409217802,1409217802,1,1,0
122360115@N05,778,14,1409280295,1409280295,1,1,0
122360115@N05,779,30,1409402199,1409402199,1,2,0
122360115@N05,779,19,1409361452,1409391940,8,2,30488
122360115@N05,780,19,1409472215,1409472215,1,1,0
122360115@N05,781,19,1409535617,1409535617,1,1,0
122360115@N05,782,19,1409575686,1409575686,1,1,0
122360115@N05,783,19,1409617099,1409633656,2,1,16557
122360115@N05,784,16,1409762189,1409762189,1,1,0
122360115@N05,785,19,1409799325,1409799325,1,1,0
122360115@N05,786,25,1409848755,1409848755,1,1,0
122360115@N05,787,30,1409901418,1409901418,1,1,0
122360115@N05,788,19,1409978526,1409978526,1,1,0
122360115@N05,789,26,1410052684,1410052684,1,3,0
122360115@N05,789,16,1410102430,1410102430,1,3,0
122360115@N05,789,19,1410078972,1410078972,1,3,0
122360115@N05,790,3,1410145266,1410145266,1,1,0
122360115@N05,791,19,1410280642,1410280642,1,1,0
122360115@N05,792,19,1410314393,1410314393,1,1,0
122360115@N05,793,19,1410425827,1410425827,1,1,0
122360115@N05,794,19,1410509603,1410509603,1,1,0
122360115@N05,795,19,1410577903,1410577903,1,1,0
122360115@N05,796,19,1410659866,1410683782,3,1,23916
122360115@N05,797,30,1410756091,1410756091,1,1,0
122360115@N05,798,19,1410826350,1410836223,2,1,9873
122360115@N05,799,19,1410931332,1410931332,1,1,0
122360115@N05,800,22,1410964562,1410964562,1,1,0
122360115@N05,801,28,1411029513,1411029513,1,1,0
122360115@N05,802,13,1411146024,1411146024,1,2,0
122360115@N05,802,19,1411084680,1411122354,3,2,37674
122360115@N05,803,19,1411233958,1411233958,1,1,0
122360115@N05,804,19,1411400075,1411400075,1,1,0
122360115@N05,805,26,1411430454,1411430454,1,1,0
122360115@N05,806,19,1411485941,1411485941,1,1,0
122360115@N05,807,26,1411519122,1411519122,1,1,0
122360115@N05,808,13,1411614132,1411614132,1,2,0
122360115@N05,808,26,1411636006,1411636006,1,2,0
122360115@N05,809,19,1411696786,1411719831,2,1,23045
122360115@N05,810,19,1411784275,1411784275,1,1,0
122360115@N05,811,14,1411866767,1411866767,1,2,0
122360115@N05,811,19,1411887664,1411887664,1,2,0
122360115@N05,812,19,1411951694,1411978954,2,1,27260
122360115@N05,813,19,1412045227,1412066507,2,1,21280
122360115@N05,814,19,1412126855,1412126855,1,1,0
122360115@N05,815,19,1412155694,1412155694,1,1,0
122360115@N05,816,19,1412216849,1412239466,2,1,22617
122360115@N05,817,19,1412312373,1412312373,1,1,0
122360115@N05,818,30,1412346704,1412346704,1,1,0
122360115@N05,819,19,1412382258,1412401721,2,1,19463
122360115@N05,820,19,1412469489,1412504760,3,1,35271
122360115@N05,821,19,1412551262,1412576740,2,1,25478
122360115@N05,822,19,1412906215,1412906215,1,1,0
122360115@N05,823,4,1413032611,1413032611,1,2,0
122360115@N05,823,19,1412990595,1413014229,6,2,23634
122360115@N05,824,26,1413066514,1413066514,1,2,0
122360115@N05,824,19,1413094061,1413104627,5,2,10566
122360115@N05,825,19,1413166508,1413166508,1,1,0
122360115@N05,826,20,1413200780,1413200780,1,1,0
122360115@N05,827,19,1413263204,1413273387,4,1,10183
122360115@N05,828,19,1413357718,1413360780,3,1,3062
122360115@N05,829,19,1413417039,1413453497,3,1,36458
122360115@N05,830,19,1413505100,1413550759,2,2,45659
122360115@N05,830,18,1413531984,1413531984,1,2,0
122360115@N05,831,19,1413583175,1413583175,1,1,0
122360115@N05,832,19,1413613711,1413613711,1,1,0
122360115@N05,833,19,1413677276,1413699557,2,1,22281
122360115@N05,834,19,1413764752,1413793508,2,1,28756
122360115@N05,835,19,1413851199,1413870409,2,1,19210
122360115@N05,836,11,1413936515,1413936515,1,2,0
122360115@N05,836,19,1413964514,1413964514,1,2,0
122360115@N05,837,20,1414025812,1414025812,1,2,0
122360115@N05,837,19,1414051888,1414051888,1,2,0
122360115@N05,838,19,1414144236,1414144236,1,1,0
122360115@N05,839,19,1414232219,1414232219,1,1,0
122360115@N05,840,19,1414310074,1414310074,1,1,0
122360115@N05,841,19,1414364757,1414387108,2,1,22351
122360115@N05,842,29,1414457431,1414457431,1,2,0
122360115@N05,842,19,1414482593,1414482593,1,2,0
122360115@N05,843,13,1414518399,1414518399,1,1,0
122360115@N05,844,24,1414591047,1414591047,1,1,0
122360115@N05,845,19,1414630068,1414630068,1,1,0
122361912@N02,846,26,1385116965,1385116965,1,1,0
122381618@N08,847,28,1393395689,1393395694,2,2,5
122381618@N08,847,1,1393395522,1393395632,6,2,110
12241674@N03,848,13,1417661302,1417669848,9,7,8546
12241674@N03,848,26,1417682655,1417682655,1,7,0
12241674@N03,848,9,1417644563,1417644843,2,7,280
12241674@N03,848,28,1417683678,1417683678,1,7,0
12241674@N03,848,22,1417654309,1417658183,2,7,3874
12241674@N03,848,7,1417645490,1417645490,1,7,0
12241674@N03,848,5,1417642480,1417642852,5,7,372
12241674@N03,849,13,1417822784,1417823837,13,4,1053
12241674@N03,849,26,1417834007,1417834007,1,4,0
12241674@N03,849,4,1417820497,1417820561,3,4,64
12241674@N03,849,6,1417832994,1417833016,2,4,22
12241674@N03,850,24,1418011607,1418011607,1,7,0
12241674@N03,850,25,1418019793,1418020904,2,7,1111
12241674@N03,850,22,1418022963,1418023734,2,7,771
12241674@N03,850,15,1417997648,1417997747,4,7,99
12241674@N03,850,16,1418016966,1418017275,3,7,309
12241674@N03,850,26,1418000210,1418029300,2,7,29090
12241674@N03,850,1,1417989183,1417989183,1,7,0
12247055@N00,851,28,1417015432,1417034073,4,4,18641
12247055@N00,851,26,1417015994,1417016076,2,4,82
12247055@N00,851,1,1417015342,1417015342,1,4,0
12247055@N00,851,20,1417030151,1417030151,1,4,0
12252801@N00,852,26,1415955385,1415955385,1,1,0
122536755@N07,853,1,1376943498,1376963236,3,1,19738
122815638@N08,854,16,1401588580,1401588580,1,1,0
122833646@N08,855,28,1281159555,1281159555,1,1,0
122833646@N08,856,28,1281264695,1281264695,1,1,0
122911104@N07,857,27,1399156840,1399156840,1,4,0
122911104@N07,857,26,1399156399,1399160581,2,4,4182
122911104@N07,857,15,1399165650,1399165650,1,4,0
122911104@N07,857,17,1399161811,1399161811,1,4,0
122911104@N07,858,26,1399202974,1399203496,2,1,522
122911104@N07,859,26,1418529399,1418552873,10,1,23474
122911104@N07,860,26,1422411921,1422411921,1,1,0
122911104@N07,861,26,1422687822,1422693953,4,1,6131
122911104@N07,862,26,1424251156,1424251156,1,1,0
122911104@N07,863,26,1428120197,1428120197,1,1,0
122911104@N07,864,26,1428830695,1428832378,9,1,1683
122911104@N07,865,26,1431124876,1431126146,2,1,1270
122911104@N07,866,26,1432249744,1432249744,1,1,0
122911104@N07,867,26,1432375022,1432383430,9,1,8408
122911104@N07,868,26,1433844907,1433846972,3,1,2065
122911104@N07,869,26,1434629150,1434629714,3,1,564
122911104@N07,870,26,1439464051,1439464051,1,1,0
122911104@N07,871,26,1439591504,1439591504,1,1,0
122911104@N07,872,26,1439895009,1439895009,1,1,0
122911104@N07,873,26,1440674076,1440674076,1,1,0
122911104@N07,874,26,1442490468,1442490468,1,1,0
122911104@N07,875,26,1442579463,1442579463,1,1,0
122911104@N07,876,26,1443842208,1443848547,3,1,6339
122911104@N07,877,26,1444371134,1444371603,4,1,469
122911104@N07,878,26,1445496423,1445510858,2,1,14435
122911104@N07,879,26,1446722014,1446722014,1,1,0
122911104@N07,880,26,1446796862,1446804858,3,1,7996
122911104@N07,881,26,1448673499,1448675533,4,1,2034
122911104@N07,882,26,1449890845,1449917144,2,1,26299
123072326@N08,883,26,1401438240,1401438240,1,1,0
123177436@N08,884,26,1387599564,1387606007,4,4,6443
123177436@N08,884,28,1387596152,1387632952,5,4,36800
123177436@N08,884,13,1387608556,1387608556,1,4,0
123177436@N08,884,1,1387591867,1387591867,1,4,0
12326995@N03,885,1,1203573013,1203573013,1,1,0
12326995@N03,886,26,1203743827,1203743836,2,5,9
12326995@N03,886,1,1203743812,1203743815,2,5,3
12326995@N03,886,28,1203743832,1203743841,3,5,9
12326995@N03,886,22,1203743817,1203743822,3,5,5
12326995@N03,886,20,1203743825,1203743847,6,5,22
12326995@N03,887,29,1203936654,1203936654,1,2,0
12326995@N03,887,1,1203936647,1203936652,4,2,5
12326995@N03,888,29,1274591700,1274592006,5,1,306
12326995@N03,889,27,1274679834,1274679834,1,4,0
12326995@N03,889,26,1274680233,1274680306,2,4,73
12326995@N03,889,29,1274690202,1274690202,1,4,0
12326995@N03,889,1,1274677603,1274677603,1,4,0
12326995@N03,890,16,1274786807,1274787432,5,5,625
12326995@N03,890,25,1274784543,1274785343,4,5,800
12326995@N03,890,24,1274781524,1274781524,1,5,0
12326995@N03,890,28,1274787655,1274787655,1,5,0
12326995@N03,890,17,1274782261,1274782261,1,5,0
12326995@N03,891,22,1274851097,1274851097,1,1,0
12329513@N06,892,10,1295440188,1295448455,8,1,8267
123393307@N03,893,26,1313286863,1313286863,1,2,0
123393307@N03,893,13,1313284505,1313284505,1,2,0
123425229@N07,894,16,1386992607,1386992607,1,4,0
123425229@N07,894,17,1386991554,1386991588,3,4,34
123425229@N07,894,26,1386985270,1386989528,3,4,4258
123425229@N07,894,1,1386979123,1386979123,1,4,0
123425229@N07,895,17,1449892179,1449892179,1,4,0
123425229@N07,895,23,1449883098,1449883098,1,4,0
123425229@N07,895,1,1449876097,1449876235,6,4,138
123425229@N07,895,28,1449918063,1449918063,1,4,0
123463941@N02,896,28,1319194062,1319194066,2,1,4
123756580@N03,897,26,1455140903,1455146054,2,7,5151
123756580@N03,897,27,1455151277,1455151277,1,7,0
123756580@N03,897,16,1455171238,1455171246,2,7,8
123756580@N03,897,6,1455148944,1455150855,5,7,1911
123756580@N03,897,3,1455141909,1455164659,2,7,22750
123756580@N03,897,4,1455143274,1455143690,2,7,416
123756580@N03,897,25,1455155984,1455155984,1,7,0
123891828@N06,898,24,1307996788,1308005324,18,1,8536
123891828@N06,899,24,1308072592,1308110710,8,1,38118
123891828@N06,900,24,1308242508,1308256644,3,1,14136
123899237@N03,901,28,1416031548,1416035786,5,5,4238
123899237@N03,901,25,1416017283,1416018723,8,5,1440
123899237@N03,901,13,1416021387,1416021694,4,5,307
123899237@N03,901,21,1416016173,1416016173,1,5,0
123899237@N03,901,4,1416016182,1416016182,1,5,0
123908048@N03,902,1,1435570297,1435570388,2,1,91
123908048@N03,903,22,1435642510,1435643243,2,15,733
123908048@N03,903,21,1435645086,1435651235,2,15,6149
123908048@N03,903,26,1435626111,1435664718,15,15,38607
123908048@N03,903,29,1435629011,1435641734,9,15,12723
123908048@N03,903,20,1435631345,1435632165,8,15,820
123908048@N03,903,31,1435643402,1435643402,1,15,0
123908048@N03,903,27,1435633087,1435650861,5,15,17774
123908048@N03,903,23,1435629368,1435632405,7,15,3037
123908048@N03,903,3,1435654471,1435655333,2,15,862
123908048@N03,903,12,1435651152,1435651832,3,15,680
123908048@N03,903,16,1435646596,1435668514,11,15,21918
123908048@N03,903,19,1435627866,1435628156,2,15,290
123908048@N03,903,28,1435663125,1435669571,3,15,6446
123908048@N03,903,17,1435644692,1435644692,1,15,0
123908048@N03,903,30,1435626616,1435664828,8,15,38212
12395214@N08,904,6,1432989189,1432989927,23,1,738
124015959@N07,905,17,1410823841,1410823841,1,2,0
124015959@N07,905,26,1410823973,1410823973,1,2,0
124116382@N06,906,28,1402211230,1402211230,1,1,0
124116382@N06,907,26,1408096523,1408097435,2,1,912
124116382@N06,908,19,1416132916,1416132916,1,1,0
124116382@N06,909,28,1416918645,1416918645,1,1,0
124116382@N06,910,18,1430363592,1430363592,1,1,0
12423353@N02,911,1,1306378680,1306378680,1,5,0
12423353@N02,911,15,1306381011,1306381214,11,5,203
12423353@N02,911,17,1306380545,1306380782,3,5,237
12423353@N02,911,28,1306378885,1306378885,1,5,0
12423353@N02,911,27,1306380236,1306380265,2,5,29
12423353@N02,912,1,1306879752,1306880914,3,6,1162
12423353@N02,912,15,1306904036,1306925165,3,6,21129
12423353@N02,912,26,1306928108,1306928699,33,6,591
12423353@N02,912,28,1306881393,1306885489,16,6,4096
12423353@N02,912,27,1306890003,1306893872,15,6,3869
12423353@N02,912,23,1306889135,1306889407,3,6,272
12423353@N02,913,25,1306975691,1306975691,1,5,0
12423353@N02,913,15,1306972792,1306972805,2,5,13
12423353@N02,913,27,1306970578,1306970578,1,5,0
12423353@N02,913,30,1306976566,1306976566,1,5,0
12423353@N02,913,23,1306976960,1306977061,3,5,101
12429838@N07,914,11,1298772826,1298788327,37,1,15501
12431650@N06,915,20,1290737732,1290737732,1,1,0
12431650@N06,916,12,1307856640,1307856640,1,1,0
12438054@N08,917,28,1352539939,1352539939,1,1,0
12445726@N06,918,28,1351052815,1351052815,1,2,0
12445726@N06,918,26,1351054286,1351054308,2,2,22
12445726@N06,919,30,1353558049,1353558049,1,3,0
12445726@N06,919,27,1353561497,1353561497,1,3,0
12445726@N06,919,1,1353563668,1353563675,2,3,7
124495835@N08,920,1,1393225627,1393225627,1,1,0
124495835@N08,921,26,1399461527,1399461527,1,1,0
124495835@N08,922,25,1420541455,1420541455,1,1,0
124495835@N08,923,28,1425548111,1425548111,1,1,0
124495835@N08,924,1,1426663762,1426663762,1,1,0
124495835@N08,925,26,1433053790,1433053790,1,2,0
124495835@N08,925,28,1433038406,1433038406,1,2,0
124495835@N08,926,26,1436794792,1436794792,1,3,0
124495835@N08,926,16,1436794068,1436794068,1,3,0
124495835@N08,926,1,1436795316,1436795316,1,3,0
124495835@N08,927,26,1440913637,1440913708,3,1,71
124495835@N08,928,28,1441195311,1441195948,2,1,637
124495835@N08,929,1,1443619814,1443619814,1,1,0
124495835@N08,930,26,1448971573,1448971573,1,3,0
124495835@N08,930,29,1448969178,1448969178,1,3,0
124495835@N08,930,28,1448974425,1448975063,2,3,638
124495835@N08,931,6,1454495066,1454495066,1,1,0
124495835@N08,932,1,1460461940,1460461940,1,2,0
124495835@N08,932,28,1460462647,1460462647,1,2,0
124545141@N08,933,26,1438136485,1438172472,8,9,35987
124545141@N08,933,17,1438161577,1438163012,7,9,1435
124545141@N08,933,1,1438136084,1438136100,3,9,16
124545141@N08,933,3,1438171762,1438172318,5,9,556
124545141@N08,933,30,1438151669,1438151669,1,9,0
124545141@N08,933,25,1438169698,1438169753,10,9,55
124545141@N08,933,15,1438162046,1438162046,1,9,0
124545141@N08,933,29,1438156709,1438156845,3,9,136
124545141@N08,933,21,1438148899,1438172275,8,9,23376
12457199@N04,934,26,1290231382,1290231382,1,1,0
12482362@N04,935,12,1366102661,1366112714,3,12,10053
12482362@N04,935,31,1366203808,1366236653,5,12,32845
12482362@N04,935,26,1366173801,1366206959,12,12,33158
12482362@N04,935,4,1366113927,1366194891,6,12,80964
12482362@N04,935,19,1366149706,1366234798,4,12,85092
12482362@N04,935,8,1366190245,1366191201,2,12,956
12482362@N04,935,6,1366164248,1366171330,3,12,7082
12482362@N04,935,24,1366196312,1366200015,4,12,3703
12482362@N04,935,13,1366106152,1366111591,4,12,5439
12482362@N04,935,7,1366156546,1366159214,3,12,2668
12482362@N04,935,22,1366146769,1366148365,2,12,1596
12482362@N04,935,1,1366240728,1366240728,1,12,0
12482362@N04,936,4,1372777673,1372777673,1,2,0
12482362@N04,936,28,1372776315,1372776315,1,2,0
12482362@N04,937,20,1372808336,1372808336,1,2,0
12482362@N04,937,7,1372806842,1372806842,1,2,0
12482362@N04,938,7,1377679975,1377693416,9,1,13441
12482362@N04,939,7,1377724101,1377780215,16,1,56114
12482362@N04,940,7,1377948565,1377948565,1,1,0
12482362@N04,941,23,1379851885,1379860866,3,1,8981
124848726@N03,942,1,1465973411,1465973411,1,1,0
12485829@N00,943,31,1340504492,1340504492,1,2,0
12485829@N00,943,9,1340506598,1340506953,2,2,355
125032415@N05,944,26,1370826731,1370849066,3,1,22335
12505291@N08,945,24,1245920905,1245920905,1,1,0
12508217@N08,946,28,1218171510,1218171600,4,3,90
12508217@N08,946,18,1218167813,1218168081,2,3,268
12508217@N08,946,29,1218165022,1218165022,1,3,0
12508217@N08,947,29,1253184035,1253184391,4,1,356
12508217@N08,948,18,1253247683,1253248406,7,2,723
12508217@N08,948,29,1253258699,1253260524,6,2,1825
12508217@N08,949,29,1278673222,1278681901,37,1,8679
12508217@N08,950,18,1334993124,1334997617,74,1,4493
12508217@N08,951,28,1346549444,1346550243,12,2,799
12508217@N08,951,18,1346551840,1346555891,72,2,4051
12508217@N08,952,27,1369414001,1369414693,6,5,692
12508217@N08,952,28,1369422589,1369425550,2,5,2961
12508217@N08,952,26,1369415697,1369415999,8,5,302
12508217@N08,952,18,1369417213,1369417244,2,5,31
12508217@N08,952,29,1369417513,1369423059,4,5,5546
12508217@N08,953,1,1369463697,1369470258,4,4,6561
12508217@N08,953,25,1369464527,1369465519,3,4,992
12508217@N08,953,3,1369469365,1369469365,1,4,0
12508217@N08,953,4,1369467015,1369468705,10,4,1690
125379110@N03,954,29,1402267018,1402268243,4,1,1225
125379110@N03,955,29,1402396302,1402396302,1,1,0
125379110@N03,956,29,1402956823,1402980723,5,1,23900
125379110@N03,957,29,1403102445,1403102445,1,1,0
125379110@N03,958,29,1403694476,1403698010,4,1,3534
125379110@N03,959,29,1403874257,1403874257,1,1,0
125508504@N03,960,23,1292638331,1292638344,2,4,13
125508504@N03,960,28,1292658132,1292658227,3,4,95
125508504@N03,960,26,1292645007,1292653172,4,4,8165
125508504@N03,960,30,1292679116,1292680018,2,4,902
125508504@N03,961,14,1292738537,1292738537,1,1,0
125508504@N03,962,25,1292931656,1292931663,2,1,7
12557280@N05,963,24,1390646506,1390646506,1,1,0
12572833@N04,964,27,1295263477,1295263477,1,1,0
12572833@N04,965,18,1338172293,1338187043,70,1,14750
125778589@N07,966,28,1450477954,1450477954,1,1,0
125778589@N07,967,20,1450527722,1450527722,1,1,0
12584309@N00,968,26,1237022160,1237022160,1,3,0
12584309@N00,968,16,1237027917,1237027917,1,3,0
12584309@N00,968,18,1237022301,1237022301,1,3,0
12599627@N04,969,21,1312338441,1312338441,1,2,0
12599627@N04,969,29,1312333040,1312333040,1,2,0
12619133@N07,970,24,1228782399,1228782565,16,2,166
12619133@N07,970,28,1228804787,1228804936,6,2,149
126229477@N05,971,26,1442578853,1442578853,1,1,0
126305887@N02,972,5,1454391788,1454391788,1,1,0
126305887@N02,973,28,1454478243,1454484677,4,1,6434
126305887@N02,974,29,1454563646,1454563646,1,1,0
126458449@N05,975,25,1386384586,1386384586,4,1,0
126695530@N07,976,1,1441484479,1441484479,1,1,0
126704266@N03,977,26,1403692606,1403692760,9,1,154
126797303@N08,978,16,1382352288,1382352288,1,5,0
126797303@N08,978,1,1382356518,1382356518,1,5,0
126797303@N08,978,14,1382349930,1382349930,1,5,0
126797303@N08,978,20,1382348177,1382348177,1,5,0
126797303@N08,978,28,1382337595,1382337807,2,5,212
12685141@N08,979,29,1359864868,1359865118,2,1,250
12685141@N08,980,15,1366430280,1366430280,1,4,0
12685141@N08,980,1,1366420638,1366420638,1,4,0
12685141@N08,980,12,1366424709,1366424709,1,4,0
12685141@N08,980,27,1366442752,1366442752,1,4,0
12685141@N08,981,28,1379328181,1379328181,1,2,0
12685141@N08,981,1,1379305096,1379305096,1,2,0
12685141@N08,982,1,1379385402,1379406975,2,1,21573
12685141@N08,983,27,1379664278,1379664278,1,1,0
12685141@N08,984,26,1381392773,1381392773,1,1,0
12689533@N05,985,1,1319782336,1319782342,2,1,6
126898848@N02,986,26,1355898912,1355898912,1,1,0
12696073@N07,987,1,1364806204,1364806204,1,1,0
12696073@N07,988,26,1370956030,1370956030,1,1,0
12696073@N07,989,1,1371108040,1371108040,1,1,0
12696073@N07,990,18,1371198227,1371198227,1,2,0
12696073@N07,990,28,1371202187,1371202187,1,2,0
12696073@N07,991,26,1376627815,1376627815,1,1,0
12696190@N05,992,14,1351571673,1351571673,1,1,0
12706502@N00,993,18,1383010693,1383010693,1,1,0
12706502@N00,994,18,1422253593,1422253593,1,1,0
127085047@N07,995,13,1409198556,1409198556,1,1,0
12726203@N07,996,19,1287996990,1287996990,1,1,0
12731599@N08,997,27,1188998550,1188998550,1,1,0
12731599@N08,998,16,1287793947,1287793947,1,1,0
12734746@N00,999,26,1270085381,1270129381,101,1,44000
12734746@N00,1000,26,1270355784,1270373781,36,1,17997
12734746@N00,1001,29,1313666359,1313677890,38,1,11531
12742129@N00,1002,26,1355404778,1355404778,1,1,0
12742129@N00,1003,1,1372508354,1372508904,4,1,550
12742129@N00,1004,28,1378514593,1378514593,1,1,0
12742564@N00,1005,28,1381566871,1381566871,1,1,0
12742564@N00,1006,31,1388551436,1388551436,1,1,0
12742564@N00,1007,20,1411121396,1411121396,1,1,0
12742564@N00,1008,19,1414721425,1414721425,1,2,0
12742564@N00,1008,30,1414728069,1414728069,1,2,0
12742564@N00,1009,28,1417075748,1417075748,1,1,0
12742564@N00,1010,1,1422155206,1422155206,1,1,0
12742564@N00,1011,29,1424591581,1424591581,1,2,0
12742564@N00,1011,1,1424585937,1424585937,1,2,0
12742564@N00,1012,28,1427713115,1427713115,1,1,0
12742564@N00,1013,18,1446275556,1446275556,1,1,0
12742564@N00,1014,15,1455087126,1455087126,1,2,0
12742564@N00,1014,18,1455086142,1455086142,1,2,0
12742564@N00,1015,18,1459318681,1459318681,1,1,0
127460346@N03,1016,20,1449800062,1449800224,3,4,162
127460346@N03,1016,27,1449821960,1449821960,1,4,0
127460346@N03,1016,19,1449788957,1449788957,1,4,0
127460346@N03,1016,17,1449787172,1449787172,1,4,0
127510853@N02,1017,26,1248350782,1248350782,1,1,0
12767421@N08,1018,28,1283769763,1283769865,2,1,102
12767421@N08,1019,21,1313327996,1313327996,1,2,0
12767421@N08,1019,4,1313327903,1313327903,1,2,0
12771314@N00,1020,18,1443675250,1443675250,1,1,0
12786044@N00,1021,30,1247437388,1247437388,1,1,0
127890209@N05,1022,15,1448358768,1448362329,8,7,3561
127890209@N05,1022,25,1448370863,1448370863,1,7,0
127890209@N05,1022,24,1448361361,1448361361,1,7,0
127890209@N05,1022,30,1448371703,1448371703,1,7,0
127890209@N05,1022,17,1448361662,1448370188,6,7,8526
127890209@N05,1022,27,1448349121,1448349121,1,7,0
127890209@N05,1022,21,1448370597,1448371072,3,7,475
12793852@N00,1023,27,1320039975,1320045974,8,13,5999
12793852@N00,1023,17,1320031462,1320031561,3,13,99
12793852@N00,1023,12,1320033293,1320033349,3,13,56
12793852@N00,1023,8,1320049201,1320049201,1,13,0
12793852@N00,1023,21,1320038845,1320039226,11,13,381
12793852@N00,1023,24,1320032177,1320045639,23,13,13462
12793852@N00,1023,15,1320031615,1320044296,6,13,12681
12793852@N00,1023,7,1320048931,1320048993,5,13,62
12793852@N00,1023,16,1320040232,1320052626,8,13,12394
12793852@N00,1023,9,1320047589,1320047589,1,13,0
12793852@N00,1023,10,1320047598,1320047598,1,13,0
12793852@N00,1023,3,1320038620,1320039386,2,13,766
12793852@N00,1023,5,1320048708,1320048715,2,13,7
12793852@N00,1024,22,1320391683,1320391713,3,2,30
12793852@N00,1024,27,1320371870,1320371897,3,2,27
12793852@N00,1025,21,1323849087,1323849087,1,1,0
12793852@N00,1026,12,1341113599,1341113678,5,5,79
12793852@N00,1026,24,1341113547,1341113732,3,5,185
12793852@N00,1026,15,1341113533,1341113533,1,5,0
12793852@N00,1026,16,1341138776,1341139184,19,5,408
12793852@N00,1026,26,1341121364,1341121364,1,5,0
128287982@N02,1027,26,1439733760,1439741293,2,2,7533
128287982@N02,1027,28,1439735734,1439736261,3,2,527
128287982@N02,1028,26,1439857624,1439857711,2,1,87
128287982@N02,1029,26,1439908299,1439908822,2,1,523
12846758@N06,1030,22,1190348282,1190348282,1,1,0
12846758@N06,1031,22,1192836502,1192836610,2,1,108
12846758@N06,1032,22,1192866154,1192866154,1,1,0
12846758@N06,1033,22,1195998759,1195998759,1,1,0
12846758@N06,1034,22,1205219873,1205219873,1,1,0
128509080@N04,1035,1,1424555797,1424555797,1,9,0
128509080@N04,1035,7,1424567847,1424568282,6,9,435
128509080@N04,1035,28,1424552024,1424552118,2,9,94
128509080@N04,1035,13,1424564987,1424565233,7,9,246
128509080@N04,1035,9,1424569400,1424569400,1,9,0
128509080@N04,1035,26,1424559250,1424559313,4,9,63
128509080@N04,1035,21,1424567267,1424567577,5,9,310
128509080@N04,1035,6,1424568484,1424568484,1,9,0
128509080@N04,1035,11,1424569825,1424571416,5,9,1591
12857322@N03,1036,12,1370837000,1370837013,3,9,13
12857322@N03,1036,22,1370857658,1370857658,1,9,0
12857322@N03,1036,11,1370848182,1370848182,1,9,0
12857322@N03,1036,26,1370835316,1370866019,3,9,30703
12857322@N03,1036,3,1370837031,1370838663,5,9,1632
12857322@N03,1036,4,1370848081,1370848170,4,9,89
12857322@N03,1036,27,1370831525,1370831525,1,9,0
12857322@N03,1036,7,1370846098,1370846098,1,9,0
12857322@N03,1036,21,1370848072,1370848423,2,9,351
12861032@N00,1037,22,1350887832,1350887946,2,1,114
12861032@N00,1038,6,1350950461,1350950463,2,2,2
12861032@N00,1038,26,1350942691,1350942691,1,2,0
12861032@N00,1039,29,1351057977,1351057977,1,1,0
12861032@N00,1040,23,1398642718,1398656908,2,9,14190
12861032@N00,1040,18,1398656454,1398656454,1,9,0
12861032@N00,1040,29,1398643448,1398643448,1,9,0
12861032@N00,1040,31,1398644850,1398644850,1,9,0
12861032@N00,1040,16,1398650426,1398650426,1,9,0
12861032@N00,1040,26,1398652657,1398652657,1,9,0
12861032@N00,1040,28,1398641930,1398642153,3,9,223
12861032@N00,1040,27,1398650420,1398650420,1,9,0
12861032@N00,1040,15,1398648906,1398649005,4,9,99
12861032@N00,1041,30,1448855541,1448858219,2,3,2678
12861032@N00,1041,20,1448846343,1448846413,2,3,70
12861032@N00,1041,19,1448849675,1448849679,2,3,4
12861032@N00,1042,1,1448951769,1448952405,3,14,636
12861032@N00,1042,5,1448929241,1448929241,1,14,0
12861032@N00,1042,18,1448933235,1448933465,3,14,230
12861032@N00,1042,31,1448933108,1448933108,1,14,0
12861032@N00,1042,29,1448933118,1448961807,10,14,28689
12861032@N00,1042,17,1448938531,1448938531,1,14,0
12861032@N00,1042,16,1448922885,1448922885,1,14,0
12861032@N00,1042,26,1448934195,1448953355,4,14,19160
12861032@N00,1042,28,1448921776,1448962271,7,14,40495
12861032@N00,1042,27,1448922911,1448923114,4,14,203
12861032@N00,1042,24,1448927087,1448927087,1,14,0
12861032@N00,1042,15,1448925560,1448925685,2,14,125
12861032@N00,1042,20,1448957770,1448959770,18,14,2000
12861032@N00,1042,19,1448933111,1448933281,10,14,170
12865054@N06,1043,24,1303188144,1303188144,1,3,0
12865054@N06,1043,25,1303208861,1303208861,1,3,0
12865054@N06,1043,29,1303205634,1303205634,1,3,0
12902435@N05,1044,6,1337066334,1337066334,1,1,0
129180516@N08,1045,30,1442050727,1442050727,1,2,0
129180516@N08,1045,14,1442044868,1442044868,1,2,0
129181069@N07,1046,17,1434450517,1434450517,1,13,0
129181069@N07,1046,1,1434428017,1434428017,1,13,0
129181069@N07,1046,12,1434435204,1434435204,1,13,0
129181069@N07,1046,10,1434461766,1434461766,1,13,0
129181069@N07,1046,25,1434436620,1434436624,2,13,4
129181069@N07,1046,20,1434446069,1434446069,1,13,0
129181069@N07,1046,26,1434413626,1434413626,1,13,0
129181069@N07,1046,30,1434408253,1434461975,5,13,53722
129181069@N07,1046,22,1434428359,1434428359,1,13,0
129181069@N07,1046,24,1434449325,1434449325,1,13,0
129181069@N07,1046,15,1434426181,1434426181,1,13,0
129181069@N07,1046,31,1434434556,1434434556,1,13,0
129181069@N07,1046,28,1434459959,1434460629,4,13,670
12939143@N00,1047,26,1255945786,1255945786,1,1,0
129397947@N05,1048,1,1455594294,1455595297,3,1,1003
129438227@N06,1049,26,1411742039,1411742039,1,1,0
129438227@N06,1050,10,1411914024,1411914024,1,1,0
129438227@N06,1051,26,1412025885,1412025885,1,1,0
129438227@N06,1052,31,1441931590,1441931590,1,1,0
129438227@N06,1053,26,1442007516,1442007516,1,1,0
129438227@N06,1054,20,1442067139,1442067139,1,1,0
129438227@N06,1055,16,1447495145,1447495145,1,1,0
129438227@N06,1056,21,1447589562,1447589562,1,1,0
129451096@N08,1057,26,1435026313,1435026313,1,2,0
129451096@N08,1057,8,1435023030,1435023360,8,2,330
129451096@N08,1058,26,1435118111,1435118573,18,1,462
129451096@N08,1059,26,1435300399,1435300487,2,1,88
129456803@N08,1060,29,1420869902,1420869902,1,1,0
12946812@N03,1061,16,1214954543,1214954543,1,10,0
12946812@N03,1061,7,1214963830,1214989305,4,10,25475
12946812@N03,1061,17,1214951954,1214951954,1,10,0
12946812@N03,1061,23,1214954610,1214958610,2,10,4000
12946812@N03,1061,12,1214951588,1214951588,1,10,0
12946812@N03,1061,27,1214952899,1214952899,1,10,0
12946812@N03,1061,22,1214958204,1214958204,1,10,0
12946812@N03,1061,29,1214954778,1214956652,5,10,1874
12946812@N03,1061,30,1214954728,1214954728,1,10,0
12946812@N03,1061,24,1214951661,1214981004,2,10,29343
129853099@N05,1062,28,1421472645,1421472860,2,1,215
12987527@N05,1063,1,1243576481,1243576481,1,2,0
12987527@N05,1063,14,1243574642,1243574642,1,2,0
12996122@N00,1064,25,1325465707,1325508830,7,1,43123
129990301@N04,1065,12,1418619745,1418619745,1,5,0
129990301@N04,1065,26,1418622018,1418634699,3,5,12681
129990301@N04,1065,1,1418623289,1418623290,2,5,1
129990301@N04,1065,24,1418618474,1418618474,1,5,0
129990301@N04,1065,28,1418622275,1418622304,2,5,29
129990301@N04,1066,5,1418689373,1418689373,1,7,0
129990301@N04,1066,13,1418685872,1418686308,3,7,436
129990301@N04,1066,25,1418685145,1418685938,4,7,793
129990301@N04,1066,26,1418689632,1418689646,2,7,14
129990301@N04,1066,3,1418688698,1418689302,3,7,604
129990301@N04,1066,15,1418684280,1418685021,8,7,741
129990301@N04,1066,30,1418690017,1418690713,3,7,696
13042723@N00,1067,26,1238199012,1238225340,21,1,26328
13042723@N00,1068,26,1238324077,1238344512,2,5,20435
13042723@N00,1068,12,1238322603,1238323063,2,5,460
13042723@N00,1068,19,1238320769,1238321058,3,5,289
13042723@N00,1068,20,1238331238,1238331238,1,5,0
13042723@N00,1068,10,1238321829,1238325485,3,5,3656
13044954@N06,1069,18,1191385023,1191388184,3,1,3161
130507424@N08,1070,1,1421576124,1421576124,1,1,0
130777482@N08,1071,16,1422661137,1422661137,1,1,0
130777482@N08,1072,16,1422710187,1422710187,1,2,0
130777482@N08,1072,7,1422708231,1422708236,3,2,5
130777482@N08,1073,4,1422936580,1422936580,1,3,0
130777482@N08,1073,21,1422933216,1422933218,2,3,2
130777482@N08,1073,7,1422936559,1422936563,2,3,4
130912872@N04,1074,26,1427430830,1427430961,2,5,131
130912872@N04,1074,24,1427452003,1427452003,1,5,0
130912872@N04,1074,29,1427443083,1427443083,1,5,0
130912872@N04,1074,25,1427434682,1427434682,1,5,0
130912872@N04,1074,20,1427444454,1427444454,1,5,0
130912872@N04,1075,26,1427490063,1427549223,2,16,59160
130912872@N04,1075,24,1427511009,1427511303,3,16,294
130912872@N04,1075,23,1427548999,1427548999,1,16,0
130912872@N04,1075,29,1427548280,1427548280,1,16,0
130912872@N04,1075,30,1427548386,1427548509,2,16,123
130912872@N04,1075,27,1427538831,1427539173,2,16,342
130912872@N04,1075,11,1427491310,1427491310,1,16,0
130912872@N04,1075,17,1427538973,1427538973,1,16,0
130912872@N04,1075,1,1427487314,1427487314,1,16,0
130912872@N04,1075,28,1427497674,1427532366,2,16,34692
130912872@N04,1075,7,1427544110,1427544110,1,16,0
130912872@N04,1075,19,1427516411,1427516411,1,16,0
130912872@N04,1075,3,1427491636,1427492003,3,16,367
130912872@N04,1075,4,1427490342,1427490342,1,16,0
130912872@N04,1075,15,1427528838,1427528861,2,16,23
130912872@N04,1075,21,1427490858,1427490871,2,16,13
130912872@N04,1076,16,1427601085,1427602633,4,5,1548
130912872@N04,1076,27,1427602872,1427602955,3,5,83
130912872@N04,1076,17,1427588301,1427588301,1,5,0
130912872@N04,1076,28,1427628339,1427628339,1,5,0
130912872@N04,1076,13,1427612740,1427612740,1,5,0
130912872@N04,1077,26,1427713710,1427713886,2,8,176
130912872@N04,1077,1,1427695368,1427695368,1,8,0
130912872@N04,1077,23,1427672751,1427672902,3,8,151
130912872@N04,1077,18,1427674169,1427685438,4,8,11269
130912872@N04,1077,28,1427695776,1427695776,1,8,0
130912872@N04,1077,19,1427685346,1427685346,1,8,0
130912872@N04,1077,8,1427678462,1427678462,1,8,0
130912872@N04,1077,13,1427675995,1427675995,1,8,0
130912872@N04,1078,18,1441349057,1441349057,1,1,0
13093780@N04,1079,26,1242724046,1242724103,6,1,57
13093780@N04,1080,19,1247477991,1247477991,1,5,0
13093780@N04,1080,26,1247477972,1247478007,2,5,35
13093780@N04,1080,25,1247478286,1247478456,6,5,170
13093780@N04,1080,30,1247478060,1247478060,1,5,0
13093780@N04,1080,28,1247478030,1247478411,11,5,381
130979231@N04,1081,21,1362529571,1362549652,2,8,20081
130979231@N04,1081,3,1362529230,1362529230,1,8,0
130979231@N04,1081,17,1362546119,1362560599,2,8,14480
130979231@N04,1081,4,1362549937,1362549937,1,8,0
130979231@N04,1081,5,1362529220,1362529220,1,8,0
130979231@N04,1081,18,1362531329,1362531329,1,8,0
130979231@N04,1081,26,1362553509,1362553690,2,8,181
130979231@N04,1081,20,1362538420,1362538420,1,8,0
130979231@N04,1082,31,1366961031,1366961031,1,3,0
130979231@N04,1082,1,1366956789,1366956789,1,3,0
130979231@N04,1082,11,1366962080,1366962080,1,3,0
13101664@N03,1083,27,1424301358,1424301358,1,13,0
13101664@N03,1083,24,1424307471,1424307471,1,13,0
13101664@N03,1083,23,1424308521,1424308521,1,13,0
13101664@N03,1083,28,1424314007,1424318756,5,13,4749
13101664@N03,1083,1,1424316902,1424323204,14,13,6302
13101664@N03,1083,30,1424334749,1424334749,1,13,0
13101664@N03,1083,15,1424312596,1424312596,1,13,0
13101664@N03,1083,17,1424310633,1424342478,2,13,31845
13101664@N03,1083,29,1424339584,1424340403,3,13,819
13101664@N03,1083,4,1424295075,1424295298,3,13,223
13101664@N03,1083,16,1424298444,1424315367,3,13,16923
13101664@N03,1083,7,1424295583,1424295583,1,13,0
13101664@N03,1083,26,1424315424,1424315781,4,13,357
13101664@N03,1084,27,1424394378,1424394388,2,10,10
13101664@N03,1084,24,1424400029,1424400037,2,10,8
13101664@N03,1084,23,1424391648,1424391648,1,10,0
13101664@N03,1084,28,1424385362,1424385362,1,10,0
13101664@N03,1084,30,1424389523,1424389619,2,10,96
13101664@N03,1084,21,1424411293,1424411440,2,10,147
13101664@N03,1084,19,1424387729,1424387729,1,10,0
13101664@N03,1084,13,1424397397,1424402331,2,10,4934
13101664@N03,1084,26,1424396220,1424407618,3,10,11398
13101664@N03,1084,3,1424410008,1424412614,2,10,2606
13101664@N03,1085,28,1424918235,1424918235,1,2,0
13101664@N03,1085,26,1424918304,1424918304,1,2,0
13125640@N07,1086,31,1197636584,1197638446,11,7,1862
13125640@N07,1086,26,1197635613,1197636214,19,7,601
13125640@N07,1086,16,1197634651,1197641790,3,7,7139
13125640@N07,1086,1,1197628633,1197628658,4,7,25
13125640@N07,1086,15,1197631129,1197632492,4,7,1363
13125640@N07,1086,28,1197641974,1197642351,11,7,377
13125640@N07,1086,24,1197639457,1197639566,3,7,109
13125640@N07,1087,30,1200132266,1200132335,3,5,69
13125640@N07,1087,16,1200138207,1200138292,4,5,85
13125640@N07,1087,23,1200132966,1200132966,1,5,0
13125640@N07,1087,15,1200134206,1200134206,1,5,0
13125640@N07,1087,27,1200120211,1200120294,3,5,83
13125640@N07,1088,1,1202466304,1202467258,26,1,954
13125640@N07,1089,23,1204285529,1204285529,1,2,0
13125640@N07,1089,28,1204284671,1204284901,5,2,230
131378402@N06,1090,26,1420290004,1420290010,4,1,6
131401490@N02,1091,26,1361747012,1361747012,1,1,0
13158511@N00,1092,4,1356863707,1356863707,1,2,0
13158511@N00,1092,16,1356867366,1356867366,1,2,0
13158511@N00,1093,28,1356957397,1356957397,1,2,0
13158511@N00,1093,18,1356958576,1356958576,1,2,0
13158511@N00,1094,17,1359780281,1359780281,1,1,0
13158511@N00,1095,15,1370598829,1370598872,6,2,43
13158511@N00,1095,29,1370598362,1370598362,1,2,0
13158511@N00,1096,1,1378634406,1378634406,1,1,0
13158511@N00,1097,1,1382253023,1382253023,1,1,0
13158511@N00,1098,1,1383442571,1383442571,1,1,0
13158511@N00,1099,17,1385264023,1385264023,1,1,0
13158511@N00,1100,1,1386227924,1386227924,1,1,0
13168981@N04,1101,26,1335322546,1335322548,3,3,2
13168981@N04,1101,30,1335322565,1335322565,1,3,0
13168981@N04,1101,23,1335322544,1335322545,2,3,1
13168981@N04,1102,28,1337574617,1337574637,2,2,20
13168981@N04,1102,1,1337574626,1337574644,4,2,18
13168981@N04,1103,18,1343198242,1343198293,38,1,51
13168981@N04,1104,1,1347752737,1347752836,20,1,99
13168981@N04,1105,26,1353096072,1353096192,21,3,120
13168981@N04,1105,20,1353096223,1353096346,21,3,123
13168981@N04,1105,30,1353096025,1353096045,6,3,20
13168981@N04,1106,28,1356134495,1356134948,27,2,453
13168981@N04,1106,26,1356134607,1356134607,1,2,0
13168981@N04,1107,30,1379071859,1379071899,10,4,40
13168981@N04,1107,1,1379071783,1379072015,5,4,232
13168981@N04,1107,23,1379072029,1379072065,9,4,36
13168981@N04,1107,14,1379072007,1379072007,1,4,0
13168981@N04,1108,28,1386129838,1386129943,2,4,105
13168981@N04,1108,20,1386129890,1386129912,6,4,22
13168981@N04,1108,1,1386129813,1386129955,3,4,142
13168981@N04,1108,14,1386129885,1386129885,1,4,0
13168981@N04,1109,30,1397848170,1397848389,22,1,219
13168981@N04,1110,20,1398160998,1398161058,4,2,60
13168981@N04,1110,29,1398161003,1398161031,4,2,28
13168981@N04,1111,20,1398244313,1398244997,14,1,684
13168981@N04,1112,29,1398454363,1398454640,8,1,277
132052954@N06,1113,15,1427090975,1427090975,1,1,0
13288022@N00,1114,1,1214645196,1214645196,1,1,0
132888308@N07,1115,26,1471827512,1471827512,1,1,0
13294928@N02,1116,8,1192783971,1192873494,98,1,89523
13294928@N02,1117,8,1192961103,1192961973,41,1,870
13294928@N02,1118,8,1193397380,1193397380,1,1,0
13294928@N02,1119,8,1195956980,1195975887,38,1,18907
133044002@N07,1120,15,1455320412,1455320412,1,1,0
133044002@N07,1121,26,1466909156,1466909156,1,1,0
133103935@N06,1122,16,1467195364,1467195364,1,2,0
133103935@N06,1122,26,1467170310,1467195132,4,2,24822
13312992@N06,1123,1,1348223808,1348223865,3,13,57
13312992@N06,1123,5,1348193827,1348193827,1,13,0
13312992@N06,1123,13,1348200920,1348200940,2,13,20
13312992@N06,1123,30,1348208579,1348208579,1,13,0
13312992@N06,1123,27,1348182852,1348182899,2,13,47
13312992@N06,1123,16,1348182745,1348232495,2,13,49750
13312992@N06,1123,28,1348182550,1348182550,1,13,0
13312992@N06,1123,18,1348201891,1348204777,5,13,2886
13312992@N06,1123,26,1348190913,1348232329,33,13,41416
13312992@N06,1123,19,1348202932,1348208320,4,13,5388
13312992@N06,1123,29,1348202783,1348227120,18,13,24337
13312992@N06,1123,31,1348213993,1348231176,8,13,17183
13312992@N06,1123,24,1348186993,1348232982,11,13,45989
13312992@N06,1124,12,1348271121,1348271121,1,8,0
13312992@N06,1124,29,1348276536,1348286210,3,8,9674
13312992@N06,1124,20,1348276780,1348278808,10,8,2028
13312992@N06,1124,14,1348278999,1348280899,5,8,1900
13312992@N06,1124,28,1348288126,1348288130,3,8,4
13312992@N06,1124,22,1348279039,1348284090,4,8,5051
13312992@N06,1124,31,1348276797,1348277104,3,8,307
13312992@N06,1124,24,1348270172,1348270208,2,8,36
13312992@N06,1125,1,1348316959,1348316959,1,3,0
13312992@N06,1125,28,1348317231,1348317282,4,3,51
13312992@N06,1125,26,1348318978,1348318978,1,3,0
13312992@N06,1126,1,1355992572,1355992572,1,4,0
13312992@N06,1126,28,1355992229,1355992331,2,4,102
13312992@N06,1126,26,1355990853,1355991366,6,4,513
13312992@N06,1126,24,1355988278,1355988278,1,4,0
13312992@N06,1127,27,1356040986,1356040986,1,17,0
13312992@N06,1127,1,1356039943,1356050705,4,17,10762
13312992@N06,1127,13,1356068605,1356068605,1,17,0
13312992@N06,1127,8,1356043423,1356043423,1,17,0
13312992@N06,1127,19,1356051342,1356067032,7,17,15690
13312992@N06,1127,21,1356042607,1356068098,68,17,25491
13312992@N06,1127,12,1356040322,1356043986,9,17,3664
13312992@N06,1127,28,1356040065,1356050853,6,17,10788
13312992@N06,1127,3,1356043407,1356069515,3,17,26108
13312992@N06,1127,16,1356041089,1356041340,4,17,251
13312992@N06,1127,4,1356043219,1356043219,1,17,0
13312992@N06,1127,20,1356057008,1356057008,1,17,0
13312992@N06,1127,14,1356055438,1356056736,28,17,1298
13312992@N06,1127,26,1356040604,1356070428,9,17,29824
13312992@N06,1127,22,1356055225,1356056881,2,17,1656
13312992@N06,1127,29,1356052960,1356061325,14,17,8365
13312992@N06,1127,24,1356041748,1356044152,9,17,2404
13312992@N06,1128,1,1356124190,1356124190,1,5,0
13312992@N06,1128,12,1356125344,1356125344,1,5,0
13312992@N06,1128,28,1356124296,1356125866,6,5,1570
13312992@N06,1128,17,1356119291,1356119291,1,5,0
13312992@N06,1128,26,1356124663,1356125558,14,5,895
13312992@N06,1129,1,1443343060,1443343060,1,1,0
13312992@N06,1130,28,1443410040,1443410062,2,2,22
13312992@N06,1130,1,1443406236,1443406310,3,2,74
13312992@N06,1131,1,1443478640,1443478640,1,4,0
13312992@N06,1131,6,1443493665,1443493665,1,4,0
13312992@N06,1131,21,1443519538,1443519538,1,4,0
13312992@N06,1131,14,1443479559,1443480716,11,4,1157
13312992@N06,1132,28,1443562243,1443565587,6,2,3344
13312992@N06,1132,1,1443562277,1443565733,2,2,3456
13332833@N06,1133,28,1326859644,1326867437,2,1,7793
13332833@N06,1134,28,1329908336,1329908336,1,3,0
13332833@N06,1134,16,1329907190,1329907190,1,3,0
13332833@N06,1134,27,1329904105,1329904105,1,3,0
133444919@N08,1135,26,1434625463,1434627855,16,1,2392
133444919@N08,1136,18,1437019176,1437019176,1,2,0
133444919@N08,1136,27,1437022722,1437022722,1,2,0
133444919@N08,1137,28,1437079954,1437131964,8,6,52010
133444919@N08,1137,25,1437083395,1437083395,1,6,0
133444919@N08,1137,21,1437081644,1437081644,1,6,0
133444919@N08,1137,12,1437086141,1437086141,1,6,0
133444919@N08,1137,5,1437080890,1437080890,1,6,0
133444919@N08,1137,11,1437081560,1437081560,1,6,0
13349207@N00,1138,13,1397279225,1397282744,2,2,3519
13349207@N00,1138,7,1397291517,1397291517,1,2,0
13349207@N00,1139,25,1415441766,1415442679,3,2,913
13349207@N00,1139,13,1415442657,1415442657,1,2,0
13349207@N00,1140,7,1426540015,1426540015,1,1,0
13349207@N00,1141,15,1433220475,1433220475,1,1,0
13349207@N00,1142,25,1441114990,1441115116,3,4,126
13349207@N00,1142,3,1441110059,1441110074,2,4,15
13349207@N00,1142,24,1441108589,1441108589,1,4,0
13349207@N00,1142,4,1441111231,1441111686,4,4,455
13349207@N00,1143,4,1460848148,1460848182,3,3,34
13349207@N00,1143,15,1460857584,1460857600,2,3,16
13349207@N00,1143,3,1460848803,1460848813,2,3,10
13355109@N08,1144,10,1202878833,1202878833,1,1,0
13355109@N08,1145,28,1226649921,1226649921,1,2,0
13355109@N08,1145,8,1226649927,1226649927,1,2,0
13355580@N00,1146,30,1283480852,1283480852,1,1,0
13355580@N00,1147,29,1317173001,1317173001,1,1,0
13359377@N05,1148,26,1421047485,1421047485,1,1,0
13359377@N05,1149,1,1421222449,1421222449,1,2,0
13359377@N05,1149,10,1421217868,1421217868,1,2,0
13359849@N00,1150,28,1349597476,1349597476,1,2,0
13359849@N00,1150,20,1349600980,1349600980,1,2,0
13359849@N00,1151,28,1358533388,1358533388,1,1,0
13359849@N00,1152,29,1373109884,1373109884,1,1,0
13359849@N00,1153,1,1377848973,1377848973,1,1,0
13359849@N00,1154,1,1378618552,1378618552,1,1,0
13359849@N00,1155,1,1400837245,1400839301,2,1,2056
13359849@N00,1156,14,1416086221,1416086221,1,1,0
13359849@N00,1157,18,1441499401,1441499401,1,1,0
13359849@N00,1158,18,1441626356,1441626356,1,1,0
13359849@N00,1159,18,1442061788,1442061788,1,1,0
133763744@N08,1160,1,1436280983,1436280983,1,1,0
133911707@N06,1161,1,1362081285,1362081285,1,3,0
133911707@N06,1161,26,1362082019,1362100893,2,3,18874
133911707@N06,1161,28,1362080848,1362080848,1,3,0
13408740@N00,1162,26,1200203558,1200203558,1,1,0
13416981@N08,1163,30,1302175225,1302175225,1,1,0
13430916@N06,1164,1,1388455616,1388455616,1,1,0
134944545@N04,1165,26,1437092271,1437092271,1,1,0
135438961@N08,1166,26,1442061598,1442061598,1,1,0
135451172@N07,1167,26,1453591388,1453591550,3,3,162
135451172@N07,1167,12,1453593370,1453593370,1,3,0
135451172@N07,1167,1,1453585562,1453585568,2,3,6
135452001@N06,1168,26,1450309722,1450309722,1,1,0
13551979@N02,1169,15,1368756489,1368756489,1,1,0
13551979@N02,1170,1,1369121282,1369121282,1,1,0
13551979@N02,1171,1,1369458089,1369458109,2,1,20
13551979@N02,1172,17,1370932157,1370932157,1,2,0
13551979@N02,1172,27,1370932131,1370932131,1,2,0
13551979@N02,1173,1,1371631100,1371631159,2,1,59
13551979@N02,1174,30,1379053890,1379053926,2,1,36
13551979@N02,1175,12,1379991683,1379991683,1,2,0
13551979@N02,1175,20,1379991664,1379991702,2,2,38
13551979@N02,1176,28,1380072488,1380072586,3,1,98
13551979@N02,1177,28,1384307282,1384307340,2,1,58
13551979@N02,1178,28,1386057971,1386057971,1,4,0
13551979@N02,1178,26,1386057952,1386057952,1,4,0
13551979@N02,1178,25,1386058006,1386058006,1,4,0
13551979@N02,1178,27,1386063595,1386063595,1,4,0
13551979@N02,1179,17,1391999200,1391999200,1,1,0
13551979@N02,1180,15,1393895284,1393895311,3,1,27
13551979@N02,1181,30,1394530903,1394530903,1,1,0
13551979@N02,1182,28,1415150933,1415150933,1,1,0
13551979@N02,1183,18,1425618916,1425618916,1,1,0
13551979@N02,1184,18,1427008826,1427008867,2,1,41
13551979@N02,1185,18,1429410164,1429411077,3,1,913
13551979@N02,1186,26,1432346399,1432346399,1,1,0
13551979@N02,1187,18,1433396982,1433396982,1,1,0
13551979@N02,1188,18,1436939432,1436939432,1,1,0
13551979@N02,1189,18,1445488187,1445488899,2,1,712
13552664@N03,1190,26,1380801462,1380801466,2,1,4
13558673@N07,1191,11,1281342878,1281342878,1,1,0
13559239@N07,1192,22,1356496287,1356496287,1,2,0
13559239@N07,1192,16,1356489344,1356489344,1,2,0
13582692@N00,1193,4,1323426812,1323426812,1,1,0
13582692@N00,1194,28,1324189793,1324189793,1,1,0
13591831@N00,1195,18,1454679089,1454679793,4,1,704
13599014@N08,1196,30,1438138480,1438164271,3,1,25791
136309822@N08,1197,26,1454252080,1454258047,5,1,5967
136309822@N08,1198,6,1454922440,1454922624,2,2,184
136309822@N08,1198,26,1454935053,1454941162,4,2,6109
136309822@N08,1199,26,1455012931,1455012931,1,1,0
136309822@N08,1200,26,1455797530,1455799222,9,1,1692
136309822@N08,1201,28,1464614892,1464616057,4,1,1165
136309822@N08,1202,26,1464677144,1464677144,1,4,0
136309822@N08,1202,16,1464662851,1464662851,1,4,0
136309822@N08,1202,1,1464653862,1464658076,5,4,4214
136309822@N08,1202,28,1464655682,1464660157,9,4,4475
13644648@N03,1203,3,1272445050,1272445054,5,17,4
13644648@N03,1203,12,1272445031,1272445051,2,17,20
13644648@N03,1203,1,1272445034,1272445034,1,17,0
13644648@N03,1203,31,1272445040,1272445040,1,17,0
13644648@N03,1203,14,1272445048,1272445048,1,17,0
13644648@N03,1203,24,1272445032,1272445041,2,17,9
13644648@N03,1203,20,1272445029,1272445042,3,17,13
13644648@N03,1203,4,1272445030,1272445033,3,17,3
13644648@N03,1203,21,1272445056,1272445056,1,17,0
13644648@N03,1203,9,1272445044,1272445044,1,17,0
13644648@N03,1203,16,1272445037,1272445045,2,17,8
13644648@N03,1203,28,1272445038,1272445039,2,17,1
13644648@N03,1203,30,1272445029,1272445029,1,17,0
13644648@N03,1203,22,1272445035,1272445051,2,17,16
13644648@N03,1203,26,1272445043,1272445049,3,17,6
13644648@N03,1203,5,1272445055,1272445055,1,17,0
13644648@N03,1203,25,1272445048,1272445048,1,17,0
13644648@N03,1204,3,1280213859,1280213912,3,20,53
13644648@N03,1204,17,1280213877,1280213886,2,20,9
13644648@N03,1204,27,1280213857,1280213857,1,20,0
13644648@N03,1204,13,1280213840,1280213900,2,20,60
13644648@N03,1204,12,1280213860,1280213888,3,20,28
13644648@N03,1204,1,1280213909,1280213909,1,20,0
13644648@N03,1204,11,1280213845,1280213845,1,20,0
13644648@N03,1204,6,1280213858,1280213858,1,20,0
13644648@N03,1204,31,1280213851,1280213851,1,20,0
13644648@N03,1204,21,1280213846,1280213872,13,20,26
13644648@N03,1204,16,1280213885,1280213887,2,20,2
13644648@N03,1204,28,1280213873,1280213902,5,20,29
13644648@N03,1204,20,1280213878,1280213908,4,20,30
13644648@N03,1204,30,1280213834,1280213906,6,20,72
13644648@N03,1204,5,1280213873,1280213873,1,20,0
13644648@N03,1204,26,1280213844,1280213903,3,20,59
13644648@N03,1204,29,1280213836,1280213913,5,20,77
13644648@N03,1204,23,1280213848,1280213850,2,20,2
13644648@N03,1204,25,1280213837,1280213910,10,20,73
13644648@N03,1204,7,1280217194,1280217195,2,20,1
13644648@N03,1205,31,1336203617,1336203617,1,1,0
13665830@N07,1206,26,1454371459,1454372481,6,3,1022
13665830@N07,1206,16,1454371482,1454371482,2,3,0
13665830@N07,1206,30,1454373363,1454373385,4,3,22
13667007@N07,1207,31,1237688880,1237688927,3,1,47
136678498@N06,1208,19,1443851615,1443851615,1,8,0
136678498@N06,1208,24,1443841180,1443841180,1,8,0
136678498@N06,1208,23,1443852354,1443852354,1,8,0
136678498@N06,1208,13,1443852723,1443852723,1,8,0
136678498@N06,1208,30,1443847821,1443847821,1,8,0
136678498@N06,1208,1,1443853172,1443853172,1,8,0
136678498@N06,1208,22,1443849657,1443849657,1,8,0
136678498@N06,1208,29,1443848991,1443850119,2,8,1128
136678498@N06,1209,23,1462434322,1462434322,1,1,0
136678498@N06,1210,21,1465978946,1465978946,1,1,0
13696003@N06,1211,18,1434043860,1434043860,1,1,0
13701504@N00,1212,29,1282719550,1282719557,3,1,7
13701504@N00,1213,15,1282872404,1282872411,3,1,7
13701504@N00,1214,14,1283741769,1283741769,1,7,0
13701504@N00,1214,12,1283741849,1283741860,3,7,11
13701504@N00,1214,26,1283741722,1283741722,1,7,0
13701504@N00,1214,19,1283741579,1283741579,1,7,0
13701504@N00,1214,24,1283741786,1283741791,2,7,5
13701504@N00,1214,28,1283741710,1283741843,3,7,133
13701504@N00,1214,29,1283741572,1283741572,1,7,0
13725093@N02,1215,5,1246924853,1246924853,1,1,0
13729350@N06,1216,24,1198435514,1198435514,1,1,0
13729350@N06,1217,10,1214043922,1214044319,2,2,397
13729350@N06,1217,30,1214043960,1214044608,2,2,648
13729350@N06,1218,10,1214122479,1214122613,2,1,134
13729350@N06,1219,10,1214726253,1214726253,1,1,0
13749494@N04,1220,26,1437280889,1437280889,1,1,0
13749494@N04,1221,26,1437353496,1437392449,12,1,38953
13749494@N04,1222,26,1437429732,1437478724,29,1,48992
13749494@N04,1223,26,1437531595,1437542707,9,1,11112
13749494@N04,1224,26,1437619173,1437625996,5,1,6823
13749494@N04,1225,26,1437689893,1437706641,5,1,16748
13750887@N06,1226,10,1193957868,1194003017,73,1,45149
13750887@N06,1227,10,1195169149,1195200657,86,1,31508
13784458@N04,1228,13,1254532610,1254532610,1,1,0
13796428@N02,1229,30,1197934352,1197973929,14,1,39577
13796428@N02,1230,30,1198576140,1198576140,1,1,0
13796428@N02,1231,18,1251364984,1251364984,1,1,0
13796428@N02,1232,15,1251433250,1251433250,1,1,0
13816967@N02,1233,1,1373329712,1373329712,1,1,0
13818837@N05,1234,6,1291686765,1291686765,1,3,0
13818837@N05,1234,24,1291702006,1291702016,2,3,10
13818837@N05,1234,20,1291696191,1291696191,1,3,0
13818837@N05,1235,26,1291798115,1291798115,1,4,0
13818837@N05,1235,15,1291784580,1291784580,1,4,0
13818837@N05,1235,28,1291764504,1291798382,2,4,33878
13818837@N05,1235,20,1291778787,1291778787,1,4,0
13818837@N05,1236,17,1317596080,1317596869,2,11,789
13818837@N05,1236,27,1317594656,1317594656,1,11,0
13818837@N05,1236,25,1317602490,1317602490,1,11,0
13818837@N05,1236,30,1317608638,1317608638,1,11,0
13818837@N05,1236,3,1317602039,1317602039,1,11,0
13818837@N05,1236,26,1317600766,1317600766,1,11,0
13818837@N05,1236,1,1317593441,1317593441,1,11,0
13818837@N05,1236,14,1317608309,1317608309,1,11,0
13818837@N05,1236,12,1317600265,1317600265,1,11,0
13818837@N05,1236,20,1317605225,1317605225,1,11,0
13818837@N05,1236,24,1317599319,1317599319,2,11,0
13818837@N05,1237,30,1317693883,1317693883,1,4,0
13818837@N05,1237,24,1317692160,1317692220,2,4,60
13818837@N05,1237,12,1317692706,1317692706,1,4,0
13818837@N05,1237,20,1317694700,1317698222,2,4,3522
13818837@N05,1238,30,1317863475,1317863475,1,4,0
13818837@N05,1238,12,1317899114,1317899114,1,4,0
13818837@N05,1238,24,1317877661,1317877661,1,4,0
13818837@N05,1238,26,1317870765,1317877089,2,4,6324
13818837@N05,1239,17,1343013884,1343013884,1,4,0
13818837@N05,1239,29,1343017992,1343017992,1,4,0
13818837@N05,1239,26,1343004774,1343004827,3,4,53
13818837@N05,1239,20,1343019343,1343019343,1,4,0
13818837@N05,1240,24,1343267449,1343281485,3,2,14036
13818837@N05,1240,12,1343268336,1343268336,1,2,0
138710409@N03,1241,26,1461712637,1461712637,1,1,0
13875847@N00,1242,26,1254606688,1254606688,1,2,0
13875847@N00,1242,17,1254607012,1254607235,2,2,223
13875847@N00,1243,26,1254689940,1254689940,1,3,0
13875847@N00,1243,16,1254690142,1254690142,1,3,0
13875847@N00,1243,30,1254690464,1254690464,1,3,0
13875847@N00,1244,17,1254731578,1254731578,1,1,0
13875847@N00,1245,26,1254906570,1254906570,1,1,0
13875847@N00,1246,26,1276384637,1276384637,1,3,0
13875847@N00,1246,29,1276400604,1276405757,3,3,5153
13875847@N00,1246,1,1276407279,1276407840,9,3,561
13875847@N00,1247,26,1286026948,1286027723,11,12,775
13875847@N00,1247,22,1285981857,1286000531,4,12,18674
13875847@N00,1247,29,1285981754,1286018227,5,12,36473
13875847@N00,1247,1,1285977745,1285978087,3,12,342
13875847@N00,1247,18,1285986332,1285986332,1,12,0
13875847@N00,1247,17,1285994964,1285995643,7,12,679
13875847@N00,1247,27,1285994016,1285994073,2,12,57
13875847@N00,1247,20,1285983370,1285985031,4,12,1661
13875847@N00,1247,15,1286022196,1286022287,3,12,91
13875847@N00,1247,24,1286028181,1286028503,2,12,322
13875847@N00,1247,31,1285981821,1285983336,4,12,1515
13875847@N00,1247,30,1285981490,1286021746,6,12,40256
13875847@N00,1248,16,1286065552,1286065552,1,1,0
13875847@N00,1249,26,1349487975,1349487986,2,6,11
13875847@N00,1249,13,1349501780,1349505446,6,6,3666
13875847@N00,1249,1,1349507706,1349508008,2,6,302
13875847@N00,1249,25,1349507138,1349507138,1,6,0
13875847@N00,1249,12,1349501132,1349501132,1,6,0
13875847@N00,1249,27,1349497186,1349497450,2,6,264
13875847@N00,1250,27,1349564536,1349564536,1,1,0
13878873@N08,1251,29,1208043416,1208043416,1,1,0
13885531@N00,1252,28,1237799550,1237799550,1,1,0
13885531@N00,1253,10,1237953089,1237953089,1,2,0
13885531@N00,1253,26,1237953445,1237953927,5,2,482
13918219@N00,1254,16,1188016438,1188021382,4,8,4944
13918219@N00,1254,21,1188023125,1188023125,1,8,0
13918219@N00,1254,23,1188030461,1188030461,1,8,0
13918219@N00,1254,29,1188014575,1188014575,1,8,0
13918219@N00,1254,17,1188018941,1188018941,1,8,0
13918219@N00,1254,12,1188000553,1188000553,1,8,0
13918219@N00,1254,24,1188005150,1188005150,1,8,0
13918219@N00,1254,26,1188021898,1188021898,1,8,0
13922841@N00,1255,12,1413004091,1413004275,4,10,184
13922841@N00,1255,23,1413006847,1413007018,3,10,171
13922841@N00,1255,29,1413005827,1413006767,3,10,940
13922841@N00,1255,30,1413004828,1413005039,4,10,211
13922841@N00,1255,1,1413007497,1413007516,2,10,19
13922841@N00,1255,20,1413006362,1413006665,9,10,303
13922841@N00,1255,26,1413004542,1413004596,3,10,54
13922841@N00,1255,24,1413001139,1413002921,13,10,1782
13922841@N00,1255,31,1413005190,1413005374,2,10,184
13922841@N00,1255,22,1413006105,1413006252,4,10,147
13922841@N00,1256,12,1437155996,1437156969,28,2,973
13922841@N00,1256,1,1437136081,1437136086,2,2,5
13922841@N00,1257,1,1440833006,1440837225,2,2,4219
13922841@N00,1257,28,1440834096,1440836960,13,2,2864
13922841@N00,1258,1,1443364383,1443364399,2,2,16
13922841@N00,1258,28,1443359322,1443362999,3,2,3677
13922841@N00,1259,23,1443855498,1443855696,6,10,198
13922841@N00,1259,1,1443858752,1443858770,4,10,18
13922841@N00,1259,19,1443830293,1443855289,3,10,24996
13922841@N00,1259,26,1443851439,1443851647,4,10,208
13922841@N00,1259,21,1443856231,1443856231,1,10,0
13922841@N00,1259,24,1443850289,1443850880,10,10,591
13922841@N00,1259,29,1443853423,1443855026,8,10,1603
13922841@N00,1259,22,1443853952,1443854040,3,10,88
13922841@N00,1259,13,1443856694,1443857905,5,10,1211
13922841@N00,1259,8,1443856000,1443856000,1,10,0
13922841@N00,1260,13,1446461628,1446461628,1,3,0
13922841@N00,1260,28,1446450464,1446450464,1,3,0
13922841@N00,1260,26,1446450889,1446450889,1,3,0
13922841@N00,1261,11,1448716447,1448716447,1,13,0
13922841@N00,1261,27,1448722922,1448722949,2,13,27
13922841@N00,1261,23,1448719238,1448719327,3,13,89
13922841@N00,1261,20,1448715577,1448715577,1,13,0
13922841@N00,1261,22,1448718005,1448718282,2,13,277
13922841@N00,1261,30,1448716827,1448719883,12,13,3056
13922841@N00,1261,1,1448729222,1448729902,6,13,680
13922841@N00,1261,24,1448727125,1448727392,5,13,267
13922841@N00,1261,10,1448720006,1448720006,1,13,0
13922841@N00,1261,15,1448723442,1448726381,20,13,2939
13922841@N00,1261,28,1448729332,1448729699,5,13,367
13922841@N00,1261,29,1448717725,1448717734,2,13,9
13922841@N00,1261,31,1448717786,1448717845,2,13,59
13922841@N00,1262,22,1448799355,1448799355,1,3,0
13922841@N00,1262,13,1448802061,1448802460,4,3,399
13922841@N00,1262,28,1448793200,1448797216,23,3,4016
13922841@N00,1263,21,1450988857,1450988976,2,10,119
13922841@N00,1263,27,1450990541,1450990691,3,10,150
13922841@N00,1263,12,1450989540,1450989540,1,10,0
13922841@N00,1263,25,1450988579,1450988928,7,10,349
13922841@N00,1263,16,1450990794,1450990866,2,10,72
13922841@N00,1263,1,1450986467,1450993626,12,10,7159
13922841@N00,1263,15,1450989861,1450989911,2,10,50
13922841@N00,1263,17,1450989967,1450989967,1,10,0
13922841@N00,1263,28,1450986485,1450992908,38,10,6423
13922841@N00,1263,26,1450990959,1450991718,10,10,759
13922841@N00,1264,29,1453101258,1453102934,10,3,1676
13922841@N00,1264,28,1453097586,1453097586,1,3,0
13922841@N00,1264,14,1453104405,1453104405,1,3,0
13922841@N00,1265,25,1453567001,1453567562,23,4,561
13922841@N00,1265,1,1453540019,1453540019,1,4,0
13922841@N00,1265,15,1453542699,1453543752,5,4,1053
13922841@N00,1265,6,1453563905,1453563905,1,4,0
13922841@N00,1266,19,1454928312,1454928312,1,4,0
13922841@N00,1266,1,1454926025,1454926058,7,4,33
13922841@N00,1266,29,1454928474,1454929004,6,4,530
13922841@N00,1266,28,1454927289,1454933102,4,4,5813
13922841@N00,1267,12,1462095537,1462095537,1,2,0
13922841@N00,1267,1,1462094720,1462094771,3,2,51
13922841@N00,1268,18,1468594192,1468594192,1,10,0
13922841@N00,1268,21,1468592200,1468592200,1,10,0
13922841@N00,1268,3,1468592321,1468592321,1,10,0
13922841@N00,1268,27,1468595331,1468595331,1,10,0
13922841@N00,1268,20,1468593287,1468593341,2,10,54
13922841@N00,1268,30,1468592720,1468593068,2,10,348
13922841@N00,1268,16,1468591882,1468591929,2,10,47
13922841@N00,1268,19,1468593129,1468593129,1,10,0
13922841@N00,1268,29,1468593268,1468593268,1,10,0
13922841@N00,1268,26,1468592009,1468592580,4,10,571
13922841@N00,1269,11,1468717711,1468717711,1,8,0
13922841@N00,1269,23,1468718037,1468718037,1,8,0
13922841@N00,1269,1,1468747620,1468769622,2,8,22002
13922841@N00,1269,29,1468739366,1468739366,1,8,0
13922841@N00,1269,24,1468739573,1468741862,2,8,2289
13922841@N00,1269,15,1468740066,1468741983,8,8,1917
13922841@N00,1269,28,1468771990,1468772043,2,8,53
13922841@N00,1269,26,1468767055,1468767625,5,8,570
13923792@N06,1270,26,1303007421,1303007421,1,1,0
13923792@N06,1271,31,1330462152,1330462152,1,1,0
13923792@N06,1272,24,1334467647,1334467647,1,1,0
13923792@N06,1273,14,1340421285,1340421285,1,1,0
13923792@N06,1274,28,1345254644,1345254644,1,1,0
13923792@N06,1275,28,1354779119,1354779119,1,1,0
13923792@N06,1276,14,1369347670,1369347670,1,1,0
13923792@N06,1277,1,1369377646,1369377646,1,1,0
13923792@N06,1278,1,1369426903,1369426903,1,2,0
13923792@N06,1278,16,1369422918,1369422918,1,2,0
13923792@N06,1279,1,1369459931,1369459931,1,1,0
13923792@N06,1280,1,1369710356,1369710356,1,2,0
13923792@N06,1280,13,1369721500,1369721500,1,2,0
13923792@N06,1281,1,1372399283,1372399283,1,1,0
13923792@N06,1282,1,1374022077,1374022077,1,1,0
13923792@N06,1283,1,1377985635,1377985635,1,2,0
13923792@N06,1283,23,1377956991,1377956991,1,2,0
13923792@N06,1284,27,1378423023,1378423023,1,1,0
13923792@N06,1285,17,1417562403,1417562403,1,1,0
13923792@N06,1286,17,1417646818,1417646818,1,1,0
13923792@N06,1287,18,1433207571,1433207571,1,1,0
13927809@N02,1288,28,1315385178,1315385178,1,1,0
13927809@N02,1289,29,1318384804,1318384804,1,1,0
13933131@N08,1290,31,1295666641,1295666641,1,9,0
13933131@N08,1290,12,1295673323,1295673323,1,9,0
13933131@N08,1290,16,1295673294,1295673294,1,9,0
13933131@N08,1290,26,1295662382,1295662465,4,9,83
13933131@N08,1290,14,1295666364,1295666364,1,9,0
13933131@N08,1290,18,1295662733,1295666809,4,9,4076
13933131@N08,1290,29,1295662970,1295662993,2,9,23
13933131@N08,1290,28,1295662071,1295673618,4,9,11547
13933131@N08,1290,1,1295661993,1295661993,1,9,0
13933131@N08,1291,26,1322124610,1322124610,1,1,0
13933131@N08,1292,26,1356063103,1356063103,1,2,0
13933131@N08,1292,29,1356060282,1356060282,1,2,0
13933131@N08,1293,21,1378543222,1378543222,1,4,0
13933131@N08,1293,27,1378515511,1378542128,34,4,26617
13933131@N08,1293,18,1378543327,1378543327,1,4,0
13933131@N08,1293,28,1378537663,1378543516,3,4,5853
13933131@N08,1294,13,1408068650,1408077334,5,1,8684
13933872@N05,1295,1,1427064149,1427064149,1,2,0
13933872@N05,1295,13,1427073767,1427073767,1,2,0
13968334@N06,1296,26,1210048175,1210048175,1,1,0
13968334@N06,1297,1,1212353967,1212353967,1,1,0
13998921@N02,1298,28,1346151236,1346157702,6,3,6466
13998921@N02,1298,1,1346153046,1346156618,3,3,3572
13998921@N02,1298,16,1346156732,1346157750,2,3,1018
13998921@N02,1299,30,1346249091,1346249091,1,4,0
13998921@N02,1299,28,1346245075,1346245285,3,4,210
13998921@N02,1299,1,1346245013,1346245013,1,4,0
13998921@N02,1299,16,1346225265,1346225265,1,4,0
13998921@N02,1300,28,1346296617,1346296617,1,1,0
14042144@N07,1301,1,1393465543,1393469314,2,3,3771
14042144@N07,1301,28,1393468465,1393469749,5,3,1284
14042144@N07,1301,26,1393470812,1393470812,1,3,0
14059381@N06,1302,26,1260055540,1260055540,1,1,0
14102022@N02,1303,8,1194948094,1194948094,1,1,0
14110651@N03,1304,26,1302652987,1302652987,1,2,0
14110651@N03,1304,5,1302661553,1302661791,2,2,238
14136614@N03,1305,29,1328234517,1328237616,2,9,3099
14136614@N03,1305,11,1328254080,1328255006,3,9,926
14136614@N03,1305,1,1328257101,1328257101,1,9,0
14136614@N03,1305,16,1328228274,1328232112,2,9,3838
14136614@N03,1305,28,1328256592,1328256592,1,9,0
14136614@N03,1305,17,1328243520,1328243520,1,9,0
14136614@N03,1305,19,1328233884,1328244556,3,9,10672
14136614@N03,1305,26,1328246940,1328250075,2,9,3135
14136614@N03,1305,31,1328232180,1328236593,3,9,4413
14157787@N07,1306,28,1317732669,1317732669,1,4,0
14157787@N07,1306,16,1317736225,1317737125,2,4,900
14157787@N07,1306,21,1317735542,1317735542,1,4,0
14157787@N07,1306,26,1317724592,1317732355,3,4,7763
14161238@N08,1307,26,1411119790,1411119790,1,4,0
14161238@N08,1307,29,1411121029,1411124671,14,4,3642
14161238@N08,1307,19,1411115269,1411115269,1,4,0
14161238@N08,1307,1,1411127983,1411128083,11,4,100
14161238@N08,1308,16,1411301451,1411301451,1,1,0
14161238@N08,1309,30,1412399544,1412399544,1,1,0
14161238@N08,1310,27,1412593075,1412593075,1,1,0
14161238@N08,1311,25,1416135339,1416135339,1,2,0
14161238@N08,1311,26,1416129468,1416129468,1,2,0
14161238@N08,1312,18,1416306172,1416306172,1,1,0
14161238@N08,1313,1,1433673099,1433673099,1,4,0
14161238@N08,1313,6,1433665708,1433665708,1,4,0
14161238@N08,1313,11,1433665631,1433665631,1,4,0
14161238@N08,1313,12,1433667460,1433667460,1,4,0
14161238@N08,1314,28,1436691039,1436691039,1,2,0
14161238@N08,1314,23,1436691831,1436693724,3,2,1893
14161238@N08,1315,7,1438253717,1438254128,3,2,411
14161238@N08,1315,21,1438254586,1438257893,24,2,3307
14173066@N04,1316,30,1417501956,1417502826,6,1,870
14193413@N06,1317,3,1249381570,1249381570,1,1,0
14213266@N06,1318,21,1322547653,1322565785,4,9,18132
14213266@N06,1318,27,1322536266,1322538284,6,9,2018
14213266@N06,1318,11,1322546753,1322547014,4,9,261
14213266@N06,1318,30,1322554489,1322554489,1,9,0
14213266@N06,1318,23,1322555169,1322555392,2,9,223
14213266@N06,1318,28,1322534706,1322535981,2,9,1275
14213266@N06,1318,9,1322550760,1322551141,4,9,381
14213266@N06,1318,3,1322544524,1322544524,1,9,0
14213266@N06,1318,26,1322553117,1322553806,7,9,689
14221499@N00,1319,18,1339416178,1339416178,1,1,0
14221499@N00,1320,29,1339486253,1339486713,2,1,460
14221499@N00,1321,12,1363316959,1363316959,1,2,0
14221499@N00,1321,17,1363319080,1363319080,1,2,0
14221499@N00,1322,18,1363350704,1363350704,1,2,0
14221499@N00,1322,15,1363350175,1363350175,1,2,0
14221499@N00,1323,14,1376557983,1376557983,1,2,0
14221499@N00,1323,26,1376538238,1376538238,1,2,0
14221499@N00,1324,13,1376665454,1376665454,1,1,0
14221499@N00,1325,19,1413194132,1413194132,1,1,0
14221499@N00,1326,1,1413237126,1413237126,1,1,0
14221499@N00,1327,1,1413288885,1413288885,1,1,0
14221499@N00,1328,1,1420976713,1420976713,1,1,0
142287241@N02,1329,9,1468554346,1468554346,1,3,0
142287241@N02,1329,1,1468552636,1468552636,1,3,0
142287241@N02,1329,11,1468554272,1468554272,1,3,0
142287241@N02,1330,22,1469085484,1469085484,1,1,0
14233893@N02,1331,26,1301049860,1301049860,1,1,0
14233893@N02,1332,3,1304506303,1304506303,1,1,0
14233893@N02,1333,27,1307801255,1307801255,1,2,0
14233893@N02,1333,3,1307794723,1307794723,1,2,0
14233893@N02,1334,7,1314938600,1314938600,1,1,0
14246866@N05,1335,17,1232252832,1232252832,1,9,0
14246866@N05,1335,1,1232251648,1232251712,2,9,64
14246866@N05,1335,27,1232252615,1232252615,1,9,0
14246866@N05,1335,16,1232253483,1232253483,1,9,0
14246866@N05,1335,8,1232254300,1232254699,2,9,399
14246866@N05,1335,29,1232262354,1232262354,1,9,0
14246866@N05,1335,28,1232251989,1232265743,5,9,13754
14246866@N05,1335,4,1232259817,1232260753,5,9,936
14246866@N05,1335,26,1232253707,1232253707,1,9,0
142525331@N04,1336,29,1460618173,1460618173,1,1,0
14256823@N08,1337,18,1192506975,1192506975,1,1,0
14258173@N00,1338,30,1191101679,1191101679,1,1,0
14272980@N03,1339,31,1192836502,1192836502,1,1,0
14272980@N03,1340,26,1196051481,1196051481,1,1,0
14272980@N03,1341,28,1196774939,1196774939,1,1,0
14272980@N03,1342,16,1201306241,1201306241,1,1,0
14280234@N04,1343,21,1195835424,1195835424,1,1,0
14280234@N04,1344,28,1206687536,1206687536,1,1,0
14280234@N04,1345,1,1217147911,1217147911,1,1,0
14280234@N04,1346,28,1222151731,1222151731,1,1,0
14280234@N04,1347,1,1225953643,1225953643,1,1,0
14280234@N04,1348,16,1231899242,1231899242,1,1,0
14280234@N04,1349,1,1245901524,1245901524,1,1,0
14280234@N04,1350,16,1248527397,1248527837,2,1,440
14280234@N04,1351,16,1253426791,1253426791,1,1,0
14280234@N04,1352,29,1254388586,1254388586,1,1,0
14280234@N04,1353,26,1254725739,1254725739,1,1,0
14280234@N04,1354,29,1255255717,1255255717,1,1,0
14280234@N04,1355,26,1256465663,1256465663,1,1,0
14280234@N04,1356,26,1256960864,1256960864,1,2,0
14280234@N04,1356,16,1256969692,1256969692,1,2,0
14280234@N04,1357,1,1258153911,1258153911,1,4,0
14280234@N04,1357,26,1258174337,1258174337,1,4,0
14280234@N04,1357,16,1258174364,1258174364,1,4,0
14280234@N04,1357,28,1258161099,1258161099,1,4,0
14280234@N04,1358,26,1258599277,1258601004,3,1,1727
14280234@N04,1359,21,1259979279,1259979279,1,2,0
14280234@N04,1359,16,1259979260,1259979260,1,2,0
14280234@N04,1360,26,1261284708,1261284708,1,1,0
14280234@N04,1361,11,1262762237,1262762237,1,1,0
14280234@N04,1362,26,1270883583,1270883583,1,1,0
14280234@N04,1363,21,1273394283,1273394283,1,1,0
14280234@N04,1364,18,1274330526,1274330526,1,2,0
14280234@N04,1364,26,1274330526,1274330526,1,2,0
14280234@N04,1365,23,1277275864,1277275864,1,2,0
14280234@N04,1365,18,1277275847,1277275847,1,2,0
14280234@N04,1366,16,1278309434,1278309434,1,1,0
14280234@N04,1367,1,1280444638,1280444638,1,1,0
14280234@N04,1368,1,1280707364,1280707364,1,1,0
14280234@N04,1369,26,1281248635,1281248852,3,1,217
14280234@N04,1370,26,1283820159,1283820159,1,2,0
14280234@N04,1370,16,1283813083,1283813083,1,2,0
14280234@N04,1371,22,1284082791,1284082791,1,1,0
14280234@N04,1372,26,1284614540,1284614540,1,1,0
14280234@N04,1373,1,1285289945,1285289945,1,2,0
14280234@N04,1373,26,1285290025,1285290025,1,2,0
14280234@N04,1374,26,1285724258,1285724258,1,1,0
14280234@N04,1375,10,1287096965,1287096965,1,3,0
14280234@N04,1375,9,1287096555,1287096555,1,3,0
14280234@N04,1375,11,1287096970,1287096970,1,3,0
14280234@N04,1376,20,1287375945,1287375945,1,1,0
14280234@N04,1377,26,1288313142,1288313142,1,1,0
14280234@N04,1378,9,1289344369,1289344390,2,1,21
14280234@N04,1379,21,1289619853,1289619853,1,1,0
14280234@N04,1380,26,1290399641,1290399641,1,2,0
14280234@N04,1380,28,1290398562,1290398562,1,2,0
14280234@N04,1381,9,1291764292,1291764292,1,1,0
14280234@N04,1382,15,1293020669,1293020669,1,1,0
14280234@N04,1383,26,1294801750,1294801750,1,1,0
14280234@N04,1384,26,1295071673,1295071673,1,1,0
14280234@N04,1385,1,1295929775,1295929775,1,1,0
14280234@N04,1386,1,1297379435,1297379435,1,1,0
14280234@N04,1387,26,1298510354,1298511489,2,1,1135
14280234@N04,1388,28,1301264875,1301264875,1,1,0
14280234@N04,1389,26,1301656395,1301656395,1,1,0
14280234@N04,1390,3,1302822904,1302822904,1,1,0
14280234@N04,1391,5,1303196882,1303196882,1,2,0
14280234@N04,1391,26,1303181276,1303181276,1,2,0
14280234@N04,1392,11,1303693002,1303693002,1,1,0
14280234@N04,1393,26,1307323090,1307323090,1,1,0
14280234@N04,1394,16,1307436890,1307436890,1,1,0
14280234@N04,1395,26,1307573603,1307573603,1,1,0
14280234@N04,1396,16,1311465413,1311465413,1,1,0
14280234@N04,1397,11,1311728196,1311728196,1,1,0
14280234@N04,1398,16,1313976432,1313976432,1,1,0
14280234@N04,1399,26,1315540049,1315540049,1,1,0
14280234@N04,1400,11,1315792670,1315792670,1,2,0
14280234@N04,1400,26,1315789652,1315789652,1,2,0
14280234@N04,1401,20,1316396410,1316396410,1,1,0
14280234@N04,1402,26,1319836354,1319836354,1,1,0
14280234@N04,1403,28,1320106796,1320106796,1,1,0
14280234@N04,1404,26,1324335255,1324335260,2,1,5
14280234@N04,1405,11,1326931482,1326931482,1,2,0
14280234@N04,1405,26,1326930325,1326930325,1,2,0
14280234@N04,1406,4,1327698722,1327698722,1,1,0
14280234@N04,1407,26,1330019664,1330019664,1,1,0
14280234@N04,1408,26,1335921656,1335921656,1,1,0
14280234@N04,1409,25,1337297199,1337297199,1,1,0
14280234@N04,1410,21,1337516141,1337516141,1,1,0
14280234@N04,1411,1,1338681931,1338681931,1,2,0
14280234@N04,1411,16,1338680282,1338680282,1,2,0
14280234@N04,1412,21,1342909963,1342909963,1,1,0
14280234@N04,1413,21,1343601379,1343601379,1,1,0
14280234@N04,1414,18,1345772183,1345772183,1,1,0
14280234@N04,1415,26,1345850301,1345850301,1,1,0
14280234@N04,1416,16,1346368111,1346368111,1,1,0
14280234@N04,1417,16,1347056552,1347056552,1,1,0
14280234@N04,1418,11,1351728047,1351728047,1,1,0
14280234@N04,1419,16,1352681469,1352681469,1,1,0
14280234@N04,1420,11,1354841746,1354841746,1,1,0
14280234@N04,1421,16,1355944248,1355944248,1,1,0
14280234@N04,1422,28,1364895551,1364895551,1,1,0
14280234@N04,1423,26,1366973819,1366973819,1,1,0
14280234@N04,1424,19,1379715934,1379715934,1,1,0
14280234@N04,1425,18,1383034296,1383034296,1,1,0
14280234@N04,1426,29,1392686258,1392686258,1,1,0
14286574@N00,1427,1,1364630245,1364630245,1,3,0
14286574@N00,1427,26,1364631679,1364631679,1,3,0
14286574@N00,1427,21,1364631270,1364631270,1,3,0
14286574@N00,1428,28,1364695717,1364697215,3,3,1498
14286574@N00,1428,1,1364680389,1364726781,4,3,46392
14286574@N00,1428,26,1364680873,1364680913,2,3,40
14286574@N00,1429,1,1364770383,1364770383,1,1,0
14288736@N05,1430,28,1370735868,1370735868,1,1,0
14291689@N07,1431,20,1360557900,1360557900,1,1,0
14291689@N07,1432,27,1422753302,1422753302,1,4,0
14291689@N07,1432,16,1422753305,1422753305,1,4,0
14291689@N07,1432,4,1422768658,1422768658,1,4,0
14291689@N07,1432,23,1422755203,1422758760,3,4,3557
143103028@N06,1433,1,1463749219,1463749371,2,1,152
14355604@N06,1434,26,1189042372,1189042372,1,2,0
14355604@N06,1434,13,1189037897,1189037897,1,2,0
14359698@N07,1435,1,1367535227,1367535227,1,4,0
14359698@N07,1435,3,1367555256,1367555256,1,4,0
14359698@N07,1435,13,1367562758,1367562758,1,4,0
14359698@N07,1435,22,1367544116,1367544116,1,4,0
14359698@N07,1436,26,1367749463,1367749463,1,1,0
14379196@N04,1437,1,1353318446,1353318446,1,1,0
14379699@N02,1438,17,1381538228,1381538228,1,3,0
14379699@N02,1438,27,1381537864,1381537864,1,3,0
14379699@N02,1438,15,1381539735,1381539735,1,3,0
14379699@N02,1439,1,1383445697,1383445697,1,1,0
14379699@N02,1440,28,1387529872,1387529872,1,2,0
14379699@N02,1440,25,1387535180,1387535180,1,2,0
14379699@N02,1441,1,1392256835,1392256835,1,1,0
14379699@N02,1442,19,1412557563,1412557563,1,1,0
14379699@N02,1443,18,1444510022,1444522058,2,1,12036
14386112@N00,1444,26,1303481363,1303481363,1,2,0
14386112@N00,1444,16,1303496670,1303496670,1,2,0
14394412@N04,1445,1,1272010148,1272010148,1,1,0
14397744@N02,1446,15,1325324416,1325324416,1,1,0
14397744@N02,1447,10,1429280928,1429280928,1,1,0
14418030@N00,1448,23,1212281065,1212281065,1,1,0
14418851@N04,1449,31,1192159498,1192161567,2,1,2069
14418851@N04,1450,28,1192357040,1192357040,1,1,0
14422698@N07,1451,1,1375523782,1375531610,5,1,7828
14425592@N07,1452,26,1189855913,1189855913,1,1,0
14447350@N05,1453,26,1324119553,1324119553,1,1,0
14447350@N05,1454,30,1324183393,1324183393,1,1,0
14449931@N08,1455,19,1420590829,1420622298,2,3,31469
14449931@N08,1455,20,1420618900,1420618900,1,3,0
14449931@N08,1455,15,1420605190,1420605190,1,3,0
14449931@N08,1456,19,1420672827,1420678721,3,2,5894
14449931@N08,1456,5,1420679096,1420679096,1,2,0
14449931@N08,1457,18,1420842126,1420862388,3,1,20262
14449931@N08,1458,16,1420978780,1420978780,1,1,0
14449931@N08,1459,7,1421493199,1421493199,1,1,0
14483469@N00,1460,30,1380951816,1380951816,1,3,0
14483469@N00,1460,17,1380945226,1380945226,1,3,0
14483469@N00,1460,1,1380942600,1380942600,1,3,0
14487451@N00,1461,30,1352632220,1352632220,1,1,0
14487451@N00,1462,29,1357427851,1357427851,1,1,0
14487451@N00,1463,14,1372601777,1372601777,1,4,0
14487451@N00,1463,17,1372602459,1372602459,1,4,0
14487451@N00,1463,1,1372583882,1372602226,2,4,18344
14487451@N00,1463,16,1372575913,1372575913,1,4,0
14487451@N00,1464,14,1372684483,1372684483,1,1,0
14506090@N06,1465,29,1189733278,1189733278,1,1,0
14523292@N00,1466,30,1326772363,1326772363,1,1,0
14523292@N00,1467,17,1332814330,1332814352,2,1,22
14523292@N00,1468,13,1425098843,1425098843,1,1,0
14526883@N08,1469,18,1209102818,1209102818,1,1,0
14526883@N08,1470,19,1243830672,1243830799,2,16,127
14526883@N08,1470,3,1243844571,1243857309,2,16,12738
14526883@N08,1470,27,1243854087,1243854087,1,16,0
14526883@N08,1470,12,1243816294,1243819770,5,16,3476
14526883@N08,1470,31,1243834537,1243834537,1,16,0
14526883@N08,1470,22,1243837981,1243837981,1,16,0
14526883@N08,1470,15,1243815809,1243856343,3,16,40534
14526883@N08,1470,1,1243807973,1243808006,2,16,33
14526883@N08,1470,21,1243843944,1243843944,1,16,0
14526883@N08,1470,29,1243830554,1243830650,3,16,96
14526883@N08,1470,23,1243829817,1243851309,2,16,21492
14526883@N08,1470,28,1243810256,1243810256,1,16,0
14526883@N08,1470,13,1243842633,1243843045,4,16,412
14526883@N08,1470,18,1243829838,1243851366,7,16,21528
14526883@N08,1470,24,1243813970,1243826926,20,16,12956
14526883@N08,1470,30,1243834460,1243850749,6,16,16289
14545153@N05,1471,1,1357206390,1357206390,1,1,0
14576853@N00,1472,21,1337839546,1337839546,1,6,0
14576853@N00,1472,4,1337842472,1337843206,2,6,734
14576853@N00,1472,16,1337851602,1337851602,1,6,0
14576853@N00,1472,24,1337847942,1337847942,1,6,0
14576853@N00,1472,22,1337832378,1337832378,1,6,0
14576853@N00,1472,10,1337841571,1337841571,1,6,0
14638226@N02,1473,1,1198000817,1198000817,1,2,0
14638226@N02,1473,26,1197990804,1197990804,1,2,0
14648099@N05,1474,29,1309160758,1309160758,1,2,0
14648099@N05,1474,18,1309164262,1309164262,1,2,0
14648099@N05,1475,28,1309333381,1309333381,1,1,0
14674876@N04,1476,3,1316859892,1316859892,1,2,0
14674876@N04,1476,9,1316843088,1316843088,1,2,0
14674876@N04,1477,22,1317003945,1317004641,2,1,696
14691845@N00,1478,26,1371038688,1371040667,3,2,1979
14691845@N00,1478,29,1371037626,1371037626,1,2,0
14759208@N05,1479,28,1408328462,1408328462,1,1,0
14792256@N00,1480,27,1339997877,1339997877,1,2,0
14792256@N00,1480,18,1340003996,1340003996,1,2,0
14792256@N00,1481,16,1358935782,1358935783,3,1,1
14831331@N07,1482,15,1343392892,1343392892,1,1,0
14831331@N07,1483,31,1347093896,1347093896,1,1,0
14834314@N00,1484,26,1340057997,1340057997,1,3,0
14834314@N00,1484,11,1340070668,1340070668,1,3,0
14834314@N00,1484,9,1340059965,1340060793,2,3,828
14834314@N00,1485,11,1340151330,1340151330,1,4,0
14834314@N00,1485,13,1340148328,1340148328,1,4,0
14834314@N00,1485,21,1340147263,1340147441,2,4,178
14834314@N00,1485,14,1340156526,1340156536,3,4,10
14834314@N00,1486,22,1340189065,1340189065,1,1,0
14834314@N00,1487,28,1340316945,1340316945,1,1,0
14848876@N00,1488,30,1282972974,1282972986,2,3,12
14848876@N00,1488,26,1283001676,1283003661,4,3,1985
14848876@N00,1488,16,1283000808,1283000808,1,3,0
14848876@N00,1489,1,1310288780,1310288780,1,1,0
14877255@N04,1490,12,1279406039,1279406039,1,1,0
14877255@N04,1491,18,1391820997,1391820997,1,2,0
14877255@N04,1491,30,1391830447,1391830447,1,2,0
14877255@N04,1492,1,1392438180,1392438180,1,1,0
14877255@N04,1493,28,1393147960,1393147960,1,1,0
14877255@N04,1494,19,1394256266,1394256266,1,1,0
14877255@N04,1495,28,1396682253,1396682253,1,1,0
14877255@N04,1496,1,1400890620,1400890620,1,1,0
14877255@N04,1497,19,1402726252,1402726252,1,1,0
14877255@N04,1498,19,1405553202,1405559221,2,2,6019
14877255@N04,1498,28,1405570232,1405584568,2,2,14336
14877255@N04,1499,19,1410579158,1410579158,1,4,0
14877255@N04,1499,17,1410566729,1410566729,1,4,0
14877255@N04,1499,11,1410579872,1410579872,1,4,0
14877255@N04,1499,13,1410585425,1410585425,1,4,0
14877255@N04,1500,26,1416637976,1416637976,1,1,0
14877255@N04,1501,17,1423296519,1423296519,1,3,0
14877255@N04,1501,29,1423288328,1423288328,1,3,0
14877255@N04,1501,26,1423302593,1423302593,1,3,0
14877255@N04,1502,18,1425783783,1425783783,1,1,0
14877255@N04,1503,28,1430549246,1430549246,1,1,0
14877255@N04,1504,18,1431024555,1431024555,1,1,0
14877255@N04,1505,26,1435397616,1435397616,1,1,0
14877255@N04,1506,21,1436068947,1436068947,1,2,0
14877255@N04,1506,18,1436064198,1436064198,1,2,0
14877255@N04,1507,24,1437106118,1437106118,1,1,0
14877255@N04,1508,28,1437291215,1437291215,1,1,0
14877255@N04,1509,18,1452908168,1452908168,1,1,0
14877255@N04,1510,18,1453537884,1453537884,1,1,0
14877255@N04,1511,18,1456873948,1456889827,2,2,15879
14877255@N04,1511,26,1456880604,1456880604,1,2,0
14877255@N04,1512,23,1461401658,1461401658,1,1,0
14877255@N04,1513,26,1469947100,1469947100,1,1,0
14894152@N04,1514,7,1382259976,1382259976,1,1,0
14894152@N04,1515,1,1384493169,1384493169,1,1,0
14894152@N04,1516,26,1389509158,1389509158,1,1,0
14897087@N04,1517,29,1337606158,1337606158,1,1,0
14902480@N02,1518,26,1340279402,1340279402,1,1,0
14920533@N06,1519,7,1395876588,1395876588,1,6,0
14920533@N06,1519,27,1395879145,1395879145,1,6,0
14920533@N06,1519,28,1395890619,1395890619,1,6,0
14920533@N06,1519,24,1395882298,1395882298,1,6,0
14920533@N06,1519,29,1395876689,1395876689,1,6,0
14920533@N06,1519,23,1395890634,1395890634,1,6,0
14934218@N03,1520,30,1194135511,1194135872,7,1,361
14934218@N03,1521,30,1219383170,1219383353,2,1,183
14965074@N03,1522,27,1399204783,1399204783,1,1,0
14965074@N03,1523,3,1400867435,1400867435,1,1,0
14965074@N03,1524,19,1417437754,1417437754,1,1,0
14965074@N03,1525,29,1458201245,1458201245,1,1,0
15003623@N04,1526,30,1210638532,1210638532,1,1,0
15019436@N08,1527,30,1224653834,1224653834,1,4,0
15019436@N08,1527,26,1224653913,1224653967,4,4,54
15019436@N08,1527,28,1224640562,1224640562,1,4,0
15019436@N08,1527,29,1224639712,1224640860,5,4,1148
15026501@N00,1528,30,1340621659,1340621659,1,3,0
15026501@N00,1528,31,1340624231,1340624231,1,3,0
15026501@N00,1528,16,1340613660,1340614279,13,3,619
15026501@N00,1529,28,1340762468,1340762468,1,1,0
15037455@N08,1530,26,1340749770,1340790956,19,1,41186
15037455@N08,1531,26,1340837995,1340890223,35,1,52228
15037455@N08,1532,26,1340923541,1340923541,1,1,0
15037455@N08,1533,26,1343450341,1343450341,1,1,0
15074684@N07,1534,28,1230938956,1230938956,1,1,0
15074684@N07,1535,28,1232320240,1232320940,3,1,700
15074684@N07,1536,28,1234748265,1234748671,10,1,406
15074684@N07,1537,28,1235049800,1235049800,1,1,0
15074684@N07,1538,28,1235263428,1235263428,1,1,0
15074684@N07,1539,28,1235548291,1235549686,2,1,1395
15074684@N07,1540,28,1236484730,1236485249,3,1,519
15074684@N07,1541,28,1237698983,1237698984,2,1,1
15079826@N00,1542,19,1313659710,1313659710,1,5,0
15079826@N00,1542,27,1313650722,1313650766,2,5,44
15079826@N00,1542,12,1313652174,1313652174,1,5,0
15079826@N00,1542,23,1313652310,1313652310,1,5,0
15079826@N00,1542,29,1313652492,1313657190,6,5,4698
15079826@N00,1543,28,1313751148,1313766999,4,1,15851
15079826@N00,1544,1,1313843614,1313843617,2,2,3
15079826@N00,1544,28,1313843564,1313843819,3,2,255
15079826@N00,1545,20,1313983006,1313991807,5,11,8801
15079826@N00,1545,10,1313976446,1314027955,2,11,51509
15079826@N00,1545,26,1313976237,1314027962,5,11,51725
15079826@N00,1545,11,1314025851,1314025851,1,11,0
15079826@N00,1545,31,1313990040,1313990298,3,11,258
15079826@N00,1545,18,1313973916,1313973916,1,11,0
15079826@N00,1545,13,1314008876,1314009633,4,11,757
15079826@N00,1545,21,1314002519,1314005930,3,11,3411
15079826@N00,1545,28,1313973579,1313973654,3,11,75
15079826@N00,1545,14,1313980623,1313982877,7,11,2254
15079826@N00,1545,23,1313985672,1314020710,14,11,35038
15079826@N00,1546,28,1375939429,1375939429,1,1,0
15079826@N00,1547,20,1376223650,1376223650,1,1,0
15099999@N07,1548,26,1276903694,1276952694,11,1,49000
15120534@N07,1549,28,1249203879,1249203879,1,1,0
15125199@N07,1550,1,1288243508,1288243613,2,3,105
15125199@N07,1550,23,1288244813,1288244813,1,3,0
15125199@N07,1550,10,1288247066,1288247066,1,3,0
15125199@N07,1551,24,1288673396,1288673396,1,1,0
15125199@N07,1552,26,1290149334,1290149334,1,1,0
15125199@N07,1553,19,1290237391,1290237768,5,1,377
15125199@N07,1554,26,1294373113,1294378251,7,3,5138
15125199@N07,1554,25,1294376439,1294376681,3,3,242
15125199@N07,1554,9,1294378111,1294378111,1,3,0
15125199@N07,1555,17,1294730808,1294730808,1,2,0
15125199@N07,1555,26,1294729469,1294729580,2,2,111
15125199@N07,1556,9,1295935622,1295935622,1,1,0
15125199@N07,1557,30,1299232387,1299232585,2,1,198
15125199@N07,1558,28,1300765909,1300768636,3,1,2727
15125199@N07,1559,13,1347331509,1347336734,3,1,5225
15217104@N02,1560,26,1366430758,1366454863,24,11,24105
15217104@N02,1560,28,1366433854,1366448555,7,11,14701
15217104@N02,1560,13,1366429543,1366429896,4,11,353
15217104@N02,1560,25,1366428479,1366429796,21,11,1317
15217104@N02,1560,1,1366442333,1366448482,15,11,6149
15217104@N02,1560,21,1366428446,1366459736,2,11,31290
15217104@N02,1560,3,1366459748,1366459748,1,11,0
15217104@N02,1560,17,1366444255,1366444291,4,11,36
15217104@N02,1560,23,1366448725,1366448740,2,11,15
15217104@N02,1560,12,1366426658,1366427924,5,11,1266
15217104@N02,1560,30,1366424236,1366449300,10,11,25064
15217104@N02,1561,18,1366501828,1366501947,2,13,119
15217104@N02,1561,28,1366520933,1366545060,2,13,24127
15217104@N02,1561,27,1366511386,1366544863,13,13,33477
15217104@N02,1561,13,1366503850,1366506351,11,13,2501
15217104@N02,1561,1,1366534169,1366534169,1,13,0
15217104@N02,1561,21,1366503273,1366506569,2,13,3296
15217104@N02,1561,3,1366502998,1366503105,2,13,107
15217104@N02,1561,17,1366517185,1366517185,1,13,0
15217104@N02,1561,23,1366501841,1366542829,2,13,40988
15217104@N02,1561,24,1366515123,1366516348,3,13,1225
15217104@N02,1561,16,1366509601,1366518623,20,13,9022
15217104@N02,1561,8,1366502604,1366502694,3,13,90
15217104@N02,1561,29,1366539590,1366542613,16,13,3023
15217104@N02,1562,16,1367243031,1367243032,3,1,1
15218401@N04,1563,29,1428888173,1428888173,1,2,0
15218401@N04,1563,30,1428891850,1428891888,2,2,38
15218401@N04,1564,17,1428921397,1428922647,2,1,1250
15218401@N04,1565,17,1429160873,1429165571,3,1,4698
15235007@N00,1566,28,1233897030,1233897055,2,2,25
15235007@N00,1566,1,1233896611,1233901743,7,2,5132
15235007@N00,1567,1,1241822164,1241822164,1,1,0
15235007@N00,1568,28,1243310232,1243310259,3,1,27
15235007@N00,1569,28,1245990420,1245991051,5,2,631
15235007@N00,1569,1,1245990278,1245990278,1,2,0
15235007@N00,1570,1,1279329210,1279329287,4,1,77
15235007@N00,1571,1,1317417757,1317417788,2,10,31
15235007@N00,1571,27,1317419624,1317419653,2,10,29
15235007@N00,1571,21,1317421561,1317422795,10,10,1234
15235007@N00,1571,16,1317418321,1317419226,23,10,905
15235007@N00,1571,30,1317427276,1317432065,8,10,4789
15235007@N00,1571,25,1317422365,1317422365,1,10,0
15235007@N00,1571,10,1317424137,1317424137,1,10,0
15235007@N00,1571,12,1317420839,1317421972,4,10,1133
15235007@N00,1571,28,1317417518,1317418040,8,10,522
15235007@N00,1571,15,1317420016,1317420380,2,10,364
15235007@N00,1572,20,1330989978,1330989978,2,2,0
15235007@N00,1572,1,1330987000,1330992045,33,2,5045
15249724@N06,1573,1,1188315142,1188315142,1,2,0
15249724@N06,1573,30,1188314446,1188314446,1,2,0
15302945@N00,1574,27,1200351063,1200351063,1,1,0
15409581@N00,1575,26,1324532433,1324532433,1,1,0
15409581@N00,1576,29,1335253231,1335253231,1,1,0
15409581@N00,1577,27,1336633892,1336633892,1,1,0
15409581@N00,1578,31,1337597718,1337597718,1,2,0
15409581@N00,1578,1,1337597759,1337597759,1,2,0
15409581@N00,1579,20,1380946912,1380946912,1,1,0
15409581@N00,1580,29,1383362856,1383387556,3,8,24700
15409581@N00,1580,20,1383358789,1383359437,2,8,648
15409581@N00,1580,14,1383351409,1383351409,1,8,0
15409581@N00,1580,31,1383363936,1383364582,2,8,646
15409581@N00,1580,23,1383368061,1383368061,1,8,0
15409581@N00,1580,27,1383369136,1383382920,2,8,13784
15409581@N00,1580,22,1383357593,1383357593,1,8,0
15409581@N00,1580,17,1383344789,1383344789,1,8,0
15409581@N00,1581,1,1384123234,1384128799,3,2,5565
15409581@N00,1581,30,1384142891,1384142891,1,2,0
15434281@N00,1582,28,1313855302,1313855304,2,1,2
15441953@N00,1583,25,1330921106,1330921211,7,4,105
15441953@N00,1583,26,1330918983,1330919013,2,4,30
15441953@N00,1583,21,1330920123,1330920123,1,4,0
15441953@N00,1583,20,1330915025,1330915025,1,4,0
15463022@N02,1584,1,1193202053,1193202055,4,1,2
15463022@N02,1585,1,1368146554,1368187250,177,9,40696
15463022@N02,1585,23,1368157438,1368157442,2,9,4
15463022@N02,1585,24,1368172486,1368172938,2,9,452
15463022@N02,1585,18,1368157444,1368157449,2,9,5
15463022@N02,1585,28,1368152421,1368152439,2,9,18
15463022@N02,1585,13,1368164690,1368167275,8,9,2585
15463022@N02,1585,4,1368154610,1368154622,2,9,12
15463022@N02,1585,16,1368176292,1368176292,1,9,0
15463022@N02,1585,25,1368163505,1368163778,3,9,273
15463022@N02,1586,1,1368249909,1368249909,1,1,0
15463022@N02,1587,1,1368317117,1368338059,157,3,20942
15463022@N02,1587,31,1368325380,1368325421,6,3,41
15463022@N02,1587,25,1368335533,1368335533,1,3,0
15463022@N02,1588,1,1368912595,1368912595,1,1,0
15463022@N02,1589,25,1369042319,1369042332,3,1,13
15468918@N00,1590,19,1361146733,1361146733,1,2,0
15468918@N00,1590,30,1361147930,1361161402,5,2,13472
15468918@N00,1591,16,1361320859,1361320859,1,16,0
15468918@N00,1591,1,1361318296,1361318472,4,16,176
15468918@N00,1591,24,1361328665,1361343601,11,16,14936
15468918@N00,1591,21,1361329431,1361329431,1,16,0
15468918@N00,1591,23,1361321185,1361321266,3,16,81
15468918@N00,1591,25,1361329186,1361329186,1,16,0
15468918@N00,1591,26,1361320795,1361342062,4,16,21267
15468918@N00,1591,28,1361320666,1361348927,5,16,28261
15468918@N00,1591,12,1361341863,1361347117,5,16,5254
15468918@N00,1591,15,1361328077,1361328103,2,16,26
15468918@N00,1591,27,1361326296,1361326296,1,16,0
15468918@N00,1591,19,1361318431,1361323652,3,16,5221
15468918@N00,1591,20,1361325073,1361325087,2,16,14
15468918@N00,1591,7,1361329512,1361329512,1,16,0
15468918@N00,1591,30,1361318618,1361341772,8,16,23154
15468918@N00,1591,29,1361323611,1361352391,3,16,28780
15468918@N00,1592,1,1392515144,1392515205,2,6,61
15468918@N00,1592,21,1392516946,1392516946,1,6,0
15468918@N00,1592,13,1392517506,1392517506,1,6,0
15468918@N00,1592,26,1392515499,1392515534,2,6,35
15468918@N00,1592,31,1392515754,1392515762,3,6,8
15468918@N00,1592,29,1392518536,1392518536,1,6,0
15474023@N03,1593,1,1229708000,1229708096,2,11,96
15474023@N03,1593,12,1229689900,1229689900,1,11,0
15474023@N03,1593,25,1229698893,1229743387,6,11,44494
15474023@N03,1593,29,1229712711,1229715719,3,11,3008
15474023@N03,1593,26,1229689948,1229719362,3,11,29414
15474023@N03,1593,27,1229681736,1229726189,8,11,44453
15474023@N03,1593,6,1229732883,1229732883,1,11,0
15474023@N03,1593,21,1229703047,1229705606,22,11,2559
15474023@N03,1593,3,1229692117,1229738432,6,11,46315
15474023@N03,1593,16,1229719580,1229749205,2,11,29625
15474023@N03,1593,28,1229706894,1229732832,4,11,25938
15474023@N03,1594,12,1229779673,1229822853,5,8,43180
15474023@N03,1594,29,1229794490,1229831923,5,8,37433
15474023@N03,1594,26,1229831353,1229858130,2,8,26777
15474023@N03,1594,3,1229818385,1229861890,3,8,43505
15474023@N03,1594,31,1229798393,1229798393,1,8,0
15474023@N03,1594,16,1229820535,1229820535,1,8,0
15474023@N03,1594,24,1229807064,1229807064,1,8,0
15474023@N03,1594,28,1229787581,1229831100,3,8,43519
15474023@N03,1595,25,1229944028,1229944028,1,1,0
15474023@N03,1596,26,1259295545,1259295549,6,2,4
15474023@N03,1596,25,1259295544,1259295545,2,2,1
15474023@N03,1597,1,1409363624,1409378789,5,8,15165
15474023@N03,1597,12,1409345340,1409345360,2,8,20
15474023@N03,1597,26,1409346459,1409371609,3,8,25150
15474023@N03,1597,15,1409374073,1409374310,3,8,237
15474023@N03,1597,7,1409346364,1409346378,3,8,14
15474023@N03,1597,17,1409373398,1409373398,1,8,0
15474023@N03,1597,16,1409345149,1409345202,3,8,53
15474023@N03,1597,30,1409346480,1409346480,1,8,0
15474023@N03,1598,15,1409432924,1409432924,1,5,0
15474023@N03,1598,6,1409432770,1409432770,1,5,0
15474023@N03,1598,21,1409433060,1409433073,2,5,13
15474023@N03,1598,14,1409429963,1409429963,1,5,0
15474023@N03,1598,30,1409432580,1409432617,2,5,37
15474023@N03,1599,1,1409471961,1409471961,1,6,0
15474023@N03,1599,26,1409479160,1409479281,2,6,121
15474023@N03,1599,23,1409475551,1409478257,2,6,2706
15474023@N03,1599,16,1409479343,1409479343,1,6,0
15474023@N03,1599,10,1409474983,1409474998,2,6,15
15474023@N03,1599,30,1409475375,1409475531,2,6,156
15499532@N06,1600,13,1464412143,1464418325,3,9,6182
15499532@N06,1600,17,1464426414,1464426414,1,9,0
15499532@N06,1600,4,1464416445,1464416445,1,9,0
15499532@N06,1600,29,1464407307,1464407307,1,9,0
15499532@N06,1600,16,1464419493,1464419493,1,9,0
15499532@N06,1600,30,1464411146,1464411146,1,9,0
15499532@N06,1600,1,1464405991,1464406053,2,9,62
15499532@N06,1600,26,1464411476,1464411476,1,9,0
15499532@N06,1600,21,1464418664,1464418664,1,9,0
15532592@N00,1601,7,1365935317,1365935317,1,1,0
15532592@N00,1602,5,1370146912,1370146912,1,1,0
15532592@N00,1603,28,1387016217,1387016217,1,1,0
15532592@N00,1604,1,1393147786,1393149446,2,3,1660
15532592@N00,1604,26,1393144454,1393144608,2,3,154
15532592@N00,1604,3,1393149242,1393149242,1,3,0
15532592@N00,1605,26,1393201367,1393202417,3,1,1050
15532592@N00,1606,13,1405982000,1405982000,1,1,0
15532592@N00,1607,19,1414759145,1414759537,3,1,392
15533065@N08,1608,28,1257748415,1257748415,1,1,0
15533594@N00,1609,26,1309157421,1309157421,1,1,0
15533594@N00,1610,1,1368930552,1368930552,1,1,0
15535152@N08,1611,28,1195448694,1195449463,2,1,769
15535152@N08,1612,28,1195511180,1195529666,11,1,18486
15588726@N00,1613,1,1373275469,1373278427,4,1,2958
15588726@N00,1614,1,1373331171,1373373774,25,1,42603
15588726@N00,1615,1,1373420955,1373462312,12,1,41357
15588726@N00,1616,1,1373524259,1373542968,11,1,18709
15588726@N00,1617,1,1373600197,1373635184,8,1,34987
15588726@N00,1618,1,1374480107,1374480107,1,1,0
15641461@N03,1619,16,1376182548,1376182548,1,5,0
15641461@N03,1619,14,1376200976,1376200976,1,5,0
15641461@N03,1619,29,1376219697,1376219697,1,5,0
15641461@N03,1619,27,1376225250,1376225250,1,5,0
15641461@N03,1619,1,1376176488,1376176488,1,5,0
15771726@N05,1620,13,1357343573,1357343573,1,1,0
15778445@N02,1621,30,1394260620,1394260945,2,1,325
15855011@N03,1622,20,1230347207,1230347207,1,4,0
15855011@N03,1622,31,1230349011,1230349011,1,4,0
15855011@N03,1622,26,1230358763,1230358763,1,4,0
15855011@N03,1622,3,1230362838,1230362838,1,4,0
15892878@N05,1623,1,1413771604,1413771604,1,1,0
15892878@N05,1624,1,1413843257,1413843257,1,1,0
15923079@N07,1625,12,1371093133,1371093133,1,1,0
15926431@N02,1626,29,1359152623,1359180575,8,1,27952
15935500@N02,1627,12,1338771665,1338771665,1,8,0
15935500@N02,1627,24,1338773057,1338773057,1,8,0
15935500@N02,1627,31,1338780764,1338785179,2,8,4415
15935500@N02,1627,22,1338778376,1338778376,2,8,0
15935500@N02,1627,30,1338786597,1338789039,4,8,2442
15935500@N02,1627,29,1338793581,1338793608,2,8,27
15935500@N02,1627,19,1338794778,1338794778,1,8,0
15935500@N02,1627,13,1338790841,1338790841,1,8,0
15935500@N02,1628,5,1342261654,1342261654,1,3,0
15935500@N02,1628,8,1342256873,1342256873,1,3,0
15935500@N02,1628,6,1342262567,1342263600,2,3,1033
15935500@N02,1629,12,1342354153,1342354153,1,2,0
15935500@N02,1629,20,1342352934,1342357991,4,2,5057
15935500@N02,1630,27,1408772841,1408772841,1,4,0
15935500@N02,1630,24,1408769661,1408769807,2,4,146
15935500@N02,1630,12,1408765042,1408765042,1,4,0
15935500@N02,1630,15,1408769898,1408769898,1,4,0
15935500@N02,1631,26,1420257008,1420262882,8,1,5874
15935500@N02,1632,15,1425788227,1425788227,1,1,0
15935500@N02,1633,27,1433030767,1433031684,2,4,917
15935500@N02,1633,30,1433040920,1433041180,3,4,260
15935500@N02,1633,28,1433042344,1433071459,12,4,29115
15935500@N02,1633,4,1433036537,1433036537,1,4,0
15935500@N02,1634,28,1437390511,1437391191,6,3,680
15935500@N02,1634,12,1437371874,1437374506,5,3,2632
15935500@N02,1634,25,1437375223,1437375240,2,3,17
15935500@N02,1635,20,1443929400,1443931917,2,5,2517
15935500@N02,1635,28,1443923513,1443937852,3,5,14339
15935500@N02,1635,26,1443923525,1443925343,13,5,1818
15935500@N02,1635,31,1443928182,1443928182,1,5,0
15935500@N02,1635,1,1443923317,1443924016,3,5,699
15935500@N02,1636,26,1451788251,1451788490,5,2,239
15935500@N02,1636,12,1451779542,1451779542,1,2,0
15935500@N02,1637,27,1469933297,1469934358,2,8,1061
15935500@N02,1637,30,1469924595,1469925408,2,8,813
15935500@N02,1637,28,1469935473,1469935473,1,8,0
15935500@N02,1637,12,1469919706,1469921457,2,8,1751
15935500@N02,1637,10,1469922299,1469922299,1,8,0
15935500@N02,1637,15,1469917674,1469934165,9,8,16491
15935500@N02,1637,22,1469925727,1469926379,2,8,652
15935500@N02,1637,1,1469947551,1469947837,6,8,286
16035349@N05,1638,5,1264825939,1264825939,1,6,0
16035349@N05,1638,16,1264814668,1264814668,1,6,0
16035349@N05,1638,13,1264845664,1264845664,1,6,0
16035349@N05,1638,11,1264852436,1264852436,1,6,0
16035349@N05,1638,12,1264816276,1264844284,2,6,28008
16035349@N05,1638,24,1264818513,1264823517,7,6,5004
16038948@N00,1639,26,1363229111,1363229111,1,1,0
16082542@N00,1640,28,1241306964,1241306964,1,1,0
16093042@N00,1641,17,1345859250,1345859250,1,4,0
16093042@N00,1641,26,1345890763,1345890763,1,4,0
16093042@N00,1641,25,1345862050,1345862050,1,4,0
16093042@N00,1641,28,1345885127,1345885127,1,4,0
16093042@N00,1642,27,1379733500,1379733500,1,2,0
16093042@N00,1642,16,1379731173,1379731173,1,2,0
16130164@N06,1643,17,1366853946,1366853946,1,1,0
16131811@N00,1644,31,1340166120,1340166120,1,1,0
16171417@N00,1645,9,1468121195,1468122017,4,3,822
16171417@N00,1645,17,1468121857,1468121867,2,3,10
16171417@N00,1645,20,1468121587,1468121617,3,3,30
16222234@N00,1646,26,1198291597,1198330287,68,1,38690
16222234@N00,1647,26,1203726131,1203771187,80,1,45056
16222234@N00,1648,26,1203831105,1203853637,4,1,22532
16222234@N00,1649,27,1368930501,1368930501,1,1,0
16222234@N00,1650,18,1447999145,1447999145,1,1,0
16272116@N03,1651,25,1259840521,1259840742,2,2,221
16272116@N03,1651,28,1259842010,1259842017,2,2,7
16272116@N03,1652,11,1260848749,1260848749,1,2,0
16272116@N03,1652,28,1260844200,1260844200,1,2,0
16272116@N03,1653,30,1263730936,1263730936,1,1,0
16272116@N03,1654,20,1291534784,1291534784,1,1,0
16272116@N03,1655,20,1303279704,1303279704,1,3,0
16272116@N03,1655,16,1303279735,1303279735,1,3,0
16272116@N03,1655,28,1303279719,1303279719,1,3,0
16295466@N00,1656,19,1411808576,1411808576,1,2,0
16295466@N00,1656,17,1411789688,1411789688,1,2,0
16336194@N00,1657,20,1415069902,1415069902,1,6,0
16336194@N00,1657,28,1415083664,1415083664,1,6,0
16336194@N00,1657,17,1415076490,1415076490,1,6,0
16336194@N00,1657,16,1415079914,1415079914,1,6,0
16336194@N00,1657,19,1415067550,1415067550,1,6,0
16336194@N00,1657,30,1415072568,1415072606,2,6,38
16336194@N00,1658,29,1421395193,1421395193,1,3,0
16336194@N00,1658,18,1421378027,1421378027,1,3,0
16336194@N00,1658,19,1421379427,1421379427,1,3,0
16336194@N00,1659,17,1429147533,1429147533,1,2,0
16336194@N00,1659,30,1429149079,1429149115,2,2,36
16336194@N00,1660,19,1431742133,1431745130,4,1,2997
16336194@N00,1661,19,1446603843,1446603843,1,4,0
16336194@N00,1661,20,1446598691,1446598691,1,4,0
16336194@N00,1661,1,1446597027,1446597027,1,4,0
16336194@N00,1661,30,1446606213,1446606213,1,4,0
16438861@N00,1662,13,1353893334,1353893334,1,8,0
16438861@N00,1662,24,1353928350,1353928350,1,8,0
16438861@N00,1662,25,1353929248,1353929248,1,8,0
16438861@N00,1662,17,1353895605,1353895605,1,8,0
16438861@N00,1662,12,1353889059,1353889059,1,8,0
16438861@N00,1662,18,1353928218,1353928218,1,8,0
16438861@N00,1662,16,1353899015,1353928257,3,8,29242
16438861@N00,1662,26,1353901001,1353901001,1,8,0
16442000@N00,1663,3,1412379783,1412379785,2,8,2
16442000@N00,1663,21,1412379027,1412379045,2,8,18
16442000@N00,1663,26,1412381593,1412405763,110,8,24170
16442000@N00,1663,1,1412375568,1412375569,2,8,1
16442000@N00,1663,8,1412405680,1412405680,1,8,0
16442000@N00,1663,24,1412381599,1412381600,3,8,1
16442000@N00,1663,13,1412397603,1412397754,6,8,151
16442000@N00,1663,28,1412375777,1412375777,1,8,0
16442000@N00,1664,3,1421145285,1421145285,1,6,0
16442000@N00,1664,21,1421145290,1421145290,1,6,0
16442000@N00,1664,26,1421113582,1421145415,87,6,31833
16442000@N00,1664,11,1421145415,1421145415,1,6,0
16442000@N00,1664,15,1421145364,1421145409,14,6,45
16442000@N00,1664,18,1421107667,1421107667,1,6,0
16442000@N00,1665,23,1421666167,1421666167,1,1,0
16442000@N00,1666,31,1428811890,1428811890,1,5,0
16442000@N00,1666,26,1428804682,1428805254,11,5,572
16442000@N00,1666,22,1428811896,1428811906,3,5,10
16442000@N00,1666,29,1428807420,1428807420,1,5,0
16442000@N00,1666,19,1428807315,1428807315,1,5,0
16442000@N00,1667,5,1431822018,1431822018,1,1,0
16442000@N00,1668,26,1438482397,1438489829,14,2,7432
16442000@N00,1668,16,1438489832,1438490022,26,2,190
16442000@N00,1669,16,1445128314,1445128321,3,1,7
16442000@N00,1670,12,1467863758,1467863766,5,9,8
16442000@N00,1670,7,1467857677,1467857683,4,9,6
16442000@N00,1670,11,1467861954,1467861970,2,9,16
16442000@N00,1670,24,1467865027,1467866050,5,9,1023
16442000@N00,1670,4,1467857689,1467857689,1,9,0
16442000@N00,1670,21,1467861790,1467861790,2,9,0
16442000@N00,1670,16,1467873796,1467876430,3,9,2634
16442000@N00,1670,30,1467875875,1467875875,1,9,0
16442000@N00,1670,26,1467869558,1467873803,17,9,4245
16472222@N00,1671,18,1361157595,1361157595,1,1,0
16520490@N08,1672,25,1198142586,1198142586,1,2,0
16520490@N08,1672,3,1198124545,1198146976,5,2,22431
16520490@N08,1673,16,1207190892,1207190892,1,1,0
16562518@N00,1674,29,1251853686,1251856416,4,1,2730
16562518@N00,1675,29,1252014898,1252014898,1,1,0
16569276@N00,1676,20,1325416853,1325416853,1,1,0
16572880@N08,1677,20,1379495329,1379495329,1,2,0
16572880@N08,1677,1,1379494855,1379494855,1,2,0
16572880@N08,1678,1,1386309637,1386309637,1,1,0
16591891@N00,1679,25,1353496701,1353496701,1,3,0
16591891@N00,1679,29,1353491372,1353491372,1,3,0
16591891@N00,1679,26,1353496941,1353496941,1,3,0
16591891@N00,1680,1,1391937767,1391937767,1,1,0
16591891@N00,1681,1,1394333138,1394333138,1,1,0
16591891@N00,1682,13,1408866942,1408866942,1,1,0
16591891@N00,1683,19,1418637845,1418637845,1,1,0
16591891@N00,1684,30,1426400567,1426400567,1,1,0
16591891@N00,1685,18,1430036236,1430036236,1,1,0
16591891@N00,1686,18,1431255904,1431255904,1,1,0
16591891@N00,1687,30,1433064493,1433064493,1,1,0
16613671@N00,1688,4,1391741377,1391741377,1,1,0
16613671@N00,1689,18,1431254782,1431254782,1,1,0
16651106@N00,1690,26,1304773849,1304806114,51,1,32265
16712945@N00,1691,26,1355306756,1355307055,2,1,299
16766249@N00,1692,21,1199425694,1199425694,1,4,0
16766249@N00,1692,20,1199425702,1199425702,1,4,0
16766249@N00,1692,29,1199425696,1199425698,3,4,2
16766249@N00,1692,13,1199425699,1199425701,2,4,2
16778006@N00,1693,19,1411289354,1411289354,1,1,0
16811913@N00,1694,28,1333790000,1333790000,1,1,0
16811913@N00,1695,15,1333869005,1333869005,1,1,0
16811913@N00,1696,28,1334192448,1334192448,1,1,0
16811913@N00,1697,17,1346112656,1346112656,1,1,0
16811913@N00,1698,27,1346290546,1346290546,1,1,0
16813616@N00,1699,27,1328245691,1328245691,1,1,0
16813616@N00,1700,28,1330652353,1330653230,2,1,877
16813616@N00,1701,17,1330693178,1330693178,1,1,0
16813616@N00,1702,29,1333942631,1333943126,3,1,495
16911222@N04,1703,1,1365119244,1365119244,2,1,0
16911222@N04,1704,4,1403566048,1403583929,2,2,17881
16911222@N04,1704,28,1403577455,1403577455,1,2,0
16911222@N04,1705,3,1407151465,1407151465,1,1,0
16911222@N04,1706,1,1451468711,1451468711,1,4,0
16911222@N04,1706,7,1451459717,1451459717,1,4,0
16911222@N04,1706,16,1451453290,1451454886,3,4,1596
16911222@N04,1706,18,1451457431,1451457431,1,4,0
16911222@N04,1707,29,1464314859,1464314859,1,4,0
16911222@N04,1707,1,1464309831,1464309831,1,4,0
16911222@N04,1707,7,1464313435,1464313435,1,4,0
16911222@N04,1707,31,1464317292,1464317292,1,4,0
16911222@N04,1708,26,1464350931,1464350931,1,1,0
16959346@N06,1709,31,1366784477,1366785402,2,6,925
16959346@N06,1709,25,1366766222,1366766852,8,6,630
16959346@N06,1709,27,1366770866,1366770866,1,6,0
16959346@N06,1709,26,1366768329,1366797636,3,6,29307
16959346@N06,1709,29,1366784430,1366784430,1,6,0
16959346@N06,1709,28,1366797773,1366797773,1,6,0
16997251@N05,1710,23,1208548860,1208548860,1,1,0
16997251@N05,1711,31,1208582028,1208582028,1,1,0
16997251@N05,1712,30,1222459672,1222459672,1,1,0
16997251@N05,1713,16,1227639720,1227639720,1,1,0
16997251@N05,1714,30,1227677358,1227677358,1,1,0
16997251@N05,1715,22,1232799951,1232799951,1,3,0
16997251@N05,1715,26,1232779872,1232779872,1,3,0
16997251@N05,1715,1,1232786688,1232786767,2,3,79
16997251@N05,1716,27,1236584688,1236585530,6,2,842
16997251@N05,1716,17,1236587397,1236587397,1,2,0
17119587@N00,1717,1,1290375506,1290419410,110,1,43904
17122396@N00,1718,30,1295134010,1295163045,40,1,29035
17122396@N00,1719,30,1295221131,1295230280,31,1,9149
17145135@N00,1720,28,1338430594,1338430594,1,1,0
17187387@N04,1721,1,1356241387,1356259133,4,1,17746
17187387@N04,1722,1,1356303110,1356339595,33,1,36485
17187387@N04,1723,1,1356386030,1356423829,20,1,37799
17187387@N04,1724,26,1385183356,1385183356,1,1,0
17221717@N02,1725,29,1367398496,1367398496,1,1,0
17221717@N02,1726,18,1372823686,1372824578,2,1,892
17221717@N02,1727,8,1373432549,1373432549,1,1,0
17398899@N05,1728,8,1330937476,1330937476,1,1,0
17398899@N05,1729,21,1331086418,1331086418,1,1,0
17404515@N00,1730,17,1320556778,1320556778,1,1,0
17442971@N00,1731,22,1275195702,1275195702,1,3,0
17442971@N00,1731,30,1275196742,1275196742,1,3,0
17442971@N00,1731,15,1275183461,1275183461,1,3,0
17529682@N05,1732,16,1202011449,1202011449,1,2,0
17529682@N05,1732,26,1202010091,1202010091,1,2,0
17529682@N05,1733,17,1212602087,1212602087,1,2,0
17529682@N05,1733,3,1212630849,1212630849,1,2,0
17596088@N00,1734,19,1260575315,1260575315,1,3,0
17596088@N00,1734,18,1260593849,1260593849,1,3,0
17596088@N00,1734,28,1260581869,1260583761,4,3,1892
17596088@N00,1735,28,1260660849,1260660849,1,2,0
17596088@N00,1735,19,1260671583,1260683586,3,2,12003
17596088@N00,1736,1,1348225195,1348225261,4,1,66
17726320@N03,1737,1,1421631491,1421631491,1,1,0
17816422@N00,1738,28,1325280778,1325280778,1,1,0
17816422@N00,1739,28,1325397119,1325397119,1,1,0
17816422@N00,1740,19,1407072366,1407072366,1,1,0
17818511@N00,1741,25,1228527206,1228527206,1,5,0
17818511@N00,1741,22,1228532924,1228532924,1,5,0
17818511@N00,1741,15,1228521504,1228521504,1,5,0
17818511@N00,1741,30,1228531402,1228531402,1,5,0
17818511@N00,1741,26,1228520931,1228521065,3,5,134
17832362@N00,1742,27,1337707625,1337707625,1,3,0
17832362@N00,1742,14,1337694941,1337694941,1,3,0
17832362@N00,1742,8,1337689942,1337689942,1,3,0
17865663@N00,1743,26,1258602841,1258602874,2,2,33
17865663@N00,1743,28,1258603700,1258603705,2,2,5
17865663@N00,1744,29,1377420347,1377420347,1,1,0
17955069@N04,1745,23,1189959092,1189959092,1,2,0
17955069@N04,1745,26,1189959411,1189959411,1,2,0
17985434@N00,1746,6,1325115052,1325115586,2,1,534
17995170@N00,1747,26,1387974249,1387974249,1,1,0
18026860@N03,1748,27,1346832515,1346832515,1,2,0
18026860@N03,1748,30,1346829226,1346829226,1,2,0
18026860@N03,1749,13,1348535138,1348535589,4,2,451
18026860@N03,1749,4,1348535681,1348535681,1,2,0
18026860@N03,1750,22,1350203211,1350203211,1,1,0
18026860@N03,1751,26,1430207475,1430207475,1,1,0
18026860@N03,1752,20,1443079847,1443079847,1,1,0
18027113@N07,1753,29,1302400226,1302400226,1,1,0
18061845@N00,1754,18,1250200089,1250248183,29,1,48094
18082086@N00,1755,16,1219672800,1219672801,2,3,1
18082086@N00,1755,21,1219672802,1219672804,3,3,2
18082086@N00,1755,23,1219672805,1219672805,1,3,0
18114679@N00,1756,15,1338088923,1338088923,1,7,0
18114679@N00,1756,27,1338104060,1338104153,2,7,93
18114679@N00,1756,8,1338111716,1338111716,1,7,0
18114679@N00,1756,23,1338122815,1338126323,3,7,3508
18114679@N00,1756,16,1338103129,1338103525,4,7,396
18114679@N00,1756,17,1338085408,1338110025,2,7,24617
18114679@N00,1756,29,1338090681,1338101097,32,7,10416
18174036@N05,1757,23,1394358088,1394358088,1,1,0
18174036@N05,1758,23,1394423531,1394423531,1,1,0
18198369@N03,1759,5,1294894499,1294894499,1,1,0
18291524@N00,1760,7,1250393966,1250393966,1,1,0
18366889@N00,1761,7,1440486657,1440486657,1,8,0
18366889@N00,1761,12,1440465105,1440466081,2,8,976
18366889@N00,1761,17,1440456526,1440503045,11,8,46519
18366889@N00,1761,29,1440476018,1440479920,4,8,3902
18366889@N00,1761,13,1440467918,1440470586,4,8,2668
18366889@N00,1761,24,1440463367,1440464725,3,8,1358
18366889@N00,1761,16,1440460955,1440482262,5,8,21307
18366889@N00,1761,25,1440466251,1440466384,3,8,133
18366889@N00,1762,4,1440581848,1440582904,3,3,1056
18366889@N00,1762,25,1440577261,1440577291,3,3,30
18366889@N00,1762,3,1440585456,1440586187,7,3,731
18366889@N00,1763,27,1440731105,1440731105,1,9,0
18366889@N00,1763,6,1440719213,1440719750,2,9,537
18366889@N00,1763,11,1440726020,1440726070,2,9,50
18366889@N00,1763,15,1440767210,1440767210,1,9,0
18366889@N00,1763,5,1440722732,1440723150,4,9,418
18366889@N00,1763,14,1440745726,1440745726,1,9,0
18366889@N00,1763,21,1440725912,1440726212,2,9,300
18366889@N00,1763,28,1440761165,1440761211,2,9,46
18366889@N00,1763,26,1440718626,1440763268,3,9,44642
18382722@N00,1764,4,1331541730,1331541730,1,1,0
18384077@N00,1765,29,1324987885,1324987885,1,2,0
18384077@N00,1765,28,1325010364,1325010364,1,2,0
18384077@N00,1766,20,1325102165,1325102165,1,1,0
18384077@N00,1767,28,1331450099,1331450099,1,1,0
18384077@N00,1768,20,1331494911,1331494911,1,1,0
18384077@N00,1769,13,1344763893,1344763893,1,1,0
18384077@N00,1770,20,1344864401,1344864401,1,2,0
18384077@N00,1770,29,1344858009,1344891774,4,2,33765
18384077@N00,1771,28,1355549840,1355549840,1,1,0
18384077@N00,1772,13,1355642473,1355642473,1,1,0
18579339@N04,1773,18,1439174727,1439174727,1,1,0
18699029@N00,1774,20,1237564692,1237570556,2,1,5864
18753948@N00,1775,25,1289445213,1289455376,12,17,10163
18753948@N00,1775,5,1289449089,1289450092,3,17,1003
18753948@N00,1775,10,1289435901,1289437001,5,17,1100
18753948@N00,1775,29,1289431564,1289431927,5,17,363
18753948@N00,1775,31,1289434638,1289434716,2,17,78
18753948@N00,1775,16,1289441253,1289464178,8,17,22925
18753948@N00,1775,15,1289461008,1289461282,2,17,274
18753948@N00,1775,26,1289437457,1289437612,3,17,155
18753948@N00,1775,20,1289432149,1289432193,2,17,44
18753948@N00,1775,17,1289471144,1289471144,1,17,0
18753948@N00,1775,13,1289445530,1289447594,6,17,2064
18753948@N00,1775,12,1289441153,1289441153,1,17,0
18753948@N00,1775,1,1289429402,1289439445,2,17,10043
18753948@N00,1775,30,1289434669,1289434669,1,17,0
18753948@N00,1775,28,1289438723,1289471902,5,17,33179
18753948@N00,1775,27,1289441343,1289441343,1,17,0
18753948@N00,1775,7,1289449530,1289449530,1,17,0
18753948@N00,1776,15,1289541674,1289544957,9,4,3283
18753948@N00,1776,20,1289518900,1289519909,12,4,1009
18753948@N00,1776,22,1289516521,1289518443,5,4,1922
18753948@N00,1776,28,1289537748,1289538893,28,4,1145
18753948@N00,1777,25,1289599393,1289636379,4,10,36986
18753948@N00,1777,29,1289604164,1289628951,5,10,24787
18753948@N00,1777,31,1289629341,1289629341,1,10,0
18753948@N00,1777,23,1289607565,1289607977,6,10,412
18753948@N00,1777,20,1289604990,1289637929,5,10,32939
18753948@N00,1777,22,1289637975,1289637975,1,10,0
18753948@N00,1777,3,1289636858,1289636858,1,10,0
18753948@N00,1777,26,1289597662,1289643073,3,10,45411
18753948@N00,1777,30,1289620331,1289620412,3,10,81
18753948@N00,1777,28,1289597430,1289597430,1,10,0
18753948@N00,1778,25,1326773428,1326784050,8,14,10622
18753948@N00,1778,29,1326756441,1326768018,4,14,11577
18753948@N00,1778,31,1326756625,1326761240,8,14,4615
18753948@N00,1778,16,1326763343,1326784294,2,14,20951
18753948@N00,1778,26,1326755075,1326782872,6,14,27797
18753948@N00,1778,1,1326754497,1326754531,2,14,34
18753948@N00,1778,23,1326755099,1326755099,1,14,0
18753948@N00,1778,13,1326775189,1326775553,7,14,364
18753948@N00,1778,17,1326763483,1326763483,1,14,0
18753948@N00,1778,20,1326770987,1326770987,1,14,0
18753948@N00,1778,22,1326758920,1326759903,3,14,983
18753948@N00,1778,3,1326773380,1326783334,2,14,9954
18753948@N00,1778,30,1326756831,1326756831,1,14,0
18753948@N00,1778,28,1326754843,1326779279,5,14,24436
18753948@N00,1779,26,1414373252,1414383023,11,2,9771
18753948@N00,1779,20,1414383229,1414384784,11,2,1555
18753948@N00,1780,20,1414457776,1414459637,8,2,1861
18753948@N00,1780,26,1414448498,1414468573,4,2,20075
18753948@N00,1781,20,1414547034,1414547736,11,3,702
18753948@N00,1781,24,1414540276,1414540709,2,3,433
18753948@N00,1781,26,1414546043,1414557262,2,3,11219
18753948@N00,1782,20,1414626282,1414626282,1,4,0
18753948@N00,1782,11,1414628449,1414629580,7,4,1131
18753948@N00,1782,24,1414630507,1414630579,2,4,72
18753948@N00,1782,26,1414623126,1414640352,6,4,17226
18753948@N00,1783,11,1414715168,1414716215,6,2,1047
18753948@N00,1783,26,1414712699,1414712699,1,2,0
18813519@N00,1784,30,1329167847,1329167847,1,1,0
18837886@N00,1785,16,1391736331,1391736331,1,1,0
18840194@N02,1786,26,1218677322,1218677322,1,7,0
18840194@N02,1786,29,1218680496,1218680496,1,7,0
18840194@N02,1786,7,1218678157,1218678157,1,7,0
18840194@N02,1786,11,1218691161,1218691161,1,7,0
18840194@N02,1786,1,1218676702,1218677007,3,7,305
18840194@N02,1786,31,1218687010,1218688394,6,7,1384
18840194@N02,1786,4,1218690198,1218690198,1,7,0
18840194@N02,1787,16,1218720635,1218720635,1,1,0
18843927@N00,1788,18,1430361655,1430361655,1,1,0
18884029@N00,1789,28,1324554727,1324554727,1,4,0
18884029@N00,1789,25,1324553756,1324553763,3,4,7
18884029@N00,1789,26,1324533384,1324539408,3,4,6024
18884029@N00,1789,21,1324537339,1324540158,6,4,2819
18898819@N03,1790,26,1188091697,1188091697,1,1,0
18898819@N03,1791,25,1194919453,1194919453,1,1,0
18963732@N06,1792,20,1408091395,1408091395,1,5,0
18963732@N06,1792,15,1408102371,1408102371,1,5,0
18963732@N06,1792,19,1408107676,1408108252,2,5,576
18963732@N06,1792,6,1408103465,1408103465,1,5,0
18963732@N06,1792,1,1408091527,1408091527,1,5,0
18963732@N06,1793,25,1408157701,1408157701,1,7,0
18963732@N06,1793,27,1408154136,1408154136,1,7,0
18963732@N06,1793,13,1408157596,1408157596,1,7,0
18963732@N06,1793,3,1408157478,1408157478,1,7,0
18963732@N06,1793,24,1408142878,1408142878,1,7,0
18963732@N06,1793,18,1408167991,1408167991,1,7,0
18963732@N06,1793,14,1408168091,1408168857,2,7,766
18963732@N06,1794,30,1408244266,1408244266,1,1,0
18966792@N00,1795,29,1429269688,1429269692,2,2,4
18966792@N00,1795,6,1429272877,1429272877,1,2,0
18966792@N00,1796,29,1463191541,1463199286,2,1,7745
18991733@N00,1797,3,1340713876,1340713876,1,3,0
18991733@N00,1797,23,1340713896,1340713896,1,3,0
18991733@N00,1797,19,1340713916,1340713916,1,3,0
19017254@N03,1798,16,1462363117,1462363117,1,3,0
19017254@N03,1798,6,1462359708,1462359708,1,3,0
19017254@N03,1798,10,1462361151,1462361151,1,3,0
19026178@N00,1799,16,1191541855,1191554334,4,12,12479
19026178@N00,1799,30,1191550681,1191550681,1,12,0
19026178@N00,1799,23,1191541532,1191541532,1,12,0
19026178@N00,1799,20,1191541088,1191541088,1,12,0
19026178@N00,1799,1,1191554862,1191554862,1,12,0
19026178@N00,1799,24,1191551375,1191552031,5,12,656
19026178@N00,1799,29,1191539768,1191562371,12,12,22603
19026178@N00,1799,15,1191586063,1191586063,1,12,0
19026178@N00,1799,17,1191542861,1191542861,1,12,0
19026178@N00,1799,26,1191541591,1191585413,18,12,43822
19026178@N00,1799,12,1191542287,1191553244,3,12,10957
19026178@N00,1799,28,1191547050,1191559313,4,12,12263
19026178@N00,1800,17,1191735674,1191735674,1,1,0
19026178@N00,1801,1,1215986007,1216016847,4,4,30840
19026178@N00,1801,29,1215996599,1215996599,1,4,0
19026178@N00,1801,17,1216013694,1216013694,1,4,0
19026178@N00,1801,27,1216013626,1216013652,3,4,26
19026178@N00,1802,25,1242442136,1242456727,13,7,14591
19026178@N00,1802,14,1242452965,1242452991,2,7,26
19026178@N00,1802,13,1242443212,1242458055,3,7,14843
19026178@N00,1802,17,1242458798,1242459284,9,7,486
19026178@N00,1802,7,1242445341,1242445358,2,7,17
19026178@N00,1802,12,1242458506,1242458506,1,7,0
19026178@N00,1802,24,1242459745,1242459923,4,7,178
19026178@N00,1803,1,1272513679,1272513686,2,2,7
19026178@N00,1803,26,1272515648,1272515673,3,2,25
19026178@N00,1804,29,1340753191,1340767862,76,1,14671
19174219@N00,1805,29,1225789613,1225789714,2,1,101
19174219@N00,1806,23,1238281212,1238281212,1,2,0
19174219@N00,1806,28,1238280698,1238280698,1,2,0
19174219@N00,1807,23,1238377794,1238397290,2,1,19496
19174219@N00,1808,22,1238480765,1238480765,1,2,0
19174219@N00,1808,28,1238458914,1238458914,1,2,0
19174219@N00,1809,11,1238545304,1238545407,2,3,103
19174219@N00,1809,23,1238574514,1238574514,1,3,0
19174219@N00,1809,29,1238570306,1238570306,1,3,0
19174219@N00,1810,29,1240433638,1240433638,1,1,0
19174219@N00,1811,13,1258635827,1258636112,2,2,285
19174219@N00,1811,30,1258637518,1258637518,1,2,0
19277091@N00,1812,22,1222742005,1222751422,2,7,9417
19277091@N00,1812,21,1222758831,1222758831,1,7,0
19277091@N00,1812,14,1222743336,1222743336,1,7,0
19277091@N00,1812,19,1222738739,1222738739,1,7,0
19277091@N00,1812,29,1222740105,1222747814,2,7,7709
19277091@N00,1812,26,1222749374,1222749374,1,7,0
19277091@N00,1812,1,1222735982,1222735982,1,7,0
19286282@N00,1813,7,1355788533,1355788533,1,1,0
19291889@N00,1814,7,1370760803,1370760803,1,5,0
19291889@N00,1814,5,1370744887,1370744887,1,5,0
19291889@N00,1814,26,1370742585,1370742585,1,5,0
19291889@N00,1814,18,1370742526,1370742526,1,5,0
19291889@N00,1814,29,1370751511,1370751511,1,5,0
19291889@N00,1815,30,1402193763,1402193763,1,1,0
19302008@N00,1816,30,1403228267,1403228267,1,1,0
19302008@N00,1817,28,1435058222,1435058222,1,1,0
19302008@N00,1818,28,1435092853,1435092853,1,1,0
19302008@N00,1819,6,1435877432,1435877432,1,1,0
19302008@N00,1820,18,1436088830,1436088830,1,1,0
19329919@N00,1821,3,1226208475,1226208475,1,1,0
19329919@N00,1822,16,1226485690,1226486395,6,1,705
19329919@N00,1823,28,1226537036,1226537036,1,1,0
19329919@N00,1824,27,1289444764,1289444764,1,1,0
19329919@N00,1825,28,1289640984,1289640984,1,1,0
19387612@N00,1826,16,1359266147,1359267164,3,1,1017
19452106@N00,1827,26,1344091844,1344091844,1,3,0
19452106@N00,1827,31,1344074712,1344074712,1,3,0
19452106@N00,1827,21,1344066605,1344066605,1,3,0
19466493@N00,1828,26,1469672250,1469672431,2,2,181
19466493@N00,1828,5,1469683919,1469683919,1,2,0
19482074@N00,1829,26,1235890291,1235890291,1,1,0
19482074@N00,1830,7,1242009753,1242009753,1,1,0
19482074@N00,1831,1,1275792825,1275792825,1,1,0
19567516@N00,1832,30,1462148404,1462148404,1,13,0
19567516@N00,1832,21,1462160731,1462161959,8,13,1228
19567516@N00,1832,17,1462149976,1462149976,1,13,0
19567516@N00,1832,28,1462161848,1462186927,16,13,25079
19567516@N00,1832,20,1462169169,1462169169,1,13,0
19567516@N00,1832,22,1462148392,1462148392,1,13,0
19567516@N00,1832,23,1462149971,1462162603,7,13,12632
19567516@N00,1832,4,1462161919,1462161922,2,13,3
19567516@N00,1832,19,1462162898,1462162906,3,13,8
19567516@N00,1832,11,1462161857,1462161879,7,13,22
19567516@N00,1832,27,1462186825,1462186830,2,13,5
19567516@N00,1832,18,1462162929,1462162934,2,13,5
19567516@N00,1832,14,1462181001,1462181027,4,13,26
19575849@N00,1833,14,1375838494,1375838494,1,2,0
19575849@N00,1833,24,1375861601,1375861601,1,2,0
19575849@N00,1834,17,1395638312,1395638312,1,1,0
19601457@N00,1835,17,1299187171,1299197637,3,1,10466
19655415@N00,1836,29,1198558271,1198559652,5,8,1381
19655415@N00,1836,18,1198555604,1198556107,6,8,503
19655415@N00,1836,26,1198561131,1198588279,5,8,27148
19655415@N00,1836,31,1198576020,1198576020,1,8,0
19655415@N00,1836,17,1198580105,1198582719,4,8,2614
19655415@N00,1836,20,1198534454,1198534627,4,8,173
19655415@N00,1836,19,1198556135,1198556290,2,8,155
19655415@N00,1836,28,1198564552,1198588565,6,8,24013
19709423@N04,1837,26,1284357553,1284357600,6,2,47
19709423@N04,1837,29,1284357801,1284357812,3,2,11
19712216@N08,1838,20,1236503365,1236503371,2,4,6
19712216@N08,1838,17,1236503362,1236503362,1,4,0
19712216@N08,1838,10,1236503368,1236503374,2,4,6
19712216@N08,1838,26,1236503350,1236503364,3,4,14
19712216@N08,1839,23,1238023218,1238023218,1,6,0
19712216@N08,1839,10,1238023654,1238028083,3,6,4429
19712216@N08,1839,20,1238025069,1238026275,7,6,1206
19712216@N08,1839,19,1238023467,1238023894,4,6,427
19712216@N08,1839,31,1238027387,1238027387,1,6,0
19712216@N08,1839,5,1238029138,1238029138,1,6,0
19712216@N08,1840,10,1240034431,1240042598,23,1,8167
19712216@N08,1841,10,1240463722,1240463726,3,1,4
19712216@N08,1842,23,1243479003,1243482667,9,2,3664
19712216@N08,1842,20,1243479596,1243481251,4,2,1655
19712216@N08,1843,28,1248739190,1248739252,2,6,62
19712216@N08,1843,29,1248755350,1248755350,1,6,0
19712216@N08,1843,23,1248747991,1248747991,1,6,0
19712216@N08,1843,26,1248739023,1248739023,1,6,0
19712216@N08,1843,20,1248745469,1248747435,2,6,1966
19712216@N08,1843,3,1248753456,1248753456,1,6,0
19712216@N08,1844,18,1256780947,1256782656,8,4,1709
19712216@N08,1844,28,1256776325,1256776607,2,4,282
19712216@N08,1844,20,1256777876,1256778495,6,4,619
19712216@N08,1844,26,1256776796,1256776796,1,4,0
19712216@N08,1845,19,1270526069,1270526069,1,1,0
19712216@N08,1846,18,1281414792,1281415545,6,1,753
19712216@N08,1847,19,1288260693,1288260737,3,3,44
19712216@N08,1847,29,1288260330,1288260330,1,3,0
19712216@N08,1847,10,1288245507,1288245507,1,3,0
19712216@N08,1848,26,1295326586,1295326586,1,1,0
19714819@N00,1849,21,1423301854,1423301854,1,4,0
19714819@N00,1849,13,1423281609,1423283680,2,4,2071
19714819@N00,1849,18,1423278291,1423278291,1,4,0
19714819@N00,1849,3,1423302067,1423302067,1,4,0
19741840@N00,1850,28,1261611375,1261611375,1,1,0
19797342@N00,1851,26,1370264117,1370264117,1,1,0
19797342@N00,1852,19,1406080569,1406081345,3,1,776
19898864@N00,1853,30,1231199753,1231199753,1,2,0
19898864@N00,1853,18,1231207071,1231207071,1,2,0
19909714@N00,1854,28,1279866638,1279866638,1,5,0
19909714@N00,1854,1,1279866816,1279866816,1,5,0
19909714@N00,1854,13,1279840766,1279841616,2,5,850
19909714@N00,1854,4,1279837053,1279861421,5,5,24368
19909714@N00,1854,16,1279836482,1279836482,1,5,0
19944325@N00,1855,17,1379771984,1379771984,1,1,0
19944325@N00,1856,18,1411446335,1411446335,1,3,0
19944325@N00,1856,7,1411432048,1411432048,1,3,0
19944325@N00,1856,23,1411444219,1411444219,1,3,0
20008009@N05,1857,26,1418259440,1418274614,2,8,15174
20008009@N05,1857,17,1418282123,1418283394,2,8,1271
20008009@N05,1857,18,1418282128,1418282128,1,8,0
20008009@N05,1857,20,1418260005,1418260005,1,8,0
20008009@N05,1857,29,1418256600,1418256600,1,8,0
20008009@N05,1857,30,1418268376,1418268376,1,8,0
20008009@N05,1857,19,1418280472,1418280472,1,8,0
20008009@N05,1857,28,1418287491,1418287491,1,8,0
20009658@N00,1858,26,1232350692,1232350692,1,5,0
20009658@N00,1858,29,1232328405,1232328405,1,5,0
20009658@N00,1858,10,1232349893,1232349893,1,5,0
20009658@N00,1858,28,1232364218,1232364218,1,5,0
20009658@N00,1858,20,1232341155,1232341801,2,5,646
20009658@N00,1859,16,1232930847,1232930847,1,2,0
20009658@N00,1859,20,1232931790,1232931790,1,2,0
20021588@N00,1860,28,1449560676,1449560676,1,1,0
20075673@N04,1861,26,1332980131,1332980245,2,2,114
20075673@N04,1861,28,1332980551,1332980551,1,2,0
20121804@N05,1862,1,1433544489,1433589615,71,1,45126
20154444@N04,1863,26,1362808291,1362808291,1,1,0
20154444@N04,1864,1,1470012236,1470012236,1,1,0
20163306@N00,1865,17,1228625079,1228625242,4,4,163
20163306@N00,1865,22,1228633333,1228633587,3,4,254
20163306@N00,1865,19,1228639871,1228640099,4,4,228
20163306@N00,1865,12,1228629978,1228629978,1,4,0
20206627@N03,1866,28,1257920131,1257920131,1,1,0
20231549@N08,1867,28,1447236639,1447236639,1,1,0
20258091@N02,1868,30,1422347317,1422347317,1,1,0
20258091@N02,1869,18,1422410920,1422410920,1,1,0
20300186@N02,1870,18,1459996054,1460010650,5,1,14596
20300186@N02,1871,18,1460082055,1460082055,1,1,0
20306506@N08,1872,8,1309148108,1309148244,8,13,136
20306506@N08,1872,6,1309148860,1309148865,3,13,5
20306506@N08,1872,29,1309142383,1309145316,31,13,2933
20306506@N08,1872,20,1309142189,1309145505,20,13,3316
20306506@N08,1872,23,1309149091,1309172205,24,13,23114
20306506@N08,1872,1,1309141533,1309171928,3,13,30395
20306506@N08,1872,27,1309141456,1309141456,1,13,0
20306506@N08,1872,5,1309148246,1309148511,24,13,265
20306506@N08,1872,18,1309141487,1309141487,1,13,0
20306506@N08,1872,19,1309150261,1309150277,4,13,16
20306506@N08,1872,12,1309148119,1309148132,3,13,13
20306506@N08,1872,28,1309141451,1309141536,4,13,85
20306506@N08,1872,26,1309148906,1309181238,12,13,32332
20319059@N06,1873,29,1217238351,1217240604,47,9,2253
20319059@N06,1873,18,1217238079,1217247148,3,9,9069
20319059@N06,1873,26,1217237897,1217238008,9,9,111
20319059@N06,1873,20,1217241050,1217241417,16,9,367
20319059@N06,1873,1,1217237473,1217248279,14,9,10806
20319059@N06,1873,30,1217238273,1217238273,1,9,0
20319059@N06,1873,31,1217242098,1217244936,114,9,2838
20319059@N06,1873,23,1217238173,1217246248,3,9,8075
20319059@N06,1873,28,1217247484,1217247492,3,9,8
20319059@N06,1874,16,1217329101,1217334639,12,5,5538
20319059@N06,1874,24,1217321355,1217325390,8,5,4035
20319059@N06,1874,21,1217327555,1217328673,22,5,1118
20319059@N06,1874,26,1217334685,1217334770,3,5,85
20319059@N06,1874,12,1217325175,1217328787,4,5,3612
20319059@N06,1875,16,1217394571,1217394638,5,10,67
20319059@N06,1875,21,1217386216,1217386216,1,10,0
20319059@N06,1875,29,1217403953,1217408642,19,10,4689
20319059@N06,1875,26,1217387676,1217400745,6,10,13069
20319059@N06,1875,20,1217404216,1217404744,17,10,528
20319059@N06,1875,3,1217396014,1217396021,4,10,7
20319059@N06,1875,30,1217387427,1217387439,2,10,12
20319059@N06,1875,31,1217385385,1217386729,5,10,1344
20319059@N06,1875,22,1217386573,1217406810,6,10,20237
20319059@N06,1875,28,1217409826,1217409826,1,10,0
20319059@N06,1876,26,1218881498,1218881498,1,2,0
20319059@N06,1876,1,1218857662,1218857670,3,2,8
20319059@N06,1877,29,1221221034,1221221232,5,1,198
20319059@N06,1878,1,1221284799,1221284862,2,3,63
20319059@N06,1878,23,1221288706,1221288853,3,3,147
20319059@N06,1878,28,1221284919,1221295987,3,3,11068
20319059@N06,1879,17,1223808327,1223808327,1,10,0
20319059@N06,1879,24,1223786332,1223787649,9,10,1317
20319059@N06,1879,11,1223793477,1223793477,1,10,0
20319059@N06,1879,21,1223788098,1223788098,1,10,0
20319059@N06,1879,26,1223805467,1223806787,2,10,1320
20319059@N06,1879,12,1223788740,1223788863,4,10,123
20319059@N06,1879,20,1223795973,1223797931,5,10,1958
20319059@N06,1879,1,1223782829,1223783448,4,10,619
20319059@N06,1879,30,1223794593,1223794834,4,10,241
20319059@N06,1879,28,1223783507,1223783584,3,10,77
20319059@N06,1880,28,1225537685,1225537694,2,1,9
20319059@N06,1881,28,1227315393,1227346362,7,9,30969
20319059@N06,1881,25,1227328862,1227330012,37,9,1150
20319059@N06,1881,11,1227332959,1227333944,4,9,985
20319059@N06,1881,22,1227338807,1227339048,3,9,241
20319059@N06,1881,29,1227318081,1227341759,9,9,23678
20319059@N06,1881,21,1227331026,1227331776,32,9,750
20319059@N06,1881,30,1227336008,1227336008,1,9,0
20319059@N06,1881,14,1227340093,1227340140,3,9,47
20319059@N06,1881,26,1227342042,1227342755,5,9,713
20319059@N06,1882,28,1230373500,1230373519,2,3,19
20319059@N06,1882,1,1230369030,1230369030,1,3,0
20319059@N06,1882,26,1230373702,1230373824,2,3,122
20319059@N06,1883,30,1237010101,1237010119,3,2,18
20319059@N06,1883,26,1237014511,1237014717,7,2,206
20319059@N06,1884,14,1243678809,1243678809,1,2,0
20319059@N06,1884,28,1243677989,1243684853,6,2,6864
20319059@N06,1885,27,1243733600,1243734016,3,4,416
20319059@N06,1885,29,1243739013,1243739287,2,4,274
20319059@N06,1885,20,1243737274,1243738481,5,4,1207
20319059@N06,1885,26,1243732274,1243732274,1,4,0
20319059@N06,1886,28,1258759241,1258759241,1,2,0
20319059@N06,1886,26,1258759406,1258759565,2,2,159
20319059@N06,1887,20,1258806619,1258806619,1,1,0
20319059@N06,1888,20,1261206642,1261207579,2,1,937
20319059@N06,1889,16,1264832566,1264832566,1,2,0
20319059@N06,1889,26,1264833609,1264849046,18,2,15437
20319059@N06,1890,23,1274515958,1274515958,1,3,0
20319059@N06,1890,17,1274518462,1274518628,2,3,166
20319059@N06,1890,28,1274515969,1274524406,2,3,8437
20319059@N06,1891,9,1289637526,1289638281,4,3,755
20319059@N06,1891,28,1289632554,1289633637,4,3,1083
20319059@N06,1891,3,1289635124,1289635368,8,3,244
20319059@N06,1892,30,1312010508,1312010508,1,3,0
20319059@N06,1892,1,1312005899,1312005899,1,3,0
20319059@N06,1892,28,1312003834,1312007717,41,3,3883
20319059@N06,1893,26,1312097178,1312097178,1,1,0
20319059@N06,1894,30,1312196422,1312196422,1,4,0
20319059@N06,1894,4,1312178435,1312179510,49,4,1075
20319059@N06,1894,28,1312186460,1312186460,1,4,0
20319059@N06,1894,29,1312193677,1312193677,1,4,0
20322483@N05,1895,28,1200667431,1200679513,3,8,12082
20322483@N05,1895,23,1200653272,1200653272,1,8,0
20322483@N05,1895,18,1200663550,1200663550,1,8,0
20322483@N05,1895,20,1200657181,1200657211,2,8,30
20322483@N05,1895,26,1200660112,1200698733,4,8,38621
20322483@N05,1895,25,1200650808,1200650808,1,8,0
20322483@N05,1895,1,1200661445,1200661445,1,8,0
20322483@N05,1895,21,1200652093,1200680273,2,8,28180
20322483@N05,1896,26,1200784227,1200784227,1,4,0
20322483@N05,1896,28,1200764654,1200765282,2,4,628
20322483@N05,1896,15,1200760854,1200761002,2,4,148
20322483@N05,1896,21,1200757615,1200781524,2,4,23909
20322483@N05,1897,26,1201073892,1201073892,1,1,0
20322483@N05,1898,29,1204340162,1204340162,1,1,0
20363327@N00,1899,30,1209256711,1209256711,1,1,0
20363327@N00,1900,26,1221176907,1221200938,87,1,24031
20363327@N00,1901,26,1221303357,1221303357,1,1,0
20363327@N00,1902,26,1221347174,1221348276,15,1,1102
20363327@N00,1903,26,1221735137,1221735296,2,1,159
20363327@N00,1904,26,1230639717,1230639848,2,2,131
20363327@N00,1904,30,1230639534,1230639534,2,2,0
20363327@N00,1905,30,1291605420,1291633247,47,2,27827
20363327@N00,1905,26,1291612196,1291612196,1,2,0
20363327@N00,1906,30,1291673736,1291710871,56,1,37135
20363327@N00,1907,30,1291890725,1291892469,4,1,1744
20372999@N03,1908,28,1294632790,1294632790,1,1,0
20420206@N07,1909,10,1237348664,1237354452,9,1,5788
20420206@N07,1910,1,1301446080,1301446081,3,14,1
20420206@N07,1910,15,1301447005,1301447044,2,14,39
20420206@N07,1910,11,1301465158,1301465170,4,14,12
20420206@N07,1910,13,1301446597,1301446597,1,14,0
20420206@N07,1910,10,1301446999,1301471267,5,14,24268
20420206@N07,1910,18,1301450371,1301451112,22,14,741
20420206@N07,1910,28,1301447478,1301448529,4,14,1051
20420206@N07,1910,29,1301480792,1301480819,6,14,27
20420206@N07,1910,5,1301464340,1301464416,6,14,76
20420206@N07,1910,30,1301454857,1301454857,1,14,0
20420206@N07,1910,14,1301453573,1301453591,2,14,18
20420206@N07,1910,19,1301451186,1301451186,1,14,0
20420206@N07,1910,17,1301447313,1301447313,1,14,0
20420206@N07,1910,26,1301447230,1301473300,4,14,26070
20420206@N07,1911,1,1395277701,1395277701,1,4,0
20420206@N07,1911,13,1395317709,1395317709,1,4,0
20420206@N07,1911,7,1395279253,1395279253,1,4,0
20420206@N07,1911,30,1395292889,1395292889,1,4,0
20493744@N00,1912,19,1200707819,1200707819,1,6,0
20493744@N00,1912,28,1200725197,1200725197,1,6,0
20493744@N00,1912,18,1200707046,1200707046,1,6,0
20493744@N00,1912,26,1200728552,1200728552,1,6,0
20493744@N00,1912,17,1200718882,1200718882,1,6,0
20493744@N00,1912,16,1200727771,1200728774,2,6,1003
20493744@N00,1913,28,1230587304,1230587304,1,5,0
20493744@N00,1913,12,1230591292,1230591292,1,5,0
20493744@N00,1913,30,1230618655,1230618655,1,5,0
20493744@N00,1913,23,1230598170,1230620117,2,5,21947
20493744@N00,1913,26,1230587446,1230624217,3,5,36771
20496242@N00,1914,16,1283828053,1283828053,1,2,0
20496242@N00,1914,28,1283831976,1283831984,2,2,8
20505456@N00,1915,7,1318143867,1318143867,1,1,0
20521043@N03,1916,25,1287788942,1287788942,1,1,0
20536887@N03,1917,27,1357374138,1357374138,1,1,0
20536887@N03,1918,18,1448143504,1448146576,2,1,3072
20536887@N03,1919,18,1449304285,1449310246,3,1,5961
20544648@N06,1920,30,1310018596,1310018651,3,5,55
20544648@N06,1920,1,1310018809,1310018838,2,5,29
20544648@N06,1920,3,1310018793,1310018793,1,5,0
20544648@N06,1920,21,1310018709,1310018741,2,5,32
20544648@N06,1920,12,1310018761,1310018761,1,5,0
20544648@N06,1921,1,1333589596,1333589596,1,7,0
20544648@N06,1921,18,1333587675,1333589648,2,7,1973
20544648@N06,1921,21,1333587612,1333587612,1,7,0
20544648@N06,1921,29,1333587637,1333589552,5,7,1915
20544648@N06,1921,20,1333587856,1333589539,2,7,1683
20544648@N06,1921,12,1333587521,1333587808,3,7,287
20544648@N06,1921,26,1333587769,1333589607,3,7,1838
20544648@N06,1922,25,1377205003,1377205003,1,5,0
20544648@N06,1922,29,1377205021,1377205226,2,5,205
20544648@N06,1922,1,1377205010,1377205010,1,5,0
20544648@N06,1922,15,1377205043,1377205043,1,5,0
20544648@N06,1922,26,1377205158,1377205158,1,5,0
20544648@N06,1923,25,1389441239,1389441245,2,11,6
20544648@N06,1923,16,1389441340,1389441340,1,11,0
20544648@N06,1923,18,1389441281,1389441296,3,11,15
20544648@N06,1923,21,1389441726,1389441726,1,11,0
20544648@N06,1923,1,1389441670,1389441670,1,11,0
20544648@N06,1923,28,1389441302,1389441324,3,11,22
20544648@N06,1923,19,1389441277,1389441277,1,11,0
20544648@N06,1923,24,1389441689,1389441689,1,11,0
20544648@N06,1923,15,1389441679,1389441679,1,11,0
20544648@N06,1923,7,1389441717,1389441717,1,11,0
20544648@N06,1923,12,1389441708,1389441708,1,11,0
20544648@N06,1924,21,1389567545,1389567545,1,5,0
20544648@N06,1924,29,1389567575,1389567590,2,5,15
20544648@N06,1924,15,1389567579,1389567586,2,5,7
20544648@N06,1924,12,1389567593,1389567593,1,5,0
20544648@N06,1924,26,1389567583,1389567583,1,5,0
20558299@N07,1925,1,1447302070,1447302162,3,6,92
20558299@N07,1925,26,1447315299,1447315299,1,6,0
20558299@N07,1925,7,1447319012,1447319012,1,6,0
20558299@N07,1925,30,1447312492,1447312546,2,6,54
20558299@N07,1925,27,1447310632,1447310798,2,6,166
20558299@N07,1925,28,1447303150,1447322033,2,6,18883
20558299@N07,1926,1,1447506829,1447506829,1,1,0
20558299@N07,1927,26,1447544410,1447544410,1,2,0
20558299@N07,1927,7,1447544305,1447544305,1,2,0
20624969@N06,1928,29,1315381752,1315381763,2,5,11
20624969@N06,1928,28,1315370207,1315377244,6,5,7037
20624969@N06,1928,15,1315377427,1315377427,1,5,0
20624969@N06,1928,30,1315386257,1315386257,1,5,0
20624969@N06,1928,24,1315377317,1315377317,1,5,0
20635459@N00,1929,26,1366325549,1366325549,1,1,0
20635459@N00,1930,1,1366499276,1366499276,1,1,0
20642429@N00,1931,13,1332830994,1332830994,1,1,0
20733134@N08,1932,22,1286180130,1286180130,1,1,0
20818329@N06,1933,28,1241840960,1241841157,3,2,197
20818329@N06,1933,21,1241848919,1241849921,6,2,1002
20826856@N04,1934,1,1377826287,1377826287,1,2,0
20826856@N04,1934,24,1377826589,1377826589,1,2,0
20826856@N04,1935,1,1392596367,1392596367,1,1,0
20953529@N03,1936,17,1306301315,1306301315,1,1,0
20953529@N03,1937,28,1306443817,1306443817,1,1,0
20955720@N00,1938,16,1297552873,1297553856,2,4,983
20955720@N00,1938,15,1297552331,1297552331,1,4,0
20955720@N00,1938,17,1297552183,1297552183,1,4,0
20955720@N00,1938,25,1297557557,1297558012,2,4,455
20955720@N00,1939,26,1307837658,1307837658,1,1,0
20955720@N00,1940,28,1309062324,1309063334,3,1,1010
21035134@N07,1941,28,1311387528,1311421515,58,1,33987
21039548@N03,1942,30,1302079685,1302079685,1,1,0
21039548@N03,1943,29,1302230028,1302230028,1,1,0
21045988@N07,1944,26,1350614285,1350614285,1,1,0
21068473@N06,1945,16,1436450797,1436450797,1,1,0
21073818@N00,1946,1,1372749726,1372749726,1,2,0
21073818@N00,1946,26,1372738604,1372738604,1,2,0
21077668@N06,1947,26,1429401706,1429401706,1,3,0
21077668@N06,1947,24,1429401370,1429401370,1,3,0
21077668@N06,1947,31,1429401925,1429401925,1,3,0
21077668@N06,1948,24,1429444747,1429445005,3,1,258
21124913@N00,1949,30,1452918579,1452918579,1,1,0
21125890@N00,1950,28,1344234235,1344234235,1,1,0
21138471@N00,1951,29,1221794440,1221796131,2,4,1691
21138471@N00,1951,24,1221787149,1221802632,3,4,15483
21138471@N00,1951,26,1221796449,1221796449,1,4,0
21138471@N00,1951,28,1221801024,1221801024,1,4,0
21186435@N00,1952,26,1190019815,1190019815,1,1,0
21228638@N00,1953,1,1220246148,1220246148,1,1,0
21228638@N00,1954,3,1224240443,1224240840,2,1,397
21228638@N00,1955,1,1226917193,1226917193,1,2,0
21228638@N00,1955,28,1226916868,1226916868,1,2,0
21242794@N08,1956,13,1238915662,1238915662,1,3,0
21242794@N08,1956,22,1238925966,1238928099,4,3,2133
21242794@N08,1956,28,1238911570,1238911570,1,3,0
21276195@N08,1957,20,1201659956,1201659956,1,1,0
21313533@N02,1958,20,1355456450,1355456450,1,1,0
21313533@N02,1959,26,1402553183,1402553197,2,2,14
21313533@N02,1959,16,1402553072,1402553072,1,2,0
21313533@N02,1960,4,1414316488,1414316488,1,2,0
21313533@N02,1960,30,1414297825,1414297825,1,2,0
21313533@N02,1961,29,1416140700,1416140700,1,1,0
21313533@N02,1962,19,1416708452,1416708452,1,1,0
21313533@N02,1963,26,1433160584,1433160584,1,1,0
21327522@N04,1964,28,1196179627,1196194585,21,1,14958
21327522@N04,1965,28,1200499477,1200504961,4,1,5484
21327522@N04,1966,28,1200698682,1200698685,3,1,3
21327522@N04,1967,28,1233028831,1233028831,1,1,0
21327522@N04,1968,26,1247140863,1247167565,9,2,26702
21327522@N04,1968,25,1247149563,1247150214,7,2,651
21340539@N05,1969,29,1425609817,1425609817,1,2,0
21340539@N05,1969,16,1425612302,1425612302,1,2,0
21358387@N02,1970,28,1323503713,1323503713,1,3,0
21358387@N02,1970,3,1323491016,1323491016,1,3,0
21358387@N02,1970,13,1323492099,1323492099,1,3,0
21361610@N00,1971,28,1312838969,1312838969,1,1,0
21392083@N05,1972,7,1436590328,1436590339,2,1,11
21392573@N02,1973,30,1196836126,1196836264,2,8,138
21392573@N02,1973,26,1196827346,1196844111,5,8,16765
21392573@N02,1973,1,1196826820,1196826853,3,8,33
21392573@N02,1973,28,1196826920,1196846912,14,8,19992
21392573@N02,1973,12,1196827353,1196839453,3,8,12100
21392573@N02,1973,18,1196827226,1196827324,3,8,98
21392573@N02,1973,29,1196827837,1196834928,19,8,7091
21392573@N02,1973,25,1196842092,1196843246,13,8,1154
21393146@N07,1974,22,1269832735,1269832735,1,3,0
21393146@N07,1974,19,1269826607,1269826607,1,3,0
21393146@N07,1974,23,1269827366,1269827366,1,3,0
21394157@N04,1975,7,1270178901,1270178901,1,3,0
21394157@N04,1975,15,1270198032,1270198163,2,3,131
21394157@N04,1975,6,1270172767,1270172767,1,3,0
21407390@N00,1976,16,1287562821,1287562821,1,1,0
21407390@N00,1977,23,1376720484,1376720484,1,2,0
21407390@N00,1977,31,1376708650,1376708650,1,2,0
21419770@N07,1978,16,1255831360,1255831360,1,1,0
21419770@N07,1979,1,1256605589,1256605589,1,3,0
21419770@N07,1979,30,1256610211,1256610211,1,3,0
21419770@N07,1979,28,1256614514,1256614514,1,3,0
21435190@N00,1980,26,1296344878,1296349609,10,1,4731
21435190@N00,1981,26,1296524383,1296540273,17,1,15890
21447068@N04,1982,1,1343206986,1343206986,1,1,0
21450435@N05,1983,26,1297392003,1297392003,1,5,0
21450435@N05,1983,8,1297392187,1297392202,2,5,15
21450435@N05,1983,21,1297392355,1297392368,2,5,13
21450435@N05,1983,29,1297398112,1297398133,2,5,21
21450435@N05,1983,6,1297392177,1297392177,1,5,0
21502601@N06,1984,29,1196937955,1196953619,6,1,15664
21502601@N06,1985,29,1197019172,1197060625,8,1,41453
21502601@N06,1986,29,1197118523,1197118682,2,1,159
21502601@N06,1987,29,1197277008,1197294333,4,1,17325
21502601@N06,1988,29,1197380940,1197380940,1,1,0
21502601@N06,1989,29,1197459838,1197459838,1,1,0
21522703@N00,1990,25,1347666424,1347666424,1,1,0
21532305@N05,1991,18,1432779740,1432799083,2,2,19343
21532305@N05,1991,29,1432784103,1432784991,2,2,888
21532305@N05,1992,18,1432855427,1432855427,1,1,0
21533607@N03,1993,13,1273824771,1273824771,1,3,0
21533607@N03,1993,24,1273824318,1273824318,1,3,0
21533607@N03,1993,25,1273824120,1273824120,1,3,0
21534233@N00,1994,31,1272160274,1272160274,1,4,0
21534233@N00,1994,18,1272156513,1272156513,1,4,0
21534233@N00,1994,26,1272160017,1272166312,2,4,6295
21534233@N00,1994,29,1272160466,1272160466,1,4,0
21541710@N00,1995,4,1213488686,1213488686,1,4,0
21541710@N00,1995,29,1213493898,1213494307,8,4,409
21541710@N00,1995,3,1213487431,1213487591,3,4,160
21541710@N00,1995,11,1213488846,1213490089,6,4,1243
21541710@N00,1996,29,1213619980,1213620003,2,1,23
21541710@N00,1997,17,1214015765,1214015790,2,1,25
21541710@N00,1998,28,1229743480,1229743480,1,3,0
21541710@N00,1998,21,1229746477,1229746477,1,3,0
21541710@N00,1998,26,1229743892,1229743897,2,3,5
21541710@N00,1999,30,1235016967,1235016967,1,1,0
21591624@N00,2000,11,1373453359,1373454566,21,3,1207
21591624@N00,2000,8,1373447748,1373448742,36,3,994
21591624@N00,2000,24,1373424520,1373446347,3,3,21827
21597019@N06,2001,28,1200014706,1200014706,1,1,0
21597019@N06,2002,28,1202176377,1202183312,3,1,6935
21597019@N06,2003,28,1210313324,1210321710,4,1,8386
21597019@N06,2004,28,1212651742,1212651742,1,1,0
21597019@N06,2005,28,1225060607,1225090167,7,1,29560
21597019@N06,2006,28,1230948535,1230969611,4,1,21076
21597019@N06,2007,28,1233877960,1233908136,7,1,30176
21597019@N06,2008,28,1238886581,1238894116,3,1,7535
21597019@N06,2009,28,1243123010,1243151199,7,1,28189
21597019@N06,2010,28,1245537989,1245563576,7,1,25587
21597019@N06,2011,28,1249688433,1249718361,9,1,29928
21615035@N08,2012,1,1366543295,1366543295,1,1,0
21632110@N06,2013,25,1379207314,1379209613,3,3,2299
21632110@N06,2013,29,1379210498,1379210498,1,3,0
21632110@N06,2013,1,1379201328,1379202819,12,3,1491
21646564@N04,2014,18,1439803232,1439803232,1,1,0
21647199@N03,2015,5,1302932174,1302932269,2,2,95
21647199@N03,2015,14,1302927021,1302927021,1,2,0
21675646@N04,2016,26,1224719891,1224745426,58,1,25535
21681738@N03,2017,15,1309233027,1309233027,1,4,0
21681738@N03,2017,26,1309231207,1309231207,1,4,0
21681738@N03,2017,13,1309222699,1309222699,1,4,0
21681738@N03,2017,1,1309233538,1309233538,1,4,0
21739162@N04,2018,26,1195335777,1195338302,13,1,2525
21739162@N04,2019,1,1240970195,1240970195,1,10,0
21739162@N04,2019,4,1240980348,1240980511,3,10,163
21739162@N04,2019,21,1240979004,1240980520,3,10,1516
21739162@N04,2019,28,1240971265,1240971265,1,10,0
21739162@N04,2019,25,1240981294,1240981294,1,10,0
21739162@N04,2019,17,1240974781,1240974781,1,10,0
21739162@N04,2019,7,1240978835,1240978931,3,10,96
21739162@N04,2019,11,1240980366,1240980438,2,10,72
21739162@N04,2019,27,1240973461,1240973461,1,10,0
21739162@N04,2019,26,1240978005,1240978359,6,10,354
21739162@N04,2020,11,1255067235,1255067235,1,7,0
21739162@N04,2020,27,1255064159,1255065177,4,7,1018
21739162@N04,2020,1,1255047483,1255047639,3,7,156
21739162@N04,2020,16,1255063888,1255065444,2,7,1556
21739162@N04,2020,26,1255065905,1255076865,3,7,10960
21739162@N04,2020,9,1255066791,1255066791,1,7,0
21739162@N04,2020,28,1255071568,1255089073,3,7,17505
21743740@N03,2021,29,1417167047,1417167047,1,1,0
21743740@N03,2022,8,1440154613,1440154613,1,1,0
21745344@N04,2023,26,1260273447,1260273447,1,1,0
21747974@N04,2024,28,1345591591,1345591591,1,1,0
21748548@N00,2025,26,1280134782,1280134782,1,9,0
21748548@N00,2025,17,1280129630,1280130615,2,9,985
21748548@N00,2025,21,1280135575,1280136013,2,9,438
21748548@N00,2025,27,1280128341,1280130232,12,9,1891
21748548@N00,2025,16,1280141737,1280141737,1,9,0
21748548@N00,2025,1,1280127806,1280127806,1,9,0
21748548@N00,2025,30,1280130824,1280136118,2,9,5294
21748548@N00,2025,8,1280134690,1280134690,1,9,0
21748548@N00,2025,28,1280144093,1280144816,6,9,723
21748548@N00,2026,26,1280183857,1280183940,3,2,83
21748548@N00,2026,19,1280188532,1280194169,3,2,5637
21748548@N00,2027,20,1280275312,1280275312,1,12,0
21748548@N00,2027,17,1280277723,1280277733,3,12,10
21748548@N00,2027,13,1280294991,1280295033,2,12,42
21748548@N00,2027,14,1280287623,1280298528,6,12,10905
21748548@N00,2027,24,1280269955,1280279141,9,12,9186
21748548@N00,2027,29,1280280080,1280316393,16,12,36313
21748548@N00,2027,31,1280284806,1280284806,1,12,0
21748548@N00,2027,22,1280283767,1280285423,4,12,1656
21748548@N00,2027,30,1280289463,1280289463,1,12,0
21748548@N00,2027,23,1280300357,1280300357,1,12,0
21748548@N00,2027,15,1280272346,1280306478,4,12,34132
21748548@N00,2027,19,1280275118,1280275118,1,12,0
21748548@N00,2028,26,1280351588,1280377254,2,12,25666
21748548@N00,2028,4,1280353376,1280355962,2,12,2586
21748548@N00,2028,21,1280356119,1280358056,2,12,1937
21748548@N00,2028,31,1280386728,1280386728,1,12,0
21748548@N00,2028,3,1280354908,1280354908,1,12,0
21748548@N00,2028,29,1280384755,1280384755,1,12,0
21748548@N00,2028,11,1280356013,1280356013,1,12,0
21748548@N00,2028,5,1280353453,1280353453,1,12,0
21748548@N00,2028,23,1280376053,1280380797,3,12,4744
21748548@N00,2028,1,1280398775,1280398775,1,12,0
21748548@N00,2028,30,1280379331,1280385167,6,12,5836
21748548@N00,2028,28,1280351394,1280375046,2,12,23652
21748548@N00,2029,29,1280450295,1280450425,3,4,130
21748548@N00,2029,16,1280443032,1280443032,1,4,0
21748548@N00,2029,23,1280453531,1280453531,1,4,0
21748548@N00,2029,28,1280446739,1280446739,1,4,0
21748548@N00,2030,30,1280565234,1280565312,8,1,78
21748548@N00,2031,15,1301967740,1301967740,1,6,0
21748548@N00,2031,7,1301956274,1301956274,1,6,0
21748548@N00,2031,16,1301960741,1301960741,1,6,0
21748548@N00,2031,23,1301990597,1301990597,1,6,0
21748548@N00,2031,17,1301992689,1301992689,1,6,0
21748548@N00,2031,18,1301990575,1301990575,1,6,0
21748548@N00,2032,24,1302042840,1302042840,1,1,0
21748548@N00,2033,25,1313981170,1313981214,2,15,44
21748548@N00,2033,29,1313973945,1313973945,2,15,0
21748548@N00,2033,7,1313971405,1313971410,4,15,5
21748548@N00,2033,28,1313969113,1313992818,3,15,23705
21748548@N00,2033,27,1313990298,1313990298,2,15,0
21748548@N00,2033,16,1313990495,1313990495,2,15,0
21748548@N00,2033,26,1313968517,1313980728,45,15,12211
21748548@N00,2033,5,1313971413,1313971453,6,15,40
21748548@N00,2033,1,1313986320,1313986320,2,15,0
21748548@N00,2033,30,1313973201,1313980718,7,15,7517
21748548@N00,2033,6,1313980785,1313980785,1,15,0
21748548@N00,2033,31,1313974024,1313974024,2,15,0
21748548@N00,2033,10,1313973952,1313973952,1,15,0
21748548@N00,2033,14,1313975128,1313975128,2,15,0
21748548@N00,2033,22,1313975167,1313976553,9,15,1386
21748548@N00,2034,16,1376042064,1376042064,1,1,0
21748548@N00,2035,1,1376219634,1376219634,1,1,0
21748548@N00,2036,4,1376260309,1376260309,1,1,0
21748548@N00,2037,16,1376537183,1376537183,1,1,0
21756137@N00,2038,27,1387792668,1387792668,1,2,0
21756137@N00,2038,18,1387778621,1387778621,1,2,0
21757303@N06,2039,13,1233296752,1233296752,1,3,0
21757303@N06,2039,29,1233296755,1233296755,1,3,0
21757303@N06,2039,26,1233296753,1233296754,2,3,1
21757303@N06,2040,13,1233817845,1233817845,1,1,0
21760961@N08,2041,26,1197678370,1197706872,44,1,28502
21778462@N04,2042,17,1399501863,1399501863,1,2,0
21778462@N04,2042,1,1399501959,1399501959,1,2,0
21778462@N04,2043,1,1400721208,1400721208,1,1,0
21857090@N08,2044,14,1189348871,1189348871,1,1,0
21897757@N00,2045,3,1191716269,1191734365,2,4,18096
21897757@N00,2045,27,1191715171,1191715197,2,4,26
21897757@N00,2045,26,1191725659,1191725659,1,4,0
21897757@N00,2045,12,1191716954,1191716954,1,4,0
21897757@N00,2046,7,1226105894,1226146169,5,15,40275
21897757@N00,2046,3,1226107161,1226146219,5,15,39058
21897757@N00,2046,10,1226105068,1226105396,3,15,328
21897757@N00,2046,13,1226108196,1226116181,21,15,7985
21897757@N00,2046,29,1226099607,1226145758,6,15,46151
21897757@N00,2046,27,1226120662,1226120662,1,15,0
21897757@N00,2046,1,1226147046,1226147046,1,15,0
21897757@N00,2046,22,1226103675,1226103802,2,15,127
21897757@N00,2046,4,1226110798,1226111045,3,15,247
21897757@N00,2046,6,1226123932,1226123932,1,15,0
21897757@N00,2046,26,1226099336,1226146004,3,15,46668
21897757@N00,2046,16,1226120984,1226121372,2,15,388
21897757@N00,2046,15,1226120384,1226120384,1,15,0
21897757@N00,2046,28,1226099181,1226124671,3,15,25490
21897757@N00,2046,20,1226102128,1226142480,9,15,40352
21897757@N00,2047,3,1226216770,1226217382,4,13,612
21897757@N00,2047,29,1226192233,1226227118,4,13,34885
21897757@N00,2047,18,1226189853,1226219066,7,13,29213
21897757@N00,2047,22,1226201398,1226201398,1,13,0
21897757@N00,2047,6,1226218163,1226218163,1,13,0
21897757@N00,2047,26,1226189622,1226196045,16,13,6423
21897757@N00,2047,23,1226187859,1226189866,2,13,2007
21897757@N00,2047,28,1226187451,1226209396,6,13,21945
21897757@N00,2047,19,1226191206,1226206157,7,13,14951
21897757@N00,2047,31,1226198183,1226200054,6,13,1871
21897757@N00,2047,10,1226192767,1226206814,4,13,14047
21897757@N00,2047,30,1226193560,1226205861,6,13,12301
21897757@N00,2047,12,1226188562,1226188955,2,13,393
21897757@N00,2048,16,1226823618,1226823618,1,1,0
21897757@N00,2049,3,1241334644,1241334644,1,7,0
21897757@N00,2049,29,1241313391,1241322855,2,7,9464
21897757@N00,2049,18,1241310900,1241312400,2,7,1500
21897757@N00,2049,22,1241313870,1241313890,2,7,20
21897757@N00,2049,26,1241311140,1241320009,3,7,8869
21897757@N00,2049,23,1241311320,1241311320,1,7,0
21897757@N00,2049,19,1241311971,1241313053,6,7,1082
21897757@N00,2050,17,1265330812,1265330812,1,1,0
21897757@N00,2051,16,1265624422,1265624422,1,2,0
21897757@N00,2051,10,1265619586,1265619586,1,2,0
21897757@N00,2052,10,1284513659,1284513659,1,3,0
21897757@N00,2052,26,1284519063,1284519063,1,3,0
21897757@N00,2052,3,1284511970,1284511970,1,3,0
21897757@N00,2053,6,1285064053,1285064053,1,2,0
21897757@N00,2053,20,1285060943,1285060943,1,2,0
21897757@N00,2054,29,1298782566,1298782566,1,1,0
21897757@N00,2055,26,1317259450,1317259450,1,2,0
21897757@N00,2055,29,1317261653,1317261653,1,2,0
21897757@N00,2056,28,1320539786,1320539786,1,1,0
21897757@N00,2057,26,1327540720,1327540720,1,1,0
21897757@N00,2058,20,1349664388,1349664388,1,1,0
21897757@N00,2059,26,1355866327,1355866327,1,2,0
21897757@N00,2059,29,1355873013,1355873013,1,2,0
21897757@N00,2060,5,1359958553,1359958553,1,2,0
21897757@N00,2060,28,1359958381,1359958381,1,2,0
21899239@N04,2061,9,1443499111,1443499111,1,13,0
21899239@N04,2061,11,1443505626,1443506909,4,13,1283
21899239@N04,2061,28,1443521751,1443522566,7,13,815
21899239@N04,2061,7,1443499012,1443499030,2,13,18
21899239@N04,2061,26,1443495388,1443495393,2,13,5
21899239@N04,2061,23,1443506960,1443506960,1,13,0
21899239@N04,2061,20,1443508133,1443508133,1,13,0
21899239@N04,2061,4,1443500158,1443500332,4,13,174
21899239@N04,2061,15,1443501745,1443501745,1,13,0
21899239@N04,2061,6,1443497498,1443497501,2,13,3
21899239@N04,2061,29,1443510065,1443510067,2,13,2
21899239@N04,2061,16,1443512481,1443512482,2,13,1
21899239@N04,2061,21,1443505295,1443505347,2,13,52
21945198@N05,2062,16,1204028079,1204028079,1,1,0
21978095@N03,2063,23,1440316018,1440316018,1,1,0
21978095@N03,2064,23,1440591653,1440591653,1,1,0
21978095@N03,2065,23,1441077927,1441077927,1,1,0
21978095@N03,2066,18,1441865292,1441865292,1,1,0
21978095@N03,2067,23,1442992542,1442999824,2,1,7282
21978095@N03,2068,18,1443591674,1443591674,1,1,0
21978095@N03,2069,18,1443926545,1443926545,1,1,0
21978095@N03,2070,18,1450093087,1450093087,1,1,0
21978095@N03,2071,18,1451897516,1451897516,1,1,0
21978095@N03,2072,18,1454143523,1454143523,1,1,0
21978095@N03,2073,18,1454306330,1454306330,1,1,0
21978095@N03,2074,18,1454832250,1454832250,1,1,0
21981021@N03,2075,10,1242606098,1242608518,19,1,2420
21997370@N00,2076,1,1376756266,1376756266,1,1,0
21997370@N00,2077,12,1376795191,1376795191,1,1,0
22005296@N07,2078,10,1284292223,1284292223,1,1,0
22026393@N00,2079,26,1280320531,1280320531,1,1,0
22026393@N00,2080,25,1375181234,1375181234,1,1,0
22090021@N07,2081,15,1331264268,1331264268,1,1,0
22117934@N05,2082,1,1375670855,1375670855,1,1,0
22174377@N05,2083,16,1212300582,1212300582,1,1,0
22191840@N00,2084,17,1211876711,1211876769,9,11,58
22191840@N00,2084,26,1211868049,1211888950,11,11,20901
22191840@N00,2084,3,1211890257,1211890546,3,11,289
22191840@N00,2084,19,1211881021,1211883933,9,11,2912
22191840@N00,2084,6,1211889155,1211889969,16,11,814
22191840@N00,2084,29,1211872269,1211881015,36,11,8746
22191840@N00,2084,18,1211878015,1211880021,29,11,2006
22191840@N00,2084,16,1211851185,1211883129,40,11,31944
22191840@N00,2084,14,1211848811,1211877416,103,11,28605
22191840@N00,2084,27,1211862112,1211888549,3,11,26437
22191840@N00,2084,22,1211877503,1211877636,2,11,133
22191840@N00,2085,23,1243481093,1243481093,1,23,0
22191840@N00,2085,5,1243468509,1243468878,3,23,369
22191840@N00,2085,21,1243468426,1243468442,2,23,16
22191840@N00,2085,24,1243467299,1243502826,6,23,35527
22191840@N00,2085,17,1243466509,1243466622,3,23,113
22191840@N00,2085,26,1243470289,1243484510,22,23,14221
22191840@N00,2085,3,1243468061,1243469715,6,23,1654
22191840@N00,2085,4,1243468469,1243468469,1,23,0
22191840@N00,2085,19,1243482526,1243483030,8,23,504
22191840@N00,2085,15,1243467228,1243501989,2,23,34761
22191840@N00,2085,6,1243469313,1243469425,6,23,112
22191840@N00,2085,13,1243504552,1243505925,13,23,1373
22191840@N00,2085,18,1243478835,1243483181,2,23,4346
22191840@N00,2085,16,1243480728,1243480728,1,23,0
22191840@N00,2085,29,1243476429,1243478007,48,23,1578
22191840@N00,2085,11,1243468587,1243468587,1,23,0
22191840@N00,2085,14,1243472368,1243473103,11,23,735
22191840@N00,2085,20,1243474021,1243482828,38,23,8807
22191840@N00,2085,8,1243507587,1243507587,1,23,0
22191840@N00,2085,7,1243468653,1243470218,4,23,1565
22191840@N00,2085,22,1243471328,1243471424,3,23,96
22191840@N00,2085,30,1243471028,1243471028,1,23,0
22191840@N00,2085,12,1243467772,1243503778,3,23,36006
22191840@N00,2086,23,1301052937,1301052937,1,9,0
22191840@N00,2086,21,1301029201,1301029201,1,9,0
22191840@N00,2086,26,1301031048,1301052774,3,9,21726
22191840@N00,2086,4,1301028916,1301028986,7,9,70
22191840@N00,2086,1,1301054500,1301054500,1,9,0
22191840@N00,2086,13,1301025462,1301027610,15,9,2148
22191840@N00,2086,16,1301032583,1301032583,1,9,0
22191840@N00,2086,11,1301028989,1301029071,3,9,82
22191840@N00,2086,27,1301046535,1301046584,4,9,49
22191840@N00,2087,23,1309175034,1309175054,4,15,20
22191840@N00,2087,22,1309140209,1309143266,2,15,3057
22191840@N00,2087,17,1309149937,1309165122,9,15,15185
22191840@N00,2087,26,1309135390,1309135390,1,15,0
22191840@N00,2087,3,1309175853,1309175860,2,15,7
22191840@N00,2087,19,1309144878,1309145025,2,15,147
22191840@N00,2087,15,1309133581,1309164927,15,15,31346
22191840@N00,2087,29,1309141205,1309141205,1,15,0
22191840@N00,2087,18,1309145492,1309145948,10,15,456
22191840@N00,2087,14,1309139042,1309139355,7,15,313
22191840@N00,2087,27,1309133081,1309150047,5,15,16966
22191840@N00,2087,20,1309173016,1309174699,55,15,1683
22191840@N00,2087,31,1309141880,1309143675,15,15,1795
22191840@N00,2087,30,1309142442,1309142442,1,15,0
22191840@N00,2087,12,1309135215,1309135215,1,15,0
22191840@N00,2088,26,1321862343,1321863018,4,11,675
22191840@N00,2088,1,1321839469,1321841063,26,11,1594
22191840@N00,2088,25,1321863249,1321863342,3,11,93
22191840@N00,2088,13,1321830629,1321831614,18,11,985
22191840@N00,2088,29,1321841602,1321848547,5,11,6945
22191840@N00,2088,16,1321836713,1321836846,5,11,133
22191840@N00,2088,14,1321844794,1321859483,24,11,14689
22191840@N00,2088,20,1321841816,1321861998,68,11,20182
22191840@N00,2088,31,1321841946,1321841946,1,11,0
22191840@N00,2088,15,1321839135,1321840977,8,11,1842
22191840@N00,2088,22,1321842111,1321842579,5,11,468
22191840@N00,2089,5,1321913453,1321913470,2,13,17
22191840@N00,2089,26,1321911611,1321911698,3,13,87
22191840@N00,2089,28,1321910829,1321910837,2,13,8
22191840@N00,2089,3,1321912455,1321950939,5,13,38484
22191840@N00,2089,19,1321920591,1321922665,13,13,2074
22191840@N00,2089,1,1321925492,1321927042,42,13,1550
22191840@N00,2089,22,1321915532,1321947520,6,13,31988
22191840@N00,2089,6,1321948730,1321950057,27,13,1327
22191840@N00,2089,29,1321915357,1321957399,119,13,42042
22191840@N00,2089,14,1321917998,1321947232,44,13,29234
22191840@N00,2089,18,1321922971,1321923522,9,13,551
22191840@N00,2089,31,1321915425,1321916035,7,13,610
22191840@N00,2089,30,1321915311,1321915311,1,13,0
22191840@N00,2090,25,1332747206,1332747206,1,11,0
22191840@N00,2090,20,1332730959,1332763254,56,11,32295
22191840@N00,2090,29,1332760553,1332760744,7,11,191
22191840@N00,2090,16,1332722979,1332726475,15,11,3496
22191840@N00,2090,27,1332724009,1332724603,13,11,594
22191840@N00,2090,30,1332743856,1332743858,2,11,2
22191840@N00,2090,23,1332739315,1332739315,1,11,0
22191840@N00,2090,24,1332720200,1332753687,44,11,33487
22191840@N00,2090,17,1332747733,1332747850,16,11,117
22191840@N00,2090,28,1332718236,1332718236,1,11,0
22191840@N00,2090,19,1332727362,1332727362,1,11,0
22191840@N00,2091,22,1416562404,1416562404,1,1,0
22191840@N00,2092,16,1416742389,1416742389,1,1,0
22198509@N03,2093,26,1298157507,1298157507,1,2,0
22198509@N03,2093,13,1298164316,1298164411,2,2,95
22198509@N03,2094,28,1298194235,1298194235,1,1,0
22198509@N03,2095,16,1298252543,1298252543,1,2,0
22198509@N03,2095,28,1298252795,1298253296,3,2,501
22201281@N08,2096,28,1314264874,1314264899,6,2,25
22201281@N08,2096,10,1314264789,1314264860,14,2,71
22201281@N08,2097,12,1314445706,1314446175,44,1,469
22213891@N03,2098,26,1299411927,1299411927,1,1,0
22213891@N03,2099,26,1316256505,1316256505,1,1,0
22224184@N00,2100,1,1395820594,1395821655,3,1,1061
22232518@N05,2101,20,1196427600,1196427600,7,10,0
22232518@N05,2101,25,1196427600,1196427600,4,10,0
22232518@N05,2101,26,1196427600,1196427600,3,10,0
22232518@N05,2101,22,1196427600,1196427600,1,10,0
22232518@N05,2101,23,1196427600,1196427600,1,10,0
22232518@N05,2101,29,1196427600,1196427600,1,10,0
22232518@N05,2101,17,1196427600,1196427600,1,10,0
22232518@N05,2101,16,1196427600,1196427600,1,10,0
22232518@N05,2101,8,1196427600,1196427600,1,10,0
22232518@N05,2101,28,1196427600,1196427600,7,10,0
22232518@N05,2102,3,1271048700,1271050435,6,15,1735
22232518@N05,2102,24,1271045888,1271048012,6,15,2124
22232518@N05,2102,13,1271056928,1271064857,6,15,7929
22232518@N05,2102,25,1271053997,1271053997,1,15,0
22232518@N05,2102,4,1271051471,1271051471,1,15,0
22232518@N05,2102,26,1271029144,1271029300,3,15,156
22232518@N05,2102,8,1271050823,1271058542,8,15,7719
22232518@N05,2102,23,1271030150,1271042704,7,15,12554
22232518@N05,2102,29,1271032048,1271067806,15,15,35758
22232518@N05,2102,17,1271043055,1271053460,5,15,10405
22232518@N05,2102,1,1271059163,1271066119,2,15,6956
22232518@N05,2102,28,1271068712,1271068712,1,15,0
22232518@N05,2102,10,1271037162,1271044826,6,15,7664
22232518@N05,2102,27,1271044546,1271049886,3,15,5340
22232518@N05,2102,12,1271045190,1271045190,1,15,0
22232518@N05,2103,26,1271141000,1271148137,5,8,7137
22232518@N05,2103,22,1271147456,1271151235,6,8,3779
22232518@N05,2103,10,1271142557,1271142557,1,8,0
22232518@N05,2103,20,1271151258,1271151258,1,8,0
22232518@N05,2103,29,1271145509,1271145509,1,8,0
22232518@N05,2103,30,1271148415,1271148415,1,8,0
22232518@N05,2103,1,1271155644,1271156158,2,8,514
22232518@N05,2103,28,1271138045,1271162590,3,8,24545
22232518@N05,2104,17,1347700541,1347700761,3,2,220
22232518@N05,2104,28,1347692992,1347693557,2,2,565
22232518@N05,2105,17,1355281574,1355281574,1,3,0
22232518@N05,2105,1,1355285272,1355285272,1,3,0
22232518@N05,2105,28,1355276953,1355301940,9,3,24987
22245172@N07,2106,10,1198133062,1198133062,1,1,0
22276416@N03,2107,28,1214464639,1214464639,1,2,0
22276416@N03,2107,16,1214472258,1214472258,1,2,0
22285503@N00,2108,25,1356073200,1356073200,1,2,0
22285503@N00,2108,30,1356065198,1356065198,1,2,0
22299423@N05,2109,30,1287046123,1287048135,4,3,2012
22299423@N05,2109,18,1287050086,1287050086,1,3,0
22299423@N05,2109,10,1287046008,1287046255,4,3,247
22299423@N05,2110,29,1287194140,1287194260,3,7,120
22299423@N05,2110,28,1287196572,1287196572,1,7,0
22299423@N05,2110,16,1287196850,1287196850,1,7,0
22299423@N05,2110,24,1287187967,1287189649,2,7,1682
22299423@N05,2110,1,1287196961,1287199234,3,7,2273
22299423@N05,2110,26,1287196225,1287196411,5,7,186
22299423@N05,2110,12,1287188307,1287196119,2,7,7812
22309110@N03,2111,1,1292747724,1292747750,3,1,26
22309110@N03,2112,1,1292800180,1292800381,13,2,201
22309110@N03,2112,9,1292804402,1292804409,2,2,7
22309110@N03,2113,23,1292847678,1292847713,2,5,35
22309110@N03,2113,29,1292845662,1292847324,6,5,1662
22309110@N03,2113,19,1292847444,1292847444,1,5,0
22309110@N03,2113,20,1292846484,1292847207,16,5,723
22309110@N03,2113,28,1292847964,1292848093,2,5,129
22309110@N03,2114,28,1292901081,1292902722,6,2,1641
22309110@N03,2114,1,1292902829,1292902860,5,2,31
22309110@N03,2115,29,1297505301,1297506597,51,1,1296
22309110@N03,2116,16,1297551379,1297551502,3,2,123
22309110@N03,2116,28,1297553373,1297553424,2,2,51
22309110@N03,2117,16,1302995668,1302995668,1,6,0
22309110@N03,2117,6,1303013308,1303013541,3,6,233
22309110@N03,2117,24,1303018475,1303019394,13,6,919
22309110@N03,2117,29,1303043574,1303044883,73,6,1309
22309110@N03,2117,18,1303014945,1303017534,56,6,2589
22309110@N03,2117,31,1303038210,1303039512,32,6,1302
22309110@N03,2118,18,1303096629,1303102518,38,1,5889
22309110@N03,2119,26,1303174868,1303182958,27,1,8090
22309110@N03,2120,18,1303274256,1303275563,46,1,1307
22309110@N03,2121,28,1310027752,1310028866,60,1,1114
22309110@N03,2122,29,1310128398,1310129705,52,4,1307
22309110@N03,2122,28,1310106595,1310115579,73,4,8984
22309110@N03,2122,18,1310099757,1310101402,10,4,1645
22309110@N03,2122,25,1310105154,1310106066,56,4,912
22309110@N03,2123,29,1313670834,1313672142,58,4,1308
22309110@N03,2123,28,1313648943,1313649590,20,4,647
22309110@N03,2123,21,1313647622,1313648553,103,4,931
22309110@N03,2123,25,1313657669,1313658500,47,4,831
22309110@N03,2124,31,1313843688,1313844947,36,1,1259
22309110@N03,2125,28,1313908091,1313908694,34,2,603
22309110@N03,2125,25,1313906621,1313917708,153,2,11087
22309110@N03,2126,31,1314014699,1314017716,50,3,3017
22309110@N03,2126,16,1313993670,1313994599,100,3,929
22309110@N03,2126,25,1314003347,1314004188,46,3,841
22309110@N03,2127,16,1314058819,1314081425,78,3,22606
22309110@N03,2127,25,1314089668,1314090487,40,3,819
22309110@N03,2127,24,1314059520,1314061141,40,3,1621
22309110@N03,2128,1,1317533715,1317533994,13,2,279
22309110@N03,2128,25,1317542173,1317543035,57,2,862
22309110@N03,2129,9,1318036984,1318036984,1,7,0
22309110@N03,2129,28,1318052170,1318052625,23,7,455
22309110@N03,2129,26,1318040553,1318041013,23,7,460
22309110@N03,2129,29,1318039676,1318039795,3,7,119
22309110@N03,2129,16,1318028807,1318028836,3,7,29
22309110@N03,2129,21,1318029758,1318030786,11,7,1028
22309110@N03,2129,25,1318050547,1318061444,130,7,10897
22309110@N03,2130,30,1319200840,1319201547,16,6,707
22309110@N03,2130,25,1319180185,1319198036,101,6,17851
22309110@N03,2130,1,1319171655,1319172480,98,6,825
22309110@N03,2130,28,1319196787,1319197152,44,6,365
22309110@N03,2130,26,1319190059,1319190428,55,6,369
22309110@N03,2130,24,1319201851,1319201944,2,6,93
22309110@N03,2131,25,1319260141,1319271204,117,4,11063
22309110@N03,2131,26,1319287284,1319287353,2,4,69
22309110@N03,2131,29,1319282371,1319283686,56,4,1315
22309110@N03,2131,1,1319261867,1319262182,11,4,315
22309110@N03,2132,28,1320449794,1320464158,460,1,14364
22309110@N03,2133,25,1325401057,1325402458,46,3,1401
22309110@N03,2133,29,1325416840,1325418140,45,3,1300
22309110@N03,2133,28,1325390239,1325391495,58,3,1256
22309110@N03,2134,25,1325487409,1325488940,47,4,1531
22309110@N03,2134,28,1325476367,1325477885,72,4,1518
22309110@N03,2134,26,1325479020,1325479151,3,4,131
22309110@N03,2134,16,1325480056,1325480153,5,4,97
22309110@N03,2135,25,1325660051,1325661464,60,1,1413
22309110@N03,2136,25,1325746544,1325747959,51,2,1415
22309110@N03,2136,29,1325757808,1325759120,95,2,1312
22309110@N03,2137,29,1325844268,1325845581,66,2,1313
22309110@N03,2137,28,1325831767,1325833004,40,2,1237
22309110@N03,2138,21,1325907600,1325909025,95,4,1425
22309110@N03,2138,25,1325919374,1325920673,33,4,1299
22309110@N03,2138,24,1325900589,1325901710,24,4,1121
22309110@N03,2138,28,1325909735,1325910095,17,4,360
22309110@N03,2139,21,1325993864,1325995203,102,2,1339
22309110@N03,2139,28,1325995765,1325996348,18,2,583
22309110@N03,2140,28,1326432905,1326433383,25,3,478
22309110@N03,2140,1,1326440388,1326441392,35,3,1004
22309110@N03,2140,25,1326431186,1326432220,63,3,1034
22309110@N03,2141,28,1326612516,1326613151,45,3,635
22309110@N03,2141,1,1326605388,1326605882,21,3,494
22309110@N03,2141,25,1326603681,1326604717,75,3,1036
22309110@N03,2142,28,1327041349,1327042193,13,4,844
22309110@N03,2142,1,1327044971,1327045876,38,4,905
22309110@N03,2142,21,1327038287,1327038510,5,4,223
22309110@N03,2142,25,1327035988,1327036887,48,4,899
22309110@N03,2143,21,1327118568,1327119431,14,2,863
22309110@N03,2143,25,1327122107,1327123023,48,2,916
22309110@N03,2144,16,1327196071,1327196150,4,4,79
22309110@N03,2144,28,1327217683,1327218666,44,4,983
22309110@N03,2144,21,1327210453,1327210857,10,4,404
22309110@N03,2144,25,1327208650,1327209642,62,4,992
22309110@N03,2145,28,1327473217,1327480730,27,2,7513
22309110@N03,2145,21,1327478761,1327479768,49,2,1007
22309110@N03,2146,8,1328228766,1328228766,1,6,0
22309110@N03,2146,28,1328242717,1328251904,34,6,9187
22309110@N03,2146,1,1328243037,1328243172,11,6,135
22309110@N03,2146,3,1328242160,1328242299,6,6,139
22309110@N03,2146,26,1328242475,1328242500,4,6,25
22309110@N03,2146,25,1328245483,1328256739,70,6,11256
22309110@N03,2147,28,1328419427,1328420231,39,2,804
22309110@N03,2147,25,1328428426,1328429225,26,2,799
22309110@N03,2148,28,1329028713,1329029564,26,5,851
22309110@N03,2148,1,1329002266,1329002401,4,5,135
22309110@N03,2148,26,1329014658,1329014784,2,5,126
22309110@N03,2148,29,1329003510,1329013835,43,5,10325
22309110@N03,2148,25,1329023050,1329034086,68,5,11036
22309110@N03,2149,28,1329456548,1329457195,14,2,647
22309110@N03,2149,25,1329455100,1329466385,77,2,11285
22309110@N03,2150,25,1329637986,1329638813,20,2,827
22309110@N03,2150,28,1329629826,1329629973,20,2,147
22309110@N03,2151,29,1330127519,1330135915,66,4,8396
22309110@N03,2151,25,1330146248,1330157244,91,4,10996
22309110@N03,2151,16,1330121862,1330126586,5,4,4724
22309110@N03,2151,11,1330126995,1330126995,1,4,0
22309110@N03,2152,29,1330524182,1330525494,65,3,1312
22309110@N03,2152,25,1330515366,1330516379,24,3,1013
22309110@N03,2152,28,1330504079,1330504470,15,3,391
22309110@N03,2153,29,1330773447,1330779326,101,3,5879
22309110@N03,2153,25,1330761167,1330762086,28,3,919
22309110@N03,2153,28,1330756684,1330757527,24,3,843
22309110@N03,2154,28,1331188782,1331189542,16,1,760
22309110@N03,2155,29,1331258710,1331293106,137,4,34396
22309110@N03,2155,25,1331270056,1331280412,102,4,10356
22309110@N03,2155,26,1331257529,1331257529,1,4,0
22309110@N03,2155,28,1331273447,1331276166,12,4,2719
22309110@N03,2156,18,1331783006,1331783012,2,3,6
22309110@N03,2156,29,1331805698,1331811521,126,3,5823
22309110@N03,2156,25,1331797859,1331798722,34,3,863
22309110@N03,2157,25,1332738126,1332749219,91,2,11093
22309110@N03,2157,29,1332756125,1332757442,68,2,1317
22309110@N03,2158,29,1333278133,1333279430,28,2,1297
22309110@N03,2158,25,1333260471,1333271250,81,2,10779
22309110@N03,2159,1,1333843756,1333844540,9,4,784
22309110@N03,2159,25,1333864908,1333876248,53,4,11340
22309110@N03,2159,31,1333888384,1333889652,45,4,1268
22309110@N03,2159,16,1333838796,1333838796,1,4,0
22309110@N03,2160,31,1334406713,1334408026,36,3,1313
22309110@N03,2160,26,1334383808,1334384671,27,3,863
22309110@N03,2160,29,1334401314,1334402627,47,3,1313
22309110@N03,2161,28,1335172863,1335173781,34,1,918
22309110@N03,2162,25,1335689441,1335690386,19,2,945
22309110@N03,2162,29,1335697336,1335703980,105,2,6644
22309110@N03,2163,28,1336203503,1336204147,11,1,644
22309110@N03,2164,25,1336987401,1336988335,43,3,934
22309110@N03,2164,29,1337002329,1337003732,49,3,1403
22309110@N03,2164,1,1337005773,1337007969,41,3,2196
22309110@N03,2165,11,1337324053,1337325180,21,4,1127
22309110@N03,2165,25,1337310562,1337331945,69,4,21383
22309110@N03,2165,28,1337308545,1337327336,25,4,18791
22309110@N03,2165,29,1337343429,1337344742,39,4,1313
22309110@N03,2166,25,1338012151,1338023221,97,2,11070
22309110@N03,2166,29,1338035545,1338036846,35,2,1301
22309110@N03,2167,21,1338523276,1338523609,5,1,333
22309110@N03,2168,29,1338553037,1338554353,54,1,1316
22309110@N03,2169,25,1339059300,1339060244,39,2,944
22309110@N03,2169,29,1339071511,1339072824,38,2,1313
22309110@N03,2170,29,1340281216,1340282530,38,1,1314
22309110@N03,2171,1,1341045311,1341046281,29,1,970
22309110@N03,2172,25,1341565112,1341565980,27,1,868
22309110@N03,2173,29,1342269099,1342270413,44,2,1314
22309110@N03,2173,25,1342255992,1342256666,17,2,674
22309110@N03,2174,25,1342342341,1342343156,41,1,815
22309110@N03,2175,1,1342499410,1342499746,40,3,336
22309110@N03,2175,25,1342494146,1342494247,9,3,101
22309110@N03,2175,24,1342489407,1342490457,6,3,1050
22309110@N03,2176,29,1343133125,1343134426,35,1,1301
22309110@N03,2177,28,1343439649,1343443770,28,1,4121
22309110@N03,2178,21,1344224495,1344224549,2,1,54
22309110@N03,2179,11,1345700120,1345701239,15,1,1119
22309110@N03,2180,11,1345781491,1345782017,8,1,526
22309110@N03,2181,14,1346038952,1346039031,4,1,79
22309110@N03,2182,29,1348230897,1348232202,48,1,1305
22309110@N03,2183,18,1348891469,1348892245,29,2,776
22309110@N03,2183,28,1348894677,1348895458,38,2,781
22309110@N03,2184,1,1349422567,1349423499,64,4,932
22309110@N03,2184,25,1349441402,1349441755,13,4,353
22309110@N03,2184,28,1349434173,1349434565,14,4,392
22309110@N03,2184,29,1349430900,1349431122,15,4,222
22309110@N03,2185,7,1350165584,1350165626,3,6,42
22309110@N03,2185,26,1350164692,1350164824,6,6,132
22309110@N03,2185,21,1350165149,1350165317,12,6,168
22309110@N03,2185,11,1350165825,1350165831,3,6,6
22309110@N03,2185,28,1350164172,1350164585,10,6,413
22309110@N03,2185,29,1350166377,1350166451,3,6,74
22309110@N03,2186,25,1350639306,1350639761,14,3,455
22309110@N03,2186,15,1350652377,1350652380,2,3,3
22309110@N03,2186,28,1350646466,1350646947,16,3,481
22309110@N03,2187,1,1351903373,1351911195,81,4,7822
22309110@N03,2187,25,1351899382,1351899561,10,4,179
22309110@N03,2187,16,1351902220,1351902260,5,4,40
22309110@N03,2187,28,1351899951,1351903175,58,4,3224
22309110@N03,2188,21,1353048745,1353049989,31,2,1244
22309110@N03,2188,28,1353039574,1353041277,55,2,1703
22309110@N03,2189,28,1353644282,1353645586,28,1,1304
22309110@N03,2190,11,1354681145,1354684177,17,1,3032
22309110@N03,2191,29,1355047340,1355054048,67,1,6708
22309110@N03,2192,1,1356150186,1356151682,39,2,1496
22309110@N03,2192,21,1356145479,1356145569,6,2,90
22309110@N03,2193,28,1356668617,1356669803,25,1,1186
22309110@N03,2194,30,1357873412,1357874653,24,1,1241
22309110@N03,2195,29,1358643622,1358643887,8,1,265
22309110@N03,2196,30,1359083027,1359084277,26,3,1250
22309110@N03,2196,29,1359075727,1359076324,18,3,597
22309110@N03,2196,1,1359093659,1359095669,6,3,2010
22309110@N03,2197,30,1359781301,1359782603,36,2,1302
22309110@N03,2197,29,1359783268,1359783852,15,2,584
22309110@N03,2198,29,1360458007,1360460205,16,2,2198
22309110@N03,2198,25,1360472660,1360473490,13,2,830
22309110@N03,2199,29,1360815916,1360815925,3,2,9
22309110@N03,2199,21,1360818330,1360819449,11,2,1119
22309110@N03,2200,29,1361095315,1361102030,66,1,6715
22309110@N03,2201,29,1361700115,1361706826,65,2,6711
22309110@N03,2201,1,1361690028,1361690038,2,2,10
22309110@N03,2202,29,1362915126,1362916429,42,1,1303
22309110@N03,2203,26,1363915030,1363916170,36,1,1140
22309110@N03,2204,29,1364292099,1364298796,49,1,6697
22309110@N03,2205,29,1364556786,1364558011,9,2,1225
22309110@N03,2205,25,1364543853,1364544765,15,2,912
22309110@N03,2206,28,1364610757,1364610771,4,1,14
22309110@N03,2207,1,1365323508,1365324462,24,2,954
22309110@N03,2207,26,1365296842,1365311939,15,2,15097
22309110@N03,2208,1,1365927594,1365931410,16,1,3816
22309110@N03,2209,29,1369479738,1369486418,55,1,6680
22309110@N03,2210,29,1371467006,1371473645,37,1,6639
22309110@N03,2211,29,1372158150,1372164869,63,1,6719
22309110@N03,2212,29,1372849353,1372856081,84,2,6728
22309110@N03,2212,1,1372840525,1372841534,36,2,1009
22309110@N03,2213,1,1372930250,1372930258,3,1,8
22309110@N03,2214,29,1373972570,1373979262,45,2,6692
22309110@N03,2214,1,1373964263,1373964310,3,2,47
22309110@N03,2215,28,1374035594,1374035876,17,5,282
22309110@N03,2215,20,1374026893,1374026981,4,5,88
22309110@N03,2215,14,1374025215,1374041541,14,5,16326
22309110@N03,2215,29,1374030704,1374065620,54,5,34916
22309110@N03,2215,1,1374027656,1374027799,4,5,143
22309110@N03,2216,29,1374583326,1374584018,9,2,692
22309110@N03,2216,1,1374569097,1374569619,5,2,522
22309110@N03,2217,28,1375519200,1375520038,7,3,838
22309110@N03,2217,29,1375527794,1375534493,43,3,6699
22309110@N03,2217,1,1375517034,1375538616,7,3,21582
22309110@N03,2218,29,1376305391,1376306680,32,1,1289
22309110@N03,2219,28,1376382960,1376384003,14,1,1043
22309110@N03,2220,1,1376815698,1376815777,2,1,79
22309110@N03,2221,29,1376997770,1377003279,35,1,5509
22309110@N03,2222,28,1377593110,1377593486,8,1,376
22309110@N03,2223,1,1377762598,1377777646,17,1,15048
22309110@N03,2224,29,1377860576,1377867241,76,1,6665
22309110@N03,2225,29,1380371578,1380372764,12,1,1186
22309110@N03,2226,21,1381609034,1381609575,27,4,541
22309110@N03,2226,24,1381609822,1381609936,6,4,114
22309110@N03,2226,11,1381608571,1381608571,1,4,0
22309110@N03,2226,28,1381607731,1381607757,4,4,26
22309110@N03,2227,14,1382705376,1382705376,1,5,0
22309110@N03,2227,1,1382694538,1382701181,73,5,6643
22309110@N03,2227,13,1382686246,1382689490,16,5,3244
22309110@N03,2227,26,1382664116,1382664987,9,5,871
22309110@N03,2227,25,1382693664,1382702010,42,5,8346
22309110@N03,2228,1,1384054478,1384054480,2,3,2
22309110@N03,2228,16,1384038125,1384046671,21,3,8546
22309110@N03,2228,28,1384040383,1384054500,166,3,14117
22309110@N03,2229,1,1384672580,1384672592,4,2,12
22309110@N03,2229,28,1384660505,1384671595,34,2,11090
22309110@N03,2230,28,1385448203,1385449112,24,4,909
22309110@N03,2230,25,1385449881,1385450532,16,4,651
22309110@N03,2230,29,1385460230,1385466902,104,4,6672
22309110@N03,2230,21,1385449652,1385449730,6,4,78
22309110@N03,2231,26,1387936245,1387937224,19,2,979
22309110@N03,2231,29,1387965957,1387976056,94,2,10099
22309110@N03,2232,26,1388707675,1388728232,67,2,20557
22309110@N03,2232,21,1388720198,1388721465,22,2,1267
22309110@N03,2233,1,1390022844,1390023863,25,3,1019
22309110@N03,2233,26,1390027797,1390028805,15,3,1008
22309110@N03,2233,25,1390032034,1390032069,2,3,35
22309110@N03,2234,1,1391240054,1391241010,16,1,956
22309110@N03,2235,25,1392528043,1392528043,1,1,0
22309110@N03,2236,29,1393149827,1393156547,92,1,6720
22309110@N03,2237,29,1394355832,1394362539,67,1,6707
22309110@N03,2238,29,1397127837,1397134517,50,1,6680
22309110@N03,2239,29,1399115061,1399121749,57,1,6688
22309110@N03,2240,29,1404904098,1404910550,46,1,6452
22309110@N03,2241,28,1405586500,1405587223,11,4,723
22309110@N03,2241,29,1405595365,1405601788,53,4,6423
22309110@N03,2241,21,1405577251,1405578191,18,4,940
22309110@N03,2241,1,1405555920,1405556380,11,4,460
22309110@N03,2242,25,1405673717,1405674455,13,2,738
22309110@N03,2242,28,1405677894,1405677894,1,2,0
22309110@N03,2243,25,1406182401,1406182401,1,1,0
22309110@N03,2244,29,1406632087,1406633180,24,1,1093
22309110@N03,2245,28,1406960609,1406961417,14,2,808
22309110@N03,2245,29,1406977525,1406984182,64,2,6657
22309110@N03,2246,28,1407825324,1407833828,22,1,8504
22309110@N03,2247,28,1408170517,1408179219,24,2,8702
22309110@N03,2247,29,1408187619,1408193809,26,2,6190
22309110@N03,2248,28,1408343640,1408344008,8,1,368
22309110@N03,2249,28,1408862440,1408870449,32,2,8009
22309110@N03,2249,29,1408878308,1408884886,45,2,6578
22309110@N03,2250,29,1409315692,1409317009,19,3,1317
22309110@N03,2250,28,1409293629,1409302596,20,3,8967
22309110@N03,2250,26,1409279160,1409290907,20,3,11747
22309110@N03,2251,28,1411807236,1411808122,7,2,886
22309110@N03,2251,25,1411797991,1411798807,7,2,816
22309110@N03,2252,21,1413060769,1413091202,16,3,30433
22309110@N03,2252,11,1413059460,1413059460,1,3,0
22309110@N03,2252,7,1413059766,1413069874,29,3,10108
22309110@N03,2253,21,1413538607,1413539062,21,4,455
22309110@N03,2253,28,1413539395,1413546551,38,4,7156
22309110@N03,2253,25,1413547218,1413547533,24,4,315
22309110@N03,2253,1,1413550615,1413550925,17,4,310
22309110@N03,2254,26,1414647732,1414648847,16,1,1115
22309110@N03,2255,28,1415506815,1415512759,19,2,5944
22309110@N03,2255,25,1415517837,1415517953,2,2,116
22309110@N03,2256,29,1416569531,1416570821,28,3,1290
22309110@N03,2256,28,1416543614,1416544798,7,3,1184
22309110@N03,2256,26,1416546693,1416546790,3,3,97
22309110@N03,2257,29,1417773802,1417780322,54,3,6520
22309110@N03,2257,21,1417752464,1417753737,22,3,1273
22309110@N03,2257,25,1417763010,1417764416,27,3,1406
22309110@N03,2258,29,1417860163,1417866890,56,1,6727
22309110@N03,2259,29,1417946601,1417953227,102,1,6626
22309110@N03,2260,28,1420344988,1420346139,18,2,1151
22309110@N03,2260,1,1420353998,1420355361,8,2,1363
22309110@N03,2261,26,1420863439,1420864812,35,2,1373
22309110@N03,2261,21,1420866368,1420866399,4,2,31
22309110@N03,2262,28,1424410008,1424410703,9,3,695
22309110@N03,2262,21,1424408245,1424418960,19,3,10715
22309110@N03,2262,1,1424409976,1424418334,8,3,8358
22309110@N03,2263,29,1426759807,1426766973,42,1,7166
22311697@N06,2264,16,1445130844,1445130844,1,4,0
22311697@N06,2264,4,1445128905,1445128905,1,4,0
22311697@N06,2264,26,1445126523,1445126523,1,4,0
22311697@N06,2264,30,1445145741,1445145741,1,4,0
22316898@N07,2265,28,1446376886,1446377133,6,4,247
22316898@N07,2265,1,1446376708,1446376708,1,4,0
22316898@N07,2265,16,1446377668,1446377723,2,4,55
22316898@N07,2265,3,1446377973,1446378466,2,4,493
22316898@N07,2266,28,1447373942,1447373952,5,9,10
22316898@N07,2266,14,1447373913,1447373953,11,9,40
22316898@N07,2266,29,1447373911,1447373912,6,9,1
22316898@N07,2266,25,1447373951,1447373951,2,9,0
22316898@N07,2266,13,1447373914,1447373952,11,9,38
22316898@N07,2266,15,1447373952,1447373952,2,9,0
22316898@N07,2266,24,1447373951,1447373951,1,9,0
22316898@N07,2266,20,1447373953,1447373953,3,9,0
22316898@N07,2266,31,1447373912,1447373912,1,9,0
22325101@N00,2267,31,1218722641,1218722641,1,6,0
22325101@N00,2267,26,1218723241,1218723241,1,6,0
22325101@N00,2267,16,1218722401,1218722401,1,6,0
22325101@N00,2267,18,1218722461,1218722521,2,6,60
22325101@N00,2267,13,1218723121,1218723181,2,6,60
22325101@N00,2267,29,1218722581,1218722581,1,6,0
22342760@N05,2268,18,1440880394,1440880394,1,1,0
22342760@N05,2269,18,1440940685,1440940685,1,1,0
22356039@N00,2270,3,1344176180,1344176180,1,1,0
22362762@N00,2271,19,1402800906,1402800906,1,1,0
22364250@N00,2272,13,1213228554,1213228554,1,1,0
22369752@N08,2273,30,1421470306,1421470306,1,1,0
22386927@N05,2274,28,1273281366,1273281366,1,1,0
22426268@N04,2275,10,1224885690,1224885690,1,1,0
22456113@N00,2276,10,1231656237,1231657100,2,9,863
22456113@N00,2276,30,1231653632,1231653729,3,9,97
22456113@N00,2276,14,1231658955,1231665267,3,9,6312
22456113@N00,2276,26,1231657807,1231657807,1,9,0
22456113@N00,2276,29,1231663878,1231664246,7,9,368
22456113@N00,2276,17,1231632990,1231660172,7,9,27182
22456113@N00,2276,11,1231662600,1231662600,1,9,0
22456113@N00,2276,28,1231658517,1231674809,2,9,16292
22456113@N00,2276,22,1231665529,1231665529,1,9,0
22472042@N02,2277,8,1365590452,1365590452,1,1,0
22499205@N00,2278,18,1427159966,1427159966,1,1,0
22519766@N03,2279,21,1339054359,1339054370,4,13,11
22519766@N03,2279,19,1339048926,1339048995,2,13,69
22519766@N03,2279,25,1339038543,1339039019,77,13,476
22519766@N03,2279,18,1339048916,1339048916,2,13,0
22519766@N03,2279,13,1339042147,1339042400,7,13,253
22519766@N03,2279,10,1339053432,1339053437,3,13,5
22519766@N03,2279,3,1339043125,1339043205,18,13,80
22519766@N03,2279,20,1339041893,1339041904,14,13,11
22519766@N03,2279,15,1339033202,1339054993,9,13,21791
22519766@N03,2279,9,1339044080,1339044080,3,13,0
22519766@N03,2279,31,1339050390,1339050390,1,13,0
22519766@N03,2279,11,1339043847,1339054982,8,13,11135
22519766@N03,2279,22,1339042287,1339042287,1,13,0
22548746@N07,2280,16,1349488414,1349489436,5,3,1022
22548746@N07,2280,26,1349487311,1349487311,1,3,0
22548746@N07,2280,27,1349487520,1349487523,2,3,3
22551995@N08,2281,20,1367730045,1367730045,1,1,0
22560305@N06,2282,30,1200462108,1200462108,1,1,0
22560305@N06,2283,12,1224362345,1224362345,1,1,0
22569657@N07,2284,4,1364526208,1364526287,2,1,79
22576224@N08,2285,14,1347626369,1347626408,2,11,39
22576224@N08,2285,31,1347625042,1347629651,15,11,4609
22576224@N08,2285,29,1347626755,1347626919,4,11,164
22576224@N08,2285,20,1347625175,1347626699,5,11,1524
22576224@N08,2285,27,1347633641,1347635838,6,11,2197
22576224@N08,2285,1,1347624277,1347624322,4,11,45
22576224@N08,2285,22,1347625257,1347626483,5,11,1226
22576224@N08,2285,19,1347630982,1347631354,17,11,372
22576224@N08,2285,28,1347624731,1347624736,2,11,5
22576224@N08,2285,23,1347624911,1347631680,11,11,6769
22576224@N08,2285,16,1347624826,1347633798,7,11,8972
22576224@N08,2286,29,1356713501,1356726800,8,9,13299
22576224@N08,2286,30,1356713274,1356713274,1,9,0
22576224@N08,2286,26,1356731678,1356731678,1,9,0
22576224@N08,2286,28,1356720956,1356721606,7,9,650
22576224@N08,2286,21,1356729425,1356729522,3,9,97
22576224@N08,2286,23,1356717875,1356718316,2,9,441
22576224@N08,2286,1,1356712307,1356712317,3,9,10
22576224@N08,2286,16,1356729527,1356731494,6,9,1967
22576224@N08,2286,10,1356729133,1356729133,1,9,0
22576224@N08,2287,21,1356798040,1356799327,22,4,1287
22576224@N08,2287,23,1356793939,1356794425,17,4,486
22576224@N08,2287,27,1356799370,1356801102,18,4,1732
22576224@N08,2287,16,1356808586,1356811856,21,4,3270
22606730@N08,2288,12,1225486239,1225486239,1,1,0
22620178@N02,2289,19,1403604104,1403604104,1,1,0
22623063@N00,2290,17,1358039699,1358039699,1,2,0
22623063@N00,2290,27,1358031085,1358031085,1,2,0
22625471@N08,2291,26,1206083310,1206083310,1,1,0
22648301@N07,2292,1,1235373017,1235373185,2,1,168
22672393@N08,2293,16,1366268584,1366268584,1,1,0
22688581@N06,2294,13,1361927156,1361927156,1,1,0
22695386@N07,2295,17,1429876510,1429876510,1,1,0
22695386@N07,2296,26,1431252680,1431252680,1,1,0
22696986@N08,2297,25,1276149185,1276149185,1,1,0
22713429@N00,2298,17,1328437186,1328439338,2,2,2152
22713429@N00,2298,14,1328441891,1328441891,1,2,0
22713429@N00,2299,27,1330251063,1330251063,1,1,0
22721767@N08,2300,30,1428312973,1428312973,1,1,0
22729779@N04,2301,7,1357469037,1357469037,1,2,0
22729779@N04,2301,21,1357470954,1357471137,2,2,183
22729779@N04,2302,22,1357641855,1357642155,4,12,300
22729779@N04,2302,7,1357650771,1357650771,1,12,0
22729779@N04,2302,17,1357617613,1357617613,1,12,0
22729779@N04,2302,21,1357623620,1357627407,3,12,3787
22729779@N04,2302,1,1357616653,1357616915,6,12,262
22729779@N04,2302,25,1357621617,1357621934,3,12,317
22729779@N04,2302,28,1357616834,1357629658,6,12,12824
22729779@N04,2302,15,1357633799,1357634082,2,12,283
22729779@N04,2302,27,1357617553,1357617553,1,12,0
22729779@N04,2302,13,1357643329,1357643329,1,12,0
22729779@N04,2302,26,1357600289,1357629403,6,12,29114
22729779@N04,2302,24,1357625412,1357626661,9,12,1249
22733375@N04,2303,10,1238219813,1238221488,6,1,1675
22733375@N04,2304,10,1238367063,1238373408,3,1,6345
22733375@N04,2305,10,1238470718,1238470718,1,1,0
22751315@N05,2306,26,1400492082,1400492082,1,1,0
22774022@N07,2307,16,1227152661,1227152661,1,2,0
22774022@N07,2307,26,1227151333,1227151419,3,2,86
22774022@N07,2308,16,1237424621,1237424655,2,4,34
22774022@N07,2308,31,1237423750,1237423750,1,4,0
22774022@N07,2308,21,1237425278,1237425278,1,4,0
22774022@N07,2308,26,1237422380,1237422959,3,4,579
22789128@N00,2309,25,1200725555,1200725555,1,1,0
22789621@N02,2310,1,1247797099,1247797099,1,6,0
22789621@N02,2310,24,1247786749,1247786749,1,6,0
22789621@N02,2310,15,1247802762,1247802784,2,6,22
22789621@N02,2310,23,1247814689,1247814689,1,6,0
22789621@N02,2310,18,1247798126,1247798126,1,6,0
22789621@N02,2310,16,1247800683,1247800824,3,6,141
22809375@N06,2311,16,1224309200,1224309200,1,4,0
22809375@N06,2311,10,1224309224,1224309224,1,4,0
22809375@N06,2311,9,1224316763,1224326062,3,4,9299
22809375@N06,2311,21,1224326083,1224326159,3,4,76
22826842@N04,2312,26,1265595572,1265595572,1,1,0
22826842@N04,2313,13,1291952974,1291952974,1,1,0
22826842@N04,2314,26,1292114698,1292114698,1,1,0
22826842@N04,2315,7,1293849788,1293849788,1,1,0
22826842@N04,2316,12,1294450049,1294450049,1,1,0
22826842@N04,2317,27,1357851350,1357851350,1,1,0
22826842@N04,2318,31,1389275694,1389275739,3,1,45
22858034@N08,2319,15,1321866451,1321881563,2,9,15112
22858034@N08,2319,25,1321879428,1321880390,2,9,962
22858034@N08,2319,30,1321857959,1321857959,1,9,0
22858034@N08,2319,16,1321884641,1321884641,1,9,0
22858034@N08,2319,1,1321848108,1321848108,1,9,0
22858034@N08,2319,17,1321874173,1321876510,2,9,2337
22858034@N08,2319,26,1321874066,1321884448,2,9,10382
22858034@N08,2319,21,1321880550,1321880550,1,9,0
22858034@N08,2319,28,1321850693,1321850693,1,9,0
22868474@N07,2320,12,1312156781,1312156781,1,1,0
22872338@N03,2321,22,1210934618,1210934618,1,1,0
22884086@N03,2322,25,1260049503,1260049503,1,2,0
22884086@N03,2322,26,1260046902,1260046902,1,2,0
22890516@N03,2323,15,1366413076,1366413076,1,1,0
22890555@N06,2324,1,1383017567,1383017567,1,1,0
22890555@N06,2325,29,1392704429,1392704429,1,1,0
22890555@N06,2326,30,1396444313,1396444313,1,1,0
22892300@N05,2327,15,1276860844,1276860981,11,5,137
22892300@N05,2327,12,1276855274,1276864651,9,5,9377
22892300@N05,2327,26,1276861498,1276861515,3,5,17
22892300@N05,2327,27,1276861308,1276861308,1,5,0
22892300@N05,2327,28,1276855027,1276855027,1,5,0
22909555@N04,2328,18,1330217412,1330217412,1,2,0
22909555@N04,2328,27,1330215355,1330215355,1,2,0
22918179@N08,2329,4,1208042219,1208042219,1,9,0
22918179@N08,2329,23,1208051687,1208051714,2,9,27
22918179@N08,2329,26,1208041389,1208041389,1,9,0
22918179@N08,2329,1,1208040920,1208040930,2,9,10
22918179@N08,2329,29,1208052024,1208052858,6,9,834
22918179@N08,2329,28,1208041007,1208041053,4,9,46
22918179@N08,2329,12,1208043616,1208043870,3,9,254
22918179@N08,2329,6,1208041520,1208041520,1,9,0
22918179@N08,2329,3,1208048604,1208048604,1,9,0
22918179@N08,2330,16,1208136108,1208144121,6,6,8013
22918179@N08,2330,13,1208145888,1208150863,12,6,4975
22918179@N08,2330,24,1208128489,1208129283,7,6,794
22918179@N08,2330,27,1208135389,1208135389,1,6,0
22918179@N08,2330,17,1208130315,1208134426,6,6,4111
22918179@N08,2330,25,1208145509,1208145509,1,6,0
22918179@N08,2331,3,1208315522,1208316550,4,6,1028
22918179@N08,2331,28,1208318057,1208318057,1,6,0
22918179@N08,2331,27,1208317659,1208317659,1,6,0
22918179@N08,2331,22,1208312797,1208312797,1,6,0
22918179@N08,2331,31,1208308388,1208309455,4,6,1067
22918179@N08,2331,26,1208317562,1208317562,1,6,0
22918179@N08,2332,21,1208404365,1208404365,1,14,0
22918179@N08,2332,29,1208409320,1208434373,16,14,25053
22918179@N08,2332,16,1208390628,1208391312,4,14,684
22918179@N08,2332,3,1208428747,1208428747,1,14,0
22918179@N08,2332,24,1208393724,1208393976,3,14,252
22918179@N08,2332,28,1208396027,1208396027,1,14,0
22918179@N08,2332,27,1208412530,1208412969,4,14,439
22918179@N08,2332,17,1208394604,1208394604,1,14,0
22918179@N08,2332,5,1208417107,1208418477,4,14,1370
22918179@N08,2332,23,1208404723,1208404723,1,14,0
22918179@N08,2332,22,1208423988,1208424377,6,14,389
22918179@N08,2332,18,1208411565,1208411802,3,14,237
22918179@N08,2332,4,1208416736,1208416823,3,14,87
22918179@N08,2332,26,1208425666,1208425666,1,14,0
22918179@N08,2333,28,1208508018,1208508596,14,1,578
22925214@N04,2334,26,1200808496,1200808514,9,1,18
22929347@N07,2335,27,1395531941,1395531941,1,1,0
22935007@N08,2336,28,1246460274,1246460274,1,1,0
22937808@N04,2337,23,1408800965,1408800965,1,1,0
22937808@N04,2338,28,1410617788,1410617788,1,2,0
22937808@N04,2338,21,1410615234,1410615234,1,2,0
22937808@N04,2339,28,1411829834,1411829834,1,1,0
22937808@N04,2340,28,1417183555,1417183555,1,1,0
22937808@N04,2341,11,1418127260,1418127260,1,1,0
22937808@N04,2342,26,1420118921,1420119407,2,1,486
22937808@N04,2343,21,1426252462,1426252462,1,2,0
22937808@N04,2343,26,1426254211,1426254211,1,2,0
22937808@N04,2344,28,1427637351,1427637351,1,2,0
22937808@N04,2344,26,1427635850,1427636431,2,2,581
22937808@N04,2345,12,1432331508,1432331508,1,3,0
22937808@N04,2345,29,1432335401,1432335706,2,3,305
22937808@N04,2345,26,1432332760,1432332760,1,3,0
22937808@N04,2346,20,1435929091,1435929091,1,2,0
22937808@N04,2346,26,1435923571,1435923991,2,2,420
22937808@N04,2347,20,1439040782,1439040782,1,2,0
22937808@N04,2347,21,1439043770,1439043770,1,2,0
22937808@N04,2348,21,1442667872,1442667872,1,2,0
22937808@N04,2348,16,1442673217,1442673217,1,2,0
22937808@N04,2349,24,1444473621,1444473713,2,1,92
22937808@N04,2350,26,1448538229,1448538229,1,2,0
22937808@N04,2350,6,1448536748,1448536748,1,2,0
22937808@N04,2351,28,1451131276,1451131276,1,1,0
22937808@N04,2352,28,1465657935,1465657935,1,1,0
22937808@N04,2353,21,1469273481,1469273481,1,1,0
22937808@N04,2354,1,1471100469,1471100469,1,2,0
22937808@N04,2354,26,1471098776,1471098776,1,2,0
22937808@N04,2355,20,1471585425,1471585425,1,1,0
22938314@N08,2356,28,1242392444,1242395389,4,2,2945
22938314@N08,2356,14,1242392559,1242392669,2,2,110
22938314@N08,2357,28,1244203797,1244203797,1,1,0
22938314@N08,2358,16,1246264714,1246264714,1,1,0
22938314@N08,2359,28,1246872946,1246872946,1,2,0
22938314@N08,2359,21,1246877393,1246877439,6,2,46
22938314@N08,2360,29,1247487158,1247487158,1,1,0
22957560@N05,2361,28,1319350528,1319350528,1,1,0
23004611@N00,2362,19,1416317002,1416317002,1,1,0
23032267@N00,2363,24,1298691717,1298691717,1,2,0
23032267@N00,2363,29,1298699117,1298699117,1,2,0
23032267@N00,2364,29,1299911815,1299911815,1,1,0
23036476@N00,2365,23,1229378840,1229378840,1,2,0
23036476@N00,2365,18,1229378938,1229378938,1,2,0
23036476@N00,2366,16,1229469558,1229469558,1,1,0
23036476@N00,2367,31,1229549659,1229549677,2,2,18
23036476@N00,2367,23,1229549916,1229549916,1,2,0
23036476@N00,2368,13,1229642722,1229642722,1,1,0
23049720@N00,2369,18,1446771677,1446771722,2,1,45
23065916@N04,2370,26,1238040304,1238040304,1,2,0
23065916@N04,2370,15,1238038100,1238038100,1,2,0
23065916@N04,2371,26,1238153826,1238153826,1,1,0
23065916@N04,2372,30,1274865427,1274865427,1,2,0
23065916@N04,2372,20,1274864925,1274865162,2,2,237
23065916@N04,2373,23,1274952219,1274952219,1,1,0
23065916@N04,2374,18,1275021333,1275021333,1,1,0
23065916@N04,2375,26,1298162844,1298162844,1,2,0
23065916@N04,2375,1,1298155155,1298155155,1,2,0
23065916@N04,2376,26,1323512357,1323512357,1,1,0
23065916@N04,2377,26,1323592870,1323592870,1,2,0
23065916@N04,2377,28,1323573818,1323573818,1,2,0
23065916@N04,2378,26,1354757894,1354757894,1,1,0
23089307@N02,2379,16,1357031342,1357031342,1,14,0
23089307@N02,2379,29,1357017026,1357028252,5,14,11226
23089307@N02,2379,17,1357001455,1357002067,2,14,612
23089307@N02,2379,22,1357018448,1357018512,2,14,64
23089307@N02,2379,6,1356996921,1356997239,2,14,318
23089307@N02,2379,15,1356999017,1357003029,9,14,4012
23089307@N02,2379,31,1357018035,1357018647,4,14,612
23089307@N02,2379,24,1356998937,1357031024,4,14,32087
23089307@N02,2379,26,1357029210,1357029210,1,14,0
23089307@N02,2379,28,1357031545,1357031545,1,14,0
23089307@N02,2379,21,1357004438,1357004449,2,14,11
23089307@N02,2379,1,1357031676,1357032315,5,14,639
23089307@N02,2379,7,1356997071,1356997071,1,14,0
23089307@N02,2379,25,1357004984,1357005659,11,14,675
23089307@N02,2380,1,1357098576,1357098576,1,1,0
23097875@N00,2381,28,1286771179,1286771179,1,7,0
23097875@N00,2381,1,1286773088,1286773101,2,7,13
23097875@N00,2381,17,1286770510,1286770510,1,7,0
23097875@N00,2381,26,1286754228,1286772295,2,7,18067
23097875@N00,2381,25,1286779798,1286781293,5,7,1495
23097875@N00,2381,16,1286751630,1286751630,1,7,0
23097875@N00,2381,15,1286753652,1286753652,1,7,0
23108813@N00,2382,26,1350722129,1350722129,1,1,0
23108813@N00,2383,24,1351137286,1351137286,1,1,0
23108813@N00,2384,30,1351318400,1351318400,1,1,0
23113465@N08,2385,1,1381593910,1381593910,1,1,0
23113465@N08,2386,1,1388999605,1389000888,2,1,1283
23113465@N08,2387,1,1389189240,1389189240,1,1,0
23113465@N08,2388,1,1395368736,1395368736,1,1,0
23113465@N08,2389,1,1396768791,1396768791,1,1,0
23113465@N08,2390,19,1405700204,1405700204,1,1,0
23113465@N08,2391,27,1408851878,1408851878,1,1,0
23113465@N08,2392,20,1412429367,1412429367,1,2,0
23113465@N08,2392,19,1412425635,1412429431,2,2,3796
23113465@N08,2393,19,1419593011,1419593011,1,1,0
23113465@N08,2394,18,1426390275,1426390275,1,1,0
23113465@N08,2395,18,1428565035,1428565035,1,1,0
23113465@N08,2396,18,1430716623,1430722941,2,1,6318
23113465@N08,2397,18,1431001348,1431001348,1,1,0
23113465@N08,2398,18,1431084261,1431084261,1,1,0
23113465@N08,2399,18,1432362019,1432362019,1,1,0
23113465@N08,2400,18,1435336037,1435336037,1,2,0
23113465@N08,2400,17,1435323745,1435323745,1,2,0
23113465@N08,2401,18,1440582024,1440582024,1,1,0
23113465@N08,2402,18,1441542137,1441542137,1,1,0
23113465@N08,2403,18,1441791665,1441791665,1,1,0
23113465@N08,2404,17,1443011230,1443011230,1,1,0
23113465@N08,2405,18,1443057858,1443057858,1,1,0
23113465@N08,2406,18,1443156144,1443180845,4,1,24701
23113465@N08,2407,30,1443424333,1443424333,1,2,0
23113465@N08,2407,18,1443415906,1443444026,4,2,28120
23113465@N08,2408,18,1443955018,1443955018,1,1,0
23113465@N08,2409,18,1444020502,1444038561,4,1,18059
23113465@N08,2410,18,1451442567,1451442567,1,1,0
23113465@N08,2411,18,1451567843,1451574322,3,2,6479
23113465@N08,2411,20,1451566679,1451566679,1,2,0
23113465@N08,2412,18,1451612903,1451612903,1,1,0
23113465@N08,2413,15,1452579276,1452579276,1,2,0
23113465@N08,2413,18,1452580541,1452580541,1,2,0
23113465@N08,2414,18,1454246280,1454246280,1,1,0
23113465@N08,2415,18,1454501048,1454501048,1,1,0
23113465@N08,2416,18,1454713591,1454730857,2,1,17266
23113465@N08,2417,18,1456053292,1456053292,1,1,0
23113465@N08,2418,18,1458004406,1458004406,1,1,0
23113465@N08,2419,20,1466480341,1466480341,1,1,0
23113465@N08,2420,10,1467434992,1467434992,1,2,0
23113465@N08,2420,20,1467439222,1467439222,1,2,0
23119895@N00,2421,17,1288674142,1288675104,2,1,962
23119895@N00,2422,18,1288762542,1288762542,1,4,0
23119895@N00,2422,24,1288756125,1288756125,1,4,0
23119895@N00,2422,13,1288752839,1288752839,1,4,0
23119895@N00,2422,16,1288760210,1288760210,1,4,0
23119895@N00,2423,8,1288918454,1288918454,1,1,0
23119895@N00,2424,3,1288999601,1288999601,1,2,0
23119895@N00,2424,29,1289015264,1289015264,1,2,0
23119895@N00,2425,12,1289044638,1289044638,1,1,0
23119895@N00,2426,8,1324249517,1324249517,1,6,0
23119895@N00,2426,3,1324251562,1324251562,1,6,0
23119895@N00,2426,1,1324248370,1324248741,2,6,371
23119895@N00,2426,5,1324252555,1324252559,3,6,4
23119895@N00,2426,16,1324262299,1324289245,2,6,26946
23119895@N00,2426,22,1324275666,1324275666,1,6,0
23119895@N00,2427,7,1324427565,1324435306,2,6,7741
23119895@N00,2427,6,1324427872,1324427872,1,6,0
23119895@N00,2427,26,1324466145,1324466145,1,6,0
23119895@N00,2427,11,1324438794,1324438821,3,6,27
23119895@N00,2427,5,1324435382,1324435382,1,6,0
23119895@N00,2427,16,1324445750,1324445880,3,6,130
23119895@N00,2428,5,1406900864,1406900864,1,1,0
23124863@N02,2429,29,1338164706,1338164706,1,1,0
23125652@N06,2430,16,1257569455,1257569455,1,1,0
23129782@N00,2431,24,1435024443,1435025896,5,15,1453
23129782@N00,2431,26,1435019791,1435019791,1,15,0
23129782@N00,2431,21,1435022047,1435022047,1,15,0
23129782@N00,2431,31,1435034926,1435034926,1,15,0
23129782@N00,2431,25,1435050550,1435051087,8,15,537
23129782@N00,2431,5,1435020301,1435020301,1,15,0
23129782@N00,2431,22,1435034512,1435034547,2,15,35
23129782@N00,2431,16,1435019623,1435019623,1,15,0
23129782@N00,2431,12,1435022143,1435025122,4,15,2979
23129782@N00,2431,23,1435032917,1435032917,1,15,0
23129782@N00,2431,19,1435032541,1435032930,4,15,389
23129782@N00,2431,20,1435036256,1435036256,1,15,0
23129782@N00,2431,11,1435050875,1435050875,1,15,0
23129782@N00,2431,30,1435034120,1435034167,2,15,47
23129782@N00,2431,1,1435018882,1435018882,1,15,0
23149244@N02,2432,27,1277844808,1277851194,7,2,6386
23149244@N02,2432,26,1277839060,1277851327,28,2,12267
23156426@N07,2433,18,1320292495,1320292808,4,2,313
23156426@N07,2433,23,1320292497,1320292497,1,2,0
23197443@N07,2434,21,1323300098,1323300098,1,1,0
23197443@N07,2435,16,1323452774,1323452774,1,1,0
23197443@N07,2436,26,1325717088,1325717166,2,1,78
23205379@N02,2437,29,1329721497,1329721497,1,1,0
23205379@N02,2438,29,1329903776,1329903776,1,1,0
23205379@N02,2439,29,1330074975,1330074975,1,1,0
23205379@N02,2440,3,1330133925,1330133925,1,1,0
23205379@N02,2441,27,1330810310,1330810310,1,1,0
23205379@N02,2442,18,1331512714,1331512714,1,2,0
23205379@N02,2442,5,1331512698,1331512698,1,2,0
23205379@N02,2443,28,1332068505,1332068505,1,1,0
23205379@N02,2444,6,1332392143,1332392143,1,3,0
23205379@N02,2444,7,1332392012,1332392012,1,3,0
23205379@N02,2444,18,1332392111,1332392111,1,3,0
23205379@N02,2445,28,1332670208,1332670208,1,4,0
23205379@N02,2445,30,1332669724,1332669724,1,4,0
23205379@N02,2445,18,1332670224,1332670224,1,4,0
23205379@N02,2445,24,1332670244,1332670244,1,4,0
23205379@N02,2446,15,1332757828,1332757828,1,1,0
23205379@N02,2447,4,1332977163,1332977163,1,3,0
23205379@N02,2447,9,1332977177,1332977177,1,3,0
23205379@N02,2447,15,1332977266,1332977266,1,3,0
23205379@N02,2448,28,1333162147,1333162147,1,3,0
23205379@N02,2448,26,1333162079,1333162079,1,3,0
23205379@N02,2448,15,1333162096,1333162096,1,3,0
23205379@N02,2449,28,1333684082,1333684191,2,4,109
23205379@N02,2449,4,1333683855,1333683855,1,4,0
23205379@N02,2449,26,1333683738,1333684119,2,4,381
23205379@N02,2449,10,1333683683,1333683683,1,4,0
23205379@N02,2450,29,1334997462,1334997462,1,2,0
23205379@N02,2450,18,1334997376,1334997376,1,2,0
23205379@N02,2451,14,1335054096,1335054096,1,2,0
23205379@N02,2451,18,1335054120,1335054120,1,2,0
23205379@N02,2452,23,1335400719,1335400719,1,6,0
23205379@N02,2452,29,1335400579,1335400579,1,6,0
23205379@N02,2452,24,1335400945,1335400945,1,6,0
23205379@N02,2452,11,1335400698,1335400698,1,6,0
23205379@N02,2452,1,1335400673,1335400673,1,6,0
23205379@N02,2452,20,1335400758,1335400758,1,6,0
23205379@N02,2453,26,1336007262,1336008906,2,1,1644
23205379@N02,2454,28,1341371249,1341371249,1,1,0
23205379@N02,2455,15,1342047579,1342047579,1,1,0
23205379@N02,2456,28,1342162196,1342162196,1,2,0
23205379@N02,2456,18,1342162274,1342162274,1,2,0
23205379@N02,2457,28,1343194529,1343194529,1,1,0
23205379@N02,2458,28,1343357404,1343357586,3,4,182
23205379@N02,2458,31,1343357479,1343357479,1,4,0
23205379@N02,2458,22,1343357573,1343357573,1,4,0
23205379@N02,2458,30,1343357496,1343357640,2,4,144
23205379@N02,2459,29,1357373875,1357373875,1,1,0
23205379@N02,2460,28,1362896675,1362896675,1,1,0
23205379@N02,2461,29,1368960516,1368960516,1,1,0
23205379@N02,2462,11,1378029966,1378029966,1,1,0
23205379@N02,2463,7,1382347174,1382347174,1,2,0
23205379@N02,2463,28,1382339936,1382350923,2,2,10987
23205379@N02,2464,29,1386572301,1386583901,2,1,11600
23205379@N02,2465,28,1398566276,1398566276,1,1,0
23205379@N02,2466,26,1399174046,1399174046,1,1,0
23205379@N02,2467,17,1400328991,1400328991,1,1,0
23205379@N02,2468,28,1401523079,1401523079,1,1,0
23205379@N02,2469,1,1402126072,1402126072,1,1,0
23205379@N02,2470,28,1404553462,1404553462,1,1,0
23205379@N02,2471,19,1405760317,1405760317,1,2,0
23205379@N02,2471,29,1405769756,1405770983,2,2,1227
23205379@N02,2472,19,1409445003,1409454348,4,2,9345
23205379@N02,2472,28,1409449521,1409449521,1,2,0
23205379@N02,2473,19,1411133490,1411133490,1,1,0
23205379@N02,2474,20,1411891703,1411891703,1,4,0
23205379@N02,2474,19,1411883614,1411907110,2,4,23496
23205379@N02,2474,27,1411897379,1411897379,1,4,0
23205379@N02,2474,28,1411888514,1411888514,1,4,0
23205379@N02,2475,17,1412053292,1412053292,1,2,0
23205379@N02,2475,28,1412032849,1412067013,2,2,34164
23205379@N02,2476,19,1412116128,1412116128,1,1,0
23205379@N02,2477,19,1412227456,1412227456,1,2,0
23205379@N02,2477,29,1412216649,1412216649,1,2,0
23205379@N02,2478,24,1412310090,1412310090,1,1,0
23205379@N02,2479,20,1412428969,1412428969,1,2,0
23205379@N02,2479,28,1412426199,1412426199,1,2,0
23205379@N02,2480,19,1412646949,1412646949,1,1,0
23205379@N02,2481,28,1412680845,1412680845,1,1,0
23205379@N02,2482,20,1412757074,1412757074,1,1,0
23205379@N02,2483,19,1412904627,1412904627,1,1,0
23205379@N02,2484,19,1413163093,1413176142,2,1,13049
23205379@N02,2485,19,1413625369,1413625369,1,1,0
23205379@N02,2486,19,1413795241,1413807568,2,1,12327
23205379@N02,2487,17,1413857484,1413857484,1,1,0
23205379@N02,2488,28,1413887888,1413887888,1,1,0
23205379@N02,2489,30,1414483543,1414483543,1,1,0
23205379@N02,2490,27,1415437882,1415437882,1,3,0
23205379@N02,2490,26,1415449562,1415449562,1,3,0
23205379@N02,2490,19,1415436478,1415441353,2,3,4875
23205379@N02,2491,25,1415966017,1415966017,1,1,0
23205379@N02,2492,19,1416471219,1416471219,1,1,0
23205379@N02,2493,19,1416625986,1416625986,1,1,0
23205379@N02,2494,26,1417172671,1417172671,1,1,0
23205379@N02,2495,19,1418189601,1418189601,1,1,0
23205379@N02,2496,19,1418461030,1418474286,3,1,13256
23205379@N02,2497,19,1418892340,1418892340,1,1,0
23205379@N02,2498,28,1419288398,1419288398,1,1,0
23205379@N02,2499,26,1419857103,1419857103,1,1,0
23205379@N02,2500,26,1419988832,1419988832,1,1,0
23205379@N02,2501,29,1420173021,1420173021,1,1,0
23205379@N02,2502,19,1420258496,1420258496,1,1,0
23205379@N02,2503,30,1420877249,1420877249,1,2,0
23205379@N02,2503,28,1420872773,1420872773,1,2,0
23205379@N02,2504,18,1421878708,1421878708,1,1,0
23205379@N02,2505,28,1422154459,1422154459,1,1,0
23205379@N02,2506,28,1422403007,1422403007,1,1,0
23205379@N02,2507,26,1423628148,1423628148,1,1,0
23205379@N02,2508,18,1424074599,1424074599,1,1,0
23205379@N02,2509,18,1424987565,1424987565,1,1,0
23205379@N02,2510,18,1425092395,1425092395,1,2,0
23205379@N02,2510,29,1425112352,1425112352,1,2,0
23205379@N02,2511,13,1425178928,1425178928,1,2,0
23205379@N02,2511,18,1425188549,1425188549,1,2,0
23205379@N02,2512,4,1425262802,1425262802,1,1,0
23205379@N02,2513,18,1425433630,1425433630,1,1,0
23205379@N02,2514,28,1425522259,1425522259,1,3,0
23205379@N02,2514,13,1425538801,1425538801,1,3,0
23205379@N02,2514,18,1425510466,1425510466,1,3,0
23205379@N02,2515,18,1425608255,1425618165,2,1,9910
23205379@N02,2516,29,1425788749,1425788749,1,1,0
23205379@N02,2517,18,1425850809,1425850809,1,1,0
23205379@N02,2518,18,1425954415,1425954415,1,1,0
23205379@N02,2519,26,1426039960,1426039960,1,1,0
23205379@N02,2520,13,1426632651,1426632651,1,2,0
23205379@N02,2520,18,1426657886,1426657886,1,2,0
23205379@N02,2521,9,1426716556,1426716556,1,2,0
23205379@N02,2521,18,1426724412,1426730270,2,2,5858
23205379@N02,2522,25,1427163275,1427163275,1,1,0
23205379@N02,2523,18,1427238421,1427238421,1,1,0
23205379@N02,2524,28,1427601104,1427601104,1,1,0
23205379@N02,2525,26,1427840327,1427840327,1,1,0
23205379@N02,2526,28,1427957639,1427957639,1,1,0
23205379@N02,2527,18,1428536130,1428536130,1,1,0
23205379@N02,2528,26,1428902833,1428902833,1,1,0
23205379@N02,2529,28,1428967375,1428967375,1,1,0
23205379@N02,2530,18,1429007168,1429007168,1,1,0
23205379@N02,2531,28,1429064197,1429064197,1,2,0
23205379@N02,2531,26,1429087198,1429087198,1,2,0
23205379@N02,2532,28,1429168540,1429168540,1,2,0
23205379@N02,2532,18,1429181621,1429181621,1,2,0
23205379@N02,2533,18,1429330054,1429330054,1,1,0
23205379@N02,2534,14,1429519494,1429519494,1,2,0
23205379@N02,2534,18,1429495908,1429495908,1,2,0
23205379@N02,2535,28,1429612288,1429612288,1,2,0
23205379@N02,2535,18,1429607840,1429607840,1,2,0
23205379@N02,2536,26,1429836431,1429836431,1,1,0
23205379@N02,2537,18,1430115376,1430115376,1,1,0
23205379@N02,2538,18,1430260118,1430260118,1,1,0
23205379@N02,2539,28,1430641626,1430641626,1,1,0
23205379@N02,2540,18,1430709705,1430709705,1,1,0
23205379@N02,2541,18,1430785149,1430785149,1,1,0
23205379@N02,2542,30,1431146481,1431146481,1,2,0
23205379@N02,2542,18,1431151261,1431151261,1,2,0
23205379@N02,2543,18,1431399512,1431399512,1,1,0
23205379@N02,2544,26,1431682543,1431682543,1,1,0
23205379@N02,2545,18,1432103477,1432113194,2,1,9717
23205379@N02,2546,26,1432160814,1432160814,1,4,0
23205379@N02,2546,28,1432178032,1432178032,1,4,0
23205379@N02,2546,18,1432170753,1432170753,1,4,0
23205379@N02,2546,3,1432204905,1432204905,1,4,0
23205379@N02,2547,28,1432261341,1432261341,1,3,0
23205379@N02,2547,1,1432286457,1432286457,1,3,0
23205379@N02,2547,18,1432255756,1432255756,1,3,0
23205379@N02,2548,20,1432439195,1432439195,1,2,0
23205379@N02,2548,22,1432449082,1432449082,1,2,0
23205379@N02,2549,28,1432555817,1432555817,1,2,0
23205379@N02,2549,18,1432527781,1432527781,1,2,0
23205379@N02,2550,18,1432608483,1432608483,1,3,0
23205379@N02,2550,29,1432614440,1432614440,1,3,0
23205379@N02,2550,4,1432598557,1432598557,1,3,0
23205379@N02,2551,3,1433214053,1433214053,1,1,0
23205379@N02,2552,18,1433412753,1433412753,1,2,0
23205379@N02,2552,14,1433403997,1433403997,1,2,0
23205379@N02,2553,18,1433651790,1433651790,1,1,0
23205379@N02,2554,18,1433846804,1433846804,1,1,0
23205379@N02,2555,3,1434260355,1434260355,1,1,0
23205379@N02,2556,28,1434500399,1434500399,1,1,0
23205379@N02,2557,28,1434853497,1434853497,1,1,0
23205379@N02,2558,18,1434976656,1434976656,1,1,0
23205379@N02,2559,28,1435096047,1435096047,1,1,0
23205379@N02,2560,12,1435300161,1435300161,1,1,0
23205379@N02,2561,18,1436000304,1436000304,1,2,0
23205379@N02,2561,11,1435996302,1435996302,1,2,0
23205379@N02,2562,18,1436173361,1436173361,1,1,0
23205379@N02,2563,28,1436274531,1436274531,1,1,0
23205379@N02,2564,28,1436350562,1436350562,1,1,0
23205379@N02,2565,18,1436679425,1436679425,1,1,0
23205379@N02,2566,29,1437020096,1437020096,1,1,0
23205379@N02,2567,18,1438166002,1438166002,1,1,0
23205379@N02,2568,28,1438435445,1438435445,1,1,0
23205379@N02,2569,29,1438602758,1438602758,1,1,0
23205379@N02,2570,28,1438740000,1438740000,1,1,0
23205379@N02,2571,28,1439105682,1439105682,1,2,0
23205379@N02,2571,30,1439112957,1439112957,1,2,0
23205379@N02,2572,18,1441323855,1441323855,1,1,0
23205379@N02,2573,18,1441413391,1441413391,1,1,0
23208151@N05,2574,31,1334879658,1334879658,1,1,0
23211922@N04,2575,18,1457074008,1457074008,1,1,0
23212779@N04,2576,26,1209116442,1209116442,1,1,0
23212779@N04,2577,3,1275558196,1275558196,1,5,0
23212779@N04,2577,26,1275544692,1275544692,1,5,0
23212779@N04,2577,12,1275557919,1275557919,1,5,0
23212779@N04,2577,21,1275558661,1275558661,1,5,0
23212779@N04,2577,24,1275559582,1275559582,1,5,0
23212779@N04,2578,29,1279509455,1279509455,1,2,0
23212779@N04,2578,26,1279509950,1279509950,1,2,0
23212779@N04,2579,29,1281962993,1281966012,2,3,3019
23212779@N04,2579,26,1281954009,1281969524,3,3,15515
23212779@N04,2579,21,1281967900,1281967900,1,3,0
23212779@N04,2580,16,1282741128,1282741128,1,1,0
23212779@N04,2581,6,1286112467,1286112467,1,4,0
23212779@N04,2581,1,1286115080,1286115080,1,4,0
23212779@N04,2581,26,1286113022,1286113022,1,4,0
23212779@N04,2581,28,1286113527,1286114685,2,4,1158
23212779@N04,2582,29,1289988637,1289988637,1,4,0
23212779@N04,2582,26,1289990995,1289991668,2,4,673
23212779@N04,2582,1,1289994113,1289994113,1,4,0
23212779@N04,2582,28,1289992115,1289992115,1,4,0
23212779@N04,2583,13,1290072095,1290072095,1,4,0
23212779@N04,2583,24,1290066981,1290066981,1,4,0
23212779@N04,2583,28,1290069189,1290069189,1,4,0
23212779@N04,2583,26,1290068054,1290076248,2,4,8194
23212779@N04,2584,6,1294742411,1294742411,1,3,0
23212779@N04,2584,30,1294720449,1294720449,1,3,0
23212779@N04,2584,12,1294728584,1294729819,2,3,1235
23212779@N04,2585,15,1297421526,1297421526,1,2,0
23212779@N04,2585,13,1297414003,1297414003,1,2,0
23212779@N04,2586,29,1303206766,1303207204,2,2,438
23212779@N04,2586,28,1303216492,1303216492,1,2,0
23212779@N04,2587,12,1304244310,1304244310,1,1,0
23212779@N04,2588,29,1307944138,1307944138,1,2,0
23212779@N04,2588,28,1307957725,1307957725,1,2,0
23212779@N04,2589,26,1308805780,1308805780,1,1,0
23212779@N04,2590,26,1310484915,1310484915,1,1,0
23212779@N04,2591,16,1314900710,1314900710,1,1,0
23212779@N04,2592,26,1316791959,1316791959,1,1,0
23212779@N04,2593,24,1316866936,1316866936,1,1,0
23212779@N04,2594,12,1318838171,1318838171,1,1,0
23212779@N04,2595,26,1319353792,1319353792,1,2,0
23212779@N04,2595,12,1319341764,1319341764,1,2,0
23212779@N04,2596,17,1319621528,1319621528,1,1,0
23212779@N04,2597,26,1321617182,1321617182,1,2,0
23212779@N04,2597,1,1321633619,1321633619,1,2,0
23212779@N04,2598,22,1323949608,1323949608,1,2,0
23212779@N04,2598,25,1323961896,1323961896,1,2,0
23212779@N04,2599,12,1324015135,1324015135,1,1,0
23212779@N04,2600,17,1326354105,1326354105,1,2,0
23212779@N04,2600,26,1326345252,1326345252,1,2,0
23212779@N04,2601,12,1327652951,1327652951,1,1,0
23212779@N04,2602,26,1330467195,1330468708,4,1,1513
23212779@N04,2603,26,1330548012,1330548012,1,1,0
23212779@N04,2604,29,1336126308,1336126308,1,2,0
23212779@N04,2604,21,1336128953,1336128953,1,2,0
23212779@N04,2605,1,1350535242,1350535242,1,1,0
23212779@N04,2606,28,1352646344,1352646344,1,1,0
23212779@N04,2607,3,1354075617,1354075617,1,1,0
23212779@N04,2608,26,1354232873,1354232873,1,1,0
23212779@N04,2609,16,1355920222,1355920222,1,1,0
23212779@N04,2610,24,1357898777,1357898777,1,1,0
23218963@N00,2611,24,1428703866,1428703866,1,4,0
23218963@N00,2611,13,1428712093,1428712093,1,4,0
23218963@N00,2611,16,1428700285,1428700554,3,4,269
23218963@N00,2611,15,1428704044,1428704044,1,4,0
23218963@N00,2612,24,1471076295,1471076295,1,3,0
23218963@N00,2612,15,1471076056,1471076207,2,3,151
23218963@N00,2612,12,1471077422,1471077422,1,3,0
23218963@N00,2613,30,1471318795,1471318828,2,3,33
23218963@N00,2613,17,1471310184,1471310184,1,3,0
23218963@N00,2613,27,1471303416,1471309468,31,3,6052
23218963@N00,2614,10,1471414165,1471414165,1,2,0
23218963@N00,2614,7,1471421775,1471421832,2,2,57
23249325@N08,2615,29,1425084914,1425084914,1,1,0
23322134@N02,2616,29,1218718193,1218718651,4,2,458
23322134@N02,2616,20,1218721524,1218722073,3,2,549
23322134@N02,2617,30,1218766717,1218766717,1,14,0
23322134@N02,2617,26,1218793938,1218794443,5,14,505
23322134@N02,2617,20,1218774904,1218774904,1,14,0
23322134@N02,2617,14,1218768209,1218771377,3,14,3168
23322134@N02,2617,6,1218795899,1218795899,1,14,0
23322134@N02,2617,29,1218797524,1218799516,5,14,1992
23322134@N02,2617,19,1218811935,1218811936,2,14,1
23322134@N02,2617,28,1218760865,1218777676,2,14,16811
23322134@N02,2617,17,1218807063,1218807579,5,14,516
23322134@N02,2617,22,1218768128,1218772770,5,14,4642
23322134@N02,2617,1,1218760308,1218760505,3,14,197
23322134@N02,2617,21,1218764449,1218764449,1,14,0
23322134@N02,2617,3,1218763533,1218763788,3,14,255
23322134@N02,2617,10,1218766441,1218795652,3,14,29211
23322134@N02,2618,24,1218846942,1218846942,1,3,0
23322134@N02,2618,12,1218847305,1218847305,1,3,0
23322134@N02,2618,1,1218844103,1218844103,1,3,0
23322134@N02,2619,29,1250234471,1250234471,1,2,0
23322134@N02,2619,13,1250225012,1250225012,1,2,0
23322134@N02,2620,4,1250315199,1250315199,1,8,0
23322134@N02,2620,3,1250297393,1250297393,1,8,0
23322134@N02,2620,16,1250321760,1250336292,3,8,14532
23322134@N02,2620,20,1250304762,1250321739,2,8,16977
23322134@N02,2620,29,1250309302,1250309302,1,8,0
23322134@N02,2620,26,1250322100,1250337802,5,8,15702
23322134@N02,2620,27,1250335413,1250335413,1,8,0
23322134@N02,2620,30,1250314188,1250314641,2,8,453
23322134@N02,2621,25,1250385070,1250385070,1,1,0
23322134@N02,2622,28,1250415592,1250422805,2,2,7213
23322134@N02,2622,22,1250417574,1250417574,1,2,0
23322958@N08,2623,17,1311470794,1311470794,1,1,0
23369489@N07,2624,3,1451519872,1451519872,1,1,0
23375196@N06,2625,30,1298675515,1298676423,4,6,908
23375196@N06,2625,29,1298674948,1298675042,2,6,94
23375196@N06,2625,26,1298671459,1298671459,1,6,0
23375196@N06,2625,11,1298676431,1298677119,8,6,688
23375196@N06,2625,10,1298672606,1298674098,5,6,1492
23375196@N06,2625,28,1298671314,1298693938,3,6,22624
23375196@N06,2626,25,1328752828,1328752828,1,2,0
23375196@N06,2626,24,1328752369,1328752369,1,2,0
23375196@N06,2627,3,1328911248,1328911248,1,4,0
23375196@N06,2627,13,1328911770,1328912142,2,4,372
23375196@N06,2627,8,1328909975,1328909975,1,4,0
23375196@N06,2627,21,1328910522,1328910522,1,4,0
23375196@N06,2628,1,1328952956,1328953857,14,1,901
23399885@N00,2629,26,1304957180,1304957180,1,3,0
23399885@N00,2629,29,1304957997,1304957997,1,3,0
23399885@N00,2629,15,1304953252,1304956529,17,3,3277
23399885@N00,2630,25,1305034378,1305034461,4,5,83
23399885@N00,2630,26,1305030303,1305030423,4,5,120
23399885@N00,2630,17,1305023579,1305027966,4,5,4387
23399885@N00,2630,22,1305017073,1305017322,8,5,249
23399885@N00,2630,21,1305021952,1305033698,25,5,11746
23403837@N05,2631,29,1293489925,1293492004,2,1,2079
23403837@N05,2632,29,1293529461,1293529461,1,1,0
23404661@N06,2633,26,1362558947,1362558947,1,1,0
23405060@N03,2634,12,1202598962,1202598962,1,2,0
23405060@N03,2634,10,1202613234,1202613234,1,2,0
23411300@N00,2635,18,1429002794,1429005041,2,2,2247
23411300@N00,2635,23,1428992135,1428992135,1,2,0
23411300@N00,2636,17,1429145350,1429145350,1,1,0
23450846@N07,2637,20,1257067982,1257067982,1,1,0
23450846@N07,2638,26,1291468926,1291468926,1,1,0
23450846@N07,2639,29,1291644830,1291644830,1,1,0
23450846@N07,2640,13,1292914508,1292914508,1,3,0
23450846@N07,2640,29,1292926677,1292926677,1,3,0
23450846@N07,2640,20,1292905519,1292905519,1,3,0
23450846@N07,2641,30,1293463801,1293463801,1,1,0
23450846@N07,2642,22,1293509904,1293510191,2,3,287
23450846@N07,2642,20,1293532123,1293532123,1,3,0
23450846@N07,2642,30,1293506340,1293508364,3,3,2024
23450846@N07,2643,26,1310451115,1310451115,1,1,0
23450846@N07,2644,26,1324560067,1324560067,1,1,0
23450846@N07,2645,26,1325341486,1325341486,1,1,0
23450846@N07,2646,28,1326174912,1326174912,1,2,0
23450846@N07,2646,30,1326183346,1326183346,1,2,0
23450846@N07,2647,26,1330463388,1330463388,1,1,0
23450846@N07,2648,18,1346745923,1346745923,1,1,0
23450846@N07,2649,28,1357392596,1357392596,1,1,0
23450846@N07,2650,13,1369350524,1369350524,1,1,0
23450846@N07,2651,9,1371729074,1371729074,1,1,0
23450846@N07,2652,16,1373547539,1373547539,1,1,0
23450846@N07,2653,28,1393681793,1393681793,1,1,0
23450846@N07,2654,30,1394967886,1394967909,2,2,23
23450846@N07,2654,4,1394967982,1394967982,1,2,0
23450846@N07,2655,29,1397399781,1397399781,1,1,0
23450846@N07,2656,28,1404673799,1404673799,1,1,0
23450846@N07,2657,29,1408843325,1408843325,1,1,0
23450846@N07,2658,26,1408987680,1408987680,1,1,0
23450846@N07,2659,26,1410278789,1410278789,1,1,0
23450846@N07,2660,26,1421410631,1421410631,1,1,0
23450846@N07,2661,20,1432536975,1432536975,1,1,0
23450846@N07,2662,28,1438775035,1438775035,1,1,0
23459187@N07,2663,16,1306931798,1306931798,1,2,0
23459187@N07,2663,12,1306931790,1306931790,1,2,0
23484004@N03,2664,3,1324296030,1324296030,1,1,0
23496566@N07,2665,25,1342836734,1342836734,1,2,0
23496566@N07,2665,1,1342833207,1342860665,2,2,27458
23496566@N07,2666,25,1342925270,1342926181,9,1,911
23508660@N06,2667,13,1349558238,1349558238,1,1,0
23517140@N07,2668,15,1334053395,1334053395,1,1,0
23517147@N00,2669,28,1289903866,1289903866,1,1,0
23555295@N04,2670,23,1206684224,1206684224,1,2,0
23555295@N04,2670,18,1206683087,1206683087,1,2,0
23571697@N00,2671,26,1218600413,1218600413,1,3,0
23571697@N00,2671,1,1218601595,1218601595,1,3,0
23571697@N00,2671,20,1218602265,1218602265,1,3,0
23571697@N00,2672,28,1221306024,1221306024,1,1,0
23571697@N00,2673,20,1225005029,1225005029,1,1,0
23571697@N00,2674,28,1232625903,1232625903,1,1,0
23571697@N00,2675,19,1270038136,1270038136,1,1,0
23571697@N00,2676,20,1351050346,1351050346,1,1,0
23571697@N00,2677,1,1363930544,1363930544,1,1,0
23571697@N00,2678,26,1383711325,1383718328,2,1,7003
23571697@N00,2679,28,1384309710,1384314362,2,1,4652
23579531@N07,2680,26,1225023759,1225027173,9,1,3414
23600002@N05,2681,26,1293379516,1293422019,48,1,42503
23621009@N07,2682,10,1202178498,1202178498,1,8,0
23621009@N07,2682,19,1202169811,1202169811,1,8,0
23621009@N07,2682,26,1202168342,1202207929,7,8,39587
23621009@N07,2682,12,1202167688,1202167688,1,8,0
23621009@N07,2682,17,1202183931,1202184122,3,8,191
23621009@N07,2682,28,1202167374,1202208492,3,8,41118
23621009@N07,2682,4,1202180452,1202181219,4,8,767
23621009@N07,2682,29,1202173043,1202173064,2,8,21
23631144@N02,2683,29,1214194134,1214194134,1,1,0
23645312@N03,2684,26,1262018799,1262018799,1,1,0
23651429@N03,2685,26,1201908108,1201908108,1,1,0
23653693@N04,2686,27,1377415117,1377416233,2,1,1116
23654380@N00,2687,31,1257748008,1257748084,5,9,76
23654380@N00,2687,13,1257739921,1257741700,24,9,1779
23654380@N00,2687,7,1257728908,1257729414,7,9,506
23654380@N00,2687,29,1257743416,1257744600,15,9,1184
23654380@N00,2687,12,1257733646,1257736263,7,9,2617
23654380@N00,2687,4,1257728699,1257728965,2,9,266
23654380@N00,2687,28,1257725040,1257757162,8,9,32122
23654380@N00,2687,21,1257727618,1257728167,9,9,549
23654380@N00,2687,26,1257755745,1257756350,12,9,605
23673310@N02,2688,22,1241913900,1241914144,6,12,244
23673310@N02,2688,24,1241949543,1241949639,4,12,96
23673310@N02,2688,16,1241909601,1241909601,1,12,0
23673310@N02,2688,18,1241921294,1241921613,3,12,319
23673310@N02,2688,25,1241923099,1241924494,10,12,1395
23673310@N02,2688,30,1241913670,1241913670,1,12,0
23673310@N02,2688,1,1241907994,1241907994,1,12,0
23673310@N02,2688,19,1241920384,1241920584,6,12,200
23673310@N02,2688,27,1241910163,1241910192,2,12,29
23673310@N02,2688,10,1241913002,1241913038,2,12,36
23673310@N02,2688,29,1241927863,1241927863,1,12,0
23673310@N02,2688,26,1241922673,1241922673,1,12,0
23673310@N02,2689,31,1313837956,1313839214,6,2,1258
23673310@N02,2689,27,1313840702,1313843838,5,2,3136
23673310@N02,2690,1,1313966922,1313992458,2,11,25536
23673310@N02,2690,26,1314003897,1314003922,2,11,25
23673310@N02,2690,5,1313969156,1313969156,1,11,0
23673310@N02,2690,25,1314009022,1314009572,13,11,550
23673310@N02,2690,27,1314012551,1314012905,6,11,354
23673310@N02,2690,22,1313971521,1313971644,2,11,123
23673310@N02,2690,10,1313977449,1313977449,1,11,0
23673310@N02,2690,24,1313981022,1313981022,1,11,0
23673310@N02,2690,28,1313967019,1314012835,36,11,45816
23673310@N02,2690,16,1313969558,1313970051,2,11,493
23673310@N02,2690,13,1313977712,1313978835,8,11,1123
23673310@N02,2691,4,1314063574,1314065156,14,7,1582
23673310@N02,2691,26,1314068653,1314068653,1,7,0
23673310@N02,2691,5,1314063230,1314063546,2,7,316
23673310@N02,2691,12,1314073608,1314073608,1,7,0
23673310@N02,2691,28,1314062844,1314062844,1,7,0
23673310@N02,2691,18,1314068644,1314068644,1,7,0
23673310@N02,2691,13,1314073577,1314073577,1,7,0
23673310@N02,2692,20,1369895689,1369895689,1,3,0
23673310@N02,2692,8,1369903402,1369904412,27,3,1010
23673310@N02,2692,13,1369899579,1369900930,3,3,1351
23673310@N02,2693,24,1369963752,1369963752,1,4,0
23673310@N02,2693,29,1369970153,1369971062,3,4,909
23673310@N02,2693,3,1369964704,1369964704,1,4,0
23673310@N02,2693,16,1369966580,1369966580,1,4,0
23677659@N00,2694,19,1412984245,1412984245,1,1,0
23679036@N04,2695,28,1396746450,1396746450,1,2,0
23679036@N04,2695,20,1396747925,1396747925,1,2,0
23679036@N04,2696,20,1396857638,1396857638,1,1,0
23679036@N04,2697,26,1426146001,1426146001,1,1,0
23684486@N07,2698,12,1188732226,1188732226,2,6,0
23684486@N07,2698,16,1188732226,1188732226,1,6,0
23684486@N07,2698,25,1188732226,1188732226,1,6,0
23684486@N07,2698,23,1188732226,1188732226,2,6,0
23684486@N07,2698,28,1188732226,1188732226,3,6,0
23684486@N07,2698,26,1188732226,1188732226,2,6,0
23684642@N08,2699,28,1244802460,1244802698,4,11,238
23684642@N08,2699,4,1244767814,1244767814,1,11,0
23684642@N08,2699,25,1244768568,1244798343,4,11,29775
23684642@N08,2699,26,1244764302,1244764302,1,11,0
23684642@N08,2699,16,1244801943,1244801943,1,11,0
23684642@N08,2699,24,1244779419,1244784105,2,11,4686
23684642@N08,2699,21,1244767726,1244798276,5,11,30550
23684642@N08,2699,15,1244771366,1244776906,6,11,5540
23684642@N08,2699,12,1244787076,1244787076,1,11,0
23684642@N08,2699,13,1244787922,1244795433,5,11,7511
23684642@N08,2699,27,1244771845,1244778517,4,11,6672
23684642@N08,2700,16,1244955460,1244961989,6,11,6529
23684642@N08,2700,18,1244933546,1244935746,2,11,2200
23684642@N08,2700,28,1244936183,1244936183,1,11,0
23684642@N08,2700,19,1244936672,1244947268,5,11,10596
23684642@N08,2700,22,1244946094,1244946094,1,11,0
23684642@N08,2700,23,1244933577,1244948775,2,11,15198
23684642@N08,2700,26,1244933313,1244956049,4,11,22736
23684642@N08,2700,20,1244939472,1244939472,1,11,0
23684642@N08,2700,29,1244935673,1244947230,3,11,11557
23684642@N08,2700,30,1244938789,1244938789,1,11,0
23684642@N08,2700,24,1244963488,1244963488,1,11,0
23684642@N08,2701,17,1245148898,1245148918,2,14,20
23684642@N08,2701,16,1245116113,1245116247,2,14,134
23684642@N08,2701,11,1245126889,1245126889,1,14,0
23684642@N08,2701,29,1245129541,1245131355,3,14,1814
23684642@N08,2701,3,1245123300,1245123300,1,14,0
23684642@N08,2701,14,1245139008,1245139047,2,14,39
23684642@N08,2701,1,1245116000,1245116000,1,14,0
23684642@N08,2701,21,1245122954,1245122954,1,14,0
23684642@N08,2701,28,1245116009,1245116026,2,14,17
23684642@N08,2701,7,1245124885,1245127949,5,14,3064
23684642@N08,2701,4,1245127186,1245127186,1,14,0
23684642@N08,2701,26,1245116321,1245117349,2,14,1028
23684642@N08,2701,30,1245128743,1245134260,2,14,5517
23684642@N08,2701,27,1245116099,1245116099,1,14,0
23684642@N08,2702,23,1251610868,1251610868,1,2,0
23684642@N08,2702,27,1251593723,1251593723,1,2,0
23684642@N08,2703,22,1251682243,1251682243,1,2,0
23684642@N08,2703,31,1251681820,1251681820,1,2,0
23684642@N08,2704,16,1251775294,1251775294,1,7,0
23684642@N08,2704,18,1251770468,1251780332,3,7,9864
23684642@N08,2704,29,1251766465,1251766465,1,7,0
23684642@N08,2704,23,1251771695,1251771695,1,7,0
23684642@N08,2704,1,1251755628,1251755628,1,7,0
23684642@N08,2704,19,1251771173,1251771219,2,7,46
23684642@N08,2704,26,1251775706,1251775706,1,7,0
23684642@N08,2705,16,1251850112,1251875206,2,4,25094
23684642@N08,2705,29,1251886930,1251887474,2,4,544
23684642@N08,2705,12,1251849829,1251849829,1,4,0
23684642@N08,2705,30,1251883479,1251883479,1,4,0
23684642@N08,2706,18,1251933636,1251933729,2,1,93
23684642@N08,2707,29,1251968418,1251968418,1,1,0
23688169@N00,2708,25,1385540940,1385540940,1,2,0
23688169@N00,2708,17,1385532081,1385532081,1,2,0
23693552@N03,2709,1,1340875059,1340875280,2,1,221
23693552@N03,2710,1,1340941900,1340941900,1,2,0
23693552@N03,2710,28,1340941397,1340941405,2,2,8
23693552@N03,2711,13,1341020153,1341020153,1,1,0
23693552@N03,2712,30,1342680237,1342680237,1,2,0
23693552@N03,2712,26,1342697679,1342697679,1,2,0
23693552@N03,2713,16,1343017086,1343017086,1,5,0
23693552@N03,2713,1,1343040778,1343040778,1,5,0
23693552@N03,2713,28,1343040956,1343040956,1,5,0
23693552@N03,2713,26,1343042796,1343042796,1,5,0
23693552@N03,2713,29,1343042735,1343042735,1,5,0
23694509@N06,2714,1,1428355583,1428355583,1,1,0
23694509@N06,2715,23,1428486174,1428486174,1,1,0
23708393@N07,2716,17,1246840893,1246840893,1,1,0
23708590@N03,2717,28,1327121174,1327121174,1,2,0
23708590@N03,2717,11,1327108346,1327108346,1,2,0
23708590@N03,2718,1,1330908093,1330908093,1,1,0
23708590@N03,2719,4,1332298086,1332298086,1,1,0
23708590@N03,2720,1,1340012050,1340012050,1,1,0
23708590@N03,2721,11,1346834065,1346834065,1,2,0
23708590@N03,2721,9,1346833923,1346833923,1,2,0
23708590@N03,2722,26,1358743476,1358743476,1,1,0
23708590@N03,2723,28,1363400970,1363401600,2,1,630
23708590@N03,2724,7,1378099615,1378099615,1,1,0
23708590@N03,2725,11,1378955053,1378955053,1,2,0
23708590@N03,2725,21,1378959406,1378959406,1,2,0
23708590@N03,2726,22,1381195191,1381195191,1,1,0
23716112@N06,2727,6,1371976440,1371976440,1,10,0
23716112@N06,2727,16,1371986806,1371986931,5,10,125
23716112@N06,2727,29,1371965653,1371974504,3,10,8851
23716112@N06,2727,1,1371960163,1371988755,4,10,28592
23716112@N06,2727,26,1371960734,1371976280,6,10,15546
23716112@N06,2727,17,1371986234,1371986237,2,10,3
23716112@N06,2727,14,1371970251,1371970296,4,10,45
23716112@N06,2727,18,1371963008,1371964071,4,10,1063
23716112@N06,2727,22,1371971251,1371971254,2,10,3
23716112@N06,2727,30,1371961505,1371962239,2,10,734
23716112@N06,2728,28,1372045095,1372055443,5,2,10348
23716112@N06,2728,13,1372050804,1372050804,1,2,0
23716112@N06,2729,7,1372115440,1372115443,2,10,3
23716112@N06,2729,28,1372110169,1372110274,8,10,105
23716112@N06,2729,17,1372112218,1372112921,3,10,703
23716112@N06,2729,29,1372113442,1372113538,2,10,96
23716112@N06,2729,1,1372110153,1372124623,4,10,14470
23716112@N06,2729,26,1372110325,1372120551,8,10,10226
23716112@N06,2729,31,1372113554,1372113568,2,10,14
23716112@N06,2729,18,1372118017,1372118204,6,10,187
23716112@N06,2729,30,1372113358,1372113400,5,10,42
23716112@N06,2729,12,1372110329,1372110329,1,10,0
23720661@N08,2730,1,1225944480,1225944480,1,4,0
23720661@N08,2730,29,1225946418,1225946418,1,4,0
23720661@N08,2730,28,1225944508,1225949803,2,4,5295
23720661@N08,2730,20,1225946640,1225946640,1,4,0
23720661@N08,2731,17,1226055103,1226055103,1,2,0
23720661@N08,2731,27,1226055149,1226055149,1,2,0
23720661@N08,2732,29,1226112526,1226124150,5,5,11624
23720661@N08,2732,30,1226117753,1226124191,2,5,6438
23720661@N08,2732,20,1226123427,1226123427,1,5,0
23720661@N08,2732,22,1226112707,1226117222,2,5,4515
23720661@N08,2732,13,1226131792,1226131792,1,5,0
23720661@N08,2733,26,1226194016,1226194093,2,5,77
23720661@N08,2733,1,1226193557,1226200562,2,5,7005
23720661@N08,2733,28,1226200715,1226200715,1,5,0
23720661@N08,2733,29,1226196031,1226199402,2,5,3371
23720661@N08,2733,20,1226199394,1226199394,1,5,0
23720661@N08,2734,26,1226660390,1226660390,1,1,0
23720661@N08,2735,29,1226720751,1226720751,1,2,0
23720661@N08,2735,20,1226734691,1226734691,1,2,0
23720661@N08,2736,30,1227061820,1227061820,1,1,0
23720661@N08,2737,20,1227162162,1227162162,1,1,0
23720661@N08,2738,26,1227331270,1227331270,1,2,0
23720661@N08,2738,29,1227334088,1227334088,1,2,0
23720661@N08,2739,29,1227413309,1227413309,1,1,0
23720661@N08,2740,20,1227665049,1227665049,1,1,0
23720661@N08,2741,23,1227787322,1227787322,1,1,0
23720661@N08,2742,29,1227856304,1227856304,1,1,0
23720661@N08,2743,20,1227917748,1227917748,1,1,0
23720661@N08,2744,20,1227952514,1227952514,1,1,0
23720661@N08,2745,26,1228118194,1228118194,1,1,0
23720661@N08,2746,20,1228521342,1228521342,1,1,0
23720661@N08,2747,26,1228821984,1228821984,1,1,0
23720661@N08,2748,26,1229179586,1229179586,1,1,0
23720661@N08,2749,26,1229239971,1229239971,1,1,0
23720661@N08,2750,30,1229311863,1229311863,1,1,0
23720661@N08,2751,28,1230165867,1230165867,1,1,0
23720661@N08,2752,20,1230613250,1230613250,1,1,0
23720661@N08,2753,1,1230988134,1230988134,1,1,0
23720661@N08,2754,30,1231246017,1231246017,1,1,0
23720661@N08,2755,20,1231926571,1231926571,1,1,0
23720661@N08,2756,28,1232856484,1232856484,1,1,0
23720661@N08,2757,1,1232953584,1232953584,1,1,0
23720661@N08,2758,26,1237789518,1237789518,1,1,0
23720661@N08,2759,23,1240931897,1240931897,1,1,0
23720661@N08,2760,29,1241255960,1241255960,1,1,0
23720661@N08,2761,26,1241679915,1241679915,1,1,0
23720661@N08,2762,1,1243957563,1243957563,1,1,0
23720661@N08,2763,17,1247312538,1247312538,1,1,0
23751350@N02,2764,5,1395098777,1395098777,1,1,0
23759021@N07,2765,26,1343167207,1343167373,3,4,166
23759021@N07,2765,29,1343167465,1343167465,1,4,0
23759021@N07,2765,28,1343167104,1343167104,1,4,0
23759021@N07,2765,16,1343167541,1343167541,1,4,0
23806189@N00,2766,31,1303352100,1303352100,1,2,0
23806189@N00,2766,16,1303373376,1303373376,1,2,0
23806189@N00,2767,28,1384488087,1384488087,1,1,0
23807199@N00,2768,29,1278896470,1278897218,2,5,748
23807199@N00,2768,1,1278888535,1278888535,1,5,0
23807199@N00,2768,25,1278891481,1278891481,1,5,0
23807199@N00,2768,20,1278897402,1278897402,1,5,0
23807199@N00,2768,18,1278906473,1278906473,1,5,0
23807199@N00,2769,24,1278973676,1278973676,1,5,0
23807199@N00,2769,29,1278977580,1278977580,1,5,0
23807199@N00,2769,18,1278984064,1278984208,2,5,144
23807199@N00,2769,31,1278980733,1278981423,2,5,690
23807199@N00,2769,5,1278970956,1278970956,1,5,0
23807199@N00,2770,26,1279022641,1279022641,1,4,0
23807199@N00,2770,3,1279018155,1279018155,1,4,0
23807199@N00,2770,25,1279014130,1279015036,3,4,906
23807199@N00,2770,7,1279016039,1279021433,12,4,5394
23807199@N00,2771,16,1279070559,1279070559,1,3,0
23807199@N00,2771,3,1279068893,1279068893,1,3,0
23807199@N00,2771,7,1279067160,1279067858,3,3,698
23807199@N00,2772,21,1309997488,1309997503,2,7,15
23807199@N00,2772,5,1309995320,1309995320,1,7,0
23807199@N00,2772,29,1310007411,1310007804,2,7,393
23807199@N00,2772,1,1309992434,1309992434,1,7,0
23807199@N00,2772,17,1310013470,1310014136,3,7,666
23807199@N00,2772,25,1309999676,1310000393,8,7,717
23807199@N00,2772,7,1309996002,1309996002,1,7,0
23807199@N00,2773,17,1310089514,1310090398,9,9,884
23807199@N00,2773,4,1310085528,1310085574,3,9,46
23807199@N00,2773,28,1310082183,1310082183,1,9,0
23807199@N00,2773,29,1310096445,1310107439,6,9,10994
23807199@N00,2773,1,1310080174,1310080174,1,9,0
23807199@N00,2773,25,1310087251,1310087784,3,9,533
23807199@N00,2773,23,1310091990,1310091990,1,9,0
23807199@N00,2773,7,1310110475,1310110686,5,9,211
23807199@N00,2773,18,1310099617,1310101422,10,9,1805
23807199@N00,2774,11,1371462761,1371462761,1,9,0
23807199@N00,2774,4,1371427991,1371428003,3,9,12
23807199@N00,2774,29,1371432954,1371433433,5,9,479
23807199@N00,2774,1,1371420198,1371420198,1,9,0
23807199@N00,2774,25,1371420897,1371462784,13,9,41887
23807199@N00,2774,7,1371427347,1371427486,2,9,139
23807199@N00,2774,24,1371457842,1371457842,1,9,0
23807199@N00,2774,20,1371435834,1371435834,1,9,0
23807199@N00,2774,16,1371455925,1371456168,4,9,243
23807199@N00,2775,31,1371538689,1371538689,1,3,0
23807199@N00,2775,28,1371536002,1371536002,1,3,0
23807199@N00,2775,6,1371520554,1371520629,3,3,75
23807199@N00,2776,13,1371616965,1371616965,1,4,0
23807199@N00,2776,29,1371612238,1371634084,5,4,21846
23807199@N00,2776,25,1371621789,1371622395,4,4,606
23807199@N00,2776,18,1371614007,1371615301,4,4,1294
23807199@N00,2777,28,1371693336,1371693336,1,5,0
23807199@N00,2777,23,1371683881,1371683881,1,5,0
23807199@N00,2777,24,1371689269,1371690346,4,5,1077
23807199@N00,2777,12,1371688138,1371688171,2,5,33
23807199@N00,2777,18,1371685547,1371685547,1,5,0
23807199@N00,2778,25,1419574940,1419574940,1,1,0
23807199@N00,2779,25,1419663066,1419666087,19,2,3021
23807199@N00,2779,6,1419636244,1419636424,2,2,180
23807199@N00,2780,18,1419725831,1419726616,3,1,785
23807199@N00,2781,13,1419809930,1419810639,4,2,709
23807199@N00,2781,25,1419806716,1419806716,1,2,0
23835518@N02,2782,16,1293986680,1293986684,3,2,4
23835518@N02,2782,31,1293986686,1293986686,1,2,0
23836685@N07,2783,30,1294703527,1294740424,40,1,36897
23837366@N00,2784,20,1352002529,1352002529,1,1,0
23837366@N00,2785,14,1355030365,1355030365,1,1,0
23837366@N00,2786,26,1355916246,1355916246,1,3,0
23837366@N00,2786,25,1355914646,1355914646,1,3,0
23837366@N00,2786,28,1355916360,1355916360,1,3,0
23837366@N00,2787,26,1357443461,1357462666,4,4,19205
23837366@N00,2787,13,1357456629,1357456629,1,4,0
23837366@N00,2787,30,1357446393,1357447474,6,4,1081
23837366@N00,2787,20,1357448831,1357449109,3,4,278
23837366@N00,2788,29,1359859478,1359859478,1,2,0
23837366@N00,2788,31,1359859505,1359859505,1,2,0
23837366@N00,2789,10,1363320361,1363320361,1,1,0
23837366@N00,2790,7,1368947923,1368947923,1,2,0
23837366@N00,2790,25,1368949378,1368950335,2,2,957
23837366@N00,2791,20,1379924835,1379924835,1,4,0
23837366@N00,2791,1,1379914973,1379914973,1,4,0
23837366@N00,2791,28,1379915274,1379915334,2,4,60
23837366@N00,2791,30,1379924565,1379924565,1,4,0
23837366@N00,2792,1,1380443819,1380443819,1,2,0
23837366@N00,2792,28,1380449235,1380449315,2,2,80
23837366@N00,2793,18,1384659891,1384659989,2,1,98
23837366@N00,2794,28,1387083960,1387083960,1,1,0
23837366@N00,2795,31,1411876882,1411876882,1,1,0
23837366@N00,2796,16,1434366923,1434366929,2,1,6
23837366@N00,2797,31,1441618310,1441618310,1,1,0
23837366@N00,2798,20,1445307148,1445307148,1,2,0
23837366@N00,2798,29,1445312538,1445312538,1,2,0
23837366@N00,2799,20,1449824911,1449824911,1,3,0
23837366@N00,2799,28,1449829120,1449829131,2,3,11
23837366@N00,2799,25,1449820977,1449820977,1,3,0
23837366@N00,2800,22,1452052711,1452053380,6,2,669
23837366@N00,2800,6,1452046252,1452046252,1,2,0
23837366@N00,2801,21,1456651038,1456651038,1,1,0
23837366@N00,2802,29,1460886884,1460886968,2,1,84
23837366@N00,2803,28,1465461073,1465461305,3,3,232
23837366@N00,2803,26,1465459768,1465459768,1,3,0
23837366@N00,2803,3,1465464203,1465464203,1,3,0
23858875@N05,2804,22,1237972091,1237972091,1,1,0
23866387@N03,2805,31,1347761677,1347761738,2,3,61
23866387@N03,2805,20,1347760607,1347761589,3,3,982
23866387@N03,2805,30,1347765433,1347765857,2,3,424
23866387@N03,2806,23,1350802684,1350804002,5,9,1318
23866387@N03,2806,18,1350802690,1350804008,8,9,1318
23866387@N03,2806,14,1350808029,1350808029,1,9,0
23866387@N03,2806,20,1350804835,1350805645,14,9,810
23866387@N03,2806,17,1350798492,1350798498,2,9,6
23866387@N03,2806,22,1350805766,1350808675,2,9,2909
23866387@N03,2806,11,1350781011,1350781011,1,9,0
23866387@N03,2806,28,1350799342,1350812408,2,9,13066
23866387@N03,2806,5,1350779980,1350780291,2,9,311
23866387@N03,2807,23,1351993134,1351993240,3,5,106
23866387@N03,2807,8,1351993441,1351993441,1,5,0
23866387@N03,2807,29,1351998239,1351998306,3,5,67
23866387@N03,2807,30,1351995999,1351996025,2,5,26
23866387@N03,2807,22,1352000223,1352000815,4,5,592
23866387@N03,2808,13,1352098404,1352098494,4,2,90
23866387@N03,2808,20,1352096230,1352096614,13,2,384
23866387@N03,2809,26,1353459812,1353460230,3,3,418
23866387@N03,2809,1,1353459597,1353459597,1,3,0
23866387@N03,2809,28,1353459624,1353459624,1,3,0
23866387@N03,2810,29,1354424770,1354444537,5,14,19767
23866387@N03,2810,15,1354434942,1354434942,1,14,0
23866387@N03,2810,12,1354411872,1354411872,1,14,0
23866387@N03,2810,20,1354431189,1354431540,13,14,351
23866387@N03,2810,30,1354431047,1354431047,1,14,0
23866387@N03,2810,26,1354444055,1354444055,1,14,0
23866387@N03,2810,1,1354409384,1354409384,1,14,0
23866387@N03,2810,31,1354444612,1354444627,3,14,15
23866387@N03,2810,18,1354424416,1354424823,6,14,407
23866387@N03,2810,24,1354411760,1354411833,4,14,73
23866387@N03,2810,3,1354434640,1354434660,2,14,20
23866387@N03,2810,21,1354446031,1354446034,2,14,3
23866387@N03,2810,25,1354413168,1354447367,49,14,34199
23866387@N03,2810,19,1354424734,1354424924,6,14,190
23866387@N03,2811,29,1355116230,1355116230,1,15,0
23866387@N03,2811,15,1355115285,1355115295,3,15,10
23866387@N03,2811,12,1355115383,1355115383,1,15,0
23866387@N03,2811,30,1355110317,1355117601,6,15,7284
23866387@N03,2811,26,1355120030,1355120030,1,15,0
23866387@N03,2811,9,1355119915,1355119920,2,15,5
23866387@N03,2811,28,1355122398,1355122402,2,15,4
23866387@N03,2811,24,1355115386,1355115497,4,15,111
23866387@N03,2811,4,1355121453,1355121472,2,15,19
23866387@N03,2811,3,1355113482,1355113493,2,15,11
23866387@N03,2811,21,1355121364,1355121422,5,15,58
23866387@N03,2811,10,1355120058,1355120067,3,15,9
23866387@N03,2811,6,1355119928,1355119951,4,15,23
23866387@N03,2811,7,1355119887,1355119887,1,15,0
23866387@N03,2811,22,1355116281,1355116281,1,15,0
23866387@N03,2812,29,1357019311,1357019949,2,8,638
23866387@N03,2812,20,1357018376,1357018391,3,8,15
23866387@N03,2812,30,1357014605,1357019928,12,8,5323
23866387@N03,2812,28,1357021068,1357021193,6,8,125
23866387@N03,2812,14,1357016577,1357017091,2,8,514
23866387@N03,2812,21,1357010270,1357010270,1,8,0
23866387@N03,2812,31,1357015099,1357020087,11,8,4988
23866387@N03,2812,22,1357015102,1357020121,16,8,5019
23866387@N03,2813,29,1362886998,1362889377,3,8,2379
23866387@N03,2813,20,1362889035,1362889717,7,8,682
23866387@N03,2813,15,1362896425,1362897078,4,8,653
23866387@N03,2813,1,1362887244,1362887244,1,8,0
23866387@N03,2813,25,1362893322,1362894102,4,8,780
23866387@N03,2813,17,1362907687,1362907687,1,8,0
23866387@N03,2813,31,1362889076,1362889166,3,8,90
23866387@N03,2813,22,1362890434,1362890441,2,8,7
23866387@N03,2814,29,1365312375,1365312375,1,9,0
23866387@N03,2814,15,1365303630,1365303630,1,9,0
23866387@N03,2814,20,1365309635,1365310141,7,9,506
23866387@N03,2814,30,1365312057,1365312060,2,9,3
23866387@N03,2814,1,1365315391,1365315615,3,9,224
23866387@N03,2814,14,1365310136,1365310136,1,9,0
23866387@N03,2814,24,1365302622,1365302682,2,9,60
23866387@N03,2814,31,1365307802,1365312728,5,9,4926
23866387@N03,2814,22,1365309705,1365312585,6,9,2880
23866387@N03,2815,29,1367128356,1367128629,13,4,273
23866387@N03,2815,15,1367131619,1367131619,1,4,0
23866387@N03,2815,18,1367124112,1367124112,1,4,0
23866387@N03,2815,27,1367131280,1367131280,1,4,0
23866387@N03,2816,29,1369628911,1369633528,3,6,4617
23866387@N03,2816,20,1369633568,1369634426,8,6,858
23866387@N03,2816,1,1369637415,1369637652,3,6,237
23866387@N03,2816,31,1369633516,1369633547,3,6,31
23866387@N03,2816,14,1369631709,1369632428,2,6,719
23866387@N03,2816,24,1369625782,1369625782,1,6,0
23866387@N03,2817,29,1373101461,1373102188,3,9,727
23866387@N03,2817,8,1373105934,1373105944,3,9,10
23866387@N03,2817,20,1373103470,1373103470,1,9,0
23866387@N03,2817,30,1373104373,1373104373,1,9,0
23866387@N03,2817,1,1373100619,1373100636,2,9,17
23866387@N03,2817,9,1373106984,1373106984,1,9,0
23866387@N03,2817,6,1373105247,1373105247,1,9,0
23866387@N03,2817,7,1373106637,1373106643,2,9,6
23866387@N03,2817,31,1373101648,1373101702,2,9,54
23866387@N03,2818,29,1376198434,1376198434,1,9,0
23866387@N03,2818,8,1376193060,1376193060,1,9,0
23866387@N03,2818,20,1376194666,1376195695,8,9,1029
23866387@N03,2818,5,1376192402,1376192407,2,9,5
23866387@N03,2818,14,1376199405,1376199515,2,9,110
23866387@N03,2818,24,1376191719,1376191726,4,9,7
23866387@N03,2818,22,1376199436,1376199522,3,9,86
23866387@N03,2818,7,1376192827,1376193016,5,9,189
23866387@N03,2818,19,1376196103,1376196436,8,9,333
23866387@N03,2819,20,1380333410,1380335169,16,6,1759
23866387@N03,2819,30,1380337746,1380337746,1,6,0
23866387@N03,2819,19,1380335389,1380335389,1,6,0
23866387@N03,2819,14,1380335068,1380335068,2,6,0
23866387@N03,2819,31,1380332854,1380332854,1,6,0
23866387@N03,2819,22,1380334651,1380334651,1,6,0
23866387@N03,2820,15,1380942923,1380943490,2,3,567
23866387@N03,2820,1,1380944809,1380944809,1,3,0
23866387@N03,2820,29,1380945908,1380946831,2,3,923
23866387@N03,2821,31,1382924159,1382924165,2,10,6
23866387@N03,2821,22,1382924146,1382930475,2,10,6329
23866387@N03,2821,1,1382922867,1382922918,2,10,51
23866387@N03,2821,13,1382929134,1382929134,1,10,0
23866387@N03,2821,18,1382933785,1382933875,2,10,90
23866387@N03,2821,19,1382931694,1382931694,1,10,0
23866387@N03,2821,15,1382922622,1382922773,6,10,151
23866387@N03,2821,23,1382933282,1382934887,2,10,1605
23866387@N03,2821,20,1382923926,1382924594,17,10,668
23866387@N03,2821,17,1382922779,1382926172,8,10,3393
23866387@N03,2822,31,1384662960,1384662960,1,12,0
23866387@N03,2822,28,1384665460,1384665460,1,12,0
23866387@N03,2822,24,1384684536,1384684568,4,12,32
23866387@N03,2822,26,1384678329,1384678352,2,12,23
23866387@N03,2822,18,1384686257,1384686257,1,12,0
23866387@N03,2822,3,1384679671,1384679676,2,12,5
23866387@N03,2822,21,1384680068,1384689787,3,12,9719
23866387@N03,2822,25,1384680181,1384689795,37,12,9614
23866387@N03,2822,15,1384661220,1384661238,3,12,18
23866387@N03,2822,1,1384677221,1384677364,2,12,143
23866387@N03,2822,20,1384688426,1384689783,7,12,1357
23866387@N03,2822,29,1384664939,1384664964,2,12,25
23866387@N03,2823,24,1386566248,1386566253,3,5,5
23866387@N03,2823,13,1386570667,1386571466,7,5,799
23866387@N03,2823,26,1386562161,1386562161,1,5,0
23866387@N03,2823,3,1386563007,1386563007,1,5,0
23866387@N03,2823,21,1386565071,1386570410,5,5,5339
23866387@N03,2824,22,1389494701,1389496815,2,4,2114
23866387@N03,2824,26,1389492400,1389492401,2,4,1
23866387@N03,2824,21,1389493008,1389493010,2,4,2
23866387@N03,2824,25,1389492721,1389493806,6,4,1085
23866387@N03,2825,31,1390702919,1390702919,1,5,0
23866387@N03,2825,22,1390703556,1390704974,2,5,1418
23866387@N03,2825,18,1390702539,1390702539,1,5,0
23866387@N03,2825,19,1390702534,1390714183,3,5,11649
23866387@N03,2825,1,1390712161,1390712161,1,5,0
23866387@N03,2826,31,1398050993,1398050993,1,5,0
23866387@N03,2826,28,1398057327,1398057341,2,5,14
23866387@N03,2826,6,1398054459,1398055310,6,5,851
23866387@N03,2826,30,1398053695,1398056180,7,5,2485
23866387@N03,2826,7,1398054346,1398054574,2,5,228
23866387@N03,2827,31,1400384542,1400384542,1,5,0
23866387@N03,2827,22,1400384291,1400384291,1,5,0
23866387@N03,2827,28,1400391564,1400391564,1,5,0
23866387@N03,2827,30,1400383892,1400393160,22,5,9268
23866387@N03,2827,29,1400384003,1400384003,1,5,0
23866387@N03,2828,8,1408191374,1408191446,9,9,72
23866387@N03,2828,14,1408188691,1408188693,2,9,2
23866387@N03,2828,12,1408183064,1408183813,2,9,749
23866387@N03,2828,3,1408191062,1408191349,14,9,287
23866387@N03,2828,10,1408185218,1408185275,5,9,57
23866387@N03,2828,5,1408191400,1408191518,10,9,118
23866387@N03,2828,30,1408184802,1408189164,13,9,4362
23866387@N03,2828,20,1408188659,1408188659,1,9,0
23866387@N03,2828,29,1408186293,1408189163,5,9,2870
23866387@N03,2829,31,1410691891,1410692067,19,6,176
23866387@N03,2829,24,1410697151,1410697185,3,6,34
23866387@N03,2829,18,1410694504,1410694569,9,6,65
23866387@N03,2829,22,1410692165,1410692256,13,6,91
23866387@N03,2829,20,1410691326,1410692709,50,6,1383
23866387@N03,2829,17,1410688212,1410695032,7,6,6820
23877122@N08,2830,4,1205363274,1205363274,1,1,0
23877277@N08,2831,25,1319323746,1319323746,1,1,0
23877277@N08,2832,28,1323507422,1323507422,1,1,0
23881252@N00,2833,15,1413438762,1413438762,1,1,0
23933172@N00,2834,1,1227189668,1227189668,1,5,0
23933172@N00,2834,29,1227181066,1227182776,2,5,1710
23933172@N00,2834,28,1227189516,1227189516,1,5,0
23933172@N00,2834,27,1227177166,1227177166,1,5,0
23933172@N00,2834,22,1227184267,1227184417,2,5,150
23933172@N00,2835,29,1266712574,1266712574,1,1,0
23944567@N05,2836,28,1224222832,1224222832,1,2,0
23944567@N05,2836,17,1224223091,1224223091,1,2,0
23951075@N06,2837,21,1214371821,1214371821,1,2,0
23951075@N06,2837,7,1214370641,1214370641,1,2,0
23951075@N06,2838,7,1238361640,1238361640,1,2,0
23951075@N06,2838,26,1238361184,1238361184,1,2,0
23951075@N06,2839,7,1255933561,1255933561,1,1,0
23951075@N06,2840,7,1260623880,1260666900,6,1,43020
23951075@N06,2841,7,1260729272,1260729272,1,1,0
23951075@N06,2842,7,1262466843,1262501780,28,7,34937
23951075@N06,2842,28,1262464979,1262465065,2,7,86
23951075@N06,2842,11,1262478724,1262478724,1,7,0
23951075@N06,2842,20,1262467518,1262467518,1,7,0
23951075@N06,2842,13,1262474024,1262474024,1,7,0
23951075@N06,2842,30,1262490927,1262498105,3,7,7178
23951075@N06,2842,29,1262467456,1262493819,6,7,26363
23951075@N06,2843,7,1262562932,1262589458,21,5,26526
23951075@N06,2843,26,1262574621,1262576656,5,5,2035
23951075@N06,2843,16,1262577234,1262577234,1,5,0
23951075@N06,2843,22,1262572308,1262572322,2,5,14
23951075@N06,2843,23,1262574226,1262574226,1,5,0
23951075@N06,2844,7,1262644846,1262645529,2,6,683
23951075@N06,2844,26,1262643038,1262643038,1,6,0
23951075@N06,2844,28,1262650442,1262650442,1,6,0
23951075@N06,2844,4,1262643831,1262644039,2,6,208
23951075@N06,2844,29,1262649218,1262649218,1,6,0
23951075@N06,2844,21,1262644532,1262645711,5,6,1179
23951075@N06,2845,7,1272094602,1272094602,1,12,0
23951075@N06,2845,11,1272094875,1272094875,1,12,0
23951075@N06,2845,18,1272098587,1272098587,1,12,0
23951075@N06,2845,13,1272070073,1272071156,6,12,1083
23951075@N06,2845,26,1272062249,1272093932,4,12,31683
23951075@N06,2845,3,1272094238,1272094238,1,12,0
23951075@N06,2845,1,1272093338,1272093338,1,12,0
23951075@N06,2845,8,1272072031,1272072031,1,12,0
23951075@N06,2845,16,1272099950,1272100653,2,12,703
23951075@N06,2845,29,1272062597,1272062597,1,12,0
23951075@N06,2845,10,1272094638,1272097205,2,12,2567
23951075@N06,2845,21,1272095155,1272096374,3,12,1219
23951075@N06,2846,18,1272166464,1272166464,1,3,0
23951075@N06,2846,23,1272166161,1272166161,1,3,0
23951075@N06,2846,11,1272160478,1272160478,1,3,0
23951075@N06,2847,28,1277457325,1277457589,5,8,264
23951075@N06,2847,27,1277453198,1277455511,4,8,2313
23951075@N06,2847,26,1277455788,1277455884,2,8,96
23951075@N06,2847,17,1277454366,1277454366,1,8,0
23951075@N06,2847,16,1277455642,1277455642,1,8,0
23951075@N06,2847,6,1277456522,1277456522,1,8,0
23951075@N06,2847,10,1277455976,1277455976,1,8,0
23951075@N06,2847,21,1277456697,1277456697,1,8,0
23951075@N06,2848,18,1277505377,1277506024,3,12,647
23951075@N06,2848,5,1277511184,1277511184,1,12,0
23951075@N06,2848,28,1277502051,1277502051,1,12,0
23951075@N06,2848,20,1277504111,1277504637,4,12,526
23951075@N06,2848,12,1277506597,1277507008,2,12,411
23951075@N06,2848,13,1277508776,1277508776,1,12,0
23951075@N06,2848,26,1277502166,1277502220,2,12,54
23951075@N06,2848,3,1277509297,1277511647,2,12,2350
23951075@N06,2848,19,1277505321,1277505792,5,12,471
23951075@N06,2848,31,1277526179,1277526179,1,12,0
23951075@N06,2848,29,1277504934,1277505696,4,12,762
23951075@N06,2848,21,1277510432,1277510432,1,12,0
23951075@N06,2849,7,1277599750,1277599750,1,6,0
23951075@N06,2849,28,1277603025,1277603025,1,6,0
23951075@N06,2849,3,1277600070,1277600070,1,6,0
23951075@N06,2849,26,1277597600,1277597600,1,6,0
23951075@N06,2849,8,1277598171,1277598171,1,6,0
23951075@N06,2849,21,1277600004,1277600004,1,6,0
23951075@N06,2850,26,1288302785,1288303340,6,5,555
23951075@N06,2850,29,1288304860,1288314229,4,5,9369
23951075@N06,2850,30,1288303686,1288303686,1,5,0
23951075@N06,2850,12,1288307849,1288307849,1,5,0
23951075@N06,2850,20,1288314736,1288314833,2,5,97
23951075@N06,2851,27,1306806589,1306806589,1,1,0
23951075@N06,2852,27,1325473354,1325473354,1,1,0
23951075@N06,2853,28,1325568186,1325568186,1,1,0
23951075@N06,2854,26,1325717877,1325717877,1,1,0
23965310@N07,2855,1,1415605147,1415605147,1,2,0
23965310@N07,2855,13,1415608594,1415608594,1,2,0
23965310@N07,2856,5,1416881791,1416881791,1,5,0
23965310@N07,2856,3,1416882619,1416882619,1,5,0
23965310@N07,2856,29,1416889216,1416889216,1,5,0
23965310@N07,2856,22,1416891429,1416891429,1,5,0
23965310@N07,2856,31,1416890105,1416890733,5,5,628
23965310@N07,2857,21,1427964655,1427964655,1,1,0
23965310@N07,2858,17,1454743711,1454743711,1,8,0
23965310@N07,2858,26,1454739047,1454742948,2,8,3901
23965310@N07,2858,11,1454736419,1454736419,1,8,0
23965310@N07,2858,19,1454741617,1454741665,3,8,48
23965310@N07,2858,23,1454739236,1454742107,2,8,2871
23965310@N07,2858,4,1454736218,1454736218,1,8,0
23965310@N07,2858,15,1454743986,1454745676,17,8,1690
23965310@N07,2858,27,1454733123,1454743395,2,8,10272
23965310@N07,2859,28,1458993382,1458993402,2,6,20
23965310@N07,2859,16,1458986541,1458987064,2,6,523
23965310@N07,2859,3,1458988967,1458988967,1,6,0
23965310@N07,2859,30,1458985057,1458985057,1,6,0
23965310@N07,2859,15,1458973739,1458973765,2,6,26
23965310@N07,2859,27,1458987112,1458987112,1,6,0
23988660@N06,2860,1,1382999724,1382999724,1,1,0
24034668@N07,2861,18,1441320860,1441320860,1,1,0
24046138@N00,2862,29,1359267243,1359267243,1,1,0
24063938@N02,2863,26,1323592436,1323592436,1,2,0
24063938@N02,2863,28,1323587719,1323599655,2,2,11936
24064040@N08,2864,25,1310985338,1310985338,1,4,0
24064040@N08,2864,21,1310984702,1310984702,1,4,0
24064040@N08,2864,11,1310982284,1310982284,1,4,0
24064040@N08,2864,3,1310982684,1310982684,1,4,0
24068712@N00,2865,26,1295636593,1295636593,1,1,0
24068712@N00,2866,10,1305395948,1305395948,1,3,0
24068712@N00,2866,20,1305376366,1305376366,1,3,0
24068712@N00,2866,30,1305396256,1305396256,1,3,0
24074281@N06,2867,3,1240363042,1240363042,1,1,0
24078248@N00,2868,15,1393108979,1393135761,21,1,26782
24089179@N00,2869,28,1199055596,1199076082,2,1,20486
24089179@N00,2870,28,1199107156,1199108478,2,1,1322
24089179@N00,2871,28,1199154050,1199154699,4,1,649
24089179@N00,2872,28,1199229250,1199277086,5,1,47836
24089179@N00,2873,28,1199328718,1199329801,5,1,1083
24090212@N04,2874,12,1237849342,1237849342,1,3,0
24090212@N04,2874,11,1237853610,1237853610,1,3,0
24090212@N04,2874,4,1237851958,1237852037,2,3,79
24090212@N04,2875,9,1238033308,1238033315,2,9,7
24090212@N04,2875,22,1238019483,1238019483,1,9,0
24090212@N04,2875,12,1238011980,1238013243,10,9,1263
24090212@N04,2875,26,1238014941,1238023950,2,9,9009
24090212@N04,2875,31,1238018536,1238021816,13,9,3280
24090212@N04,2875,30,1238021902,1238022121,2,9,219
24090212@N04,2875,13,1238032867,1238033016,5,9,149
24090212@N04,2875,24,1238025566,1238025750,4,9,184
24090212@N04,2875,18,1238016110,1238016344,6,9,234
24108474@N06,2876,1,1316762881,1316762881,1,1,0
24122903@N00,2877,17,1292238316,1292238316,1,1,0
24122903@N00,2878,3,1298266926,1298266926,1,4,0
24122903@N00,2878,17,1298263446,1298287764,3,4,24318
24122903@N00,2878,5,1298268978,1298268978,1,4,0
24122903@N00,2878,26,1298262584,1298262584,1,4,0
24122903@N00,2879,27,1313286838,1313286838,1,1,0
24122903@N00,2880,29,1313543259,1313543259,1,1,0
24122903@N00,2881,1,1383167451,1383167451,1,1,0
24122903@N00,2882,22,1405887392,1405887392,1,1,0
24122903@N00,2883,17,1422681768,1422681768,1,1,0
24124275@N08,2884,3,1427007000,1427007000,1,1,0
24153575@N00,2885,29,1345004782,1345004782,1,1,0
24153575@N00,2886,20,1345268799,1345268799,1,1,0
24153575@N00,2887,30,1345370631,1345370631,1,1,0
24153575@N00,2888,12,1345471078,1345471078,1,1,0
24153575@N00,2889,7,1345556284,1345556284,1,1,0
24153575@N00,2890,3,1347104943,1347104943,1,1,0
24207284@N03,2891,14,1353546153,1353546165,2,7,12
24207284@N03,2891,15,1353558020,1353558039,3,7,19
24207284@N03,2891,30,1353550331,1353550339,2,7,8
24207284@N03,2891,20,1353546251,1353546467,4,7,216
24207284@N03,2891,28,1353562864,1353562885,3,7,21
24207284@N03,2891,22,1353546169,1353546526,11,7,357
24207284@N03,2891,24,1353553617,1353553631,3,7,14
24230954@N06,2892,1,1218073667,1218073667,1,3,0
24230954@N06,2892,3,1218078050,1218080646,2,3,2596
24230954@N06,2892,26,1218077976,1218078059,2,3,83
24293654@N00,2893,1,1319543732,1319543732,1,1,0
24293654@N00,2894,24,1320023542,1320023543,2,2,1
24293654@N00,2894,5,1320023545,1320023545,1,2,0
24293654@N00,2895,25,1320064569,1320064569,2,6,0
24293654@N00,2895,1,1320064568,1320064597,42,6,29
24293654@N00,2895,16,1320064597,1320064601,10,6,4
24293654@N00,2895,6,1320064572,1320064572,1,6,0
24293654@N00,2895,28,1320064568,1320064568,1,6,0
24293654@N00,2895,26,1320064570,1320064572,4,6,2
24293654@N00,2896,18,1362390252,1362390252,1,1,0
24293654@N00,2897,1,1382342578,1382342578,1,1,0
24295504@N05,2898,17,1298209083,1298209083,1,1,0
24295504@N05,2899,26,1304231713,1304231713,1,1,0
24295504@N05,2900,29,1305798267,1305798314,2,3,47
24295504@N05,2900,17,1305790889,1305790889,1,3,0
24295504@N05,2900,21,1305793366,1305793366,1,3,0
24295504@N05,2901,16,1306237687,1306237687,1,3,0
24295504@N05,2901,27,1306228981,1306228981,1,3,0
24295504@N05,2901,28,1306231276,1306231276,1,3,0
24295504@N05,2902,23,1314093105,1314096159,9,5,3054
24295504@N05,2902,19,1314092276,1314092666,4,5,390
24295504@N05,2902,18,1314092916,1314097214,10,5,4298
24295504@N05,2902,29,1314092837,1314092837,1,5,0
24295504@N05,2902,28,1314092705,1314092861,2,5,156
24295504@N05,2903,18,1314871174,1314871174,1,1,0
24295504@N05,2904,18,1316155633,1316158804,2,3,3171
24295504@N05,2904,23,1316158797,1316158819,4,3,22
24295504@N05,2904,19,1316154982,1316155419,6,3,437
24295504@N05,2905,18,1316190793,1316191456,2,2,663
24295504@N05,2905,23,1316190780,1316190780,1,2,0
24295504@N05,2906,18,1318930481,1318930481,1,1,0
24295504@N05,2907,6,1321169254,1321169254,1,2,0
24295504@N05,2907,26,1321171382,1321171589,3,2,207
24295504@N05,2908,20,1325834718,1325834718,1,3,0
24295504@N05,2908,23,1325838372,1325838372,1,3,0
24295504@N05,2908,29,1325858189,1325858189,1,3,0
24295504@N05,2909,20,1328451489,1328451489,1,1,0
24295504@N05,2910,24,1331615880,1331616029,2,1,149
24328796@N05,2911,28,1295172446,1295172446,1,1,0
24328796@N05,2912,23,1297552823,1297552823,1,1,0
24328796@N05,2913,26,1297597988,1297597988,1,1,0
24328796@N05,2914,29,1301820324,1301820324,1,1,0
24328796@N05,2915,16,1321411244,1321411670,3,3,426
24328796@N05,2915,4,1321421858,1321421858,1,3,0
24328796@N05,2915,8,1321423418,1321423418,1,3,0
24328796@N05,2916,28,1356037065,1356037065,1,1,0
24328796@N05,2917,28,1356094086,1356094086,1,1,0
24328796@N05,2918,26,1362310113,1362310113,1,1,0
24329359@N00,2919,28,1350297975,1350297975,1,1,0
24342711@N06,2920,26,1287304078,1287304078,1,1,0
24344010@N02,2921,23,1437218514,1437218514,1,1,0
24353989@N06,2922,17,1204168528,1204168528,1,4,0
24353989@N06,2922,16,1204182904,1204182904,1,4,0
24353989@N06,2922,26,1204162976,1204163100,2,4,124
24353989@N06,2922,1,1204152474,1204152474,1,4,0
24354425@N03,2923,27,1295353819,1295353819,1,2,0
24354425@N03,2923,17,1295353933,1295353933,1,2,0
24356860@N00,2924,1,1374283012,1374283012,1,1,0
24356860@N00,2925,27,1374320023,1374320023,1,2,0
24356860@N00,2925,28,1374326967,1374326967,1,2,0
24356860@N00,2926,22,1374387867,1374387867,1,1,0
24376530@N00,2927,26,1300750159,1300750159,1,1,0
24435646@N00,2928,26,1209112492,1209126419,10,4,13927
24435646@N00,2928,17,1209119263,1209119455,3,4,192
24435646@N00,2928,27,1209119615,1209119668,4,4,53
24435646@N00,2928,1,1209110419,1209110431,2,4,12
24435646@N00,2929,18,1444722456,1444722456,1,1,0
24435646@N00,2930,18,1446534077,1446535131,2,1,1054
24435646@N00,2931,18,1454652498,1454652498,1,1,0
24435646@N00,2932,18,1454806228,1454809796,2,2,3568
24435646@N00,2932,15,1454806993,1454806993,1,2,0
24435646@N00,2933,18,1457751378,1457751436,2,1,58
24435646@N00,2934,26,1469327115,1469327115,1,1,0
24435646@N00,2935,26,1470561680,1470561680,1,1,0
24503701@N02,2936,17,1282260565,1282260565,1,3,0
24503701@N02,2936,1,1282255403,1282256603,2,3,1200
24503701@N02,2936,22,1282262186,1282262249,2,3,63
24503701@N02,2937,26,1282342663,1282342663,1,6,0
24503701@N02,2937,20,1282346436,1282346436,1,6,0
24503701@N02,2937,12,1282343723,1282343723,1,6,0
24503701@N02,2937,21,1282349444,1282349444,1,6,0
24503701@N02,2937,29,1282347176,1282347176,1,6,0
24503701@N02,2937,3,1282343559,1282343559,1,6,0
24509213@N00,2938,24,1434965747,1434965747,2,7,0
24509213@N00,2938,26,1434968283,1434968283,1,7,0
24509213@N00,2938,15,1434957639,1434957639,1,7,0
24509213@N00,2938,28,1434973560,1434973560,1,7,0
24509213@N00,2938,17,1434954447,1434954447,1,7,0
24509213@N00,2938,11,1434937411,1434937411,1,7,0
24509213@N00,2938,25,1434959605,1434959605,1,7,0
24509213@N00,2939,30,1435151145,1435151151,2,7,6
24509213@N00,2939,26,1435122479,1435128208,2,7,5729
24509213@N00,2939,21,1435143279,1435144118,3,7,839
24509213@N00,2939,13,1435130706,1435130706,1,7,0
24509213@N00,2939,4,1435140068,1435140068,1,7,0
24509213@N00,2939,28,1435112698,1435112698,1,7,0
24509213@N00,2939,25,1435143362,1435143569,3,7,207
24509213@N00,2940,16,1435297893,1435297893,1,3,0
24509213@N00,2940,24,1435313559,1435313559,1,3,0
24509213@N00,2940,26,1435293140,1435293140,1,3,0
24528629@N06,2941,29,1368571205,1368571205,2,1,0
24528629@N06,2942,11,1368669985,1368694778,17,16,24793
24528629@N06,2942,12,1368689309,1368691607,8,16,2298
24528629@N06,2942,18,1368684654,1368686512,12,16,1858
24528629@N06,2942,1,1368665743,1368666153,10,16,410
24528629@N06,2942,30,1368678604,1368678648,8,16,44
24528629@N06,2942,16,1368698596,1368698664,6,16,68
24528629@N06,2942,24,1368690037,1368694606,22,16,4569
24528629@N06,2942,29,1368682581,1368696684,10,16,14103
24528629@N06,2942,21,1368669991,1368691757,25,16,21766
24528629@N06,2942,26,1368666502,1368666932,18,16,430
24528629@N06,2942,19,1368684114,1368686329,13,16,2215
24528629@N06,2942,15,1368693372,1368695017,6,16,1645
24528629@N06,2942,7,1368666989,1368667481,14,16,492
24528629@N06,2942,25,1368673975,1368677803,22,16,3828
24528629@N06,2942,28,1368666186,1368699668,32,16,33482
24528629@N06,2942,4,1368667473,1368691380,31,16,23907
24528629@N06,2943,8,1368756055,1368756055,2,14,0
24528629@N06,2943,11,1368757175,1368773940,18,14,16765
24528629@N06,2943,30,1368758873,1368758873,2,14,0
24528629@N06,2943,17,1368764908,1368767254,10,14,2346
24528629@N06,2943,31,1368775463,1368775463,2,14,0
24528629@N06,2943,20,1368775527,1368775560,6,14,33
24528629@N06,2943,6,1368759638,1368759638,2,14,0
24528629@N06,2943,24,1368770776,1368770776,2,14,0
24528629@N06,2943,29,1368778441,1368779860,8,14,1419
24528629@N06,2943,26,1368762135,1368787099,17,14,24964
24528629@N06,2943,28,1368756014,1368756014,2,14,0
24528629@N06,2943,10,1368761178,1368762492,12,14,1314
24528629@N06,2943,9,1368768880,1368768880,1,14,0
24528629@N06,2943,4,1368757136,1368759026,6,14,1890
24537422@N02,2944,1,1395092079,1395172817,95,1,80738
24537422@N02,2945,15,1395283462,1395283493,5,7,31
24537422@N02,2945,18,1395299589,1395299589,1,7,0
24537422@N02,2945,23,1395299499,1395299523,3,7,24
24537422@N02,2945,11,1395279581,1395279581,1,7,0
24537422@N02,2945,14,1395275365,1395275365,1,7,0
24537422@N02,2945,1,1395266079,1395273842,69,7,7763
24537422@N02,2945,28,1395265825,1395265827,3,7,2
24567273@N07,2946,23,1243697335,1243697335,1,3,0
24567273@N07,2946,16,1243699911,1243700869,2,3,958
24567273@N07,2946,20,1243705793,1243705793,1,3,0
24577327@N06,2947,16,1343631482,1343631482,1,4,0
24577327@N06,2947,11,1343617765,1343617765,1,4,0
24577327@N06,2947,27,1343618105,1343618105,1,4,0
24577327@N06,2947,21,1343638255,1343638876,7,4,621
24577327@N06,2948,28,1429342959,1429342959,1,3,0
24577327@N06,2948,16,1429346712,1429347076,2,3,364
24577327@N06,2948,21,1429347531,1429347531,1,3,0
24577736@N04,2949,11,1300093527,1300093552,2,1,25
24603283@N00,2950,16,1248610952,1248610952,1,1,0
24603283@N00,2951,28,1248845054,1248845080,2,1,26
24603283@N00,2952,26,1256009546,1256009546,1,1,0
24633725@N00,2953,20,1193901326,1193914267,34,1,12941
24635124@N03,2954,26,1297566804,1297566804,1,1,0
24635124@N03,2955,31,1300181111,1300181111,1,1,0
24635124@N03,2956,20,1300446445,1300446445,1,1,0
24635124@N03,2957,26,1303778097,1303823120,104,1,45023
24646193@N05,2958,6,1208315758,1208315758,1,1,0
24655146@N08,2959,29,1306206226,1306213545,10,1,7319
24675871@N02,2960,1,1374122284,1374122284,1,1,0
24684763@N02,2961,28,1353551989,1353552289,2,1,300
24684763@N02,2962,24,1353635970,1353635970,1,2,0
24684763@N02,2962,30,1353642796,1353642796,1,2,0
24685814@N04,2963,28,1268773062,1268773062,1,1,0
24688575@N06,2964,26,1296351681,1296351681,1,4,0
24688575@N06,2964,28,1296350247,1296357369,2,4,7122
24688575@N06,2964,3,1296372309,1296372309,1,4,0
24688575@N06,2964,16,1296352187,1296372974,4,4,20787
24688575@N06,2965,13,1298169174,1298169174,1,1,0
24689127@N07,2966,26,1437127823,1437136806,3,1,8983
24692700@N00,2967,26,1298850246,1298880617,50,1,30371
24692700@N00,2968,1,1448227239,1448227242,2,7,3
24692700@N00,2968,21,1448250682,1448254920,7,7,4238
24692700@N00,2968,20,1448227838,1448228664,4,7,826
24692700@N00,2968,18,1448230948,1448233764,3,7,2816
24692700@N00,2968,19,1448231503,1448231574,2,7,71
24692700@N00,2968,29,1448229339,1448231532,5,7,2193
24692700@N00,2968,25,1448249651,1448250314,9,7,663
24692700@N00,2969,26,1448317200,1448317200,1,6,0
24692700@N00,2969,28,1448344868,1448349577,9,6,4709
24692700@N00,2969,17,1448326859,1448326859,1,6,0
24692700@N00,2969,15,1448330563,1448333453,5,6,2890
24692700@N00,2969,16,1448325848,1448325848,1,6,0
24692700@N00,2969,27,1448322836,1448325850,6,6,3014
24719278@N05,2970,25,1411275080,1411276846,37,1,1766
24732960@N03,2971,1,1376122513,1376122513,1,1,0
24732960@N03,2972,19,1407223978,1407225329,2,1,1351
24733288@N07,2973,17,1287732226,1287732291,2,2,65
24733288@N07,2973,26,1287748622,1287748622,1,2,0
24736628@N05,2974,20,1415070080,1415071271,2,6,1191
24736628@N05,2974,28,1415085275,1415085275,1,6,0
24736628@N05,2974,23,1415059141,1415085597,2,6,26456
24736628@N05,2974,22,1415067524,1415067524,1,6,0
24736628@N05,2974,26,1415092173,1415092173,1,6,0
24736628@N05,2974,17,1415061579,1415061579,1,6,0
24736628@N05,2975,27,1446702346,1446702346,1,1,0
24739740@N00,2976,10,1297926278,1297926278,1,4,0
24739740@N00,2976,26,1297926244,1297926287,2,4,43
24739740@N00,2976,12,1297926262,1297926262,1,4,0
24739740@N00,2976,27,1297926294,1297926294,1,4,0
24739740@N00,2977,23,1301458490,1301458490,1,2,0
24739740@N00,2977,24,1301467385,1301467385,1,2,0
24739867@N02,2978,7,1215318166,1215318166,1,1,0
24761610@N04,2979,12,1204635602,1204635603,2,4,1
24761610@N04,2979,13,1204635604,1204635604,1,4,0
24761610@N04,2979,10,1204635600,1204635600,1,4,0
24761610@N04,2979,3,1204635605,1204635606,2,4,1
24792498@N07,2980,28,1345454465,1345459458,3,1,4993
24792498@N07,2981,28,1353305153,1353311011,3,2,5858
24792498@N07,2981,1,1353306187,1353310360,3,2,4173
24792498@N07,2982,28,1353920278,1353920278,1,1,0
24850040@N07,2983,28,1197783510,1197787235,5,3,3725
24850040@N07,2983,26,1197782482,1197787895,5,3,5413
24850040@N07,2983,1,1197783863,1197783863,1,3,0
24850040@N07,2984,28,1197821776,1197822303,2,2,527
24850040@N07,2984,26,1197820421,1197820421,1,2,0
24850040@N07,2985,20,1197877345,1197877345,1,2,0
24850040@N07,2985,3,1197896336,1197896336,1,2,0
24850040@N07,2986,7,1213614923,1213614923,1,4,0
24850040@N07,2986,11,1213615091,1213615091,1,4,0
24850040@N07,2986,23,1213616742,1213616742,1,4,0
24850040@N07,2986,17,1213613634,1213613700,2,4,66
24850040@N07,2987,26,1213672414,1213672553,2,2,139
24850040@N07,2987,16,1213672280,1213672280,1,2,0
24850040@N07,2988,15,1215682935,1215682935,1,1,0
24850040@N07,2989,24,1215761138,1215762062,4,4,924
24850040@N07,2989,9,1215758547,1215758750,2,4,203
24850040@N07,2989,17,1215759573,1215759811,3,4,238
24850040@N07,2989,30,1215753340,1215755501,6,4,2161
24850040@N07,2990,24,1215954056,1215954351,2,5,295
24850040@N07,2990,17,1215963329,1215963329,1,5,0
24850040@N07,2990,1,1215924768,1215925847,8,5,1079
24850040@N07,2990,28,1215945819,1215945933,2,5,114
24850040@N07,2990,26,1215949507,1215950196,7,5,689
24850040@N07,2991,29,1216025498,1216026366,3,3,868
24850040@N07,2991,19,1216052205,1216052205,1,3,0
24850040@N07,2991,18,1216053358,1216053358,1,3,0
24850040@N07,2992,28,1216098017,1216098163,4,1,146
24850040@N07,2993,15,1218196670,1218196670,1,4,0
24850040@N07,2993,24,1218196736,1218196831,3,4,95
24850040@N07,2993,9,1218196939,1218196996,2,4,57
24850040@N07,2993,26,1218196910,1218196910,1,4,0
24850040@N07,2994,26,1233904589,1233904589,1,1,0
24850040@N07,2995,30,1233988032,1233988032,1,2,0
24850040@N07,2995,28,1233981258,1233981721,4,2,463
24850040@N07,2996,27,1234097765,1234097811,3,3,46
24850040@N07,2996,22,1234074195,1234074195,1,3,0
24850040@N07,2996,1,1234064395,1234064986,6,3,591
24850040@N07,2997,27,1236163686,1236163686,1,2,0
24850040@N07,2997,1,1236163309,1236163357,2,2,48
24850040@N07,2998,16,1247654566,1247667213,5,7,12647
24850040@N07,2998,29,1247658624,1247659137,13,7,513
24850040@N07,2998,18,1247655806,1247657001,9,7,1195
24850040@N07,2998,23,1247656250,1247656250,1,7,0
24850040@N07,2998,28,1247654354,1247654354,1,7,0
24850040@N07,2998,26,1247661307,1247661307,1,7,0
24850040@N07,2998,12,1247663091,1247663091,1,7,0
24850040@N07,2999,26,1247761063,1247761103,2,1,40
24850040@N07,3000,22,1247811198,1247821075,5,9,9877
24850040@N07,3000,29,1247848320,1247848953,9,9,633
24850040@N07,3000,31,1247811979,1247821362,8,9,9383
24850040@N07,3000,30,1247820144,1247821901,4,9,1757
24850040@N07,3000,27,1247834996,1247835119,4,9,123
24850040@N07,3000,19,1247819529,1247819580,3,9,51
24850040@N07,3000,1,1247808844,1247808844,1,9,0
24850040@N07,3000,18,1247818068,1247819342,2,9,1274
24850040@N07,3000,13,1247822795,1247823600,5,9,805
24850040@N07,3001,28,1247889383,1247889541,2,2,158
24850040@N07,3001,26,1247890236,1247891213,7,2,977
24850040@N07,3002,11,1248068439,1248068439,1,8,0
24850040@N07,3002,23,1248072671,1248072762,2,8,91
24850040@N07,3002,29,1248106553,1248108045,5,8,1492
24850040@N07,3002,7,1248067894,1248067894,1,8,0
24850040@N07,3002,30,1248072155,1248072493,4,8,338
24850040@N07,3002,4,1248068279,1248068279,1,8,0
24850040@N07,3002,3,1248068045,1248068045,1,8,0
24850040@N07,3002,15,1248094494,1248098426,6,8,3932
24850040@N07,3003,22,1248160480,1248185967,2,9,25487
24850040@N07,3003,23,1248163794,1248164956,5,9,1162
24850040@N07,3003,17,1248152737,1248152812,4,9,75
24850040@N07,3003,20,1248184764,1248187732,6,9,2968
24850040@N07,3003,28,1248154051,1248154352,3,9,301
24850040@N07,3003,12,1248180138,1248181161,5,9,1023
24850040@N07,3003,1,1248152818,1248153829,5,9,1011
24850040@N07,3003,18,1248154903,1248162226,8,9,7323
24850040@N07,3003,26,1248161484,1248161484,1,9,0
24850040@N07,3004,20,1253012972,1253012972,1,1,0
24850040@N07,3005,29,1263572417,1263572417,1,3,0
24850040@N07,3005,20,1263570490,1263570490,1,3,0
24850040@N07,3005,28,1263569433,1263569473,2,3,40
24850040@N07,3006,29,1263615818,1263629519,5,5,13701
24850040@N07,3006,20,1263630790,1263630790,1,5,0
24850040@N07,3006,1,1263614059,1263614275,5,5,216
24850040@N07,3006,12,1263624664,1263626774,6,5,2110
24850040@N07,3006,26,1263627106,1263627954,2,5,848
24850040@N07,3007,16,1263700600,1263700600,1,3,0
24850040@N07,3007,30,1263713267,1263713267,1,3,0
24850040@N07,3007,20,1263732998,1263733864,5,3,866
24850040@N07,3008,11,1263804412,1263804412,1,2,0
24850040@N07,3008,30,1263808453,1263808453,1,2,0
24850040@N07,3009,21,1266621480,1266621480,1,1,0
24850040@N07,3010,26,1266661994,1266661994,1,1,0
24850040@N07,3011,18,1279129052,1279129052,1,3,0
24850040@N07,3011,28,1279129634,1279129634,1,3,0
24850040@N07,3011,26,1279128440,1279128764,3,3,324
24850040@N07,3012,12,1279182835,1279183264,2,6,429
24850040@N07,3012,18,1279179987,1279180524,9,6,537
24850040@N07,3012,25,1279184616,1279184616,1,6,0
24850040@N07,3012,31,1279186368,1279186368,1,6,0
24850040@N07,3012,23,1279186124,1279188158,3,6,2034
24850040@N07,3012,21,1279183599,1279184503,3,6,904
24850040@N07,3013,31,1279275659,1279275995,4,1,336
24850040@N07,3014,1,1279343129,1279344593,4,7,1464
24850040@N07,3014,17,1279361027,1279361825,3,7,798
24850040@N07,3014,15,1279360875,1279360972,3,7,97
24850040@N07,3014,29,1279365259,1279377919,5,7,12660
24850040@N07,3014,28,1279350690,1279350690,1,7,0
24850040@N07,3014,30,1279348554,1279384851,25,7,36297
24850040@N07,3014,26,1279364258,1279364549,3,7,291
24850040@N07,3015,18,1279522201,1279522238,2,3,37
24850040@N07,3015,1,1279521282,1279521642,3,3,360
24850040@N07,3015,26,1279522794,1279523593,8,3,799
24850040@N07,3016,29,1279559116,1279559384,2,4,268
24850040@N07,3016,23,1279559828,1279559945,3,4,117
24850040@N07,3016,20,1279556975,1279557010,2,4,35
24850040@N07,3016,19,1279559565,1279559565,1,4,0
24850040@N07,3017,1,1287289360,1287289360,1,3,0
24850040@N07,3017,28,1287289273,1287289855,3,3,582
24850040@N07,3017,30,1287290362,1287290552,4,3,190
24850040@N07,3018,8,1287467428,1287467428,1,5,0
24850040@N07,3018,18,1287499824,1287499824,1,5,0
24850040@N07,3018,17,1287488221,1287488258,2,5,37
24850040@N07,3018,20,1287497201,1287500320,12,5,3119
24850040@N07,3018,30,1287500036,1287500065,2,5,29
24850040@N07,3019,22,1287572271,1287572271,1,10,0
24850040@N07,3019,17,1287566109,1287566158,2,10,49
24850040@N07,3019,31,1287562211,1287572212,7,10,10001
24850040@N07,3019,20,1287550313,1287567584,8,10,17271
24850040@N07,3019,23,1287555199,1287556974,10,10,1775
24850040@N07,3019,29,1287561601,1287561601,1,10,0
24850040@N07,3019,21,1287547060,1287547157,2,10,97
24850040@N07,3019,30,1287572614,1287572614,1,10,0
24850040@N07,3019,3,1287547526,1287547618,2,10,92
24850040@N07,3019,26,1287548527,1287548530,2,10,3
24850040@N07,3020,23,1309442400,1309442400,1,18,0
24850040@N07,3020,1,1309442400,1309442400,3,18,0
24850040@N07,3020,24,1309442400,1309442400,1,18,0
24850040@N07,3020,22,1309442400,1309442400,3,18,0
24850040@N07,3020,16,1309442400,1309442400,6,18,0
24850040@N07,3020,18,1309442400,1309442400,3,18,0
24850040@N07,3020,31,1309442400,1309442400,3,18,0
24850040@N07,3020,25,1309442400,1309442400,1,18,0
24850040@N07,3020,30,1309442400,1309442400,5,18,0
24850040@N07,3020,14,1309442400,1309442400,1,18,0
24850040@N07,3020,6,1309442400,1309442400,1,18,0
24850040@N07,3020,4,1309442400,1309442400,3,18,0
24850040@N07,3020,27,1309442400,1309442400,4,18,0
24850040@N07,3020,15,1309442400,1309442400,4,18,0
24850040@N07,3020,29,1309442400,1309442400,5,18,0
24850040@N07,3020,12,1309442400,1309442400,1,18,0
24850040@N07,3020,26,1309442400,1309442400,7,18,0
24850040@N07,3020,21,1309442400,1309442400,1,18,0
24850040@N07,3021,19,1349263810,1349264786,3,3,976
24850040@N07,3021,30,1349258430,1349260197,8,3,1767
24850040@N07,3021,17,1349256857,1349256857,1,3,0
24850040@N07,3022,16,1349452892,1349453066,2,1,174
24850040@N07,3023,28,1349682239,1349682239,1,2,0
24850040@N07,3023,1,1349682743,1349682743,1,2,0
24850040@N07,3024,30,1358255593,1358255593,1,1,0
24850040@N07,3025,20,1407813610,1407813610,1,2,0
24850040@N07,3025,25,1407814692,1407814692,1,2,0
24850040@N07,3026,28,1407851577,1407862372,3,4,10795
24850040@N07,3026,16,1407861902,1407861902,1,4,0
24850040@N07,3026,27,1407854201,1407854330,2,4,129
24850040@N07,3026,26,1407860736,1407861645,3,4,909
24850040@N07,3027,17,1407979349,1407979349,1,2,0
24850040@N07,3027,27,1407980691,1407980691,1,2,0
24851604@N03,3028,1,1417225609,1417232278,2,1,6669
24875210@N06,3029,26,1246008536,1246008536,1,1,0
24875210@N06,3030,28,1246181348,1246181348,1,1,0
24913492@N00,3031,24,1316765780,1316765780,1,1,0
24914070@N07,3032,28,1253760153,1253761019,16,1,866
24914070@N07,3033,28,1254371897,1254372188,10,1,291
24928011@N00,3034,26,1381546591,1381571272,2,4,24681
24928011@N00,3034,15,1381564841,1381565181,2,4,340
24928011@N00,3034,23,1381571442,1381571442,1,4,0
24928011@N00,3034,28,1381579606,1381579606,1,4,0
24959465@N08,3035,16,1330568405,1330568405,1,1,0
24959465@N08,3036,26,1330769969,1330769969,1,4,0
24959465@N08,3036,19,1330769912,1330769916,3,4,4
24959465@N08,3036,18,1330769905,1330769905,1,4,0
24959465@N08,3036,8,1330769930,1330769930,1,4,0
24959465@N08,3037,27,1330942169,1330942169,1,1,0
24959465@N08,3038,17,1352600662,1352600662,1,1,0
24959465@N08,3039,23,1352795814,1352795814,1,3,0
24959465@N08,3039,27,1352786695,1352786695,1,3,0
24959465@N08,3039,21,1352781567,1352781567,1,3,0
24959465@N08,3040,21,1363247658,1363247658,1,2,0
24959465@N08,3040,29,1363225252,1363225252,1,2,0
24959465@N08,3041,18,1363571356,1363571387,2,2,31
24959465@N08,3041,17,1363562633,1363562633,1,2,0
24959465@N08,3042,24,1367314575,1367314575,1,1,0
24959465@N08,3043,12,1367568829,1367568829,1,3,0
24959465@N08,3043,7,1367540509,1367540509,1,3,0
24959465@N08,3043,27,1367552483,1367552483,1,3,0
24959465@N08,3044,12,1374818089,1374818089,1,1,0
24959465@N08,3045,27,1378120427,1378120427,1,1,0
24959465@N08,3046,24,1378279622,1378279622,1,1,0
24959465@N08,3047,26,1386146382,1386146382,1,1,0
24959465@N08,3048,27,1418448918,1418448918,1,1,0
24959465@N08,3049,9,1424090789,1424090789,1,1,0
24959465@N08,3050,27,1440413715,1440413715,1,1,0
25013736@N03,3051,26,1223544024,1223544024,1,1,0
25017746@N00,3052,23,1197158306,1197158306,1,1,0
25027171@N08,3053,25,1346729677,1346731931,16,17,2254
25027171@N08,3053,30,1346734386,1346743060,20,17,8674
25027171@N08,3053,29,1346734910,1346743330,10,17,8420
25027171@N08,3053,24,1346728959,1346729057,6,17,98
25027171@N08,3053,11,1346733655,1346733665,4,17,10
25027171@N08,3053,21,1346731917,1346732428,6,17,511
25027171@N08,3053,27,1346719287,1346719287,2,17,0
25027171@N08,3053,6,1346733786,1346733827,10,17,41
25027171@N08,3053,31,1346742937,1346742972,4,17,35
25027171@N08,3053,9,1346733734,1346733757,4,17,23
25027171@N08,3053,15,1346723776,1346727997,10,17,4221
25027171@N08,3053,4,1346733590,1346733590,2,17,0
25027171@N08,3053,26,1346733992,1346750992,128,17,17000
25027171@N08,3053,28,1346718769,1346751551,40,17,32782
25027171@N08,3053,16,1346751146,1346751146,2,17,0
25027171@N08,3053,3,1346733470,1346733487,6,17,17
25027171@N08,3053,13,1346731951,1346732029,12,17,78
25027171@N08,3054,28,1386647882,1386647983,3,6,101
25027171@N08,3054,31,1386644997,1386644997,1,6,0
25027171@N08,3054,14,1386644397,1386644783,16,6,386
25027171@N08,3054,20,1386645058,1386645677,13,6,619
25027171@N08,3054,22,1386644424,1386644964,7,6,540
25027171@N08,3054,1,1386652879,1386655356,3,6,2477
25027171@N08,3055,25,1386818952,1386819593,53,12,641
25027171@N08,3055,29,1386808995,1386809805,5,12,810
25027171@N08,3055,18,1386802821,1386804848,3,12,2027
25027171@N08,3055,28,1386833864,1386833954,5,12,90
25027171@N08,3055,21,1386836634,1386836634,1,12,0
25027171@N08,3055,31,1386812516,1386812524,2,12,8
25027171@N08,3055,14,1386813065,1386813664,4,12,599
25027171@N08,3055,20,1386811891,1386813104,13,12,1213
25027171@N08,3055,22,1386813552,1386813627,3,12,75
25027171@N08,3055,19,1386804912,1386804912,1,12,0
25027171@N08,3055,26,1386825774,1386839145,9,12,13371
25027171@N08,3055,1,1386828058,1386832825,99,12,4767
25027171@N08,3056,30,1386897923,1386899532,2,5,1609
25027171@N08,3056,29,1386899525,1386932418,155,5,32893
25027171@N08,3056,24,1386905145,1386905145,1,5,0
25027171@N08,3056,11,1386901993,1386901993,1,5,0
25027171@N08,3056,13,1386902396,1386903327,24,5,931
25033627@N00,3057,12,1350096085,1350096085,1,1,0
25069338@N05,3058,24,1307923159,1307923159,1,2,0
25069338@N05,3058,25,1307924371,1307924371,1,2,0
25069338@N05,3059,14,1307961982,1307961982,1,1,0
25119612@N02,3060,1,1189301294,1189301859,2,1,565
25119612@N02,3061,29,1190512230,1190512478,4,1,248
25119612@N02,3062,21,1192941999,1192942128,2,3,129
25119612@N02,3062,28,1192942696,1192944348,3,3,1652
25119612@N02,3062,16,1192927657,1192927657,1,3,0
25119612@N02,3063,8,1195954337,1195954337,1,3,0
25119612@N02,3063,26,1195953377,1195953692,4,3,315
25119612@N02,3063,28,1195948047,1195948047,1,3,0
25119612@N02,3064,29,1197154300,1197154412,4,2,112
25119612@N02,3064,1,1197152351,1197152791,2,2,440
25119612@N02,3065,28,1198384190,1198389556,2,1,5366
25119612@N02,3066,21,1199591672,1199591730,2,2,58
25119612@N02,3066,28,1199591165,1199602577,12,2,11412
25119612@N02,3067,21,1200009015,1200009015,1,5,0
25119612@N02,3067,26,1200009043,1200009043,1,5,0
25119612@N02,3067,28,1200008661,1200033959,8,5,25298
25119612@N02,3067,1,1200003352,1200004521,3,5,1169
25119612@N02,3067,18,1200016615,1200016615,1,5,0
25119612@N02,3068,11,1201393123,1201393123,1,2,0
25119612@N02,3068,28,1201407611,1201408193,3,2,582
25119612@N02,3069,3,1222601510,1222601743,2,1,233
25119612@N02,3070,26,1226193500,1226193500,1,2,0
25119612@N02,3070,21,1226209790,1226209790,1,2,0
25119612@N02,3071,28,1238912290,1238920764,8,1,8474
25119612@N02,3072,18,1240722091,1240722091,1,2,0
25119612@N02,3072,28,1240735460,1240735460,1,2,0
25119612@N02,3073,28,1241331075,1241340126,5,1,9051
25119612@N02,3074,16,1247797344,1247797344,1,2,0
25119612@N02,3074,21,1247822021,1247822021,1,2,0
25119612@N02,3075,28,1272261489,1272261489,1,1,0
25119612@N02,3076,21,1281084265,1281084265,1,1,0
25119612@N02,3077,28,1281267865,1281267871,3,1,6
25119612@N02,3078,26,1283756925,1283756925,1,1,0
25119612@N02,3079,3,1286585212,1286585471,6,8,259
25119612@N02,3079,8,1286579120,1286579120,1,8,0
25119612@N02,3079,18,1286577042,1286577042,1,8,0
25119612@N02,3079,26,1286575565,1286575565,1,8,0
25119612@N02,3079,27,1286601975,1286601975,1,8,0
25119612@N02,3079,28,1286592052,1286601280,18,8,9228
25119612@N02,3079,21,1286590257,1286591021,22,8,764
25119612@N02,3079,25,1286603230,1286603726,4,8,496
25119612@N02,3080,29,1290472650,1290472650,1,1,0
25126997@N08,3081,26,1411738131,1411738131,1,1,0
25126997@N08,3082,26,1467591521,1467591521,1,1,0
25138015@N03,3083,1,1368489577,1368489577,1,1,0
25138015@N03,3084,17,1368781427,1368781427,1,1,0
25194038@N02,3085,16,1295741709,1295741709,1,1,0
25199567@N05,3086,26,1213277602,1213277602,1,2,0
25199567@N05,3086,8,1213278001,1213278001,1,2,0
25203548@N00,3087,1,1413770957,1413770957,1,2,0
25203548@N00,3087,12,1413770898,1413770898,1,2,0
25203548@N00,3088,17,1429076179,1429076179,1,1,0
25217083@N08,3089,28,1213364690,1213364690,1,1,0
25224114@N08,3090,26,1378025371,1378025371,1,1,0
25228353@N03,3091,28,1457911641,1457911641,1,1,0
25228353@N03,3092,28,1457955259,1457955259,1,2,0
25228353@N03,3092,26,1457940716,1457940716,1,2,0
25233266@N04,3093,17,1291010786,1291010786,1,1,0
25262413@N03,3094,28,1199106000,1199106000,1,1,0
25262413@N03,3095,18,1448794612,1448794612,1,1,0
25262413@N03,3096,17,1460946428,1460946428,1,1,0
25269451@N07,3097,26,1213961423,1213961423,1,1,0
25276142@N07,3098,13,1213539147,1213544412,3,1,5265
25295728@N08,3099,1,1369262563,1369262563,1,1,0
25360342@N02,3100,6,1393223983,1393223983,1,4,0
25360342@N02,3100,21,1393222755,1393222755,1,4,0
25360342@N02,3100,13,1393223007,1393223007,1,4,0
25360342@N02,3100,26,1393221616,1393224336,2,4,2720
25360342@N02,3101,1,1393303615,1393303615,1,5,0
25360342@N02,3101,12,1393282518,1393282518,1,5,0
25360342@N02,3101,30,1393309070,1393309070,1,5,0
25360342@N02,3101,26,1393308267,1393308267,1,5,0
25360342@N02,3101,22,1393287244,1393287244,1,5,0
25360342@N02,3102,17,1393396734,1393396734,1,4,0
25360342@N02,3102,29,1393384540,1393384540,1,4,0
25360342@N02,3102,3,1393399947,1393399947,1,4,0
25360342@N02,3102,24,1393404520,1393405243,2,4,723
25360342@N02,3103,15,1393562016,1393562016,1,5,0
25360342@N02,3103,11,1393553960,1393554155,2,5,195
25360342@N02,3103,16,1393547179,1393547185,2,5,6
25360342@N02,3103,23,1393547652,1393547652,1,5,0
25360342@N02,3103,29,1393555934,1393555934,1,5,0
25387061@N06,3104,18,1458558919,1458558919,1,1,0
25387336@N07,3105,29,1300955120,1300955120,1,2,0
25387336@N07,3105,30,1300955125,1300955125,1,2,0
25403350@N00,3106,20,1255754797,1255754797,1,2,0
25403350@N00,3106,28,1255751821,1255751821,1,2,0
25449594@N07,3107,15,1294945461,1294945461,1,4,0
25449594@N07,3107,28,1294928886,1294928886,1,4,0
25449594@N07,3107,11,1294931401,1294931401,1,4,0
25449594@N07,3107,3,1294941166,1294941166,1,4,0
25468573@N08,3108,23,1238384293,1238389281,5,4,4988
25468573@N08,3108,26,1238384096,1238384122,2,4,26
25468573@N08,3108,25,1238404922,1238405132,5,4,210
25468573@N08,3108,12,1238411434,1238411453,2,4,19
25468671@N00,3109,1,1391901237,1391901237,1,1,0
25468671@N00,3110,19,1458384957,1458384957,1,3,0
25468671@N00,3110,17,1458368617,1458368617,1,3,0
25468671@N00,3110,28,1458386360,1458386360,1,3,0
25495689@N03,3111,25,1464994443,1464994443,1,1,0
25514912@N08,3112,19,1431462071,1431462071,1,1,0
25554959@N06,3113,24,1213702037,1213702037,1,2,0
25554959@N06,3113,26,1213703060,1213703060,1,2,0
25569106@N00,3114,1,1404711342,1404711342,1,1,0
25596925@N05,3115,24,1217069794,1217069794,1,10,0
25596925@N05,3115,16,1217069935,1217070659,7,10,724
25596925@N05,3115,28,1217041693,1217042382,9,10,689
25596925@N05,3115,21,1217051905,1217056094,12,10,4189
25596925@N05,3115,30,1217047307,1217074955,4,10,27648
25596925@N05,3115,26,1217071361,1217080540,8,10,9179
25596925@N05,3115,27,1217064859,1217065582,6,10,723
25596925@N05,3115,12,1217073732,1217073732,1,10,0
25596925@N05,3115,18,1217042548,1217047161,31,10,4613
25596925@N05,3115,11,1217050380,1217050744,4,10,364
25601992@N00,3116,12,1432515639,1432515658,3,6,19
25601992@N00,3116,22,1432516985,1432518295,6,6,1310
25601992@N00,3116,29,1432516594,1432516611,2,6,17
25601992@N00,3116,1,1432514924,1432519750,4,6,4826
25601992@N00,3116,26,1432516220,1432518910,2,6,2690
25601992@N00,3116,28,1432515138,1432515138,1,6,0
25609254@N02,3117,8,1261738945,1261738945,1,1,0
25628053@N00,3118,26,1230526956,1230537109,4,1,10153
25628053@N00,3119,28,1236314169,1236314169,1,1,0
25628053@N00,3120,26,1236379686,1236391879,24,1,12193
25628053@N00,3121,26,1236474919,1236483096,5,1,8177
25628053@N00,3122,26,1242885784,1242905310,2,1,19526
25628053@N00,3123,26,1242948406,1242948751,3,1,345
25628053@N00,3124,26,1243001579,1243001579,1,1,0
25628053@N00,3125,26,1243076714,1243085303,6,1,8589
25633301@N00,3126,5,1414808812,1414809179,4,2,367
25633301@N00,3126,29,1414812480,1414812480,1,2,0
25633301@N00,3127,28,1414912208,1414912208,1,6,0
25633301@N00,3127,26,1414890503,1414890503,1,6,0
25633301@N00,3127,1,1414891497,1414893357,5,6,1860
25633301@N00,3127,19,1414880918,1414881168,4,6,250
25633301@N00,3127,11,1414898790,1414900795,4,6,2005
25633301@N00,3127,27,1414887648,1414887648,1,6,0
25633301@N00,3128,16,1415067651,1415068162,8,1,511
25638916@N05,3129,26,1457358034,1457358034,1,1,0
25728552@N00,3130,21,1461650706,1461650706,1,1,0
25728552@N00,3131,16,1461797852,1461797852,1,3,0
25728552@N00,3131,17,1461800076,1461800076,1,3,0
25728552@N00,3131,26,1461803218,1461803280,3,3,62
25728552@N00,3132,25,1461891923,1461892613,5,3,690
25728552@N00,3132,28,1461900226,1461900226,1,3,0
25728552@N00,3132,13,1461892686,1461892686,1,3,0
25771935@N08,3133,15,1334113792,1334113792,1,1,0
25771935@N08,3134,18,1340584034,1340584034,1,1,0
25771935@N08,3135,27,1348102801,1348102801,1,1,0
25771935@N08,3136,24,1348277953,1348277953,1,2,0
25771935@N08,3136,27,1348274571,1348274571,1,2,0
25771935@N08,3137,27,1351498693,1351498693,1,1,0
25771935@N08,3138,29,1351853679,1351853679,1,1,0
25792183@N00,3139,28,1258973826,1258973826,1,2,0
25792183@N00,3139,26,1258966766,1258966832,2,2,66
25793750@N07,3140,26,1207836018,1207836018,1,1,0
25827417@N00,3141,7,1367468142,1367468142,1,1,0
25827417@N00,3142,10,1447629570,1447629570,1,1,0
25827417@N00,3143,26,1447899308,1447899308,1,1,0
25827417@N00,3144,26,1447976362,1447984245,3,1,7883
25854008@N00,3145,29,1327929916,1327929916,1,1,0
25854008@N00,3146,17,1327990166,1327990166,1,3,0
25854008@N00,3146,13,1327990742,1327990742,1,3,0
25854008@N00,3146,18,1327990595,1327990595,1,3,0
25854008@N00,3147,20,1358672512,1358672512,1,1,0
25854008@N00,3148,23,1358745557,1358746659,2,2,1102
25854008@N00,3148,18,1358750459,1358750460,3,2,1
25855529@N04,3149,28,1336093760,1336094931,2,1,1171
25855529@N04,3150,29,1336282239,1336282243,2,4,4
25855529@N04,3150,10,1336281431,1336284787,4,4,3356
25855529@N04,3150,26,1336280786,1336281232,2,4,446
25855529@N04,3150,23,1336281143,1336281143,1,4,0
25950855@N08,3151,27,1340660887,1340662969,31,3,2082
25950855@N08,3151,7,1340671070,1340671084,3,3,14
25950855@N08,3151,9,1340685160,1340685160,1,3,0
25950855@N08,3152,17,1449176787,1449176997,3,12,210
25950855@N08,3152,1,1449206895,1449206895,1,12,0
25950855@N08,3152,27,1449179242,1449179246,2,12,4
25950855@N08,3152,31,1449210290,1449210290,1,12,0
25950855@N08,3152,7,1449187668,1449187668,1,12,0
25950855@N08,3152,16,1449175972,1449175972,1,12,0
25950855@N08,3152,20,1449193094,1449193235,4,12,141
25950855@N08,3152,29,1449195654,1449195654,1,12,0
25950855@N08,3152,30,1449192380,1449199166,23,12,6786
25950855@N08,3152,6,1449184912,1449184912,2,12,0
25950855@N08,3152,18,1449207826,1449209878,7,12,2052
25950855@N08,3152,23,1449202554,1449209898,8,12,7344
25972243@N07,3153,30,1302175312,1302175312,1,1,0
25992206@N08,3154,1,1377950532,1377950532,1,1,0
25992206@N08,3155,1,1383452372,1383465477,2,1,13105
25995071@N02,3156,3,1300796488,1300796488,1,1,0
26000176@N07,3157,23,1211092077,1211092077,1,2,0
26000176@N07,3157,1,1211083336,1211083336,1,2,0
26000176@N07,3158,28,1211182522,1211182522,1,1,0
26000176@N07,3159,12,1223088501,1223088501,1,2,0
26000176@N07,3159,27,1223100075,1223100075,1,2,0
26000176@N07,3160,18,1223170479,1223170479,1,1,0
26000176@N07,3161,28,1223246098,1223246098,1,1,0
26000176@N07,3162,23,1314231898,1314231898,1,1,0
26000176@N07,3163,3,1321673526,1321673526,1,1,0
26000176@N07,3164,14,1321739746,1321739746,1,1,0
26000176@N07,3165,18,1321844301,1321844301,1,1,0
26000176@N07,3166,3,1321876356,1321876356,1,1,0
26000176@N07,3167,23,1345191572,1345191572,1,1,0
26000176@N07,3168,31,1345271998,1345271998,1,1,0
26000176@N07,3169,17,1391661948,1391661948,1,2,0
26000176@N07,3169,19,1391664868,1391664868,1,2,0
26000176@N07,3170,15,1448184010,1448184010,1,1,0
26000176@N07,3171,15,1452296093,1452296093,1,1,0
26051472@N05,3172,25,1358570212,1358571407,2,2,1195
26051472@N05,3172,13,1358572896,1358579366,2,2,6470
26051472@N05,3173,21,1358643064,1358644478,3,7,1414
26051472@N05,3173,13,1358642169,1358642169,1,7,0
26051472@N05,3173,1,1358636913,1358637150,2,7,237
26051472@N05,3173,4,1358644218,1358644218,1,7,0
26051472@N05,3173,26,1358665401,1358665401,1,7,0
26051472@N05,3173,11,1358644330,1358644330,1,7,0
26051472@N05,3173,24,1358645041,1358645041,1,7,0
26051623@N00,3174,4,1260110833,1260110833,1,4,0
26051623@N00,3174,28,1260085554,1260111276,2,4,25722
26051623@N00,3174,21,1260089216,1260090374,14,4,1158
26051623@N00,3174,26,1260111072,1260111072,1,4,0
26054914@N08,3175,28,1327825737,1327841570,2,1,15833
26066055@N00,3176,29,1221790203,1221819165,6,1,28962
26066055@N00,3177,29,1221860428,1221916965,30,1,56537
26066055@N00,3178,29,1221952888,1221982258,18,1,29370
26066055@N00,3179,17,1296338934,1296338934,1,1,0
26071009@N04,3180,25,1336867095,1336867237,2,1,142
26094076@N08,3181,14,1354876440,1354876440,1,1,0
26104563@N00,3182,29,1283887919,1283887919,1,6,0
26104563@N00,3182,5,1283887919,1283887919,1,6,0
26104563@N00,3182,1,1283887919,1283887919,1,6,0
26104563@N00,3182,28,1283887919,1283887919,1,6,0
26104563@N00,3182,26,1283886213,1283887919,2,6,1706
26104563@N00,3182,16,1283887919,1283887919,1,6,0
26118937@N08,3183,25,1368062295,1368062295,1,1,0
26142249@N08,3184,18,1434786177,1434786177,1,1,0
26153219@N00,3185,16,1284597851,1284630693,7,5,32842
26153219@N00,3185,4,1284624640,1284624640,1,5,0
26153219@N00,3185,28,1284597451,1284622539,6,5,25088
26153219@N00,3185,29,1284598226,1284600606,3,5,2380
26153219@N00,3185,22,1284599691,1284599903,2,5,212
26161002@N03,3186,25,1321167386,1321167475,3,4,89
26161002@N03,3186,20,1321144194,1321144544,2,4,350
26161002@N03,3186,27,1321139767,1321139767,1,4,0
26161002@N03,3186,17,1321150218,1321150218,1,4,0
26163728@N02,3187,1,1241834884,1241846822,11,1,11938
26168151@N00,3188,20,1279162116,1279162116,1,1,0
26170480@N05,3189,1,1380437434,1380437434,1,3,0
26170480@N05,3189,16,1380439582,1380439582,1,3,0
26170480@N05,3189,24,1380439013,1380439104,2,3,91
26173770@N06,3190,1,1370646902,1370646902,1,1,0
26173770@N06,3191,31,1370837602,1370837602,1,1,0
26175247@N00,3192,29,1312695971,1312695971,1,4,0
26175247@N00,3192,25,1312678285,1312678285,1,4,0
26175247@N00,3192,18,1312682546,1312682546,1,4,0
26175247@N00,3192,1,1312689795,1312689795,1,4,0
26232027@N02,3193,10,1209715247,1209715247,1,1,0
26232027@N02,3194,30,1218955812,1218955812,1,1,0
26251489@N04,3195,29,1292147927,1292147927,1,1,0
26284290@N05,3196,22,1241272800,1241272800,1,2,0
26284290@N05,3196,16,1241272801,1241272801,1,2,0
26284290@N05,3197,28,1274450400,1274450400,1,1,0
26284290@N05,3198,31,1290862801,1290862803,2,2,2
26284290@N05,3198,3,1290862800,1290862800,1,2,0
26284290@N05,3199,29,1299330000,1299330000,1,2,0
26284290@N05,3199,28,1299330003,1299330003,1,2,0
26284290@N05,3200,17,1375663913,1375663913,1,1,0
26312461@N00,3201,20,1234779592,1234779592,1,1,0
26326476@N05,3202,29,1350985420,1350985420,1,1,0
26340416@N07,3203,16,1312291080,1312291080,1,1,0
26340416@N07,3204,27,1316583972,1316583972,1,1,0
26340416@N07,3205,28,1321418274,1321418274,1,1,0
26340416@N07,3206,28,1328429254,1328429254,1,2,0
26340416@N07,3206,23,1328434795,1328434795,1,2,0
26340416@N07,3207,28,1330500099,1330500099,1,1,0
26340416@N07,3208,28,1335261993,1335261993,1,1,0
26340416@N07,3209,28,1338719571,1338719571,1,2,0
26340416@N07,3209,16,1338693678,1338693678,1,2,0
26340416@N07,3210,28,1339484543,1339486657,2,2,2114
26340416@N07,3210,27,1339501842,1339501842,1,2,0
26340416@N07,3211,28,1340698345,1340698345,1,1,0
26340416@N07,3212,28,1342954899,1342954899,1,1,0
26340416@N07,3213,28,1348552650,1348564816,2,1,12166
26340416@N07,3214,30,1348999409,1348999409,1,2,0
26340416@N07,3214,28,1349012483,1349012483,1,2,0
26340416@N07,3215,28,1349055411,1349055411,1,1,0
26340416@N07,3216,28,1353080539,1353080539,1,1,0
26340416@N07,3217,29,1355048692,1355048692,1,1,0
26340416@N07,3218,16,1355987066,1355987066,1,1,0
26340416@N07,3219,18,1357895651,1357895651,1,2,0
26340416@N07,3219,28,1357900701,1357900701,1,2,0
26340416@N07,3220,1,1366547170,1366547170,1,1,0
26376681@N00,3221,11,1377651434,1377651434,1,1,0
26391574@N07,3222,26,1217229427,1217229476,29,1,49
26392736@N03,3223,28,1449008423,1449008423,1,2,0
26392736@N03,3223,18,1449001923,1449001923,1,2,0
26392736@N03,3224,18,1452670611,1452670611,1,1,0
26392736@N03,3225,18,1456686505,1456686505,1,1,0
26410425@N03,3226,28,1245013976,1245060983,102,1,47007
26415623@N00,3227,15,1276666461,1276666461,1,6,0
26415623@N00,3227,25,1276662451,1276662451,1,6,0
26415623@N00,3227,21,1276659872,1276661376,4,6,1504
26415623@N00,3227,7,1276659235,1276659399,2,6,164
26415623@N00,3227,26,1276658678,1276658803,2,6,125
26415623@N00,3227,4,1276687204,1276687204,1,6,0
26433797@N00,3228,26,1240101007,1240104046,16,1,3039
26433797@N00,3229,26,1240193313,1240222376,12,1,29063
26433797@N00,3230,26,1240268325,1240274866,9,1,6541
26460999@N02,3231,13,1297857946,1297864900,8,2,6954
26460999@N02,3231,28,1297853869,1297854002,4,2,133
26475706@N08,3232,26,1335476457,1335476975,2,2,518
26475706@N08,3232,16,1335478396,1335478396,1,2,0
26522673@N07,3233,23,1203570532,1203570532,1,18,0
26522673@N07,3233,10,1203576680,1203577040,2,18,360
26522673@N07,3233,30,1203580540,1203580540,1,18,0
26522673@N07,3233,20,1203582135,1203582294,2,18,159
26522673@N07,3233,1,1203560048,1203560048,1,18,0
26522673@N07,3233,3,1203587538,1203587538,1,18,0
26522673@N07,3233,24,1203564116,1203564116,1,18,0
26522673@N07,3233,21,1203587476,1203587476,1,18,0
26522673@N07,3233,12,1203563082,1203563082,1,18,0
26522673@N07,3233,15,1203562950,1203562950,1,18,0
26522673@N07,3233,19,1203571941,1203571941,1,18,0
26522673@N07,3233,27,1203568214,1203570408,2,18,2194
26522673@N07,3233,17,1203562910,1203569654,3,18,6744
26522673@N07,3233,26,1203560664,1203560664,1,18,0
26522673@N07,3233,22,1203582121,1203582121,1,18,0
26522673@N07,3233,18,1203571676,1203572585,5,18,909
26522673@N07,3233,31,1203578269,1203578269,1,18,0
26522673@N07,3233,28,1203560197,1203590078,8,18,29881
26522673@N07,3234,12,1203975503,1203975503,1,1,0
26522673@N07,3235,23,1211536724,1211536724,1,2,0
26522673@N07,3235,24,1211536736,1211536736,1,2,0
26522673@N07,3236,22,1212410758,1212410758,1,1,0
26522673@N07,3237,22,1213268390,1213268390,1,1,0
26522673@N07,3238,16,1216453378,1216453378,1,1,0
26522673@N07,3239,12,1222855879,1222864004,2,1,8125
26522673@N07,3240,24,1226104814,1226104814,1,1,0
26522673@N07,3241,12,1226325574,1226325574,1,1,0
26538493@N00,3242,10,1234570971,1234574182,3,6,3211
26538493@N00,3242,12,1234577560,1234577560,1,6,0
26538493@N00,3242,25,1234590916,1234598023,3,6,7107
26538493@N00,3242,26,1234568481,1234608108,6,6,39627
26538493@N00,3242,8,1234598414,1234598414,1,6,0
26538493@N00,3242,16,1234602076,1234602112,2,6,36
26544234@N03,3243,30,1399969092,1399969950,6,1,858
26544234@N03,3244,28,1418902564,1418902635,2,2,71
26544234@N03,3244,25,1418904039,1418904402,2,2,363
26565770@N02,3245,28,1404258804,1404329651,66,1,70847
26565770@N02,3246,28,1408529758,1408529758,1,1,0
26567016@N08,3247,28,1218705863,1218705863,1,1,0
26568149@N00,3248,16,1236137795,1236155867,11,18,18072
26568149@N00,3248,12,1236144694,1236144819,2,18,125
26568149@N00,3248,13,1236138514,1236153343,4,18,14829
26568149@N00,3248,6,1236154940,1236154940,1,18,0
26568149@N00,3248,27,1236142462,1236142462,1,18,0
26568149@N00,3248,4,1236129174,1236154184,5,18,25010
26568149@N00,3248,8,1236138837,1236155102,2,18,16265
26568149@N00,3248,1,1236125306,1236146073,3,18,20767
26568149@N00,3248,29,1236149669,1236149669,1,18,0
26568149@N00,3248,18,1236147910,1236148005,3,18,95
26568149@N00,3248,14,1236127436,1236127541,2,18,105
26568149@N00,3248,25,1236144773,1236153548,2,18,8775
26568149@N00,3248,26,1236128892,1236155196,5,18,26304
26568149@N00,3248,7,1236154447,1236154992,3,18,545
26568149@N00,3248,28,1236125518,1236156269,2,18,30751
26568149@N00,3248,24,1236132451,1236145036,16,18,12585
26568149@N00,3248,15,1236132162,1236145638,3,18,13476
26568149@N00,3248,21,1236138605,1236138605,1,18,0
26568149@N00,3249,27,1245061217,1245061246,2,3,29
26568149@N00,3249,28,1245060233,1245060248,2,3,15
26568149@N00,3249,1,1245059865,1245060096,3,3,231
26616207@N00,3250,1,1293415060,1293415060,1,4,0
26616207@N00,3250,24,1293441394,1293441394,1,4,0
26616207@N00,3250,25,1293422924,1293422924,1,4,0
26616207@N00,3250,29,1293455072,1293455072,1,4,0
26616207@N00,3251,5,1336537117,1336537117,1,2,0
26616207@N00,3251,21,1336537108,1336537108,1,2,0
26624922@N03,3252,18,1469494883,1469494883,1,5,0
26624922@N03,3252,16,1469515893,1469516622,4,5,729
26624922@N03,3252,15,1469496579,1469496737,3,5,158
26624922@N03,3252,27,1469512272,1469512272,1,5,0
26624922@N03,3252,21,1469511084,1469511084,1,5,0
26631756@N04,3253,28,1243041901,1243041901,1,1,0
26640890@N04,3254,28,1325813899,1325813899,1,1,0
26640890@N04,3255,28,1352774411,1352795610,2,1,21199
26646647@N04,3256,16,1336036281,1336036281,1,1,0
26646647@N04,3257,28,1348653664,1348653664,1,1,0
26670686@N06,3258,7,1459313518,1459313518,1,2,0
26670686@N06,3258,26,1459321469,1459321469,1,2,0
26670686@N06,3259,27,1464313867,1464313867,1,4,0
26670686@N06,3259,15,1464313688,1464313688,1,4,0
26670686@N06,3259,28,1464313923,1464313923,1,4,0
26670686@N06,3259,16,1464313869,1464313869,1,4,0
26670686@N06,3260,29,1465110649,1465110649,1,1,0
26670686@N06,3261,28,1465557021,1465557030,2,1,9
26670686@N06,3262,22,1468749268,1468749268,1,2,0
26670686@N06,3262,26,1468720490,1468720490,1,2,0
26670686@N06,3263,16,1469938814,1469938814,1,1,0
26681113@N00,3264,19,1405418314,1405418314,1,1,0
26704339@N05,3265,15,1211262019,1211262019,1,4,0
26704339@N05,3265,12,1211262040,1211262040,1,4,0
26704339@N05,3265,17,1211255887,1211255887,1,4,0
26704339@N05,3265,7,1211255895,1211255895,1,4,0
26766729@N06,3266,16,1286110514,1286110514,1,2,0
26766729@N06,3266,28,1286113692,1286113692,1,2,0
26766729@N06,3267,30,1287318466,1287318466,1,1,0
26794632@N00,3268,1,1383083326,1383083326,1,1,0
26806480@N07,3269,26,1439890466,1439905746,9,1,15280
26806480@N07,3270,26,1439976677,1439977068,3,1,391
26806480@N07,3271,26,1440063105,1440077626,2,1,14521
26806480@N07,3272,26,1455676758,1455700564,34,1,23806
26806480@N07,3273,26,1458795868,1458822931,7,1,27063
26806480@N07,3274,26,1461313672,1461318675,10,1,5003
26806480@N07,3275,26,1464184427,1464184440,2,1,13
26806480@N07,3276,26,1464270860,1464270879,3,1,19
26854278@N08,3277,18,1191460156,1191460194,3,1,38
26874770@N06,3278,16,1219845887,1219845887,1,1,0
26874770@N06,3279,24,1219888147,1219888147,1,1,0
26874770@N06,3280,29,1219927656,1219927912,2,2,256
26874770@N06,3280,20,1219929721,1219929721,1,2,0
26874770@N06,3281,29,1219976876,1219982234,2,5,5358
26874770@N06,3281,31,1219976904,1219976904,1,5,0
26874770@N06,3281,24,1219985743,1219985843,2,5,100
26874770@N06,3281,20,1219981981,1219981981,1,5,0
26874770@N06,3281,1,1219974097,1219974114,2,5,17
26874770@N06,3282,17,1220017689,1220017931,2,2,242
26874770@N06,3282,20,1220021809,1220022317,4,2,508
26874770@N06,3283,17,1220062591,1220062903,2,4,312
26874770@N06,3283,27,1220062570,1220064688,3,4,2118
26874770@N06,3283,24,1220062730,1220064470,8,4,1740
26874770@N06,3283,15,1220061084,1220063045,3,4,1961
26874770@N06,3284,29,1220194427,1220195347,5,1,920
26874770@N06,3285,17,1220236229,1220236392,2,9,163
26874770@N06,3285,22,1220241006,1220242020,5,9,1014
26874770@N06,3285,29,1220242322,1220263200,2,9,20878
26874770@N06,3285,25,1220237302,1220237302,1,9,0
26874770@N06,3285,31,1220241131,1220243695,7,9,2564
26874770@N06,3285,27,1220231526,1220234512,4,9,2986
26874770@N06,3285,24,1220237148,1220237148,1,9,0
26874770@N06,3285,4,1220237448,1220237448,1,9,0
26874770@N06,3285,5,1220277666,1220277666,1,9,0
26874770@N06,3286,17,1220319568,1220319630,2,7,62
26874770@N06,3286,29,1220330205,1220336350,5,7,6145
26874770@N06,3286,27,1220318901,1220318901,1,7,0
26874770@N06,3286,16,1220318777,1220318777,1,7,0
26874770@N06,3286,24,1220322478,1220322478,1,7,0
26874770@N06,3286,12,1220320767,1220320767,1,7,0
26874770@N06,3286,5,1220323077,1220323077,1,7,0
26874770@N06,3287,17,1220420581,1220420581,1,6,0
26874770@N06,3287,25,1220439227,1220439227,1,6,0
26874770@N06,3287,16,1220417995,1220417995,1,6,0
26874770@N06,3287,24,1220439480,1220439480,1,6,0
26874770@N06,3287,20,1220416002,1220416002,1,6,0
26874770@N06,3287,5,1220419121,1220419121,1,6,0
26874770@N06,3288,17,1220515210,1220515210,1,4,0
26874770@N06,3288,31,1220533433,1220533480,3,4,47
26874770@N06,3288,24,1220515369,1220515437,2,4,68
26874770@N06,3288,15,1220515220,1220515236,2,4,16
26874770@N06,3289,31,1220594472,1220594610,4,4,138
26874770@N06,3289,16,1220594768,1220594768,1,4,0
26874770@N06,3289,24,1220594794,1220598652,2,4,3858
26874770@N06,3289,20,1220597794,1220597794,1,4,0
26874770@N06,3290,3,1221310505,1221310505,1,1,0
26874770@N06,3291,27,1225163108,1225163108,1,7,0
26874770@N06,3291,16,1225159833,1225161388,6,7,1555
26874770@N06,3291,5,1225154112,1225154213,3,7,101
26874770@N06,3291,20,1225164380,1225164380,1,7,0
26874770@N06,3291,26,1225163491,1225163491,1,7,0
26874770@N06,3291,17,1225163100,1225163100,1,7,0
26874770@N06,3291,29,1225164269,1225175140,5,7,10871
26874770@N06,3292,20,1225253756,1225275179,8,2,21423
26874770@N06,3292,29,1225250154,1225253712,2,2,3558
26874770@N06,3293,5,1225326275,1225326275,1,4,0
26874770@N06,3293,20,1225330150,1225330382,2,4,232
26874770@N06,3293,24,1225328478,1225328478,1,4,0
26874770@N06,3293,17,1225335466,1225335486,2,4,20
26874770@N06,3294,27,1225453534,1225453579,2,4,45
26874770@N06,3294,16,1225453524,1225453524,1,4,0
26874770@N06,3294,20,1225447102,1225454281,2,4,7179
26874770@N06,3294,29,1225453741,1225453741,1,4,0
26874770@N06,3295,6,1227003239,1227003239,1,1,0
26874770@N06,3296,27,1227701324,1227701324,1,1,0
26874770@N06,3297,15,1228548303,1228548303,1,1,0
26874770@N06,3298,20,1229074296,1229074298,2,1,2
26874770@N06,3299,20,1248240995,1248240995,1,3,0
26874770@N06,3299,26,1248239994,1248240639,11,3,645
26874770@N06,3299,15,1248234522,1248234522,1,3,0
26874770@N06,3300,25,1248318999,1248318999,1,2,0
26874770@N06,3300,16,1248319772,1248319772,1,2,0
26874770@N06,3301,31,1276393682,1276393682,1,1,0
26874770@N06,3302,29,1277714925,1277714925,1,2,0
26874770@N06,3302,1,1277712914,1277712914,1,2,0
26874770@N06,3303,27,1277831105,1277831105,1,1,0
26874770@N06,3304,26,1285348362,1285348404,2,3,42
26874770@N06,3304,21,1285328194,1285328403,3,3,209
26874770@N06,3304,17,1285345506,1285345506,1,3,0
26874770@N06,3305,1,1285426941,1285426941,1,1,0
26874770@N06,3306,1,1285470135,1285470135,1,1,0
26874770@N06,3307,29,1285506747,1285506747,1,3,0
26874770@N06,3307,28,1285516829,1285516850,2,3,21
26874770@N06,3307,5,1285502367,1285502367,1,3,0
26874770@N06,3308,26,1285578056,1285578056,1,6,0
26874770@N06,3308,21,1285557881,1285557881,1,6,0
26874770@N06,3308,27,1285577635,1285577635,1,6,0
26874770@N06,3308,17,1285577271,1285577271,1,6,0
26874770@N06,3308,28,1285555955,1285560131,3,6,4176
26874770@N06,3308,1,1285571140,1285571140,1,6,0
26874770@N06,3309,29,1307398358,1307410184,6,1,11826
26874770@N06,3310,29,1307451215,1307452219,2,1,1004
26874770@N06,3311,1,1439784913,1439784913,1,1,0
26879117@N08,3312,1,1405036209,1405036209,1,2,0
26879117@N08,3312,21,1405047747,1405047758,2,2,11
26879117@N08,3313,20,1414365253,1414365275,2,3,22
26879117@N08,3313,13,1414361122,1414361122,1,3,0
26879117@N08,3313,11,1414361879,1414361879,1,3,0
26897917@N02,3314,19,1422667409,1422667409,1,1,0
26920251@N04,3315,10,1253949544,1253949544,1,1,0
26968331@N00,3316,26,1212541275,1212570257,10,1,28982
26970624@N02,3317,3,1438671554,1438671968,2,2,414
26970624@N02,3317,26,1438656074,1438659343,5,2,3269
27012782@N02,3318,26,1230334306,1230382510,39,1,48204
27012782@N02,3319,26,1261875139,1261913675,11,1,38536
27045606@N06,3320,29,1325478529,1325478529,1,1,0
27045606@N06,3321,24,1358226860,1358226860,1,1,0
27059988@N08,3322,17,1365938011,1365938011,1,1,0
27059988@N08,3323,1,1460839207,1460839207,1,1,0
27059988@N08,3324,1,1461486615,1461486615,1,1,0
27059988@N08,3325,1,1462003224,1462003224,1,1,0
27087639@N00,3326,15,1399888015,1399888015,1,1,0
27103307@N00,3327,7,1388581366,1388582450,2,1,1084
27103307@N00,3328,28,1388732177,1388732177,1,1,0
27107561@N00,3329,19,1269057174,1269058142,8,2,968
27107561@N00,3329,28,1269056297,1269056313,2,2,16
27116474@N08,3330,12,1213151261,1213151261,1,3,0
27116474@N08,3330,28,1213143589,1213143589,1,3,0
27116474@N08,3330,20,1213166521,1213166521,1,3,0
27136682@N00,3331,26,1209089584,1209089584,1,7,0
27136682@N00,3331,29,1209118519,1209119000,3,7,481
27136682@N00,3331,23,1209095123,1209096598,4,7,1475
27136682@N00,3331,31,1209097799,1209097799,1,7,0
27136682@N00,3331,28,1209119848,1209119848,1,7,0
27136682@N00,3331,3,1209117043,1209117043,1,7,0
27136682@N00,3331,30,1209117493,1209117493,1,7,0
27136682@N00,3332,6,1209179741,1209179741,1,2,0
27136682@N00,3332,19,1209186442,1209186442,1,2,0
27136682@N00,3333,3,1209253755,1209253755,1,2,0
27136682@N00,3333,4,1209252537,1209252537,1,2,0
27176897@N05,3334,18,1447671773,1447672360,4,2,587
27176897@N05,3334,15,1447672450,1447672450,1,2,0
27188738@N02,3335,17,1334123788,1334123788,1,1,0
27188738@N02,3336,30,1334180851,1334180851,1,1,0
27188738@N02,3337,17,1334364766,1334364766,1,1,0
27190564@N02,3338,22,1356559172,1356559172,1,3,0
27190564@N02,3338,30,1356562592,1356562701,4,3,109
27190564@N02,3338,26,1356499853,1356618363,74,3,118510
27190564@N02,3339,26,1356739090,1356783937,8,1,44847
27190564@N02,3340,30,1356860279,1356916727,24,2,56448
27190564@N02,3340,26,1356881498,1356928927,26,2,47429
27191491@N06,3341,28,1355004446,1355004446,1,1,0
27204329@N02,3342,28,1216045370,1216046686,14,1,1316
27204329@N02,3343,28,1216080957,1216125013,169,1,44056
27205052@N05,3344,6,1299456808,1299456831,2,16,23
27205052@N05,3344,12,1299469554,1299480172,2,16,10618
27205052@N05,3344,19,1299461132,1299484566,6,16,23434
27205052@N05,3344,25,1299454400,1299473508,9,16,19108
27205052@N05,3344,27,1299450849,1299450849,1,16,0
27205052@N05,3344,15,1299474364,1299475810,7,16,1446
27205052@N05,3344,17,1299477324,1299478558,4,16,1234
27205052@N05,3344,28,1299450569,1299487669,4,16,37100
27205052@N05,3344,26,1299468507,1299486903,4,16,18396
27205052@N05,3344,24,1299450967,1299480155,6,16,29188
27205052@N05,3344,30,1299456953,1299480992,10,16,24039
27205052@N05,3344,18,1299465405,1299467995,15,16,2590
27205052@N05,3344,7,1299456764,1299456764,1,16,0
27205052@N05,3344,20,1299462611,1299462611,1,16,0
27205052@N05,3344,1,1299450495,1299479528,2,16,29033
27205052@N05,3344,29,1299460981,1299484901,18,16,23920
27245281@N05,3345,29,1278143228,1278143228,1,1,0
27249348@N03,3346,1,1370059310,1370074492,2,1,15182
27258925@N00,3347,28,1218972117,1218972296,2,1,179
27258925@N00,3348,27,1239538050,1239538050,1,1,0
27258925@N00,3349,16,1239668954,1239668974,2,2,20
27258925@N00,3349,28,1239675225,1239675386,4,2,161
27258925@N00,3350,3,1281993733,1281993752,4,3,19
27258925@N00,3350,12,1281993831,1281993839,3,3,8
27258925@N00,3350,7,1281993820,1281993820,1,3,0
27258925@N00,3351,26,1282042438,1282042438,1,1,0
27258925@N00,3352,17,1287736898,1287736988,2,2,90
27258925@N00,3352,10,1287738048,1287738048,1,2,0
27261720@N00,3353,19,1202308208,1202308208,1,1,0
27270059@N04,3354,10,1218793405,1218806995,10,1,13590
27270059@N04,3355,10,1221881629,1221905201,14,1,23572
27270059@N04,3356,10,1224387733,1224400008,6,1,12275
27270059@N04,3357,10,1224915216,1224915216,1,1,0
27270059@N04,3358,10,1227507520,1227516192,3,1,8672
27270059@N04,3359,10,1230778322,1230799815,10,1,21493
27270059@N04,3360,10,1235191947,1235213355,11,1,21408
27270059@N04,3361,10,1235870740,1235870781,2,1,41
27276174@N07,3362,1,1368066971,1368066971,1,1,0
27343295@N07,3363,28,1230418387,1230418391,2,1,4
27343295@N07,3364,24,1230455625,1230455625,1,4,0
27343295@N07,3364,9,1230448999,1230448999,1,4,0
27343295@N07,3364,26,1230457189,1230457189,1,4,0
27343295@N07,3364,21,1230456947,1230456947,1,4,0
27343295@N07,3365,17,1230532342,1230532342,1,5,0
27343295@N07,3365,7,1230533724,1230533724,1,5,0
27343295@N07,3365,28,1230509230,1230529946,3,5,20716
27343295@N07,3365,14,1230508020,1230508059,2,5,39
27343295@N07,3365,22,1230507586,1230507586,1,5,0
27343295@N07,3366,26,1232881855,1232881855,1,1,0
27365671@N00,3367,20,1353646551,1353646551,1,1,0
27365671@N00,3368,7,1383451100,1383451100,1,3,0
27365671@N00,3368,27,1383435034,1383435034,1,3,0
27365671@N00,3368,5,1383451921,1383451921,1,3,0
27365671@N00,3369,20,1417305100,1417305100,2,3,0
27365671@N00,3369,18,1417297499,1417297499,1,3,0
27365671@N00,3369,11,1417304097,1417304097,1,3,0
27365671@N00,3370,21,1419371883,1419371883,1,1,0
27374044@N00,3371,13,1280822104,1280822104,1,8,0
27374044@N00,3371,25,1280822112,1280822112,1,8,0
27374044@N00,3371,26,1280812730,1280812730,1,8,0
27374044@N00,3371,1,1280822607,1280822607,1,8,0
27374044@N00,3371,20,1280817933,1280820764,2,8,2831
27374044@N00,3371,28,1280810144,1280825296,7,8,15152
27374044@N00,3371,15,1280815075,1280815075,1,8,0
27374044@N00,3371,27,1280810566,1280810566,1,8,0
27374044@N00,3372,30,1280897801,1280900345,5,9,2544
27374044@N00,3372,25,1280916102,1280916102,1,9,0
27374044@N00,3372,26,1280903835,1280921605,5,9,17770
27374044@N00,3372,1,1280907745,1280907745,1,9,0
27374044@N00,3372,10,1280900497,1280900565,3,9,68
27374044@N00,3372,21,1280916695,1280916866,2,9,171
27374044@N00,3372,24,1280912969,1280913121,2,9,152
27374044@N00,3372,28,1280910684,1280911617,6,9,933
27374044@N00,3372,12,1280914325,1280914325,1,9,0
27374044@N00,3373,28,1312519752,1312519752,1,1,0
27379479@N00,3374,23,1308314557,1308314557,1,1,0
27379479@N00,3375,26,1308461439,1308461439,1,1,0
27379479@N00,3376,28,1308569604,1308569604,1,1,0
27388187@N07,3377,4,1310535831,1310535831,1,5,0
27388187@N07,3377,3,1310536350,1310536383,3,5,33
27388187@N07,3377,19,1310521681,1310523627,2,5,1946
27388187@N07,3377,1,1310518939,1310518939,1,5,0
27388187@N07,3377,20,1310528987,1310528987,1,5,0
27388187@N07,3378,21,1310605061,1310605061,1,3,0
27388187@N07,3378,1,1310627827,1310627827,1,3,0
27388187@N07,3378,22,1310606995,1310606995,1,3,0
27428435@N00,3379,14,1244347545,1244347545,1,2,0
27428435@N00,3379,4,1244358002,1244358002,1,2,0
27428435@N00,3380,28,1261619243,1261619243,1,1,0
27428435@N00,3381,3,1266033980,1266033980,1,1,0
27428435@N00,3382,24,1266647328,1266647328,1,1,0
27428435@N00,3383,13,1280557613,1280557618,2,1,5
27428435@N00,3384,1,1290568806,1290568814,2,1,8
27428435@N00,3385,14,1293154367,1293154367,1,1,0
27452410@N00,3386,26,1374839679,1374839679,1,1,0
27453680@N05,3387,26,1246581301,1246581301,1,4,0
27453680@N05,3387,16,1246618286,1246618286,1,4,0
27453680@N05,3387,30,1246598961,1246598961,1,4,0
27453680@N05,3387,22,1246601728,1246601728,1,4,0
27464730@N06,3388,13,1332573777,1332573777,1,1,0
27464730@N06,3389,27,1332721659,1332721895,2,2,236
27464730@N06,3389,24,1332748644,1332748644,1,2,0
27466777@N05,3390,1,1190435294,1190435294,1,1,0
27467292@N03,3391,3,1261427448,1261427448,1,1,0
27467292@N03,3392,23,1268178005,1268178005,1,1,0
27467292@N03,3393,10,1275941873,1275941873,1,1,0
27467292@N03,3394,27,1276023761,1276023761,1,1,0
27467292@N03,3395,13,1299582628,1299582628,1,1,0
27467292@N03,3396,6,1299717343,1299717343,1,1,0
27467292@N03,3397,6,1307136985,1307136985,1,1,0
27467292@N03,3398,28,1307222019,1307222019,1,1,0
27467292@N03,3399,13,1307263409,1307263409,1,1,0
27467292@N03,3400,26,1333488912,1333489430,2,2,518
27467292@N03,3400,1,1333486211,1333486211,1,2,0
27468992@N04,3401,17,1219327261,1219327261,1,2,0
27468992@N04,3401,26,1219317405,1219317409,2,2,4
27468992@N04,3402,19,1219416428,1219416681,2,1,253
27502547@N02,3403,26,1354956350,1354956350,1,1,0
27502547@N02,3404,29,1355119396,1355119396,1,1,0
27502547@N02,3405,30,1355189233,1355189233,1,1,0
27522121@N02,3406,27,1276570169,1276570169,1,1,0
27527078@N05,3407,28,1310955569,1310955956,3,2,387
27527078@N05,3407,9,1310957538,1310957554,2,2,16
27527078@N05,3408,25,1311154158,1311154167,2,1,9
27527078@N05,3409,4,1311236209,1311236209,1,3,0
27527078@N05,3409,5,1311218607,1311236162,4,3,17555
27527078@N05,3409,1,1311217101,1311217113,3,3,12
27534487@N08,3410,30,1351573908,1351573908,1,1,0
27534487@N08,3411,17,1355290154,1355290154,1,1,0
27534487@N08,3412,17,1358128649,1358128649,1,2,0
27534487@N08,3412,23,1358133694,1358133694,1,2,0
27534487@N08,3413,17,1360716988,1360716988,1,2,0
27534487@N08,3413,23,1360722286,1360722286,1,2,0
27534487@N08,3414,18,1362011795,1362011795,1,3,0
27534487@N08,3414,29,1362028998,1362028998,1,3,0
27534487@N08,3414,28,1362012738,1362012738,1,3,0
27534487@N08,3415,10,1365486628,1365486628,1,1,0
27534487@N08,3416,15,1366687684,1366687914,2,1,230
27534487@N08,3417,29,1368090148,1368090148,1,1,0
27534487@N08,3418,13,1369726472,1369726472,1,1,0
27534487@N08,3419,29,1389241230,1389241230,1,1,0
27534487@N08,3420,28,1394516348,1394516348,1,1,0
27534487@N08,3421,17,1422968579,1422968579,1,1,0
27537590@N00,3422,26,1354481956,1354481956,1,1,0
27550464@N05,3423,13,1236830404,1236830404,1,1,0
27583299@N03,3424,20,1241685218,1241685218,1,1,0
27583299@N03,3425,26,1306235618,1306235618,1,2,0
27583299@N03,3425,28,1306218069,1306218069,1,2,0
27583299@N03,3426,23,1332295641,1332295641,1,1,0
27583299@N03,3427,30,1332819314,1332819314,1,2,0
27583299@N03,3427,28,1332835090,1332835186,2,2,96
27583299@N03,3428,17,1370213129,1370213129,1,1,0
27609173@N03,3429,21,1306980620,1306983965,4,9,3345
27609173@N03,3429,13,1306982744,1306982744,1,9,0
27609173@N03,3429,4,1306980180,1306980216,3,9,36
27609173@N03,3429,18,1306966211,1306966211,1,9,0
27609173@N03,3429,5,1306980731,1306983688,3,9,2957
27609173@N03,3429,3,1306984262,1306984262,1,9,0
27609173@N03,3429,15,1306989499,1306989499,1,9,0
27609173@N03,3429,16,1306966738,1306967740,5,9,1002
27609173@N03,3429,25,1306981784,1306982178,5,9,394
27615993@N03,3430,29,1271227031,1271227031,1,1,0
27637794@N05,3431,7,1335436669,1335436669,1,2,0
27637794@N05,3431,28,1335421962,1335421962,1,2,0
27666630@N00,3432,18,1401445635,1401445635,1,1,0
27668789@N00,3433,28,1195696688,1195735770,24,1,39082
27681352@N05,3434,1,1239011331,1239011331,1,1,0
27693484@N06,3435,26,1466244791,1466244791,1,1,0
27702462@N07,3436,18,1358575499,1358575499,1,2,0
27702462@N07,3436,20,1358592416,1358592416,1,2,0
27702462@N07,3437,27,1358650169,1358650169,1,6,0
27702462@N07,3437,25,1358660570,1358660570,1,6,0
27702462@N07,3437,17,1358685399,1358685399,1,6,0
27702462@N07,3437,5,1358663828,1358663828,1,6,0
27702462@N07,3437,13,1358664403,1358664403,1,6,0
27702462@N07,3437,12,1358657681,1358667417,2,6,9736
27705062@N03,3438,26,1466423675,1466423675,1,1,0
27711944@N03,3439,26,1468824066,1468824066,1,1,0
27745483@N07,3440,27,1419867556,1419867751,3,12,195
27745483@N07,3440,18,1419868130,1419868130,1,12,0
27745483@N07,3440,26,1419864169,1419864258,2,12,89
27745483@N07,3440,23,1419864086,1419868056,6,12,3970
27745483@N07,3440,28,1419866244,1419866244,1,12,0
27745483@N07,3440,21,1419863073,1419863073,1,12,0
27745483@N07,3440,7,1419867796,1419867796,1,12,0
27745483@N07,3440,25,1419863156,1419863356,2,12,200
27745483@N07,3440,29,1419863943,1419863943,1,12,0
27745483@N07,3440,30,1419863929,1419863929,1,12,0
27745483@N07,3440,15,1419868469,1419868523,2,12,54
27745483@N07,3440,19,1419836337,1419875926,14,12,39589
27751748@N08,3441,30,1262065378,1262065391,2,4,13
27751748@N08,3441,28,1262076309,1262076309,1,4,0
27751748@N08,3441,16,1262090519,1262090624,7,4,105
27751748@N08,3441,9,1262056060,1262056060,1,4,0
27761152@N03,3442,11,1223958485,1223960864,4,1,2379
27761152@N03,3443,11,1227676827,1227681782,6,1,4955
27801060@N00,3444,16,1430694950,1430695141,2,2,191
27801060@N00,3444,29,1430701843,1430701843,1,2,0
27813472@N00,3445,25,1358415744,1358415744,1,1,0
27813472@N00,3446,26,1358463351,1358463351,1,3,0
27813472@N00,3446,6,1358463137,1358463137,1,3,0
27813472@N00,3446,11,1358463289,1358463289,1,3,0
27813472@N00,3447,11,1360523452,1360523452,1,2,0
27813472@N00,3447,4,1360523516,1360523516,1,2,0
27813472@N00,3448,29,1361000486,1361000486,1,2,0
27813472@N00,3448,28,1360997931,1360997931,1,2,0
27813472@N00,3449,18,1361059142,1361061715,12,10,2573
27813472@N00,3449,15,1361053272,1361054054,6,10,782
27813472@N00,3449,29,1361054017,1361058464,8,10,4447
27813472@N00,3449,20,1361053911,1361053911,1,10,0
27813472@N00,3449,30,1361061752,1361064763,8,10,3011
27813472@N00,3449,26,1361065678,1361065741,2,10,63
27813472@N00,3449,24,1361052778,1361067488,9,10,14710
27813472@N00,3449,22,1361057486,1361058026,3,10,540
27813472@N00,3449,12,1361052752,1361066733,2,10,13981
27813472@N00,3449,1,1361053720,1361054442,2,10,722
27813472@N00,3450,16,1361174061,1361174061,1,7,0
27813472@N00,3450,1,1361157940,1361158548,7,7,608
27813472@N00,3450,28,1361157850,1361158720,6,7,870
27813472@N00,3450,18,1361176892,1361176892,1,7,0
27813472@N00,3450,26,1361176180,1361176357,2,7,177
27813472@N00,3450,24,1361183155,1361183717,2,7,562
27813472@N00,3450,17,1361182222,1361182222,1,7,0
27813472@N00,3451,22,1361265664,1361267442,2,7,1778
27813472@N00,3451,27,1361260692,1361260692,1,7,0
27813472@N00,3451,3,1361263946,1361263946,1,7,0
27813472@N00,3451,26,1361264089,1361271116,13,7,7027
27813472@N00,3451,17,1361262415,1361262415,1,7,0
27813472@N00,3451,7,1361263976,1361270909,6,7,6933
27813472@N00,3451,30,1361268776,1361268776,1,7,0
27813472@N00,3452,22,1361324409,1361328109,3,15,3700
27813472@N00,3452,10,1361319730,1361319730,1,15,0
27813472@N00,3452,31,1361324123,1361324723,5,15,600
27813472@N00,3452,19,1361334080,1361334291,4,15,211
27813472@N00,3452,23,1361334891,1361334932,2,15,41
27813472@N00,3452,9,1361319762,1361319762,1,15,0
27813472@N00,3452,20,1361324371,1361324371,1,15,0
27813472@N00,3452,28,1361336282,1361336282,1,15,0
27813472@N00,3452,7,1361319898,1361321706,3,15,1808
27813472@N00,3452,18,1361334711,1361334711,1,15,0
27813472@N00,3452,26,1361319243,1361322638,6,15,3395
27813472@N00,3452,11,1361319507,1361319507,1,15,0
27813472@N00,3452,6,1361319891,1361320292,9,15,401
27813472@N00,3452,29,1361324132,1361333477,9,15,9345
27813472@N00,3452,14,1361329238,1361330931,2,15,1693
27813472@N00,3453,3,1361396400,1361397075,4,5,675
27813472@N00,3453,1,1361397723,1361397723,1,5,0
27813472@N00,3453,28,1361395470,1361395478,2,5,8
27813472@N00,3453,26,1361397483,1361397483,1,5,0
27813472@N00,3453,7,1361397408,1361397408,1,5,0
27813472@N00,3454,26,1361500869,1361500869,1,1,0
27813472@N00,3455,28,1362264347,1362264349,2,1,2
27813472@N00,3456,4,1367471196,1367472059,3,6,863
27813472@N00,3456,27,1367471434,1367471434,1,6,0
27813472@N00,3456,20,1367471033,1367471033,1,6,0
27813472@N00,3456,28,1367471530,1367478367,3,6,6837
27813472@N00,3456,26,1367470798,1367470900,2,6,102
27813472@N00,3456,29,1367472480,1367472480,1,6,0
27813472@N00,3457,28,1403335231,1403335231,1,2,0
27813472@N00,3457,26,1403326094,1403326094,1,2,0
27813472@N00,3458,25,1418278898,1418278898,1,1,0
27813472@N00,3459,22,1418337116,1418337116,1,7,0
27813472@N00,3459,25,1418374247,1418374787,2,7,540
27813472@N00,3459,3,1418376561,1418376561,1,7,0
27813472@N00,3459,12,1418339286,1418339286,1,7,0
27813472@N00,3459,28,1418333281,1418370277,2,7,36996
27813472@N00,3459,26,1418375844,1418375844,1,7,0
27813472@N00,3459,24,1418355156,1418355156,1,7,0
27813472@N00,3460,1,1418452569,1418452569,1,1,0
27813472@N00,3461,26,1425003755,1425003755,1,1,0
27813472@N00,3462,18,1425037782,1425037782,1,1,0
27813472@N00,3463,26,1425105205,1425105743,17,5,538
27813472@N00,3463,22,1425102011,1425102011,1,5,0
27813472@N00,3463,29,1425114728,1425115416,2,5,688
27813472@N00,3463,31,1425102005,1425102005,1,5,0
27813472@N00,3463,6,1425105716,1425105716,1,5,0
27813472@N00,3464,30,1425161282,1425162480,3,6,1198
27813472@N00,3464,23,1425162766,1425162864,5,6,98
27813472@N00,3464,29,1425161879,1425161879,1,6,0
27813472@N00,3464,22,1425162064,1425162064,1,6,0
27813472@N00,3464,20,1425158681,1425159001,4,6,320
27813472@N00,3464,31,1425159645,1425162454,4,6,2809
27813472@N00,3465,29,1437032509,1437032509,1,4,0
27813472@N00,3465,28,1437033114,1437045985,28,4,12871
27813472@N00,3465,1,1437024051,1437024739,3,4,688
27813472@N00,3465,25,1437026190,1437027380,9,4,1190
27813472@N00,3466,26,1437113214,1437137799,7,12,24585
27813472@N00,3466,21,1437090671,1437092271,4,12,1600
27813472@N00,3466,23,1437081055,1437081062,2,12,7
27813472@N00,3466,22,1437084776,1437084897,5,12,121
27813472@N00,3466,29,1437128899,1437130770,4,12,1871
27813472@N00,3466,20,1437084471,1437085204,2,12,733
27813472@N00,3466,19,1437081106,1437081106,1,12,0
27813472@N00,3466,28,1437079697,1437080501,5,12,804
27813472@N00,3466,14,1437084862,1437085977,4,12,1115
27813472@N00,3466,1,1437079597,1437115240,3,12,35643
27813472@N00,3466,10,1437087744,1437087744,1,12,0
27813472@N00,3466,3,1437089687,1437089687,1,12,0
27813472@N00,3467,26,1437174192,1437182602,6,12,8410
27813472@N00,3467,18,1437189985,1437189985,1,12,0
27813472@N00,3467,23,1437210308,1437210308,1,12,0
27813472@N00,3467,22,1437206512,1437208920,5,12,2408
27813472@N00,3467,4,1437180821,1437181021,3,12,200
27813472@N00,3467,31,1437209973,1437209973,1,12,0
27813472@N00,3467,28,1437182690,1437210475,12,12,27785
27813472@N00,3467,1,1437189762,1437201789,13,12,12027
27813472@N00,3467,21,1437180597,1437181079,8,12,482
27813472@N00,3467,11,1437180851,1437180937,3,12,86
27813472@N00,3467,27,1437200712,1437200970,2,12,258
27813472@N00,3467,29,1437206118,1437210170,5,12,4052
27813472@N00,3468,30,1437266940,1437280473,3,5,13533
27813472@N00,3468,26,1437256953,1437257313,6,5,360
27813472@N00,3468,16,1437256855,1437256855,1,5,0
27813472@N00,3468,28,1437257449,1437276932,8,5,19483
27813472@N00,3468,1,1437256063,1437274603,15,5,18540
27813472@N00,3469,28,1437735824,1437741105,3,3,5281
27813472@N00,3469,1,1437735811,1437743340,3,3,7529
27813472@N00,3469,21,1437738833,1437738833,1,3,0
27813472@N00,3470,29,1437782624,1437798885,5,10,16261
27813472@N00,3470,1,1437775574,1437832400,11,10,56826
27813472@N00,3470,19,1437783109,1437783109,1,10,0
27813472@N00,3470,26,1437783650,1437796156,6,10,12506
27813472@N00,3470,15,1437787284,1437787328,2,10,44
27813472@N00,3470,28,1437775191,1437807867,13,10,32676
27813472@N00,3470,30,1437798719,1437799821,4,10,1102
27813472@N00,3470,22,1437780425,1437799607,5,10,19182
27813472@N00,3470,31,1437780021,1437798997,7,10,18976
27813472@N00,3470,23,1437800214,1437800257,2,10,43
27813472@N00,3471,1,1437861639,1437862217,11,3,578
27813472@N00,3471,28,1437863787,1437863957,4,3,170
27813472@N00,3471,23,1437864139,1437864139,1,3,0
27813472@N00,3472,29,1439357576,1439357576,1,9,0
27813472@N00,3472,14,1439373881,1439373881,1,9,0
27813472@N00,3472,1,1439352547,1439384647,8,9,32100
27813472@N00,3472,26,1439362086,1439362086,1,9,0
27813472@N00,3472,19,1439353228,1439353228,1,9,0
27813472@N00,3472,22,1439373168,1439373296,5,9,128
27813472@N00,3472,20,1439380584,1439380584,1,9,0
27813472@N00,3472,31,1439357514,1439357514,1,9,0
27813472@N00,3472,28,1439352870,1439381519,3,9,28649
27813472@N00,3473,29,1439418368,1439428893,5,13,10525
27813472@N00,3473,14,1439430471,1439430471,1,13,0
27813472@N00,3473,1,1439417727,1439418141,4,13,414
27813472@N00,3473,10,1439420204,1439420204,1,13,0
27813472@N00,3473,19,1439428783,1439428783,1,13,0
27813472@N00,3473,25,1439422918,1439423965,15,13,1047
27813472@N00,3473,17,1439427542,1439427542,1,13,0
27813472@N00,3473,30,1439420836,1439428658,2,13,7822
27813472@N00,3473,15,1439419661,1439419661,1,13,0
27813472@N00,3473,31,1439429029,1439429146,2,13,117
27813472@N00,3473,28,1439416599,1439416623,2,13,24
27813472@N00,3473,18,1439434048,1439434055,2,13,7
27813472@N00,3473,23,1439428709,1439428727,2,13,18
27813472@N00,3474,21,1439463061,1439463066,2,3,5
27813472@N00,3474,29,1439475530,1439475596,2,3,66
27813472@N00,3474,20,1439475470,1439475470,1,3,0
27813472@N00,3475,11,1439524319,1439526024,3,14,1705
27813472@N00,3475,14,1439506886,1439506886,1,14,0
27813472@N00,3475,27,1439553089,1439553089,1,14,0
27813472@N00,3475,13,1439505121,1439505172,2,14,51
27813472@N00,3475,25,1439505187,1439505187,1,14,0
27813472@N00,3475,26,1439516912,1439518038,4,14,1126
27813472@N00,3475,29,1439506040,1439530976,7,14,24936
27813472@N00,3475,28,1439536450,1439536450,1,14,0
27813472@N00,3475,17,1439531562,1439531562,1,14,0
27813472@N00,3475,30,1439509397,1439509397,1,14,0
27813472@N00,3475,22,1439506842,1439506842,1,14,0
27813472@N00,3475,20,1439506814,1439507641,3,14,827
27813472@N00,3475,18,1439552247,1439552247,1,14,0
27813472@N00,3475,23,1439505910,1439505910,1,14,0
27813472@N00,3476,29,1439677182,1439678804,13,10,1622
27813472@N00,3476,9,1439676394,1439676394,1,10,0
27813472@N00,3476,26,1439635019,1439676772,9,10,41753
27813472@N00,3476,1,1439673665,1439673810,4,10,145
27813472@N00,3476,10,1439634682,1439634736,4,10,54
27813472@N00,3476,19,1439678349,1439678637,8,10,288
27813472@N00,3476,30,1439648129,1439679217,6,10,31088
27813472@N00,3476,6,1439634656,1439634855,2,10,199
27813472@N00,3476,20,1439677122,1439677948,10,10,826
27813472@N00,3476,28,1439638404,1439681046,12,10,42642
27813472@N00,3477,26,1445309059,1445309059,1,5,0
27813472@N00,3477,1,1445306828,1445337477,3,5,30649
27813472@N00,3477,8,1445311584,1445311584,1,5,0
27813472@N00,3477,28,1445308150,1445336088,3,5,27938
27813472@N00,3477,18,1445336011,1445336011,1,5,0
27813472@N00,3478,6,1445408998,1445408998,1,9,0
27813472@N00,3478,12,1445412965,1445412965,1,9,0
27813472@N00,3478,24,1445415093,1445415260,3,9,167
27813472@N00,3478,19,1445404306,1445407159,7,9,2853
27813472@N00,3478,3,1445411262,1445411262,1,9,0
27813472@N00,3478,5,1445408502,1445408502,1,9,0
27813472@N00,3478,30,1445386396,1445404986,4,9,18590
27813472@N00,3478,15,1445412745,1445412745,1,9,0
27813472@N00,3478,18,1445404013,1445404511,3,9,498
27813472@N00,3479,19,1445481715,1445481802,2,16,87
27813472@N00,3479,6,1445503635,1445503840,2,16,205
27813472@N00,3479,14,1445484279,1445484279,1,16,0
27813472@N00,3479,1,1445478058,1445500135,7,16,22077
27813472@N00,3479,10,1445503911,1445503911,1,16,0
27813472@N00,3479,13,1445502638,1445502638,1,16,0
27813472@N00,3479,26,1445501428,1445501428,1,16,0
27813472@N00,3479,8,1445501687,1445501687,1,16,0
27813472@N00,3479,17,1445500320,1445500320,1,16,0
27813472@N00,3479,30,1445511024,1445511024,1,16,0
27813472@N00,3479,22,1445483620,1445483620,1,16,0
27813472@N00,3479,20,1445483683,1445483683,1,16,0
27813472@N00,3479,16,1445509141,1445509141,1,16,0
27813472@N00,3479,28,1445485942,1445511614,5,16,25672
27813472@N00,3479,23,1445481555,1445481555,1,16,0
27813472@N00,3479,18,1445480928,1445483047,9,16,2119
27813472@N00,3480,1,1449732993,1449733135,3,3,142
27813472@N00,3480,28,1449733278,1449733278,1,3,0
27813472@N00,3480,21,1449733717,1449736651,8,3,2934
27813472@N00,3481,25,1453973107,1453973316,2,3,209
27813472@N00,3481,31,1453966890,1453966900,2,3,10
27813472@N00,3481,29,1453949772,1453949772,1,3,0
27813472@N00,3482,15,1454023498,1454023498,1,4,0
27813472@N00,3482,26,1454025044,1454025337,11,4,293
27813472@N00,3482,21,1454047961,1454049121,3,4,1160
27813472@N00,3482,10,1454047355,1454047558,3,4,203
27813472@N00,3483,16,1454100063,1454100951,2,8,888
27813472@N00,3483,12,1454105399,1454105399,1,8,0
27813472@N00,3483,31,1454102277,1454102489,4,8,212
27813472@N00,3483,1,1454099545,1454100686,2,8,1141
27813472@N00,3483,18,1454101446,1454101446,1,8,0
27813472@N00,3483,29,1454102455,1454102474,2,8,19
27813472@N00,3483,28,1454100261,1454100596,6,8,335
27813472@N00,3483,26,1454100136,1454101099,2,8,963
27813472@N00,3484,23,1454138974,1454138974,1,4,0
27813472@N00,3484,31,1454143568,1454143568,1,4,0
27813472@N00,3484,1,1454136636,1454136636,1,4,0
27813472@N00,3484,29,1454136404,1454142814,2,4,6410
27813472@N00,3485,1,1455521973,1455522273,2,2,300
27813472@N00,3485,28,1455522451,1455522451,1,2,0
27813472@N00,3486,17,1455575881,1455575881,1,7,0
27813472@N00,3486,24,1455603643,1455603643,1,7,0
27813472@N00,3486,19,1455582799,1455582799,1,7,0
27813472@N00,3486,31,1455574991,1455586378,2,7,11387
27813472@N00,3486,20,1455585833,1455585833,1,7,0
27813472@N00,3486,30,1455575492,1455575492,1,7,0
27813472@N00,3486,14,1455601009,1455601009,1,7,0
27813472@N00,3487,6,1455665634,1455665681,2,9,47
27813472@N00,3487,3,1455664087,1455664087,1,9,0
27813472@N00,3487,4,1455664261,1455664261,1,9,0
27813472@N00,3487,25,1455702991,1455703397,6,9,406
27813472@N00,3487,12,1455678235,1455678235,1,9,0
27813472@N00,3487,31,1455707028,1455707052,3,9,24
27813472@N00,3487,28,1455660317,1455707775,3,9,47458
27813472@N00,3487,30,1455680838,1455680857,2,9,19
27813472@N00,3487,26,1455665722,1455665722,1,9,0
27813472@N00,3488,6,1455751836,1455751836,1,4,0
27813472@N00,3488,29,1455747835,1455747912,2,4,77
27813472@N00,3488,26,1455751857,1455752291,7,4,434
27813472@N00,3488,8,1455751974,1455752212,2,4,238
27813472@N00,3489,3,1461498075,1461498075,1,2,0
27813472@N00,3489,20,1461499059,1461499072,2,2,13
27813472@N00,3490,1,1461568783,1461569798,6,5,1015
27813472@N00,3490,20,1461543554,1461543554,1,5,0
27813472@N00,3490,28,1461550200,1461550206,2,5,6
27813472@N00,3490,26,1461570663,1461570691,2,5,28
27813472@N00,3490,9,1461571866,1461571866,1,5,0
27813472@N00,3491,28,1461624057,1461624344,5,4,287
27813472@N00,3491,29,1461625726,1461626385,2,4,659
27813472@N00,3491,31,1461626105,1461626105,1,4,0
27813472@N00,3491,23,1461625551,1461625551,1,4,0
27813472@N00,3492,1,1461720198,1461720198,1,6,0
27813472@N00,3492,26,1461719641,1461719641,1,6,0
27813472@N00,3492,28,1461720344,1461720344,1,6,0
27813472@N00,3492,7,1461714426,1461714426,1,6,0
27813472@N00,3492,25,1461716996,1461716996,1,6,0
27813472@N00,3492,23,1461720772,1461720772,1,6,0
27813472@N00,3493,26,1461751915,1461751915,1,3,0
27813472@N00,3493,30,1461754017,1461754017,1,3,0
27813472@N00,3493,31,1461754187,1461754744,3,3,557
27813472@N00,3494,1,1461880118,1461880118,1,2,0
27813472@N00,3494,23,1461880823,1461880823,1,2,0
27815295@N00,3495,27,1379145762,1379145762,1,1,0
27815295@N00,3496,30,1397366459,1397366459,1,1,0
27837910@N00,3497,27,1353203867,1353203867,1,1,0
27860489@N03,3498,26,1342487541,1342487541,1,2,0
27860489@N03,3498,23,1342510486,1342510486,1,2,0
27867978@N08,3499,29,1328430841,1328431424,2,2,583
27867978@N08,3499,30,1328431693,1328431693,1,2,0
27867978@N08,3500,23,1355625188,1355625188,1,1,0
27867978@N08,3501,11,1361755186,1361755579,4,3,393
27867978@N08,3501,23,1361755914,1361755914,1,3,0
27867978@N08,3501,10,1361755647,1361755647,1,3,0
27867978@N08,3502,11,1378440482,1378465646,4,1,25164
27867978@N08,3503,11,1378796217,1378796224,8,1,7
27867978@N08,3504,11,1379496070,1379496246,13,1,176
27874578@N06,3505,13,1441074491,1441074654,3,1,163
27883541@N00,3506,28,1286768590,1286768590,1,1,0
27891275@N00,3507,29,1206415342,1206415342,1,1,0
27917561@N00,3508,26,1461804279,1461823836,38,1,19557
27927327@N04,3509,1,1387682340,1387682340,1,1,0
27934342@N00,3510,6,1420761615,1420761615,1,4,0
27934342@N00,3510,16,1420778308,1420778308,1,4,0
27934342@N00,3510,20,1420788067,1420788067,1,4,0
27934342@N00,3510,4,1420763196,1420763274,2,4,78
27948083@N02,3511,28,1329448273,1329448273,1,1,0
27948083@N02,3512,28,1329531623,1329531623,1,1,0
27948083@N02,3513,1,1363859457,1363859457,1,1,0
27950434@N04,3514,1,1352421898,1352456173,17,1,34275
27950434@N04,3515,1,1355800506,1355802717,6,1,2211
27950434@N04,3516,1,1414637534,1414659785,19,1,22251
27950434@N04,3517,1,1415577801,1415603830,19,1,26029
27950434@N04,3518,1,1416296190,1416296370,3,1,180
27983123@N00,3519,29,1254548905,1254548905,1,2,0
27983123@N00,3519,20,1254545413,1254545413,1,2,0
27983123@N00,3520,29,1270969531,1270969531,1,3,0
27983123@N00,3520,20,1270960654,1270960654,1,3,0
27983123@N00,3520,22,1270963761,1270963761,1,3,0
27983123@N00,3521,20,1302316830,1302316830,1,3,0
27983123@N00,3521,31,1302323326,1302323326,1,3,0
27983123@N00,3521,26,1302339188,1302339188,1,3,0
27991056@N07,3522,4,1298810280,1298810280,1,3,0
27991056@N07,3522,26,1298810278,1298810278,1,3,0
27991056@N07,3522,16,1298810279,1298810279,1,3,0
27991056@N07,3523,15,1299331316,1299331316,1,4,0
27991056@N07,3523,4,1299331314,1299331314,1,4,0
27991056@N07,3523,12,1299331313,1299331313,1,4,0
27991056@N07,3523,17,1299331315,1299331315,1,4,0
28043814@N06,3524,17,1357393304,1357393304,1,1,0
28046435@N05,3525,30,1398500995,1398508497,9,1,7502
28057734@N03,3526,28,1286606542,1286606542,1,1,0
28057734@N03,3527,15,1318668008,1318668008,1,3,0
28057734@N03,3527,29,1318668010,1318668010,1,3,0
28057734@N03,3527,1,1318668013,1318668013,1,3,0
28057734@N03,3528,28,1335786851,1335787610,3,1,759
28057734@N03,3529,30,1336443240,1336443240,1,4,0
28057734@N03,3529,29,1336444202,1336444202,1,4,0
28057734@N03,3529,1,1336443251,1336443251,1,4,0
28057734@N03,3529,22,1336424539,1336424539,1,4,0
28057734@N03,3530,28,1336615589,1336615589,1,1,0
28059153@N08,3531,23,1366423392,1366423392,1,1,0
28059153@N08,3532,28,1385375193,1385375227,3,1,34
28096801@N05,3533,24,1274514471,1274516144,2,1,1673
28096801@N05,3534,24,1290218252,1290218252,1,1,0
28132447@N00,3535,19,1257648186,1257648186,1,1,0
28139097@N00,3536,28,1230881569,1230881569,1,1,0
28139097@N00,3537,27,1236429189,1236429189,1,2,0
28139097@N00,3537,25,1236403521,1236404149,57,2,628
28172462@N00,3538,29,1303434515,1303434515,1,1,0
28172462@N00,3539,16,1337754233,1337754233,1,1,0
28173907@N00,3540,14,1283576398,1283576398,1,1,0
28176577@N04,3541,16,1400838731,1400838731,1,1,0
28215341@N07,3542,21,1429067141,1429067642,5,19,501
28215341@N07,3542,15,1429062114,1429062117,2,19,3
28215341@N07,3542,13,1429065294,1429066602,11,19,1308
28215341@N07,3542,17,1429059525,1429071834,2,19,12309
28215341@N07,3542,20,1429079157,1429079158,2,19,1
28215341@N07,3542,29,1429071980,1429074711,4,19,2731
28215341@N07,3542,28,1429058360,1429071930,13,19,13570
28215341@N07,3542,26,1429059518,1429059519,2,19,1
28215341@N07,3542,27,1429059004,1429059004,1,19,0
28215341@N07,3542,5,1429067842,1429068532,7,19,690
28215341@N07,3542,6,1429068250,1429068250,1,19,0
28215341@N07,3542,4,1429067623,1429068381,4,19,758
28215341@N07,3542,18,1429071497,1429071902,3,19,405
28215341@N07,3542,16,1429058745,1429059278,6,19,533
28215341@N07,3542,11,1429067528,1429067535,3,19,7
28215341@N07,3542,1,1429058392,1429058392,1,19,0
28215341@N07,3542,22,1429079257,1429079257,1,19,0
28215341@N07,3542,30,1429082674,1429082674,1,19,0
28215341@N07,3542,23,1429070782,1429070788,3,19,6
28223347@N00,3543,29,1270078803,1270078980,2,11,177
28223347@N00,3543,18,1270116821,1270116821,1,11,0
28223347@N00,3543,20,1270077101,1270077548,4,11,447
28223347@N00,3543,1,1270073769,1270073769,1,11,0
28223347@N00,3543,28,1270085287,1270094579,2,11,9292
28223347@N00,3543,26,1270074029,1270079024,2,11,4995
28223347@N00,3543,25,1270080948,1270081358,2,11,410
28223347@N00,3543,24,1270074441,1270074441,1,11,0
28223347@N00,3543,13,1270096305,1270100947,5,11,4642
28223347@N00,3543,6,1270079835,1270079853,2,11,18
28223347@N00,3543,16,1270074084,1270074084,1,11,0
28248687@N00,3544,1,1393389536,1393396255,2,1,6719
28254653@N03,3545,18,1337501151,1337501221,2,1,70
28254965@N04,3546,17,1311673762,1311673762,1,1,0
28287117@N00,3547,20,1282006545,1282006545,1,1,0
28287117@N00,3548,13,1282375061,1282375238,2,1,177
28288340@N03,3549,29,1297484468,1297484468,1,1,0
28289318@N07,3550,26,1454116963,1454156746,21,1,39783
28293356@N00,3551,27,1381461319,1381461319,1,1,0
28293356@N00,3552,14,1381536915,1381536915,1,1,0
28293356@N00,3553,23,1381713289,1381713289,1,2,0
28293356@N00,3553,1,1381703263,1381703713,2,2,450
28310527@N05,3554,24,1188801947,1188807082,17,1,5135
28366245@N03,3555,27,1386078781,1386078781,1,2,0
28366245@N03,3555,17,1386078148,1386078148,1,2,0
28402154@N03,3556,23,1379077107,1379077107,1,1,0
28402154@N03,3557,26,1386938218,1386938763,4,2,545
28402154@N03,3557,28,1386939871,1386939871,1,2,0
28402154@N03,3558,26,1388407597,1388407597,1,3,0
28402154@N03,3558,18,1388376389,1388410581,2,3,34192
28402154@N03,3558,31,1388401336,1388401336,1,3,0
28402154@N03,3559,17,1391255412,1391255412,1,3,0
28402154@N03,3559,18,1391235146,1391235146,1,3,0
28402154@N03,3559,23,1391235136,1391235136,1,3,0
28402154@N03,3560,27,1391302386,1391302386,1,1,0
28402154@N03,3561,1,1411002466,1411027673,6,1,25207
28402154@N03,3562,28,1417266093,1417266416,2,1,323
28402154@N03,3563,5,1419590869,1419590869,1,1,0
28438133@N08,3564,12,1304293691,1304293691,1,1,0
28438133@N08,3565,26,1304414067,1304414067,1,1,0
28443026@N04,3566,26,1221815315,1221815315,1,1,0
28443026@N04,3567,26,1221878587,1221878587,1,1,0
28443026@N04,3568,17,1385355833,1385355833,1,1,0
28450912@N02,3569,26,1446783812,1446783812,1,1,0
28450912@N02,3570,17,1446870416,1446870416,1,5,0
28450912@N02,3570,1,1446857294,1446857294,1,5,0
28450912@N02,3570,28,1446857376,1446857376,1,5,0
28450912@N02,3570,15,1446870280,1446870548,2,5,268
28450912@N02,3570,26,1446859440,1446876488,8,5,17048
28450912@N02,3571,13,1446949842,1446950166,5,8,324
28450912@N02,3571,19,1446947354,1446947354,1,8,0
28450912@N02,3571,30,1446956252,1446956252,1,8,0
28450912@N02,3571,16,1446948382,1446948382,1,8,0
28450912@N02,3571,29,1446955648,1446955648,1,8,0
28450912@N02,3571,28,1446947548,1446947548,1,8,0
28450912@N02,3571,21,1446949736,1446949736,1,8,0
28450912@N02,3571,31,1446952142,1446954078,2,8,1936
28495222@N04,3572,27,1238380702,1238380702,1,4,0
28495222@N04,3572,30,1238385630,1238385636,2,4,6
28495222@N04,3572,1,1238402973,1238403039,3,4,66
28495222@N04,3572,15,1238380633,1238380638,2,4,5
28505792@N06,3573,26,1292746422,1292746422,1,2,0
28505792@N06,3573,29,1292725582,1292725582,1,2,0
28519626@N07,3574,1,1299188392,1299188392,1,1,0
28519626@N07,3575,28,1299217706,1299226758,4,2,9052
28519626@N07,3575,1,1299225655,1299227382,2,2,1727
28519626@N07,3576,1,1299273711,1299273711,1,1,0
28519626@N07,3577,28,1353457039,1353457039,1,1,0
28530203@N03,3578,30,1388105734,1388105767,3,2,33
28530203@N03,3578,29,1388108514,1388108569,6,2,55
28555425@N00,3579,28,1347879480,1347879480,1,9,0
28555425@N00,3579,16,1347876370,1347876370,1,9,0
28555425@N00,3579,4,1347873734,1347873734,1,9,0
28555425@N00,3579,3,1347876163,1347876163,1,9,0
28555425@N00,3579,1,1347867837,1347867837,1,9,0
28555425@N00,3579,30,1347868271,1347870932,3,9,2661
28555425@N00,3579,27,1347879394,1347879394,1,9,0
28555425@N00,3579,26,1347876304,1347876304,1,9,0
28555425@N00,3579,20,1347869818,1347870862,6,9,1044
28555425@N00,3580,29,1347952270,1347952270,1,6,0
28555425@N00,3580,11,1347953422,1347953422,1,6,0
28555425@N00,3580,4,1347941792,1347941792,1,6,0
28555425@N00,3580,20,1347951073,1347951073,1,6,0
28555425@N00,3580,28,1347925317,1347925317,1,6,0
28555425@N00,3580,30,1347949254,1347949254,1,6,0
28558260@N04,3581,26,1470621432,1470652736,27,1,31304
28558260@N04,3582,26,1470729411,1470729411,1,1,0
28578888@N02,3583,4,1457174435,1457174435,1,1,0
28582753@N08,3584,17,1315688344,1315688344,1,1,0
28585603@N04,3585,8,1363848161,1363849800,6,9,1639
28585603@N04,3585,26,1363817486,1363823332,3,9,5846
28585603@N04,3585,3,1363818153,1363818846,2,9,693
28585603@N04,3585,4,1363823689,1363824011,5,9,322
28585603@N04,3585,14,1363813556,1363862103,8,9,48547
28585603@N04,3585,28,1363813261,1363813261,1,9,0
28585603@N04,3585,1,1363812931,1363813106,2,9,175
28585603@N04,3585,29,1363850013,1363850013,1,9,0
28585603@N04,3585,13,1363824467,1363825801,3,9,1334
28630872@N08,3586,23,1310903326,1310913340,84,2,10014
28630872@N08,3586,18,1310915055,1310915055,1,2,0
28721101@N05,3587,18,1293265941,1293265941,1,1,0
28736650@N07,3588,16,1244543769,1244543769,1,2,0
28736650@N07,3588,20,1244548606,1244548606,1,2,0
28736650@N07,3589,16,1244611378,1244611378,1,1,0
28736650@N07,3590,16,1244703489,1244703489,1,2,0
28736650@N07,3590,1,1244704379,1244704379,1,2,0
28736650@N07,3591,27,1338839967,1338839967,1,1,0
28742299@N04,3592,26,1468575382,1468588764,2,1,13382
28757300@N06,3593,1,1367847085,1367847085,1,1,0
28757300@N06,3594,1,1367961947,1367961947,1,1,0
28786002@N00,3595,28,1244166257,1244166257,1,1,0
28786002@N00,3596,21,1244269258,1244269394,5,2,136
28786002@N00,3596,28,1244265790,1244273585,6,2,7795
28789416@N05,3597,12,1343275215,1343275215,1,1,0
28799689@N00,3598,21,1203157760,1203158474,3,2,714
28799689@N00,3598,26,1203160940,1203160940,1,2,0
28934867@N04,3599,26,1233580079,1233580110,2,1,31
28934867@N04,3600,26,1242623000,1242623000,1,1,0
28934867@N04,3601,26,1242785727,1242785727,1,1,0
28935188@N00,3602,17,1349691866,1349691866,1,1,0
28935188@N00,3603,24,1349767408,1349767408,1,1,0
28935188@N00,3604,1,1349949589,1349949589,1,1,0
28935188@N00,3605,25,1350000517,1350000517,1,1,0
28935188@N00,3606,3,1350078138,1350079011,2,2,873
28935188@N00,3606,17,1350076210,1350076210,1,2,0
28935188@N00,3607,14,1383544285,1383544558,2,3,273
28935188@N00,3607,1,1383530764,1383530764,1,3,0
28935188@N00,3607,20,1383537996,1383537996,1,3,0
28935188@N00,3608,12,1383605432,1383605432,1,1,0
28935188@N00,3609,29,1383708897,1383708897,1,2,0
28935188@N00,3609,22,1383707749,1383707749,1,2,0
28935188@N00,3610,3,1450416464,1450416464,1,1,0
28977679@N02,3611,3,1453077783,1453077949,2,2,166
28977679@N02,3611,8,1453077879,1453077879,1,2,0
28977679@N02,3612,1,1453173047,1453173047,1,1,0
28977679@N02,3613,29,1453249484,1453249484,1,6,0
28977679@N02,3613,10,1453243009,1453243009,1,6,0
28977679@N02,3613,30,1453234668,1453234668,1,6,0
28977679@N02,3613,27,1453225036,1453232999,4,6,7963
28977679@N02,3613,1,1453223258,1453223258,1,6,0
28977679@N02,3613,19,1453248008,1453248402,8,6,394
28977679@N02,3614,20,1453495487,1453496718,11,1,1231
28977679@N02,3615,16,1453605316,1453605943,15,1,627
28977679@N02,3616,13,1453671485,1453671485,1,5,0
28977679@N02,3616,28,1453675471,1453675471,1,5,0
28977679@N02,3616,21,1453671932,1453671932,1,5,0
28977679@N02,3616,12,1453671182,1453671182,1,5,0
28977679@N02,3616,26,1453672101,1453672101,1,5,0
28979635@N02,3617,3,1283920532,1283920532,1,1,0
28980639@N02,3618,29,1388943598,1388943598,1,4,0
28980639@N02,3618,22,1388945517,1388945517,1,4,0
28980639@N02,3618,24,1388944071,1388944071,1,4,0
28980639@N02,3618,27,1388943820,1388945730,4,4,1910
28986472@N02,3619,1,1233448431,1233448431,1,1,0
28986472@N02,3620,29,1233533901,1233533901,1,1,0
29013352@N06,3621,16,1303645468,1303645468,1,4,0
29013352@N06,3621,26,1303645065,1303645065,1,4,0
29013352@N06,3621,28,1303645378,1303646305,7,4,927
29013352@N06,3621,24,1303639795,1303639795,1,4,0
29013352@N06,3622,12,1305593078,1305593078,1,3,0
29013352@N06,3622,16,1305602957,1305602957,1,3,0
29013352@N06,3622,24,1305594559,1305594559,1,3,0
29061824@N04,3623,29,1236391582,1236391582,1,1,0
29066111@N06,3624,16,1464095409,1464095425,2,5,16
29066111@N06,3624,20,1464071058,1464089894,2,5,18836
29066111@N06,3624,26,1464093858,1464093858,1,5,0
29066111@N06,3624,22,1464089830,1464090181,11,5,351
29066111@N06,3624,30,1464074483,1464074483,1,5,0
29066111@N06,3625,11,1464239710,1464239710,1,4,0
29066111@N06,3625,1,1464246034,1464246034,1,4,0
29066111@N06,3625,28,1464245849,1464246067,5,4,218
29066111@N06,3625,30,1464239765,1464239765,1,4,0
29080772@N05,3626,21,1221198368,1221198368,1,2,0
29080772@N05,3626,1,1221196691,1221196691,1,2,0
29080772@N05,3627,19,1221270425,1221270425,1,1,0
29129621@N05,3628,24,1243330166,1243330166,1,1,0
29131150@N07,3629,26,1438736080,1438736080,1,1,0
29173152@N08,3630,28,1270253269,1270253269,1,1,0
29224349@N04,3631,24,1351905560,1351906308,5,2,748
29224349@N04,3631,17,1351901100,1351901100,1,2,0
29225947@N00,3632,12,1318405177,1318405177,1,11,0
29225947@N00,3632,18,1318410650,1318410650,1,11,0
29225947@N00,3632,1,1318395708,1318402588,7,11,6880
29225947@N00,3632,27,1318408099,1318409182,11,11,1083
29225947@N00,3632,21,1318409947,1318409947,1,11,0
29225947@N00,3632,3,1318403414,1318403414,1,11,0
29225947@N00,3632,26,1318402944,1318403266,13,11,322
29225947@N00,3632,25,1318409991,1318409991,1,11,0
29225947@N00,3632,24,1318393303,1318395501,6,11,2198
29225947@N00,3632,16,1318403127,1318410419,5,11,7292
29225947@N00,3632,28,1318395551,1318402812,6,11,7261
29225947@N00,3633,23,1318477039,1318477127,6,12,88
29225947@N00,3633,1,1318470556,1318470591,8,12,35
29225947@N00,3633,13,1318504811,1318506828,26,12,2017
29225947@N00,3633,3,1318507777,1318507881,7,12,104
29225947@N00,3633,11,1318482122,1318482122,2,12,0
29225947@N00,3633,25,1318504532,1318504705,5,12,173
29225947@N00,3633,30,1318480344,1318480344,2,12,0
29225947@N00,3633,26,1318502042,1318502749,7,12,707
29225947@N00,3633,22,1318456600,1318460869,20,12,4269
29225947@N00,3633,16,1318452255,1318456493,47,12,4238
29225947@N00,3633,28,1318470743,1318475489,22,12,4746
29225947@N00,3633,20,1318478549,1318479019,8,12,470
29225947@N00,3634,3,1318539832,1318540657,4,3,825
29225947@N00,3634,4,1318542288,1318558120,48,3,15832
29225947@N00,3634,28,1318578163,1318596546,6,3,18383
29225947@N00,3635,1,1318627383,1318627484,3,6,101
29225947@N00,3635,14,1318632616,1318633645,9,6,1029
29225947@N00,3635,26,1318627602,1318627662,2,6,60
29225947@N00,3635,22,1318630779,1318631138,2,6,359
29225947@N00,3635,16,1318628507,1318630332,10,6,1825
29225947@N00,3635,28,1318633917,1318633917,1,6,0
29226741@N00,3636,26,1364202220,1364202220,1,1,0
29238928@N03,3637,16,1349487241,1349487241,1,1,0
29238928@N03,3638,26,1349521389,1349521948,2,1,559
29251788@N07,3639,6,1227765771,1227766160,2,5,389
29251788@N07,3639,3,1227764074,1227764074,1,5,0
29251788@N07,3639,14,1227763259,1227763430,4,5,171
29251788@N07,3639,26,1227767895,1227767895,1,5,0
29251788@N07,3639,5,1227764734,1227764734,1,5,0
29251788@N07,3640,14,1227939586,1227939586,1,7,0
29251788@N07,3640,28,1227949621,1227949621,1,7,0
29251788@N07,3640,10,1227933801,1227933801,1,7,0
29251788@N07,3640,22,1227932890,1227932890,1,7,0
29251788@N07,3640,31,1227933280,1227933280,1,7,0
29251788@N07,3640,24,1227956034,1227956034,1,7,0
29251788@N07,3640,1,1227951139,1227951139,1,7,0
29259314@N04,3641,28,1254780237,1254780294,2,18,57
29259314@N04,3641,1,1254778740,1254814750,5,18,36010
29259314@N04,3641,12,1254771319,1254784047,5,18,12728
29259314@N04,3641,7,1254785538,1254785605,3,18,67
29259314@N04,3641,26,1254815363,1254815363,1,18,0
29259314@N04,3641,20,1254789376,1254818958,9,18,29582
29259314@N04,3641,22,1254791473,1254802594,6,18,11121
29259314@N04,3641,17,1254780579,1254780882,3,18,303
29259314@N04,3641,9,1254785632,1254785632,1,18,0
29259314@N04,3641,25,1254808055,1254808055,1,18,0
29259314@N04,3641,31,1254790050,1254791636,14,18,1586
29259314@N04,3641,30,1254787009,1254790034,7,18,3025
29259314@N04,3641,24,1254781549,1254782029,3,18,480
29259314@N04,3641,15,1254780507,1254780507,1,18,0
29259314@N04,3641,29,1254787805,1254798969,9,18,11164
29259314@N04,3641,21,1254784478,1254784649,3,18,171
29259314@N04,3641,3,1254784318,1254785477,4,18,1159
29259314@N04,3641,19,1254819079,1254819079,1,18,0
29259314@N04,3642,12,1254886942,1254886942,1,2,0
29259314@N04,3642,10,1254888663,1254888663,1,2,0
29259314@N04,3643,28,1314998154,1314998395,2,11,241
29259314@N04,3643,1,1314998474,1314998474,1,11,0
29259314@N04,3643,26,1314998237,1314998237,1,11,0
29259314@N04,3643,22,1314997202,1315010181,3,11,12979
29259314@N04,3643,10,1315007534,1315041721,10,11,34187
29259314@N04,3643,5,1314997967,1314997967,1,11,0
29259314@N04,3643,13,1314997675,1314997675,1,11,0
29259314@N04,3643,25,1314997085,1314997867,3,11,782
29259314@N04,3643,30,1315034230,1315034240,2,11,10
29259314@N04,3643,19,1315012081,1315012523,4,11,442
29259314@N04,3643,27,1315013846,1315013890,4,11,44
29259314@N04,3644,28,1315081928,1315081948,2,12,20
29259314@N04,3644,14,1315082674,1315082674,1,12,0
29259314@N04,3644,1,1315081902,1315081902,1,12,0
29259314@N04,3644,12,1315082207,1315082207,1,12,0
29259314@N04,3644,26,1315082280,1315082300,3,12,20
29259314@N04,3644,22,1315082542,1315082542,1,12,0
29259314@N04,3644,6,1315082277,1315082277,1,12,0
29259314@N04,3644,13,1315082888,1315082910,2,12,22
29259314@N04,3644,25,1315082967,1315083033,2,12,66
29259314@N04,3644,30,1315082361,1315082383,2,12,22
29259314@N04,3644,29,1315082409,1315082409,1,12,0
29259314@N04,3644,21,1315082949,1315082949,1,12,0
29259314@N04,3645,28,1315193719,1315193909,4,5,190
29259314@N04,3645,26,1315185020,1315185020,1,5,0
29259314@N04,3645,22,1315187717,1315187717,1,5,0
29259314@N04,3645,16,1315193938,1315193938,1,5,0
29259314@N04,3645,27,1315185610,1315197227,2,5,11617
29259314@N04,3646,12,1315269592,1315269687,2,3,95
29259314@N04,3646,26,1315265727,1315270431,2,3,4704
29259314@N04,3646,4,1315267394,1315268061,9,3,667
29259314@N04,3647,28,1315381649,1315382239,2,5,590
29259314@N04,3647,1,1315371925,1315384364,3,5,12439
29259314@N04,3647,26,1315382000,1315382069,2,5,69
29259314@N04,3647,10,1315377977,1315377977,1,5,0
29259314@N04,3647,29,1315364793,1315370939,27,5,6146
29259314@N04,3648,26,1377900460,1377900460,1,3,0
29259314@N04,3648,13,1377899553,1377899553,1,3,0
29259314@N04,3648,30,1377900184,1377900184,1,3,0
29259314@N04,3649,1,1378079689,1378079689,1,6,0
29259314@N04,3649,26,1378081363,1378085127,3,6,3764
29259314@N04,3649,18,1378081655,1378081655,1,6,0
29259314@N04,3649,30,1378083945,1378083945,1,6,0
29259314@N04,3649,24,1378088791,1378088791,1,6,0
29259314@N04,3649,11,1378086531,1378086564,2,6,33
29259314@N04,3650,31,1378193469,1378193469,1,1,0
29259314@N04,3651,29,1378268431,1378268431,1,10,0
29259314@N04,3651,3,1378260509,1378275776,2,10,15267
29259314@N04,3651,11,1378259256,1378259256,1,10,0
29259314@N04,3651,4,1378253968,1378260748,5,10,6780
29259314@N04,3651,19,1378271877,1378271877,1,10,0
29259314@N04,3651,10,1378275415,1378275439,2,10,24
29259314@N04,3651,18,1378273660,1378273684,2,10,24
29259314@N04,3651,26,1378274823,1378274823,1,10,0
29259314@N04,3651,22,1378266265,1378266921,2,10,656
29259314@N04,3651,23,1378268740,1378268834,3,10,94
29311223@N00,3652,16,1223192877,1223192877,1,1,0
29311223@N00,3653,15,1223277147,1223277147,1,1,0
29311223@N00,3654,23,1225591839,1225591839,1,2,0
29311223@N00,3654,30,1225594437,1225594454,3,2,17
29311223@N00,3655,17,1240907654,1240907654,1,1,0
29311223@N00,3656,15,1244349888,1244350221,4,6,333
29311223@N00,3656,17,1244350323,1244350323,1,6,0
29311223@N00,3656,25,1244357247,1244357497,4,6,250
29311223@N00,3656,22,1244342403,1244342688,2,6,285
29311223@N00,3656,29,1244340970,1244340970,1,6,0
29311223@N00,3656,26,1244337398,1244364000,24,6,26602
29311223@N00,3657,16,1244543372,1244543392,2,1,20
29311223@N00,3658,24,1251601224,1251601224,1,1,0
29311223@N00,3659,24,1260906735,1260906735,1,1,0
29311223@N00,3660,28,1265243934,1265243934,1,1,0
29311223@N00,3661,17,1285979254,1285979254,1,1,0
29315916@N07,3662,31,1373519970,1373519970,1,2,0
29315916@N07,3662,29,1373506104,1373506104,1,2,0
29329200@N04,3663,26,1419927721,1419927897,2,5,176
29329200@N04,3663,29,1419923496,1419923817,2,5,321
29329200@N04,3663,19,1419950328,1419950328,1,5,0
29329200@N04,3663,6,1419928556,1419928556,1,5,0
29329200@N04,3663,27,1419898225,1419898225,1,5,0
29329200@N04,3664,7,1419984842,1419984842,1,2,0
29329200@N04,3664,6,1419983790,1419983790,1,2,0
29335885@N00,3665,25,1388482665,1388482665,1,1,0
29336227@N00,3666,17,1198638894,1198638894,1,1,0
29349767@N03,3667,20,1360647564,1360647564,1,8,0
29349767@N03,3667,13,1360642315,1360642460,2,8,145
29349767@N03,3667,25,1360642139,1360642139,1,8,0
29349767@N03,3667,30,1360634273,1360645143,2,8,10870
29349767@N03,3667,18,1360648580,1360648580,1,8,0
29349767@N03,3667,28,1360633824,1360633932,2,8,108
29349767@N03,3667,17,1360636568,1360636568,1,8,0
29349767@N03,3667,24,1360639322,1360640882,2,8,1560
29358051@N07,3668,5,1216265591,1216265591,1,5,0
29358051@N07,3668,28,1216280457,1216280959,3,5,502
29358051@N07,3668,16,1216268795,1216271516,2,5,2721
29358051@N07,3668,13,1216275201,1216275201,1,5,0
29358051@N07,3668,26,1216264200,1216264200,1,5,0
29358051@N07,3669,21,1216454910,1216454910,1,7,0
29358051@N07,3669,5,1216455335,1216455335,1,7,0
29358051@N07,3669,16,1216453256,1216453256,1,7,0
29358051@N07,3669,11,1216457816,1216457816,1,7,0
29358051@N07,3669,24,1216451614,1216451614,1,7,0
29358051@N07,3669,10,1216456437,1216456437,1,7,0
29358051@N07,3669,26,1216465380,1216465380,1,7,0
29358051@N07,3670,28,1229470452,1229498164,2,8,27712
29358051@N07,3670,13,1229494639,1229494639,1,8,0
29358051@N07,3670,26,1229497892,1229497892,1,8,0
29358051@N07,3670,21,1229494389,1229494471,2,8,82
29358051@N07,3670,25,1229496126,1229496126,1,8,0
29358051@N07,3670,24,1229473753,1229473753,1,8,0
29358051@N07,3670,11,1229494024,1229494079,2,8,55
29358051@N07,3670,7,1229491342,1229491342,1,8,0
29389873@N00,3671,30,1239176483,1239176483,1,6,0
29389873@N00,3671,1,1239159075,1239159084,2,6,9
29389873@N00,3671,5,1239181496,1239182101,4,6,605
29389873@N00,3671,18,1239172650,1239172650,1,6,0
29389873@N00,3671,17,1239189122,1239190705,3,6,1583
29389873@N00,3671,22,1239166291,1239171129,3,6,4838
29412746@N00,3672,28,1299560409,1299560435,4,2,26
29412746@N00,3672,18,1299567265,1299567265,2,2,0
29426527@N03,3673,26,1361414229,1361414229,1,1,0
29426527@N03,3674,17,1361622750,1361622750,1,1,0
29426527@N03,3675,28,1362899745,1362899745,1,1,0
29426527@N03,3676,1,1364701288,1364701288,1,2,0
29426527@N03,3676,26,1364712025,1364712025,1,2,0
29426527@N03,3677,14,1364814170,1364814170,1,1,0
29426527@N03,3678,26,1365726311,1365726311,1,1,0
29426527@N03,3679,1,1366703427,1366703427,1,1,0
29426527@N03,3680,1,1367032141,1367032141,1,1,0
29426527@N03,3681,26,1367134611,1367134611,1,1,0
29426527@N03,3682,1,1367271862,1367271862,1,1,0
29426527@N03,3683,1,1367964924,1367964924,1,1,0
29426527@N03,3684,1,1368066427,1368066427,1,1,0
29426527@N03,3685,26,1369371762,1369372474,2,1,712
29426527@N03,3686,1,1370327426,1370327426,1,1,0
29426527@N03,3687,1,1370482185,1370482185,1,1,0
29426527@N03,3688,12,1373332926,1373332926,1,1,0
29426527@N03,3689,1,1374710407,1374710407,1,1,0
29426527@N03,3690,1,1374965762,1374965762,1,1,0
29426527@N03,3691,1,1376379345,1376379345,1,1,0
29426527@N03,3692,4,1378200727,1378200727,1,1,0
29426527@N03,3693,1,1380015609,1380015609,1,1,0
29428169@N02,3694,28,1351991380,1351991380,1,2,0
29428169@N02,3694,30,1351998681,1352019618,2,2,20937
29428169@N02,3695,27,1352094802,1352094802,1,2,0
29428169@N02,3695,14,1352086360,1352086360,1,2,0
29428169@N02,3696,28,1352158951,1352158951,1,1,0
29449403@N00,3697,27,1250505528,1250505528,1,4,0
29449403@N00,3697,16,1250481997,1250482987,2,4,990
29449403@N00,3697,28,1250483036,1250483036,1,4,0
29449403@N00,3697,19,1250485021,1250485021,1,4,0
29456148@N00,3698,28,1319232895,1319232895,1,1,0
29456148@N00,3699,29,1319328924,1319328924,1,1,0
29466940@N03,3700,25,1326530105,1326530105,1,1,0
29468257@N08,3701,16,1343106893,1343106893,1,1,0
29501028@N00,3702,16,1273635367,1273656310,7,1,20943
29501028@N00,3703,16,1273704164,1273739097,12,1,34933
29501028@N00,3704,18,1273820338,1273820338,1,3,0
29501028@N00,3704,16,1273792571,1273836823,24,3,44252
29501028@N00,3704,27,1273800857,1273800857,1,3,0
29501028@N00,3705,16,1273888893,1273911828,4,1,22935
29501028@N00,3706,16,1273977130,1274014839,11,1,37709
29501028@N00,3707,16,1276162310,1276162310,1,1,0
29501028@N00,3708,16,1276219432,1276257956,23,1,38524
29501028@N00,3709,16,1288849380,1288849398,4,1,18
29501028@N00,3710,28,1350134284,1350134284,1,1,0
29507492@N07,3711,16,1276508017,1276508134,4,10,117
29507492@N07,3711,13,1276510295,1276515355,13,10,5060
29507492@N07,3711,30,1276517057,1276517758,3,10,701
29507492@N07,3711,26,1276508134,1276508615,18,10,481
29507492@N07,3711,11,1276509701,1276509785,4,10,84
29507492@N07,3711,5,1276508616,1276515915,7,10,7299
29507492@N07,3711,28,1276507684,1276521550,55,10,13866
29507492@N07,3711,21,1276509420,1276514880,10,10,5460
29507492@N07,3711,22,1276517846,1276517846,1,10,0
29507492@N07,3711,4,1276508817,1276509612,5,10,795
29507492@N07,3712,23,1276581580,1276581580,1,2,0
29507492@N07,3712,17,1276579057,1276579057,1,2,0
29507492@N07,3713,12,1276881834,1276881839,6,3,5
29507492@N07,3713,22,1276883178,1276883202,2,3,24
29507492@N07,3713,29,1276887686,1276890781,13,3,3095
29507492@N07,3714,16,1277025664,1277029848,3,7,4184
29507492@N07,3714,13,1277039208,1277042772,9,7,3564
29507492@N07,3714,26,1277025364,1277030228,2,7,4864
29507492@N07,3714,28,1277025226,1277025410,10,7,184
29507492@N07,3714,24,1277025927,1277029269,11,7,3342
29507492@N07,3714,22,1277038464,1277038464,1,7,0
29507492@N07,3714,18,1277030595,1277030679,2,7,84
29507492@N07,3715,13,1277286841,1277286841,1,9,0
29507492@N07,3715,26,1277283785,1277312875,6,9,29090
29507492@N07,3715,25,1277290858,1277290858,1,9,0
29507492@N07,3715,1,1277297179,1277297906,3,9,727
29507492@N07,3715,12,1277288809,1277289160,2,9,351
29507492@N07,3715,22,1277311993,1277311993,1,9,0
29507492@N07,3715,24,1277288941,1277288941,1,9,0
29507492@N07,3715,19,1277280694,1277281416,7,9,722
29507492@N07,3715,29,1277293134,1277293165,2,9,31
29507492@N07,3716,26,1277372960,1277374467,3,1,1507
29555476@N06,3717,7,1319100216,1319100216,1,1,0
29555476@N06,3718,29,1322642726,1322642726,1,1,0
29577569@N02,3719,26,1216612189,1216612189,1,1,0
29652206@N07,3720,1,1228360781,1228360781,1,1,0
29674761@N02,3721,26,1417137096,1417149708,10,1,12612
29684629@N08,3722,18,1421450363,1421494580,4,1,44217
29684629@N08,3723,18,1421643790,1421643790,1,1,0
29708201@N00,3724,24,1222653705,1222653705,1,1,0
29709298@N02,3725,26,1410363728,1410363728,1,1,0
29709298@N02,3726,18,1410397116,1410397116,1,5,0
29709298@N02,3726,28,1410394838,1410395240,7,5,402
29709298@N02,3726,27,1410394530,1410394530,1,5,0
29709298@N02,3726,26,1410397245,1410397245,1,5,0
29709298@N02,3726,16,1410394467,1410394769,4,5,302
29722669@N05,3727,26,1354282408,1354282408,1,1,0
29758791@N00,3728,29,1273422246,1273422246,1,1,0
29758791@N00,3729,27,1358662251,1358662251,1,2,0
29758791@N00,3729,16,1358663019,1358663019,1,2,0
29758791@N00,3730,30,1385518815,1385518815,1,1,0
29762068@N03,3731,13,1252098397,1252098397,1,10,0
29762068@N03,3731,28,1252098604,1252099036,6,10,432
29762068@N03,3731,17,1252098133,1252098133,1,10,0
29762068@N03,3731,8,1252098241,1252098241,1,10,0
29762068@N03,3731,14,1252097572,1252097572,1,10,0
29762068@N03,3731,1,1252098083,1252099089,2,10,1006
29762068@N03,3731,27,1252098187,1252098187,1,10,0
29762068@N03,3731,25,1252098294,1252098345,2,10,51
29762068@N03,3731,11,1252098449,1252098449,1,10,0
29762068@N03,3731,26,1252098551,1252098551,1,10,0
29762068@N03,3732,12,1252181653,1252181653,1,7,0
29762068@N03,3732,17,1252181600,1252181600,1,7,0
29762068@N03,3732,30,1252181758,1252181758,1,7,0
29762068@N03,3732,14,1252181858,1252181858,1,7,0
29762068@N03,3732,1,1252181550,1252181550,1,7,0
29762068@N03,3732,5,1252181702,1252181702,1,7,0
29762068@N03,3732,31,1252181808,1252181808,1,7,0
29764570@N00,3733,29,1287015215,1287015215,1,5,0
29764570@N00,3733,16,1287009220,1287009220,1,5,0
29764570@N00,3733,17,1287011236,1287011236,1,5,0
29764570@N00,3733,12,1286996130,1286996130,1,5,0
29764570@N00,3733,19,1287013145,1287013145,1,5,0
29764570@N00,3734,26,1287885542,1287905226,5,13,19684
29764570@N00,3734,8,1287888845,1287888845,1,13,0
29764570@N00,3734,22,1287887891,1287902705,9,13,14814
29764570@N00,3734,16,1287905398,1287908630,6,13,3232
29764570@N00,3734,20,1287901480,1287901480,1,13,0
29764570@N00,3734,31,1287887675,1287887675,1,13,0
29764570@N00,3734,25,1287890067,1287890654,19,13,587
29764570@N00,3734,23,1287885713,1287885713,1,13,0
29764570@N00,3734,28,1287913494,1287917205,3,13,3711
29764570@N00,3734,18,1287886174,1287886689,8,13,515
29764570@N00,3734,30,1287888451,1287917595,3,13,29144
29764570@N00,3734,29,1287897671,1287900914,11,13,3243
29764570@N00,3734,1,1287884887,1287884887,1,13,0
29774230@N00,3735,23,1397099447,1397099447,1,2,0
29774230@N00,3735,24,1397110829,1397110829,1,2,0
29781127@N07,3736,28,1284694608,1284694608,1,1,0
29797746@N08,3737,8,1230548483,1230548483,1,1,0
29807137@N03,3738,12,1248858709,1248858709,1,2,0
29807137@N03,3738,26,1248867527,1248867527,1,2,0
29848483@N05,3739,28,1354779075,1354788561,2,1,9486
29848483@N05,3740,25,1354870535,1354870535,1,1,0
29848483@N05,3741,18,1399344913,1399344913,1,2,0
29848483@N05,3741,16,1399350937,1399350937,1,2,0
29856669@N02,3742,21,1357100705,1357100790,3,5,85
29856669@N02,3742,29,1357096535,1357096535,1,5,0
29856669@N02,3742,31,1357090633,1357099281,2,5,8648
29856669@N02,3742,12,1357086054,1357086054,1,5,0
29856669@N02,3742,28,1357106823,1357109593,29,5,2770
29870964@N06,3743,26,1249859176,1249859176,1,1,0
29873212@N05,3744,19,1416970028,1416986943,2,1,16915
29874979@N07,3745,21,1382845403,1382845403,1,1,0
29874979@N07,3746,20,1383439408,1383439408,1,1,0
29885425@N02,3747,25,1303871753,1303871935,4,1,182
29888328@N03,3748,7,1281961493,1281961493,1,3,0
29888328@N03,3748,26,1281964961,1281964961,1,3,0
29888328@N03,3748,13,1281958137,1281958137,1,3,0
29918730@N00,3749,7,1399017880,1399017880,1,1,0
29948744@N03,3750,26,1193726456,1193726456,1,4,0
29948744@N03,3750,22,1193711795,1193713461,2,4,1666
29948744@N03,3750,4,1193725292,1193725292,1,4,0
29948744@N03,3750,3,1193724703,1193724703,1,4,0
29948744@N03,3751,7,1193810021,1193810021,1,2,0
29948744@N03,3751,3,1193808099,1193808099,1,2,0
29948744@N03,3752,3,1209364809,1209364809,1,1,0
29966284@N00,3753,20,1352114175,1352114175,1,1,0
29966284@N00,3754,13,1461145452,1461145452,1,1,0
30002708@N03,3755,20,1290142062,1290142062,1,2,0
30002708@N03,3755,17,1290137570,1290137570,1,2,0
30034659@N02,3756,28,1303518958,1303518958,1,1,0
30034659@N02,3757,29,1352015100,1352015100,1,1,0
30082031@N04,3758,28,1354258973,1354258973,1,1,0
30082031@N04,3759,28,1360814253,1360814253,1,1,0
30082031@N04,3760,30,1365498701,1365498701,1,1,0
30082031@N04,3761,15,1367474164,1367474164,1,1,0
30141170@N07,3762,28,1298758501,1298758501,1,2,0
30141170@N07,3762,30,1298761450,1298761450,1,2,0
30141170@N07,3763,16,1307844004,1307844004,1,1,0
30141170@N07,3764,27,1319755163,1319755163,1,1,0
30141170@N07,3765,22,1319872869,1319872869,1,1,0
30141170@N07,3766,26,1323600985,1323600985,1,1,0
30141170@N07,3767,27,1333793714,1333793714,1,1,0
30141170@N07,3768,25,1333842124,1333842124,1,6,0
30141170@N07,3768,27,1333833283,1333833283,1,6,0
30141170@N07,3768,22,1333838660,1333838660,1,6,0
30141170@N07,3768,29,1333836456,1333836456,1,6,0
30141170@N07,3768,16,1333835248,1333835555,2,6,307
30141170@N07,3768,30,1333837399,1333837399,1,6,0
30141170@N07,3769,4,1333919891,1333919891,1,1,0
30141170@N07,3770,26,1335571775,1335572242,4,3,467
30141170@N07,3770,23,1335572819,1335572819,1,3,0
30141170@N07,3770,30,1335572491,1335572491,1,3,0
30141170@N07,3771,17,1335651228,1335651228,1,1,0
30141170@N07,3772,26,1364594924,1364594924,1,1,0
30141170@N07,3773,24,1372895557,1372895557,1,1,0
30141170@N07,3774,1,1374813350,1374813350,1,1,0
30147619@N04,3775,3,1455157108,1455157108,1,2,0
30147619@N04,3775,18,1455148526,1455148526,1,2,0
30184872@N06,3776,22,1301634681,1301634681,1,2,0
30184872@N06,3776,30,1301635112,1301635112,1,2,0
30184872@N06,3777,17,1315376320,1315376320,1,1,0
30184872@N06,3778,5,1349912098,1349912098,1,1,0
30184872@N06,3779,24,1352674854,1352674854,1,2,0
30184872@N06,3779,14,1352680852,1352680852,1,2,0
30184872@N06,3780,15,1357008738,1357008738,1,2,0
30184872@N06,3780,29,1357013574,1357013574,1,2,0
30184872@N06,3781,29,1364105339,1364105339,1,1,0
30184872@N06,3782,26,1373172936,1373172962,2,3,26
30184872@N06,3782,15,1373172061,1373172061,1,3,0
30184872@N06,3782,3,1373172747,1373172747,1,3,0
30213495@N02,3783,3,1314398424,1314398424,1,4,0
30213495@N02,3783,22,1314422144,1314422144,1,4,0
30213495@N02,3783,15,1314410731,1314410731,1,4,0
30213495@N02,3783,4,1314399541,1314399990,2,4,449
30314547@N00,3784,27,1262500904,1262500904,1,1,0
30314547@N00,3785,29,1287047945,1287047945,1,1,0
30346812@N07,3786,26,1221177571,1221177571,1,1,0
30346812@N07,3787,28,1226450084,1226450084,1,1,0
30346812@N07,3788,26,1250222536,1250222536,1,1,0
30346812@N07,3789,4,1334893104,1334893104,1,1,0
30346812@N07,3790,4,1417753886,1417753886,1,1,0
30346812@N07,3791,30,1417990064,1417990064,1,2,0
30346812@N07,3791,16,1417990367,1417990367,1,2,0
30346812@N07,3792,30,1454385470,1454385470,1,4,0
30346812@N07,3792,16,1454390681,1454390681,1,4,0
30346812@N07,3792,4,1454390784,1454390784,1,4,0
30346812@N07,3792,26,1454390956,1454390956,1,4,0
30350281@N06,3793,16,1344237353,1344237353,1,4,0
30350281@N06,3793,22,1344235493,1344235493,1,4,0
30350281@N06,3793,31,1344235472,1344235472,1,4,0
30350281@N06,3793,27,1344237318,1344237318,1,4,0
30350281@N06,3794,17,1348897996,1348899427,3,3,1431
30350281@N06,3794,26,1348898311,1348898349,2,3,38
30350281@N06,3794,28,1348897718,1348902815,2,3,5097
30352121@N05,3795,26,1376307541,1376307541,1,1,0
30352121@N05,3796,1,1393275100,1393275100,1,1,0
30352121@N05,3797,1,1402917787,1402917787,1,1,0
30401284@N05,3798,13,1342666355,1342666622,7,2,267
30401284@N05,3798,3,1342665885,1342665885,1,2,0
30410290@N07,3799,1,1374477425,1374477425,1,2,0
30410290@N07,3799,27,1374467929,1374467929,1,2,0
30427204@N02,3800,28,1221359031,1221359031,1,1,0
30441069@N05,3801,26,1399111812,1399111812,1,1,0
30441069@N05,3802,20,1399775113,1399775113,1,3,0
30441069@N05,3802,23,1399774435,1399774435,1,3,0
30441069@N05,3802,17,1399785958,1399785958,1,3,0
30441069@N05,3803,1,1401961520,1401961520,1,1,0
30441069@N05,3804,19,1408255596,1408255596,1,2,0
30441069@N05,3804,1,1408203321,1408229760,2,2,26439
30441069@N05,3805,18,1408501585,1408501585,1,1,0
30441069@N05,3806,30,1410596667,1410596667,1,2,0
30441069@N05,3806,3,1410605064,1410605064,1,2,0
30441069@N05,3807,18,1442038163,1442038163,1,1,0
30441069@N05,3808,23,1467784851,1467809663,2,1,24812
30441069@N05,3809,3,1467869402,1467869402,1,1,0
30446909@N07,3810,29,1293266092,1293266092,1,1,0
30450479@N04,3811,1,1373637916,1373637916,1,3,0
30450479@N04,3811,13,1373632403,1373632403,1,3,0
30450479@N04,3811,29,1373632823,1373632823,1,3,0
30455563@N00,3812,26,1275788787,1275804141,18,1,15354
30517235@N02,3813,21,1261614321,1261614321,1,1,0
30517235@N02,3814,19,1263299001,1263299001,1,3,0
30517235@N02,3814,21,1263299032,1263299032,1,3,0
30517235@N02,3814,1,1263298930,1263298930,1,3,0
30517235@N02,3815,29,1264847221,1264847221,1,1,0
30521264@N03,3816,28,1248440457,1248456259,6,5,15802
30521264@N03,3816,16,1248443490,1248443490,1,5,0
30521264@N03,3816,26,1248443673,1248456192,2,5,12519
30521264@N03,3816,11,1248454211,1248454211,1,5,0
30521264@N03,3816,29,1248441238,1248441238,1,5,0
30521264@N03,3817,30,1248532252,1248532252,1,1,0
30545687@N00,3818,26,1213323714,1213330704,30,1,6990
30545687@N00,3819,28,1233270352,1233302012,25,1,31660
30573133@N00,3820,6,1375506594,1375506594,1,1,0
30573133@N00,3821,16,1375573861,1375574163,2,4,302
30573133@N00,3821,29,1375586767,1375586767,1,4,0
30573133@N00,3821,19,1375586702,1375586702,1,4,0
30573133@N00,3821,27,1375573861,1375573861,1,4,0
30573133@N00,3822,23,1375679451,1375679451,1,2,0
30573133@N00,3822,18,1375680960,1375680960,1,2,0
30573204@N04,3823,16,1392162925,1392191119,10,1,28194
30573204@N04,3824,16,1392246894,1392271383,24,1,24489
30573204@N04,3825,16,1392326466,1392337587,14,1,11121
30573204@N04,3826,26,1412734547,1412734658,3,2,111
30573204@N04,3826,4,1412734560,1412734560,1,2,0
30573204@N04,3827,26,1412816625,1412836710,5,1,20085
30573204@N04,3828,29,1444197335,1444197335,1,2,0
30573204@N04,3828,1,1444212704,1444217190,8,2,4486
30586074@N07,3829,23,1271659481,1271659822,4,6,341
30586074@N07,3829,13,1271655464,1271658481,7,6,3017
30586074@N07,3829,29,1271640332,1271664303,8,6,23971
30586074@N07,3829,12,1271658715,1271658722,2,6,7
30586074@N07,3829,1,1271640210,1271668733,13,6,28523
30586074@N07,3829,26,1271658920,1271659068,3,6,148
30628679@N04,3830,14,1222393339,1222393965,3,2,626
30628679@N04,3830,28,1222386031,1222400586,6,2,14555
30650680@N02,3831,24,1333345167,1333345167,1,2,0
30650680@N02,3831,4,1333343400,1333343400,1,2,0
30650680@N02,3832,21,1333674992,1333674992,1,2,0
30650680@N02,3832,3,1333674584,1333674584,1,2,0
30650680@N02,3833,16,1359341883,1359341883,1,3,0
30650680@N02,3833,26,1359340820,1359340820,1,3,0
30650680@N02,3833,1,1359337344,1359337344,1,3,0
30650680@N02,3834,30,1359525178,1359525178,1,1,0
30650680@N02,3835,16,1359595386,1359595386,1,6,0
30650680@N02,3835,15,1359593412,1359593412,2,6,0
30650680@N02,3835,11,1359596855,1359596855,1,6,0
30650680@N02,3835,8,1359595744,1359595744,1,6,0
30650680@N02,3835,24,1359595545,1359595545,1,6,0
30650680@N02,3835,28,1359595200,1359595200,1,6,0
30650680@N02,3836,17,1361696526,1361696526,1,1,0
30650680@N02,3837,16,1361768946,1361768946,1,2,0
30650680@N02,3837,26,1361768938,1361768938,1,2,0
30650680@N02,3838,8,1367887009,1367887009,1,8,0
30650680@N02,3838,26,1367888326,1367888326,1,8,0
30650680@N02,3838,10,1367887860,1367890137,2,8,2277
30650680@N02,3838,16,1367887510,1367887517,2,8,7
30650680@N02,3838,29,1367890655,1367890663,2,8,8
30650680@N02,3838,28,1367887503,1367890674,2,8,3171
30650680@N02,3838,18,1367887707,1367891510,3,8,3803
30650680@N02,3838,23,1367887758,1367887758,1,8,0
30674850@N00,3839,4,1228519227,1228519227,1,1,0
30674850@N00,3840,4,1228551575,1228551575,1,2,0
30674850@N00,3840,26,1228568431,1228568431,1,2,0
30696510@N06,3841,26,1289678520,1289678520,1,1,0
30704692@N00,3842,28,1278690196,1278692945,2,1,2749
30726295@N05,3843,28,1307450811,1307451151,5,1,340
30738244@N07,3844,25,1236319572,1236319617,3,3,45
30738244@N07,3844,22,1236314904,1236314904,1,3,0
30738244@N07,3844,5,1236317472,1236317472,1,3,0
30738244@N07,3845,17,1236408427,1236429191,2,3,20764
30738244@N07,3845,19,1236426134,1236426367,4,3,233
30738244@N07,3845,24,1236410024,1236410162,6,3,138
30755785@N02,3846,25,1325020365,1325028513,3,6,8148
30755785@N02,3846,26,1325065088,1325065088,1,6,0
30755785@N02,3846,1,1325021446,1325021446,1,6,0
30755785@N02,3846,6,1325065658,1325065658,1,6,0
30755785@N02,3846,19,1325041175,1325041175,1,6,0
30755785@N02,3846,28,1325024028,1325024028,1,6,0
30755785@N02,3847,16,1325224470,1325224470,1,2,0
30755785@N02,3847,27,1325231592,1325231592,1,2,0
30755785@N02,3848,26,1325296119,1325296119,1,1,0
30755785@N02,3849,28,1325327218,1325327218,1,1,0
30758629@N00,3850,19,1296272472,1296272524,2,1,52
30759752@N08,3851,5,1396502828,1396502828,1,1,0
30768270@N04,3852,26,1303081136,1303091419,2,2,10283
30768270@N04,3852,27,1303079687,1303079687,1,2,0
30768270@N04,3853,25,1303168436,1303168436,1,1,0
30783759@N06,3854,19,1414466339,1414466339,1,1,0
30793917@N07,3855,29,1305979407,1305979407,1,2,0
30793917@N07,3855,5,1305957890,1305957890,1,2,0
30832998@N02,3856,20,1284174072,1284174072,1,1,0
30832998@N02,3857,30,1288419683,1288419683,1,1,0
30844146@N02,3858,24,1370670321,1370670321,1,4,0
30844146@N02,3858,15,1370661325,1370661325,1,4,0
30844146@N02,3858,27,1370662571,1370662571,1,4,0
30844146@N02,3858,26,1370659621,1370659621,1,4,0
30848780@N03,3859,28,1239489234,1239535826,18,1,46592
30848780@N03,3860,28,1239577342,1239583623,5,1,6281
30848780@N03,3861,28,1239613346,1239613346,1,1,0
30848780@N03,3862,28,1239669281,1239694391,12,1,25110
30848780@N03,3863,28,1239839828,1239842868,2,1,3040
30892581@N08,3864,26,1392668508,1392668533,2,1,25
30894945@N04,3865,26,1354955512,1354955926,3,7,414
30894945@N04,3865,1,1354953867,1354953955,4,7,88
30894945@N04,3865,15,1354956918,1354956918,1,7,0
30894945@N04,3865,3,1354956074,1354956127,4,7,53
30894945@N04,3865,28,1354954016,1354955194,8,7,1178
30894945@N04,3865,21,1354956221,1354956553,12,7,332
30894945@N04,3865,16,1354955567,1354958831,7,7,3264
30902022@N00,3866,30,1203683349,1203683349,1,4,0
30902022@N00,3866,28,1203683200,1203683538,4,4,338
30902022@N00,3866,29,1203683278,1203683565,4,4,287
30902022@N00,3866,1,1203683390,1203683390,1,4,0
30902022@N00,3867,30,1203762594,1203762594,1,1,0
30941874@N03,3868,26,1244128024,1244128024,1,1,0
30981640@N05,3869,20,1373268557,1373268557,1,2,0
30981640@N05,3869,29,1373266841,1373266841,1,2,0
31019923@N00,3870,3,1343605169,1343605289,3,10,120
31019923@N00,3870,16,1343598831,1343598876,3,10,45
31019923@N00,3870,23,1343602801,1343602801,1,10,0
31019923@N00,3870,8,1343620550,1343620550,1,10,0
31019923@N00,3870,17,1343617932,1343623731,3,10,5799
31019923@N00,3870,29,1343608247,1343609663,5,10,1416
31019923@N00,3870,26,1343605511,1343620319,5,10,14808
31019923@N00,3870,12,1343605220,1343605236,2,10,16
31019923@N00,3870,6,1343610327,1343610370,2,10,43
31019923@N00,3870,30,1343606261,1343606275,2,10,14
31019923@N00,3871,20,1352698596,1352699710,10,6,1114
31019923@N00,3871,19,1352694804,1352694833,2,6,29
31019923@N00,3871,23,1352694257,1352694257,1,6,0
31019923@N00,3871,29,1352698381,1352698682,4,6,301
31019923@N00,3871,18,1352694103,1352695226,11,6,1123
31019923@N00,3871,31,1352698558,1352698558,1,6,0
31052620@N00,3872,11,1262150625,1262150625,1,1,0
31070925@N07,3873,14,1416195650,1416195926,5,3,276
31070925@N07,3873,15,1416183011,1416185886,16,3,2875
31070925@N07,3873,26,1416201345,1416201345,1,3,0
31105023@N06,3874,26,1309690604,1309690604,1,1,0
31130361@N06,3875,28,1326367992,1326368183,3,2,191
31130361@N06,3875,25,1326368506,1326368506,1,2,0
31130361@N06,3876,28,1326516518,1326516722,2,1,204
31138817@N00,3877,25,1290569183,1290569823,2,5,640
31138817@N00,3877,30,1290577803,1290581368,3,5,3565
31138817@N00,3877,16,1290577465,1290577465,1,5,0
31138817@N00,3877,21,1290568036,1290568036,1,5,0
31138817@N00,3877,18,1290574959,1290574959,1,5,0
31160848@N06,3878,28,1346911585,1346911585,1,1,0
31172882@N02,3879,29,1222986688,1222988964,9,14,2276
31172882@N02,3879,21,1222979411,1222979504,3,14,93
31172882@N02,3879,20,1222989678,1222990965,16,14,1287
31172882@N02,3879,1,1222977331,1222977366,2,14,35
31172882@N02,3879,8,1222994706,1222994706,1,14,0
31172882@N02,3879,16,1222977977,1222977977,1,14,0
31172882@N02,3879,28,1222977558,1222977616,2,14,58
31172882@N02,3879,23,1222993459,1222993459,1,14,0
31172882@N02,3879,6,1222994908,1222995013,3,14,105
31172882@N02,3879,3,1222996538,1222996577,3,14,39
31172882@N02,3879,30,1222978464,1222978464,1,14,0
31172882@N02,3879,26,1222978018,1222994398,11,14,16380
31172882@N02,3879,11,1222995278,1222995496,2,14,218
31172882@N02,3879,12,1222980444,1222980638,2,14,194
31172882@N02,3880,20,1224844368,1224844368,1,1,0
31177379@N02,3881,27,1387526187,1387526187,1,1,0
31195909@N07,3882,24,1424066146,1424066181,4,1,35
31208576@N06,3883,30,1347710039,1347710039,1,1,0
31223689@N00,3884,17,1236552144,1236552862,3,4,718
31223689@N00,3884,23,1236556896,1236556896,1,4,0
31223689@N00,3884,29,1236555476,1236556588,4,4,1112
31223689@N00,3884,26,1236554347,1236557955,4,4,3608
31232304@N05,3885,26,1282752948,1282752948,1,1,0
31254726@N03,3886,23,1292918713,1292918713,1,5,0
31254726@N03,3886,26,1292916950,1292918616,2,5,1666
31254726@N03,3886,15,1292918357,1292918357,1,5,0
31254726@N03,3886,28,1292918457,1292918457,1,5,0
31254726@N03,3886,18,1292918073,1292918418,2,5,345
31266253@N06,3887,26,1227769762,1227769762,1,1,0
31266253@N06,3888,26,1227860661,1227860661,1,1,0
31266253@N06,3889,8,1231458538,1231458538,1,1,0
31266253@N06,3890,19,1259904927,1259905042,2,6,115
31266253@N06,3890,18,1259899637,1259899637,1,6,0
31266253@N06,3890,24,1259910204,1259910204,1,6,0
31266253@N06,3890,20,1259900300,1259900300,1,6,0
31266253@N06,3890,1,1259899259,1259899259,1,6,0
31266253@N06,3890,29,1259899870,1259899870,1,6,0
31266253@N06,3891,26,1259992555,1260000445,2,1,7890
31355566@N06,3892,10,1279585083,1279585083,1,3,0
31355566@N06,3892,26,1279577228,1279577228,1,3,0
31355566@N06,3892,13,1279591803,1279591813,2,3,10
31385681@N02,3893,14,1257737066,1257737066,1,1,0
31397036@N00,3894,26,1279687118,1279713463,18,1,26345
31397036@N00,3895,26,1280356176,1280356225,3,1,49
31428730@N07,3896,26,1377982707,1378008022,18,1,25315
31428878@N02,3897,26,1245991770,1245991770,1,1,0
31428878@N02,3898,29,1251343993,1251344685,2,1,692
31428878@N02,3899,16,1253251741,1253251741,1,1,0
31428878@N02,3900,17,1254454040,1254454040,1,1,0
31429576@N04,3901,6,1250738267,1250738267,1,4,0
31429576@N04,3901,28,1250745625,1250745625,1,4,0
31429576@N04,3901,26,1250724664,1250724779,2,4,115
31429576@N04,3901,12,1250722660,1250722660,1,4,0
31429576@N04,3902,23,1288405274,1288416849,6,3,11575
31429576@N04,3902,28,1288433781,1288433781,1,3,0
31429576@N04,3902,26,1288422399,1288432529,11,3,10130
31429576@N04,3903,6,1294044308,1294044308,1,7,0
31429576@N04,3903,25,1294034037,1294054948,2,7,20911
31429576@N04,3903,30,1294042602,1294042602,1,7,0
31429576@N04,3903,28,1294067360,1294067360,1,7,0
31429576@N04,3903,13,1294046252,1294046800,2,7,548
31429576@N04,3903,26,1294050393,1294065235,6,7,14842
31429576@N04,3903,29,1294061484,1294061484,1,7,0
31453381@N02,3904,10,1306831297,1306831297,1,1,0
31468609@N00,3905,26,1301277107,1301308766,18,1,31659
31479144@N00,3906,16,1336265763,1336265763,1,1,0
31508945@N06,3907,30,1322538206,1322538206,1,1,0
31544947@N00,3908,26,1437742223,1437742273,2,2,50
31544947@N00,3908,30,1437736596,1437736609,2,2,13
31544947@N00,3909,26,1437832748,1437832748,1,1,0
31544947@N00,3910,26,1437915528,1437915551,2,1,23
31579500@N08,3911,28,1345636876,1345636876,1,1,0
31579500@N08,3912,20,1347628414,1347628414,1,1,0
31579500@N08,3913,20,1353382486,1353382486,1,2,0
31579500@N08,3913,11,1353383011,1353383011,1,2,0
31599559@N00,3914,19,1412458968,1412458968,1,1,0
31599559@N00,3915,20,1412493250,1412493250,1,1,0
31641212@N05,3916,13,1309256711,1309256711,1,1,0
31641212@N05,3917,16,1309364280,1309364280,1,1,0
31641212@N05,3918,15,1388114585,1388114585,1,3,0
31641212@N05,3918,20,1388108180,1388108180,1,3,0
31641212@N05,3918,29,1388107911,1388107911,1,3,0
31641212@N05,3919,29,1388145024,1388145024,1,1,0
31641212@N05,3920,18,1397552029,1397552095,2,2,66
31641212@N05,3920,30,1397548823,1397548823,1,2,0
31641212@N05,3921,26,1397697351,1397697351,1,1,0
31648659@N08,3922,18,1447915237,1447915237,1,1,0
31660989@N05,3923,30,1279598872,1279598872,1,4,0
31660989@N05,3923,26,1279584634,1279591563,2,4,6929
31660989@N05,3923,28,1279613011,1279613011,1,4,0
31660989@N05,3923,18,1279598030,1279598030,1,4,0
31660989@N05,3924,1,1279698176,1279698279,2,1,103
31664770@N02,3925,26,1283162407,1283162431,2,1,24
31664770@N02,3926,29,1312779958,1312779961,3,2,3
31664770@N02,3926,26,1312761090,1312761090,1,2,0
31664770@N02,3927,29,1346738187,1346738187,1,2,0
31664770@N02,3927,26,1346744627,1346744627,1,2,0
31692641@N00,3928,3,1465257673,1465257673,1,10,0
31692641@N00,3928,29,1465293286,1465293297,2,10,11
31692641@N00,3928,18,1465290112,1465290771,5,10,659
31692641@N00,3928,5,1465257544,1465257544,1,10,0
31692641@N00,3928,16,1465304218,1465304342,2,10,124
31692641@N00,3928,20,1465287658,1465287658,1,10,0
31692641@N00,3928,13,1465262316,1465263093,2,10,777
31692641@N00,3928,23,1465291975,1465292130,2,10,155
31692641@N00,3928,7,1465302254,1465302254,1,10,0
31692641@N00,3928,24,1465251904,1465264307,8,10,12403
31701053@N08,3929,26,1290924446,1290924446,1,1,0
31751836@N04,3930,26,1362449343,1362477713,2,1,28370
31753774@N00,3931,20,1195724089,1195726917,3,1,2828
31779495@N05,3932,26,1416017980,1416018387,4,1,407
31779495@N05,3933,15,1416070829,1416070829,1,7,0
31779495@N05,3933,19,1416062442,1416062442,1,7,0
31779495@N05,3933,28,1416096186,1416104954,2,7,8768
31779495@N05,3933,26,1416104783,1416104783,1,7,0
31779495@N05,3933,5,1416096777,1416096777,1,7,0
31779495@N05,3933,1,1416106459,1416106479,2,7,20
31779495@N05,3933,21,1416096783,1416096783,1,7,0
31794493@N00,3934,29,1305965082,1305965082,1,5,0
31794493@N00,3934,21,1305960241,1305960241,1,5,0
31794493@N00,3934,13,1305960486,1305960486,1,5,0
31794493@N00,3934,20,1305966850,1305967566,4,5,716
31794493@N00,3934,27,1305955381,1305955682,3,5,301
31794493@N00,3935,23,1306216001,1306216001,1,15,0
31794493@N00,3935,18,1306215951,1306217461,4,15,1510
31794493@N00,3935,31,1306201548,1306201548,1,15,0
31794493@N00,3935,29,1306201599,1306207058,18,15,5459
31794493@N00,3935,30,1306201554,1306201554,1,15,0
31794493@N00,3935,9,1306212684,1306212684,1,15,0
31794493@N00,3935,5,1306212620,1306212758,3,15,138
31794493@N00,3935,6,1306212792,1306213384,6,15,592
31794493@N00,3935,8,1306212829,1306212829,1,15,0
31794493@N00,3935,20,1306202437,1306202509,3,15,72
31794493@N00,3935,28,1306217719,1306217865,3,15,146
31794493@N00,3935,26,1306212735,1306213681,6,15,946
31794493@N00,3935,3,1306212381,1306212559,5,15,178
31794493@N00,3935,15,1306209141,1306209245,5,15,104
31794493@N00,3935,10,1306213396,1306213396,1,15,0
31794493@N00,3936,8,1306344968,1306345187,2,6,219
31794493@N00,3936,20,1306337823,1306337869,2,6,46
31794493@N00,3936,28,1306344556,1306345278,2,6,722
31794493@N00,3936,27,1306345205,1306345205,1,6,0
31794493@N00,3936,26,1306345165,1306345165,1,6,0
31794493@N00,3936,3,1306345239,1306345260,2,6,21
31864937@N00,3937,28,1293886816,1293886816,1,1,0
31864937@N00,3938,1,1294056174,1294056174,1,1,0
31898392@N03,3939,16,1359881358,1359881358,1,2,0
31898392@N03,3939,17,1359884416,1359885182,5,2,766
31916258@N00,3940,26,1205888937,1205922441,3,12,33504
31916258@N00,3940,13,1205881521,1205882843,5,12,1322
31916258@N00,3940,27,1205884120,1205884147,2,12,27
31916258@N00,3940,12,1205876093,1205888956,16,12,12863
31916258@N00,3940,20,1205892172,1205892189,2,12,17
31916258@N00,3940,1,1205898823,1205919194,2,12,20371
31916258@N00,3940,29,1205889473,1205891455,7,12,1982
31916258@N00,3940,17,1205878188,1205886281,2,12,8093
31916258@N00,3940,10,1205896949,1205897349,3,12,400
31916258@N00,3940,18,1205895114,1205898550,11,12,3436
31916258@N00,3940,16,1205888201,1205888219,2,12,18
31916258@N00,3940,28,1205898802,1205898802,1,12,0
31916258@N00,3941,26,1247279002,1247292019,3,3,13017
31916258@N00,3941,13,1247283096,1247283096,1,3,0
31916258@N00,3941,29,1247273687,1247308614,3,3,34927
31916258@N00,3942,17,1247357341,1247358151,2,1,810
31916258@N00,3943,26,1247471889,1247471889,1,1,0
31916258@N00,3944,17,1248572962,1248572962,1,3,0
31916258@N00,3944,3,1248580958,1248580958,1,3,0
31916258@N00,3944,12,1248581250,1248581250,1,3,0
31916258@N00,3945,26,1257565634,1257571121,4,5,5487
31916258@N00,3945,13,1257563764,1257564884,3,5,1120
31916258@N00,3945,29,1257575882,1257578575,4,5,2693
31916258@N00,3945,30,1257574936,1257581509,2,5,6573
31916258@N00,3945,23,1257578710,1257578710,1,5,0
31916258@N00,3946,26,1298172545,1298200513,21,1,27968
31918796@N02,3947,26,1188172727,1188172727,1,1,0
31940369@N04,3948,10,1348039012,1348039012,1,2,0
31940369@N04,3948,28,1348031080,1348031080,1,2,0
31940369@N04,3949,26,1353412434,1353412434,1,1,0
31949792@N00,3950,3,1266984419,1266984419,1,3,0
31949792@N00,3950,17,1266985913,1266985913,1,3,0
31949792@N00,3950,29,1266976327,1266976327,1,3,0
31949792@N00,3951,23,1267064961,1267064961,1,1,0
31949792@N00,3952,23,1267343038,1267343038,1,1,0
31954625@N00,3953,28,1384834057,1384834128,4,4,71
31954625@N00,3953,1,1384833525,1384837735,18,4,4210
31954625@N00,3953,30,1384835115,1384835124,2,4,9
31954625@N00,3953,26,1384834283,1384834283,1,4,0
31954625@N00,3954,1,1386135413,1386135421,2,3,8
31954625@N00,3954,11,1386132290,1386132290,1,3,0
31954625@N00,3954,26,1386131505,1386131510,2,3,5
31954625@N00,3955,28,1386648682,1386648688,3,1,6
31954625@N00,3956,17,1397019771,1397022648,4,2,2877
31954625@N00,3956,18,1397022502,1397022502,1,2,0
31954625@N00,3957,1,1399961860,1399961860,1,2,0
31954625@N00,3957,20,1399961082,1399961082,1,2,0
31954625@N00,3958,31,1401340318,1401340318,1,1,0
31954625@N00,3959,27,1401776545,1401776545,1,1,0
31954625@N00,3960,17,1401886465,1401886465,1,2,0
31954625@N00,3960,30,1401884588,1401884588,1,2,0
31954625@N00,3961,1,1401970994,1401971011,2,2,17
31954625@N00,3961,20,1401970402,1401970402,1,2,0
31954625@N00,3962,27,1409285408,1409285408,1,1,0
31954625@N00,3963,1,1410755142,1410755224,2,4,82
31954625@N00,3963,17,1410755521,1410755521,1,4,0
31954625@N00,3963,28,1410755240,1410755305,7,4,65
31954625@N00,3963,16,1410755353,1410755353,1,4,0
31954625@N00,3964,1,1412575237,1412575237,1,2,0
31954625@N00,3964,28,1412575241,1412575246,2,2,5
31954625@N00,3965,27,1414044667,1414044667,1,2,0
31954625@N00,3965,26,1414048649,1414048649,1,2,0
31954625@N00,3966,30,1414561518,1414561588,2,1,70
31954625@N00,3967,1,1416460106,1416460226,5,3,120
31954625@N00,3967,26,1416459756,1416459756,1,3,0
31954625@N00,3967,28,1416458098,1416458098,1,3,0
31954625@N00,3968,29,1417578490,1417578490,1,2,0
31954625@N00,3968,26,1417575779,1417575779,1,2,0
31954625@N00,3969,15,1418875071,1418875210,10,5,139
31954625@N00,3969,26,1418879959,1418879978,10,5,19
31954625@N00,3969,12,1418879816,1418879816,1,5,0
31954625@N00,3969,7,1418880170,1418880201,6,5,31
31954625@N00,3969,28,1418884596,1418884596,1,5,0
31957707@N08,3970,30,1346486344,1346486539,4,8,195
31957707@N08,3970,5,1346489345,1346489365,2,8,20
31957707@N08,3970,3,1346489339,1346489339,1,8,0
31957707@N08,3970,20,1346484572,1346484572,1,8,0
31957707@N08,3970,28,1346464932,1346465350,3,8,418
31957707@N08,3970,26,1346473258,1346473265,3,8,7
31957707@N08,3970,7,1346489298,1346489298,1,8,0
31957707@N08,3970,11,1346473255,1346473255,1,8,0
32021900@N00,3971,28,1331414294,1331414294,1,1,0
32046871@N00,3972,28,1361608553,1361608553,1,1,0
32169245@N00,3973,16,1325293181,1325293181,1,8,0
32169245@N00,3973,1,1325285421,1325285421,1,8,0
32169245@N00,3973,26,1325323899,1325323899,1,8,0
32169245@N00,3973,30,1325298186,1325298186,1,8,0
32169245@N00,3973,31,1325289822,1325289822,1,8,0
32169245@N00,3973,17,1325286823,1325286823,1,8,0
32169245@N00,3973,28,1325322034,1325322034,1,8,0
32169245@N00,3973,29,1325300082,1325300082,1,8,0
32218114@N00,3974,23,1361592277,1361592277,1,1,0
32218114@N00,3975,17,1361624685,1361624685,1,1,0
32218114@N00,3976,17,1361668350,1361681529,2,4,13179
32218114@N00,3976,31,1361679917,1361679917,1,4,0
32218114@N00,3976,30,1361679873,1361698605,4,4,18732
32218114@N00,3976,26,1361683920,1361683920,1,4,0
32218114@N00,3977,17,1361758677,1361779016,3,1,20339
32218114@N00,3978,20,1378432486,1378432584,3,4,98
32218114@N00,3978,13,1378449921,1378450089,3,4,168
32218114@N00,3978,26,1378458516,1378459120,5,4,604
32218114@N00,3978,30,1378431629,1378445788,6,4,14159
32218114@N00,3979,26,1393131316,1393141855,2,1,10539
32233251@N07,3980,26,1440125147,1440125147,1,1,0
32233251@N07,3981,26,1440153964,1440153964,1,1,0
32248086@N03,3982,26,1430064418,1430064631,2,3,213
32248086@N03,3982,30,1430059961,1430060661,2,3,700
32248086@N03,3982,6,1430062847,1430062847,1,3,0
32248086@N03,3983,26,1461937759,1461937868,2,1,109
32255839@N00,3984,26,1334619599,1334619599,1,10,0
32255839@N00,3984,16,1334617260,1334661109,2,10,43849
32255839@N00,3984,15,1334659784,1334659791,2,10,7
32255839@N00,3984,28,1334645531,1334660786,2,10,15255
32255839@N00,3984,12,1334631300,1334631300,1,10,0
32255839@N00,3984,17,1334619160,1334630421,2,10,11261
32255839@N00,3984,24,1334650404,1334650407,2,10,3
32255839@N00,3984,8,1334659609,1334659614,2,10,5
32255839@N00,3984,20,1334642866,1334642866,1,10,0
32255839@N00,3984,7,1334631614,1334631631,3,10,17
32281247@N08,3985,16,1301631496,1301631496,1,2,0
32281247@N08,3985,12,1301631420,1301631549,2,2,129
32288855@N08,3986,4,1435473297,1435473707,2,4,410
32288855@N08,3986,21,1435469245,1435469245,1,4,0
32288855@N08,3986,25,1435470200,1435471512,3,4,1312
32288855@N08,3986,26,1435467274,1435467274,1,4,0
32288855@N08,3987,21,1435579266,1435579266,1,1,0
32289743@N03,3988,11,1309679373,1309679373,1,1,0
32289743@N03,3989,20,1310185531,1310185531,1,1,0
32289743@N03,3990,13,1314503701,1314503701,1,1,0
32289743@N03,3991,28,1319255455,1319255455,1,1,0
32289743@N03,3992,12,1327618504,1327618504,1,2,0
32289743@N03,3992,13,1327619638,1327619638,1,2,0
32289743@N03,3993,26,1329360187,1329360187,1,1,0
32289743@N03,3994,12,1330052045,1330052045,1,4,0
32289743@N03,3994,30,1330047717,1330047717,1,4,0
32289743@N03,3994,26,1330051835,1330051892,2,4,57
32289743@N03,3994,10,1330046956,1330046956,1,4,0
32289743@N03,3995,11,1330463856,1330463856,1,4,0
32289743@N03,3995,23,1330463131,1330463131,1,4,0
32289743@N03,3995,16,1330462807,1330462807,1,4,0
32289743@N03,3995,7,1330466111,1330466111,1,4,0
32289743@N03,3996,28,1330496753,1330496753,1,1,0
32289743@N03,3997,3,1330535876,1330535876,1,3,0
32289743@N03,3997,16,1330534378,1330534378,1,3,0
32289743@N03,3997,28,1330534182,1330534182,1,3,0
32289743@N03,3998,18,1332145993,1332145993,1,1,0
32289743@N03,3999,20,1332383851,1332383851,1,4,0
32289743@N03,3999,30,1332383066,1332383066,1,4,0
32289743@N03,3999,18,1332382808,1332382808,1,4,0
32289743@N03,3999,31,1332382968,1332382968,1,4,0
32289743@N03,4000,18,1333590809,1333590809,1,3,0
32289743@N03,4000,23,1333590775,1333590873,2,3,98
32289743@N03,4000,12,1333587574,1333587574,1,3,0
32289743@N03,4001,1,1334309195,1334309195,1,1,0
32289743@N03,4002,29,1334798389,1334798389,1,3,0
32289743@N03,4002,6,1334797948,1334797948,1,3,0
32289743@N03,4002,13,1334800153,1334800153,1,3,0
32289743@N03,4003,30,1335434652,1335434652,1,2,0
32289743@N03,4003,4,1335430595,1335430595,1,2,0
32289743@N03,4004,13,1335767292,1335767292,1,1,0
32289743@N03,4005,22,1335863308,1335863731,3,1,423
32289743@N03,4006,28,1336006818,1336006818,1,3,0
32289743@N03,4006,31,1336011884,1336011884,1,3,0
32289743@N03,4006,13,1336009047,1336009145,2,3,98
32289743@N03,4007,28,1336634795,1336634795,1,2,0
32289743@N03,4007,30,1336627495,1336630438,2,2,2943
32289743@N03,4008,28,1337235487,1337235487,1,2,0
32289743@N03,4008,16,1337236034,1337236034,1,2,0
32289743@N03,4009,1,1338259236,1338259236,1,2,0
32289743@N03,4009,28,1338259985,1338259985,1,2,0
32289743@N03,4010,30,1339042464,1339042464,1,2,0
32289743@N03,4010,13,1339038147,1339038197,2,2,50
32289743@N03,4011,29,1339645303,1339645940,2,1,637
32289743@N03,4012,21,1340519281,1340519281,1,3,0
32289743@N03,4012,3,1340518325,1340518325,1,3,0
32289743@N03,4012,12,1340518860,1340518860,1,3,0
32289743@N03,4013,13,1342077449,1342077449,1,1,0
32289743@N03,4014,26,1342497654,1342497851,2,1,197
32289743@N03,4015,27,1342701918,1342701918,1,1,0
32289743@N03,4016,31,1342764798,1342764798,1,1,0
32289743@N03,4017,29,1343279036,1343279036,1,2,0
32289743@N03,4017,30,1343278992,1343278992,1,2,0
32289743@N03,4018,30,1343891709,1343893302,2,3,1593
32289743@N03,4018,10,1343892151,1343892289,3,3,138
32289743@N03,4018,24,1343889180,1343889287,4,3,107
32289743@N03,4019,30,1347585806,1347585854,2,2,48
32289743@N03,4019,28,1347584907,1347584907,1,2,0
32289743@N03,4020,1,1348571090,1348571281,2,1,191
32289743@N03,4021,29,1348733596,1348733596,1,2,0
32289743@N03,4021,22,1348733979,1348733979,1,2,0
32289743@N03,4022,20,1352946726,1352946775,2,2,49
32289743@N03,4022,1,1352944416,1352944416,1,2,0
32303563@N00,4023,28,1288306892,1288338395,3,11,31503
32303563@N00,4023,20,1288311483,1288311495,2,11,12
32303563@N00,4023,26,1288332644,1288332644,1,11,0
32303563@N00,4023,22,1288318592,1288320496,5,11,1904
32303563@N00,4023,17,1288333062,1288337039,2,11,3977
32303563@N00,4023,27,1288337994,1288337994,1,11,0
32303563@N00,4023,3,1288321277,1288321277,1,11,0
32303563@N00,4023,24,1288323694,1288324063,2,11,369
32303563@N00,4023,10,1288321121,1288321144,2,11,23
32303563@N00,4023,1,1288306843,1288306843,1,11,0
32303563@N00,4023,29,1288307337,1288315080,3,11,7743
32349630@N00,4024,26,1227744679,1227791415,27,1,46736
32349630@N00,4025,26,1254352421,1254380538,18,1,28117
32349630@N00,4026,26,1259240684,1259240684,1,1,0
32349630@N00,4027,26,1259332877,1259332877,1,1,0
32352764@N00,4028,13,1191936722,1191936722,1,2,0
32352764@N00,4028,28,1191919930,1191919930,1,2,0
32354567@N00,4029,29,1365909213,1365909246,2,1,33
32373689668@N01,4030,28,1257458016,1257458016,2,1,0
32404529@N05,4031,11,1279878048,1279878048,1,1,0
32431753@N00,4032,17,1387344250,1387344250,1,1,0
32431753@N00,4033,17,1448702965,1448702965,1,4,0
32431753@N00,4033,27,1448663872,1448663872,1,4,0
32431753@N00,4033,29,1448695509,1448695509,1,4,0
32431753@N00,4033,18,1448680988,1448680988,1,4,0
32434595@N02,4034,3,1320461622,1320461622,1,1,0
32442033@N00,4035,29,1423980415,1423980415,1,5,0
32442033@N00,4035,3,1423975669,1423975688,3,5,19
32442033@N00,4035,30,1423978272,1423978330,2,5,58
32442033@N00,4035,25,1423985013,1423985159,3,5,146
32442033@N00,4035,20,1423981769,1423981793,4,5,24
32444760@N02,4036,26,1294822410,1294822410,1,2,0
32444760@N02,4036,22,1294817240,1294817240,1,2,0
32471539@N03,4037,18,1290598577,1290598577,1,1,0
32491696@N00,4038,26,1285458561,1285458561,1,1,0
32491696@N00,4039,26,1323311956,1323311956,1,1,0
32493439@N00,4040,18,1356486137,1356486137,1,5,0
32493439@N00,4040,26,1356479113,1356479113,1,5,0
32493439@N00,4040,8,1356479866,1356479866,1,5,0
32493439@N00,4040,13,1356481337,1356481337,1,5,0
32493439@N00,4040,17,1356479015,1356479015,1,5,0
32493439@N00,4041,26,1356523030,1356523030,1,3,0
32493439@N00,4041,25,1356523640,1356523640,1,3,0
32493439@N00,4041,3,1356519394,1356519394,1,3,0
32504140@N05,4042,28,1341125673,1341125673,1,1,0
32504140@N05,4043,17,1341156112,1341156112,1,1,0
32518478@N02,4044,28,1361644177,1361644177,1,2,0
32518478@N02,4044,17,1361634778,1361634778,1,2,0
32518478@N02,4045,1,1396857839,1396857839,1,1,0
32586096@N00,4046,18,1440218052,1440238553,2,1,20501
32589831@N04,4047,8,1248400425,1248400425,1,1,0
32601772@N07,4048,31,1200022941,1200022941,1,1,0
32601772@N07,4049,26,1209119641,1209119641,1,1,0
32601772@N07,4050,30,1274414862,1274414862,1,1,0
32604470@N08,4051,31,1398149773,1398149773,1,6,0
32604470@N08,4051,29,1398138357,1398147339,3,6,8982
32604470@N08,4051,16,1398157090,1398157090,1,6,0
32604470@N08,4051,13,1398129711,1398129711,1,6,0
32604470@N08,4051,17,1398153730,1398154184,2,6,454
32604470@N08,4051,1,1398124888,1398124888,1,6,0
32604470@N08,4052,29,1435727531,1435727531,1,1,0
32609765@N00,4053,29,1460705205,1460705205,1,2,0
32609765@N00,4053,16,1460701834,1460701834,1,2,0
32609765@N00,4054,6,1460805835,1460805835,1,1,0
32627881@N07,4055,31,1338783644,1338811694,731,1,28050
32627881@N07,4056,31,1338854648,1338905506,668,1,50858
32627881@N07,4057,31,1339020251,1339020251,1,1,0
32627881@N07,4058,31,1341609149,1341621270,8,1,12121
32643997@N00,4059,26,1385258349,1385258349,1,1,0
32715151@N04,4060,29,1449558065,1449558065,1,2,0
32715151@N04,4060,17,1449566645,1449566645,1,2,0
32715151@N04,4061,18,1449824361,1449824361,1,1,0
32715151@N04,4062,18,1449971182,1449971182,1,1,0
32715761@N00,4063,7,1201244795,1201251057,8,1,6262
32715761@N00,4064,28,1201301344,1201301344,1,10,0
32715761@N00,4064,7,1201335843,1201335843,1,10,0
32715761@N00,4064,1,1201301163,1201301258,3,10,95
32715761@N00,4064,3,1201337843,1201338210,4,10,367
32715761@N00,4064,26,1201312626,1201314321,16,10,1695
32715761@N00,4064,24,1201302083,1201339813,22,10,37730
32715761@N00,4064,12,1201302067,1201302357,2,10,290
32715761@N00,4064,16,1201301519,1201312743,4,10,11224
32715761@N00,4064,27,1201310893,1201310974,2,10,81
32715761@N00,4064,17,1201307106,1201307106,1,10,0
32715761@N00,4065,7,1201388505,1201389498,5,9,993
32715761@N00,4065,3,1201387817,1201388132,4,9,315
32715761@N00,4065,5,1201387736,1201390747,4,9,3011
32715761@N00,4065,29,1201393318,1201393318,1,9,0
32715761@N00,4065,23,1201398404,1201398404,1,9,0
32715761@N00,4065,26,1201387592,1201387592,1,9,0
32715761@N00,4065,19,1201398680,1201398707,2,9,27
32715761@N00,4065,22,1201392106,1201392459,3,9,353
32715761@N00,4065,31,1201391856,1201391856,1,9,0
32715761@N00,4066,1,1201475213,1201475254,3,5,41
32715761@N00,4066,28,1201480399,1201480794,3,5,395
32715761@N00,4066,4,1201477221,1201478178,5,5,957
32715761@N00,4066,21,1201478825,1201479061,2,5,236
32715761@N00,4066,23,1201475644,1201475644,1,5,0
32715761@N00,4067,28,1223502795,1223502934,3,13,139
32715761@N00,4067,7,1223506460,1223506460,1,13,0
32715761@N00,4067,1,1223523809,1223523809,1,13,0
32715761@N00,4067,13,1223514916,1223519426,10,13,4510
32715761@N00,4067,4,1223508861,1223509036,3,13,175
32715761@N00,4067,3,1223510247,1223512619,12,13,2372
32715761@N00,4067,21,1223507119,1223509850,8,13,2731
32715761@N00,4067,5,1223506891,1223506891,1,13,0
32715761@N00,4067,11,1223508882,1223508967,3,13,85
32715761@N00,4067,30,1223520199,1223520626,5,13,427
32715761@N00,4067,26,1223505888,1223506002,5,13,114
32715761@N00,4067,27,1223505513,1223505513,1,13,0
32715761@N00,4067,31,1223521641,1223521641,1,13,0
32715761@N00,4068,28,1223594102,1223594102,1,8,0
32715761@N00,4068,1,1223605326,1223621725,3,8,16399
32715761@N00,4068,29,1223598759,1223602631,2,8,3872
32715761@N00,4068,23,1223594173,1223594173,1,8,0
32715761@N00,4068,30,1223600399,1223602460,5,8,2061
32715761@N00,4068,26,1223598525,1223598525,1,8,0
32715761@N00,4068,19,1223602919,1223603372,10,8,453
32715761@N00,4068,12,1223597635,1223597795,3,8,160
32715761@N00,4069,1,1223691027,1223691027,1,9,0
32715761@N00,4069,23,1223682635,1223682655,2,9,20
32715761@N00,4069,15,1223672333,1223679900,2,9,7567
32715761@N00,4069,26,1223682568,1223682568,1,9,0
32715761@N00,4069,24,1223669812,1223679806,7,9,9994
32715761@N00,4069,12,1223671294,1223671340,2,9,46
32715761@N00,4069,17,1223676918,1223676918,1,9,0
32715761@N00,4069,22,1223689260,1223689571,4,9,311
32715761@N00,4069,31,1223687676,1223688805,8,9,1129
32715761@N00,4070,24,1223764739,1223770762,2,6,6023
32715761@N00,4070,27,1223771124,1223771124,1,6,0
32715761@N00,4070,3,1223766752,1223767036,4,6,284
32715761@N00,4070,21,1223765497,1223766048,3,6,551
32715761@N00,4070,13,1223768220,1223768324,3,6,104
32715761@N00,4070,4,1223766209,1223766209,1,6,0
32752574@N07,4071,26,1337180828,1337180828,1,1,0
32771019@N07,4072,1,1273890673,1273890673,1,1,0
32771930@N03,4073,29,1276419425,1276419444,2,1,19
32771930@N03,4074,29,1280656578,1280660249,3,1,3671
32782751@N07,4075,29,1302087786,1302087786,1,1,0
32782751@N07,4076,22,1302156770,1302156770,1,1,0
32783047@N07,4077,26,1427014018,1427014018,1,1,0
32783264@N08,4078,4,1437098430,1437098430,1,3,0
32783264@N08,4078,7,1437098626,1437098626,1,3,0
32783264@N08,4078,16,1437097142,1437097142,1,3,0
32814878@N00,4079,28,1353241215,1353241215,1,1,0
32814878@N00,4080,28,1353301191,1353301191,1,1,0
32823446@N00,4081,16,1300582157,1300582157,1,4,0
32823446@N00,4081,1,1300576288,1300576288,1,4,0
32823446@N00,4081,17,1300589494,1300589494,1,4,0
32823446@N00,4081,30,1300599704,1300599704,1,4,0
32823446@N00,4082,16,1301031733,1301031733,2,1,0
32823446@N00,4083,14,1364688161,1364688161,1,3,0
32823446@N00,4083,26,1364684097,1364684097,1,3,0
32823446@N00,4083,1,1364677030,1364677030,1,3,0
32823446@N00,4084,21,1450484390,1450484390,1,3,0
32823446@N00,4084,8,1450484795,1450484795,1,3,0
32823446@N00,4084,31,1450501409,1450501409,1,3,0
32823446@N00,4085,1,1450662254,1450662254,1,1,0
32835156@N00,4086,26,1260250117,1260256247,5,1,6130
32835156@N00,4087,28,1260325126,1260325126,1,1,0
32835156@N00,4088,16,1260506983,1260506983,1,2,0
32835156@N00,4088,15,1260507043,1260507043,1,2,0
32835156@N00,4089,22,1408247806,1408247806,1,2,0
32835156@N00,4089,20,1408247774,1408247774,1,2,0
32835156@N00,4090,28,1408325719,1408325719,1,1,0
32835156@N00,4091,26,1408498475,1408498555,6,2,80
32835156@N00,4091,16,1408492091,1408498504,2,2,6413
32835156@N00,4092,5,1408573274,1408573274,1,2,0
32835156@N00,4092,29,1408577905,1408577968,5,2,63
32841500@N05,4093,26,1402667978,1402667978,1,2,0
32841500@N05,4093,1,1402640517,1402664220,4,2,23703
32841500@N05,4094,14,1402903193,1402903193,1,3,0
32841500@N05,4094,19,1402903316,1402904465,6,3,1149
32841500@N05,4094,23,1402903081,1402903081,1,3,0
32841500@N05,4095,19,1402978259,1402978259,1,1,0
32853736@N08,4096,22,1277136462,1277136462,1,1,0
32917595@N00,4097,8,1303083593,1303083593,1,6,0
32917595@N00,4097,29,1303093234,1303093234,1,6,0
32917595@N00,4097,1,1303102758,1303102758,1,6,0
32917595@N00,4097,5,1303085257,1303085257,1,6,0
32917595@N00,4097,30,1303087657,1303124031,2,6,36374
32917595@N00,4097,27,1303078817,1303097558,2,6,18741
32917595@N00,4098,7,1303167683,1303167683,1,2,0
32917595@N00,4098,1,1303191011,1303191011,1,2,0
32927192@N00,4099,24,1223076673,1223076673,1,6,0
32927192@N00,4099,12,1223075140,1223076685,2,6,1545
32927192@N00,4099,28,1223073596,1223073596,1,6,0
32927192@N00,4099,29,1223080457,1223082135,5,6,1678
32927192@N00,4099,26,1223078246,1223078291,2,6,45
32927192@N00,4099,20,1223082351,1223083889,19,6,1538
32927192@N00,4100,17,1223119288,1223120636,2,1,1348
32932933@N00,4101,28,1361506281,1361506281,1,1,0
32932933@N00,4102,20,1387071145,1387071145,1,2,0
32932933@N00,4102,1,1387062110,1387065509,2,2,3399
32932933@N00,4103,29,1387103088,1387103088,1,1,0
32941012@N08,4104,19,1417385728,1417385728,1,2,0
32941012@N08,4104,24,1417373242,1417373242,1,2,0
32955865@N04,4105,16,1327287292,1327298824,2,1,11532
32975422@N06,4106,26,1356000096,1356000096,1,1,0
33005083@N00,4107,3,1316852271,1316852271,1,2,0
33005083@N00,4107,8,1316824888,1316824888,1,2,0
33005083@N00,4108,17,1328748859,1328752847,4,4,3988
33005083@N00,4108,26,1328743137,1328743137,1,4,0
33005083@N00,4108,1,1328741409,1328741409,1,4,0
33005083@N00,4108,27,1328748995,1328748995,1,4,0
33005083@N00,4109,17,1370733739,1370744698,4,2,10959
33005083@N00,4109,12,1370736430,1370739946,2,2,3516
33022236@N05,4110,18,1445441595,1445441595,1,1,0
33063488@N02,4111,26,1260534964,1260534964,1,2,0
33063488@N02,4111,21,1260525377,1260525377,1,2,0
33063488@N02,4112,12,1281869160,1281869160,1,6,0
33063488@N02,4112,26,1281866749,1281866749,1,6,0
33063488@N02,4112,21,1281867930,1281867930,1,6,0
33063488@N02,4112,15,1281888706,1281888706,1,6,0
33063488@N02,4112,17,1281887444,1281887444,1,6,0
33063488@N02,4112,1,1281864522,1281864705,3,6,183
33063488@N02,4113,25,1281974975,1281974975,1,11,0
33063488@N02,4113,22,1281972064,1281972515,3,11,451
33063488@N02,4113,1,1281977414,1281977567,2,11,153
33063488@N02,4113,15,1281975899,1281975899,1,11,0
33063488@N02,4113,29,1281970195,1281973045,2,11,2850
33063488@N02,4113,21,1281974678,1281975456,3,11,778
33063488@N02,4113,3,1281940061,1281940061,1,11,0
33063488@N02,4113,28,1281976434,1281977194,3,11,760
33063488@N02,4113,16,1281962540,1281976594,2,11,14054
33063488@N02,4113,10,1281973941,1281973941,1,11,0
33063488@N02,4113,26,1281963184,1281976668,5,11,13484
33063488@N02,4114,28,1282024267,1282024267,1,1,0
33063488@N02,4115,7,1294748518,1294749022,2,11,504
33063488@N02,4115,11,1294748097,1294748097,1,11,0
33063488@N02,4115,12,1294736226,1294738078,2,11,1852
33063488@N02,4115,18,1294750848,1294750848,1,11,0
33063488@N02,4115,1,1294751397,1294751397,1,11,0
33063488@N02,4115,26,1294749620,1294749620,1,11,0
33063488@N02,4115,15,1294739304,1294739406,2,11,102
33063488@N02,4115,24,1294738701,1294738701,1,11,0
33063488@N02,4115,6,1294749184,1294749184,1,11,0
33063488@N02,4115,28,1294750135,1294750502,3,11,367
33063488@N02,4115,31,1294746568,1294747029,2,11,461
33063488@N02,4116,29,1326360909,1326360909,1,3,0
33063488@N02,4116,22,1326362433,1326362433,1,3,0
33063488@N02,4116,26,1326367828,1326368116,2,3,288
33063488@N02,4117,26,1346424391,1346424391,1,1,0
33063488@N02,4118,26,1353232240,1353232240,1,1,0
33063488@N02,4119,28,1354101395,1354101588,2,2,193
33063488@N02,4119,16,1354099838,1354100293,2,2,455
33063488@N02,4120,26,1386227567,1386227567,1,1,0
33067733@N05,4121,28,1349522143,1349522143,1,1,0
33077451@N02,4122,29,1238283971,1238283971,1,2,0
33077451@N02,4122,28,1238280617,1238289310,2,2,8693
33077451@N02,4123,20,1238394279,1238394279,1,1,0
33077451@N02,4124,20,1238479932,1238479932,1,3,0
33077451@N02,4124,29,1238484316,1238484358,2,3,42
33077451@N02,4124,11,1238465898,1238465937,2,3,39
33077451@N02,4125,18,1238551579,1238551579,1,4,0
33077451@N02,4125,1,1238560257,1238560257,1,4,0
33077451@N02,4125,23,1238575395,1238575395,1,4,0
33077451@N02,4125,28,1238541209,1238568645,2,4,27436
33077451@N02,4126,29,1238634396,1238634547,2,4,151
33077451@N02,4126,11,1238644125,1238644125,1,4,0
33077451@N02,4126,28,1238631633,1238631633,1,4,0
33077451@N02,4126,23,1238646552,1238646552,1,4,0
33077451@N02,4127,28,1240464349,1240464349,1,1,0
33124345@N07,4128,26,1226231441,1226231441,1,1,0
33149991@N00,4129,30,1305967489,1305967489,1,1,0
33176557@N06,4130,18,1444881607,1444881607,1,1,0
33207205@N00,4131,12,1255739535,1255739535,1,2,0
33207205@N00,4131,28,1255760572,1255775854,2,2,15282
33207205@N00,4132,29,1265167422,1265167422,1,1,0
33207205@N00,4133,27,1265238534,1265238534,1,1,0
33207205@N00,4134,21,1271916470,1271916470,1,1,0
33207205@N00,4135,29,1275280205,1275280205,1,1,0
33207205@N00,4136,27,1280584744,1280584744,1,2,0
33207205@N00,4136,1,1280576498,1280576498,1,2,0
33207205@N00,4137,26,1285899570,1285899570,1,2,0
33207205@N00,4137,29,1285900444,1285904467,3,2,4023
33207205@N00,4138,28,1289096715,1289096715,1,1,0
33207205@N00,4139,17,1292649578,1292649578,1,1,0
33207205@N00,4140,27,1305846830,1305846830,1,1,0
33207205@N00,4141,3,1317365872,1317365872,1,1,0
33207205@N00,4142,19,1317462464,1317462464,1,1,0
33207205@N00,4143,16,1317550540,1317550540,1,1,0
33212119@N00,4144,15,1301047743,1301047743,1,1,0
33213804@N04,4145,16,1354872478,1354872478,1,4,0
33213804@N04,4145,18,1354883666,1354883666,1,4,0
33213804@N04,4145,12,1354876820,1354876820,1,4,0
33213804@N04,4145,20,1354862311,1354864036,2,4,1725
33213804@N04,4146,21,1354938122,1354940003,2,3,1881
33213804@N04,4146,26,1354938124,1354938124,1,3,0
33213804@N04,4146,28,1354945377,1354945377,1,3,0
33213804@N04,4147,26,1370226337,1370226337,1,1,0
33213804@N04,4148,28,1373622906,1373622906,1,1,0
33213804@N04,4149,29,1373948559,1373948559,1,1,0
33213804@N04,4150,30,1401613273,1401615312,3,1,2039
33213804@N04,4151,7,1401763685,1401763685,1,1,0
33213804@N04,4152,17,1404730947,1404730947,1,2,0
33213804@N04,4152,12,1404726625,1404726625,1,2,0
33213804@N04,4153,29,1462586136,1462586136,1,4,0
33213804@N04,4153,20,1462584513,1462584673,2,4,160
33213804@N04,4153,30,1462582610,1462582610,2,4,0
33213804@N04,4153,31,1462584505,1462584505,1,4,0
33213804@N04,4154,7,1462671214,1462681963,3,15,10749
33213804@N04,4154,29,1462696858,1462696858,1,15,0
33213804@N04,4154,28,1462673693,1462673697,3,15,4
33213804@N04,4154,9,1462681964,1462681970,2,15,6
33213804@N04,4154,17,1462672436,1462672436,1,15,0
33213804@N04,4154,27,1462664802,1462664802,1,15,0
33213804@N04,4154,3,1462669146,1462670692,2,15,1546
33213804@N04,4154,23,1462707066,1462707066,1,15,0
33213804@N04,4154,11,1462679782,1462679788,3,15,6
33213804@N04,4154,15,1462668643,1462671025,5,15,2382
33213804@N04,4154,30,1462698407,1462698407,2,15,0
33213804@N04,4154,12,1462686921,1462686921,1,15,0
33213804@N04,4154,6,1462676473,1462692100,3,15,15627
33213804@N04,4154,5,1462689459,1462689459,2,15,0
33213804@N04,4154,16,1462667098,1462667101,2,15,3
33213804@N04,4155,20,1462754883,1462754901,3,3,18
33213804@N04,4155,27,1462750321,1462750321,1,3,0
33213804@N04,4155,16,1462750302,1462750302,1,3,0
33227061@N08,4156,26,1406961965,1406980457,2,2,18492
33227061@N08,4156,18,1406955539,1406955539,1,2,0
33234549@N02,4157,28,1325748260,1325748260,2,1,0
33234549@N02,4158,28,1325807003,1325807003,2,1,0
33234549@N02,4159,30,1325847382,1325847382,1,1,0
33234549@N02,4160,26,1325895543,1325895543,1,1,0
33254284@N02,4161,19,1402795220,1402795220,1,1,0
33274024@N04,4162,21,1255571049,1255571049,1,3,0
33274024@N04,4162,26,1255571050,1255571050,1,3,0
33274024@N04,4162,18,1255571051,1255571051,1,3,0
33295748@N00,4163,30,1263913745,1263913745,1,1,0
33295748@N00,4164,30,1263952923,1263963692,12,1,10769
33308929@N04,4165,14,1232869442,1232869442,1,2,0
33308929@N04,4165,26,1232835408,1232874854,10,2,39446
33308929@N04,4166,26,1235725405,1235725835,4,1,430
33308929@N04,4167,26,1235799526,1235799762,5,1,236
33308929@N04,4168,14,1237682435,1237683122,3,1,687
33308929@N04,4169,26,1251503416,1251527238,7,1,23822
33308929@N04,4170,26,1256298917,1256298917,1,1,0
33308929@N04,4171,26,1260095356,1260096491,9,1,1135
33308929@N04,4172,26,1280144314,1280149102,6,1,4788
33308929@N04,4173,26,1283852125,1283852125,1,1,0
33308929@N04,4174,26,1287799548,1287834049,7,1,34501
33308929@N04,4175,26,1295151359,1295162063,2,1,10704
33308929@N04,4176,22,1312683199,1312683199,1,1,0
33308929@N04,4177,26,1319285499,1319298999,10,1,13500
33308929@N04,4178,26,1323430312,1323430312,1,1,0
33308929@N04,4179,26,1324974961,1324979872,3,1,4911
33308929@N04,4180,28,1327223914,1327224268,4,2,354
33308929@N04,4180,8,1327229146,1327247249,9,2,18103
33308929@N04,4181,1,1327282836,1327282836,1,1,0
33308929@N04,4182,26,1328353250,1328353250,1,1,0
33308929@N04,4183,26,1331457955,1331484141,6,2,26186
33308929@N04,4183,10,1331447143,1331447202,2,2,59
33308929@N04,4184,6,1331528385,1331528385,1,1,0
33308929@N04,4185,7,1331957205,1331957205,1,4,0
33308929@N04,4185,21,1331957085,1331957085,1,4,0
33308929@N04,4185,10,1331960201,1331960209,2,4,8
33308929@N04,4185,12,1331956968,1331956968,1,4,0
33308929@N04,4186,10,1332031294,1332031294,1,1,0
33308929@N04,4187,27,1333850277,1333850277,1,3,0
33308929@N04,4187,26,1333851047,1333851047,1,3,0
33308929@N04,4187,31,1333851757,1333851757,1,3,0
33308929@N04,4188,17,1339846914,1339846914,1,1,0
33308929@N04,4189,28,1339978917,1339978917,1,1,0
33308929@N04,4190,26,1342784760,1342785067,2,1,307
33308929@N04,4191,24,1342827489,1342827489,1,1,0
33308929@N04,4192,16,1347418737,1347418737,1,1,0
33308929@N04,4193,26,1348319527,1348319527,1,1,0
33308929@N04,4194,18,1350124420,1350124697,3,1,277
33308929@N04,4195,26,1350687497,1350702536,3,2,15039
33308929@N04,4195,20,1350687961,1350687961,1,2,0
33308929@N04,4196,26,1359873705,1359873705,1,2,0
33308929@N04,4196,18,1359866027,1359866027,1,2,0
33308929@N04,4197,26,1386414756,1386414756,1,2,0
33308929@N04,4197,25,1386415093,1386416998,4,2,1905
33308929@N04,4198,26,1456535245,1456535245,1,1,0
33312419@N07,4199,17,1363717152,1363717152,1,1,0
33312419@N07,4200,18,1363766480,1363766480,1,1,0
33312419@N07,4201,26,1363815674,1363815674,1,1,0
33313572@N02,4202,3,1240481874,1240482094,3,1,220
33349859@N00,4203,14,1395902541,1395902541,1,1,0
33356547@N02,4204,18,1299361164,1299361509,4,1,345
33356547@N02,4205,18,1299410080,1299444603,24,1,34523
33420213@N06,4206,10,1264665886,1264665886,1,1,0
33439043@N06,4207,26,1247021994,1247037284,5,1,15290
33444594@N02,4208,21,1314318684,1314318684,1,1,0
33445276@N03,4209,26,1197071483,1197097219,3,1,25736
33472625@N07,4210,26,1356810675,1356810675,1,1,0
33509969@N08,4211,1,1364850640,1364852232,5,8,1592
33509969@N08,4211,28,1364861975,1364861980,9,8,5
33509969@N08,4211,6,1364876689,1364876689,3,8,0
33509969@N08,4211,13,1364869873,1364869875,6,8,2
33509969@N08,4211,10,1364879027,1364879027,3,8,0
33509969@N08,4211,27,1364886582,1364886582,3,8,0
33509969@N08,4211,16,1364861784,1364862274,33,8,490
33509969@N08,4211,26,1364877949,1364879105,21,8,1156
33509969@N08,4212,29,1364957385,1364957406,12,2,21
33509969@N08,4212,26,1364954767,1364954963,27,2,196
33509969@N08,4213,22,1365035223,1365035230,6,2,7
33509969@N08,4213,31,1365035407,1365035462,20,2,55
33516396@N06,4214,25,1318825604,1318826128,2,2,524
33516396@N06,4214,20,1318808038,1318813692,6,2,5654
33516396@N06,4215,20,1318888357,1318888386,3,2,29
33516396@N06,4215,19,1318889654,1318889654,1,2,0
33516396@N06,4216,28,1318920689,1318920966,3,3,277
33516396@N06,4216,26,1318921130,1318921134,2,3,4
33516396@N06,4216,30,1318922478,1318922478,1,3,0
33537150@N06,4217,26,1310127212,1310127212,1,1,0
33547445@N04,4218,28,1246876610,1246876610,1,1,0
33547445@N04,4219,28,1261973721,1261973721,1,1,0
33587686@N07,4220,16,1304329428,1304329428,1,1,0
33591736@N08,4221,28,1353979431,1353979431,1,1,0
33620268@N07,4222,16,1260182318,1260182782,2,1,464
33620268@N07,4223,15,1324478892,1324478892,1,1,0
33658269@N00,4224,18,1449758446,1449758446,1,1,0
33745480@N05,4225,25,1420532489,1420532489,1,1,0
33753067@N04,4226,26,1411133150,1411133758,3,1,608
33791276@N06,4227,7,1230728400,1230728400,1,1,0
33803664@N06,4228,29,1253835033,1253837867,5,11,2834
33803664@N06,4228,24,1253841605,1253875847,8,11,34242
33803664@N06,4228,11,1253861472,1253862593,2,11,1121
33803664@N06,4228,16,1253841479,1253841479,1,11,0
33803664@N06,4228,15,1253842090,1253858895,4,11,16805
33803664@N06,4228,14,1253829231,1253829231,1,11,0
33803664@N06,4228,13,1253854864,1253862828,6,11,7964
33803664@N06,4228,26,1253854567,1253856723,5,11,2156
33803664@N06,4228,22,1253837406,1253879994,4,11,42588
33803664@N06,4228,1,1253831949,1253852508,11,11,20559
33803664@N06,4228,28,1253841390,1253876561,14,11,35171
33803664@N06,4229,29,1254006894,1254006894,1,4,0
33803664@N06,4229,24,1253999585,1254000969,2,4,1384
33803664@N06,4229,22,1254007055,1254008567,4,4,1512
33803664@N06,4229,28,1253999186,1254009953,4,4,10767
33803664@N06,4230,28,1254040596,1254040596,1,1,0
33813043@N00,4231,26,1250226244,1250270757,59,1,44513
33813043@N00,4232,26,1342433311,1342448724,29,1,15413
33813043@N00,4233,26,1437265780,1437310790,42,2,45010
33813043@N00,4233,30,1437307710,1437307726,4,2,16
33823100@N00,4234,26,1353382248,1353382248,1,6,0
33823100@N00,4234,27,1353415177,1353415177,1,6,0
33823100@N00,4234,17,1353414506,1353414506,1,6,0
33823100@N00,4234,11,1353403787,1353403787,1,6,0
33823100@N00,4234,28,1353414735,1353415227,3,6,492
33823100@N00,4234,16,1353379873,1353379873,1,6,0
33823100@N00,4235,1,1370844470,1370866128,2,6,21658
33823100@N00,4235,26,1370846181,1370846893,2,6,712
33823100@N00,4235,15,1370854641,1370854641,1,6,0
33823100@N00,4235,30,1370844605,1370844605,1,6,0
33823100@N00,4235,14,1370857740,1370857740,1,6,0
33823100@N00,4235,16,1370844382,1370844382,1,6,0
33823100@N00,4236,1,1383020467,1383020537,2,3,70
33823100@N00,4236,20,1383029887,1383029958,2,3,71
33823100@N00,4236,11,1383030016,1383030016,1,3,0
33823100@N00,4237,1,1383216655,1383216655,1,4,0
33823100@N00,4237,24,1383193636,1383194004,4,4,368
33823100@N00,4237,20,1383216398,1383216398,1,4,0
33823100@N00,4237,12,1383193756,1383193756,1,4,0
33823100@N00,4238,1,1383305487,1383305487,1,1,0
33823100@N00,4239,1,1387856193,1387856193,1,1,0
33823100@N00,4240,18,1421914656,1421914656,1,1,0
33843414@N02,4241,26,1260005905,1260005905,1,1,0
33873368@N00,4242,24,1361671576,1361671576,1,1,0
33876889@N05,4243,1,1393230361,1393230361,1,1,0
33884092@N04,4244,22,1276331556,1276331556,1,1,0
33884801@N02,4245,27,1358855129,1358855129,1,2,0
33884801@N02,4245,24,1358876866,1358876866,1,2,0
33888060@N00,4246,18,1441532160,1441532160,1,1,0
33896813@N03,4247,10,1278845007,1278845536,2,1,529
33959358@N05,4248,17,1298781554,1298781554,1,1,0
33959358@N05,4249,26,1306229234,1306229234,1,1,0
33959358@N05,4250,3,1306838622,1306838622,1,1,0
33959358@N05,4251,29,1307239468,1307239468,1,1,0
33959358@N05,4252,28,1338596815,1338596815,1,1,0
33959358@N05,4253,28,1338691229,1338691229,1,1,0
33959358@N05,4254,12,1346019706,1346019706,1,1,0
33959358@N05,4255,20,1348038849,1348038849,1,1,0
33959358@N05,4256,28,1348387597,1348387597,1,1,0
33959358@N05,4257,28,1349090193,1349090193,1,1,0
33959358@N05,4258,26,1353441659,1353441659,1,1,0
33959358@N05,4259,26,1359765677,1359765677,1,1,0
33959358@N05,4260,12,1359842478,1359842478,1,1,0
33959358@N05,4261,28,1361250324,1361250324,1,1,0
33999459@N06,4262,1,1367101321,1367101336,2,2,15
33999459@N06,4262,14,1367105311,1367105311,1,2,0
33999674@N02,4263,27,1307936714,1307937582,5,3,868
33999674@N02,4263,17,1307952259,1307952259,1,3,0
33999674@N02,4263,29,1307941243,1307943000,11,3,1757
34008959@N02,4264,30,1245982977,1245982989,3,1,12
34019920@N06,4265,26,1310365617,1310365617,1,1,0
34052289@N06,4266,28,1293501011,1293501011,1,1,0
34052289@N06,4267,27,1305623907,1305623907,1,1,0
34061516@N06,4268,20,1368088945,1368088945,1,1,0
34078107@N00,4269,1,1392441646,1392441646,1,1,0
34078107@N00,4270,18,1458206245,1458206245,1,1,0
34095068@N03,4271,4,1299551664,1299551805,3,1,141
34095068@N03,4272,28,1345702526,1345702526,1,1,0
34095068@N03,4273,28,1356663291,1356663291,1,1,0
34095068@N03,4274,28,1359366696,1359366696,1,1,0
34118276@N04,4275,26,1228467781,1228467781,1,3,0
34118276@N04,4275,16,1228455105,1228455105,1,3,0
34118276@N04,4275,28,1228454363,1228467990,2,3,13627
34128007@N04,4276,22,1238205295,1238209649,4,14,4354
34128007@N04,4276,28,1238213817,1238232433,12,14,18616
34128007@N04,4276,3,1238212077,1238212077,1,14,0
34128007@N04,4276,24,1238212391,1238224237,3,14,11846
34128007@N04,4276,30,1238202839,1238203332,3,14,493
34128007@N04,4276,4,1238211998,1238211998,1,14,0
34128007@N04,4276,19,1238213265,1238220017,3,14,6752
34128007@N04,4276,14,1238209446,1238209446,1,14,0
34128007@N04,4276,31,1238202538,1238207599,3,14,5061
34128007@N04,4276,29,1238209766,1238211077,5,14,1311
34128007@N04,4276,26,1238200916,1238231468,3,14,30552
34128007@N04,4276,1,1238200546,1238233198,3,14,32652
34128007@N04,4276,16,1238218270,1238218270,1,14,0
34128007@N04,4276,13,1238227464,1238227629,2,14,165
34128007@N04,4277,24,1284177079,1284177573,3,1,494
34131297@N02,4278,28,1291122000,1291122000,3,2,0
34131297@N02,4278,26,1291122000,1291122000,18,2,0
34154171@N00,4279,1,1310454707,1310454707,1,3,0
34154171@N00,4279,26,1310456334,1310456334,1,3,0
34154171@N00,4279,16,1310472682,1310472682,1,3,0
34154171@N00,4280,30,1311315632,1311315632,1,1,0
34154171@N00,4281,13,1313726392,1313726392,1,1,0
34154171@N00,4282,17,1315727465,1315727465,1,1,0
34154171@N00,4283,28,1318681682,1318681682,1,1,0
34154171@N00,4284,20,1321012775,1321012775,1,1,0
34154171@N00,4285,31,1335937104,1335937104,1,1,0
34154171@N00,4286,17,1337672815,1337672815,1,2,0
34154171@N00,4286,1,1337670828,1337681862,2,2,11034
34154171@N00,4287,28,1338800672,1338800672,1,1,0
34154171@N00,4288,28,1339917036,1339917036,1,2,0
34154171@N00,4288,31,1339933227,1339933227,1,2,0
34154171@N00,4289,28,1341567073,1341567073,1,1,0
34154171@N00,4290,28,1346995364,1346995364,1,1,0
34154171@N00,4291,28,1347772592,1347772592,1,1,0
34154171@N00,4292,28,1349444519,1349444519,1,1,0
34168709@N00,4293,29,1232328861,1232328861,1,4,0
34168709@N00,4293,27,1232330267,1232330267,1,4,0
34168709@N00,4293,28,1232314590,1232314590,1,4,0
34168709@N00,4293,23,1232328635,1232328635,1,4,0
34168709@N00,4294,12,1232774931,1232775017,2,8,86
34168709@N00,4294,29,1232768282,1232771496,3,8,3214
34168709@N00,4294,19,1232791555,1232791555,1,8,0
34168709@N00,4294,7,1232789367,1232789367,1,8,0
34168709@N00,4294,14,1232770462,1232770501,3,8,39
34168709@N00,4294,16,1232772111,1232772111,1,8,0
34168709@N00,4294,3,1232787467,1232787774,4,8,307
34168709@N00,4294,26,1232772303,1232789699,3,8,17396
34168709@N00,4295,27,1232973026,1232973026,1,2,0
34168709@N00,4295,7,1232973572,1232973572,1,2,0
34168709@N00,4296,29,1244982825,1244984061,12,3,1236
34168709@N00,4296,25,1244985971,1244987020,2,3,1049
34168709@N00,4296,26,1244975681,1244985476,10,3,9795
34168709@N00,4297,22,1245416917,1245416917,1,10,0
34168709@N00,4297,19,1245417050,1245417050,1,10,0
34168709@N00,4297,30,1245416932,1245416996,8,10,64
34168709@N00,4297,1,1245416865,1245416865,1,10,0
34168709@N00,4297,28,1245417065,1245417065,1,10,0
34168709@N00,4297,12,1245416873,1245417039,6,10,166
34168709@N00,4297,31,1245416924,1245416924,1,10,0
34168709@N00,4297,15,1245416897,1245417011,4,10,114
34168709@N00,4297,6,1245417024,1245417024,1,10,0
34168709@N00,4297,26,1245416912,1245417058,4,10,146
34168709@N00,4298,28,1246340764,1246364627,2,1,23863
34168709@N00,4299,29,1262517551,1262520400,4,1,2849
34168709@N00,4300,28,1279076795,1279076795,1,6,0
34168709@N00,4300,30,1279091514,1279091537,2,6,23
34168709@N00,4300,12,1279080307,1279080426,3,6,119
34168709@N00,4300,29,1279091324,1279091324,1,6,0
34168709@N00,4300,27,1279082618,1279083144,5,6,526
34168709@N00,4300,1,1279076732,1279076732,1,6,0
34180475@N06,4301,18,1416048335,1416048594,2,1,259
34183523@N00,4302,26,1355313473,1355313473,1,1,0
34190461@N04,4303,30,1237973426,1237973501,2,4,75
34190461@N04,4303,29,1237968877,1237974232,4,4,5355
34190461@N04,4303,28,1237986536,1237986536,1,4,0
34190461@N04,4303,26,1237978336,1237986232,2,4,7896
34194745@N06,4304,15,1376214473,1376214795,2,1,322
34204052@N00,4305,18,1420765645,1420765645,1,2,0
34204052@N00,4305,20,1420783144,1420784564,2,2,1420
34204052@N00,4306,18,1420851092,1420851092,1,2,0
34204052@N00,4306,15,1420851201,1420851201,1,2,0
34207923@N02,4307,28,1325901486,1325901486,1,1,0
34207923@N02,4308,26,1326514508,1326514508,1,1,0
34207923@N02,4309,3,1336779588,1336779591,3,5,3
34207923@N02,4309,12,1336779489,1336779605,7,5,116
34207923@N02,4309,26,1336779906,1336785982,10,5,6076
34207923@N02,4309,28,1336786275,1336786285,8,5,10
34207923@N02,4309,21,1336779587,1336782147,7,5,2560
34207923@N02,4310,29,1359166062,1359169692,36,4,3630
34207923@N02,4310,30,1359165185,1359170804,39,4,5619
34207923@N02,4310,26,1359165381,1359171552,14,4,6171
34207923@N02,4310,31,1359169704,1359169795,10,4,91
34207923@N02,4311,28,1388441776,1388441832,5,7,56
34207923@N02,4311,22,1388447739,1388448324,17,7,585
34207923@N02,4311,30,1388447434,1388447555,12,7,121
34207923@N02,4311,9,1388451610,1388451610,1,7,0
34207923@N02,4311,26,1388441842,1388451908,7,7,10066
34207923@N02,4311,31,1388447591,1388447646,6,7,55
34207923@N02,4311,1,1388441603,1388441747,6,7,144
34207923@N02,4312,28,1438421802,1438421802,1,1,0
34240084@N05,4313,26,1262517523,1262517523,1,1,0
34240084@N05,4314,24,1268298096,1268298096,1,1,0
34240084@N05,4315,26,1290388574,1290388574,1,1,0
34240084@N05,4316,7,1340550145,1340550145,1,1,0
34240084@N05,4317,28,1355650120,1355650120,1,1,0
34240084@N05,4318,26,1362784906,1362784906,1,1,0
34248408@N03,4319,17,1310838142,1310856295,2,1,18153
34249366@N03,4320,28,1345104976,1345105032,2,1,56
34270790@N07,4321,29,1373785996,1373785996,1,3,0
34270790@N07,4321,14,1373787580,1373787580,1,3,0
34270790@N07,4321,1,1373769781,1373769781,1,3,0
34320594@N07,4322,3,1232782771,1232782771,1,1,0
34342819@N07,4323,26,1230031839,1230031839,1,1,0
34359597@N00,4324,25,1323846183,1323846183,1,1,0
34361471@N02,4325,26,1327212993,1327212993,1,1,0
34366518@N00,4326,13,1293505121,1293505121,1,1,0
34379501@N00,4327,26,1383399442,1383399442,1,1,0
34379501@N00,4328,29,1434785591,1434785591,1,1,0
34390084@N07,4329,23,1207840478,1207840478,1,2,0
34390084@N07,4329,1,1207835870,1207835870,1,2,0
34390084@N07,4330,26,1208053355,1208053355,1,4,0
34390084@N07,4330,31,1208048036,1208049137,5,4,1101
34390084@N07,4330,30,1208041384,1208041384,1,4,0
34390084@N07,4330,29,1208049261,1208049261,1,4,0
34390084@N07,4331,28,1208093640,1208108583,5,6,14943
34390084@N07,4331,16,1208105270,1208105270,1,6,0
34390084@N07,4331,26,1208094415,1208094424,2,6,9
34390084@N07,4331,1,1208109409,1208109409,1,6,0
34390084@N07,4331,20,1208104143,1208104143,1,6,0
34390084@N07,4331,6,1208094790,1208094834,2,6,44
34390084@N07,4332,24,1228408229,1228408229,1,3,0
34390084@N07,4332,13,1228428793,1228428805,2,3,12
34390084@N07,4332,21,1228430776,1228430776,1,3,0
34390084@N07,4333,28,1228606205,1228609327,5,2,3122
34390084@N07,4333,18,1228613854,1228614355,2,2,501
34390084@N07,4334,28,1228671366,1228671366,1,2,0
34390084@N07,4334,12,1228684518,1228684518,1,2,0
34390084@N07,4335,28,1233156015,1233156015,1,4,0
34390084@N07,4335,26,1233153070,1233153070,1,4,0
34390084@N07,4335,22,1233151199,1233151199,1,4,0
34390084@N07,4335,31,1233152374,1233152374,1,4,0
34390084@N07,4336,25,1241880554,1241880554,1,4,0
34390084@N07,4336,3,1241881295,1241881295,1,4,0
34390084@N07,4336,30,1241882191,1241882191,1,4,0
34390084@N07,4336,26,1241879074,1241879638,3,4,564
34390084@N07,4337,28,1242101345,1242101345,1,2,0
34390084@N07,4337,26,1242102995,1242102995,1,2,0
34390084@N07,4338,28,1260099656,1260103883,6,1,4227
34426369@N06,4339,7,1385458689,1385458689,1,1,0
34426369@N06,4340,1,1394529404,1394529404,1,1,0
34428567@N02,4341,1,1238319051,1238319051,1,1,0
34444521@N03,4342,19,1339203946,1339241933,78,3,37987
34444521@N03,4342,29,1339216951,1339218234,3,3,1283
34444521@N03,4342,15,1339203544,1339209815,2,3,6271
34444521@N03,4343,19,1339298388,1339315474,17,4,17086
34444521@N03,4343,16,1339297422,1339298401,3,4,979
34444521@N03,4343,25,1339331710,1339332588,4,4,878
34444521@N03,4343,29,1339301469,1339323370,2,4,21901
34444521@N03,4344,19,1339380199,1339393731,32,1,13532
34453007@N00,4345,7,1268463407,1268463407,1,1,0
34453007@N00,4346,30,1323233313,1323233313,1,1,0
34457978@N00,4347,28,1221442786,1221451457,3,1,8671
34459091@N07,4348,31,1335596722,1335596722,1,1,0
34468249@N06,4349,1,1366882322,1366882322,1,1,0
34469598@N00,4350,16,1278591323,1278591323,1,1,0
34475966@N02,4351,26,1367812984,1367812984,1,6,0
34475966@N02,4351,20,1367807389,1367807389,1,6,0
34475966@N02,4351,31,1367812577,1367812585,2,6,8
34475966@N02,4351,28,1367804630,1367831974,5,6,27344
34475966@N02,4351,1,1367804604,1367830225,3,6,25621
34475966@N02,4351,18,1367826481,1367826793,2,6,312
34478296@N07,4352,28,1347157856,1347157856,1,1,0
34505603@N02,4353,28,1306075794,1306079915,6,1,4121
34505603@N02,4354,28,1308455130,1308455150,2,1,20
34540702@N06,4355,21,1354672626,1354672626,1,1,0
34561876@N07,4356,1,1338811745,1338811745,1,1,0
34572651@N00,4357,25,1291947767,1291947767,1,1,0
34576019@N02,4358,18,1245287511,1245287511,1,2,0
34576019@N02,4358,26,1245273404,1245282226,2,2,8822
34583114@N03,4359,11,1248517544,1248517592,2,1,48
34588263@N00,4360,29,1201921112,1201930016,11,1,8904
34649366@N06,4361,28,1290600170,1290600254,2,2,84
34649366@N06,4361,26,1290597783,1290597783,1,2,0
34649366@N06,4362,24,1291370042,1291370042,1,3,0
34649366@N06,4362,16,1291372660,1291373234,2,3,574
34649366@N06,4362,26,1291373761,1291373761,1,3,0
34681290@N00,4363,27,1448599570,1448599748,5,11,178
34681290@N00,4363,10,1448610475,1448610480,2,11,5
34681290@N00,4363,17,1448597104,1448599596,2,11,2492
34681290@N00,4363,28,1448588420,1448626741,3,11,38321
34681290@N00,4363,29,1448612289,1448612397,2,11,108
34681290@N00,4363,11,1448608057,1448608057,1,11,0
34681290@N00,4363,31,1448612576,1448612576,1,11,0
34681290@N00,4363,16,1448593091,1448593099,2,11,8
34681290@N00,4363,12,1448602505,1448602505,1,11,0
34681290@N00,4363,1,1448588013,1448627490,5,11,39477
34681290@N00,4363,30,1448609880,1448610663,9,11,783
34729147@N00,4364,22,1358492708,1358492708,1,1,0
34754162@N00,4365,28,1260619579,1260628480,8,1,8901
34794168@N00,4366,18,1242439664,1242439865,5,1,201
34849589@N03,4367,28,1262222715,1262259534,11,4,36819
34849589@N03,4367,29,1262227891,1262228235,3,4,344
34849589@N03,4367,8,1262239034,1262244622,3,4,5588
34849589@N03,4367,31,1262229439,1262229439,1,4,0
34864673@N08,4368,26,1299235362,1299235362,1,1,0
34864673@N08,4369,23,1324116427,1324116427,1,1,0
34875170@N06,4370,28,1235625284,1235625798,9,1,514
34899062@N05,4371,8,1337504936,1337504936,1,1,0
34899062@N05,4372,17,1337587913,1337587913,1,4,0
34899062@N05,4372,16,1337581061,1337581061,1,4,0
34899062@N05,4372,28,1337600319,1337600319,1,4,0
34899062@N05,4372,30,1337571605,1337571605,1,4,0
34899062@N05,4373,14,1349011962,1349011962,1,3,0
34899062@N05,4373,29,1348998869,1348998869,1,3,0
34899062@N05,4373,20,1348991914,1348991914,1,3,0
34899062@N05,4374,27,1366860548,1366860548,1,1,0
34899062@N05,4375,27,1383890526,1383890526,1,2,0
34899062@N05,4375,30,1383887622,1383887622,1,2,0
34899062@N05,4376,12,1390883758,1390883758,1,1,0
34899062@N05,4377,29,1406326335,1406326335,1,1,0
34935493@N04,4378,6,1307329605,1307329605,1,2,0
34935493@N04,4378,16,1307333083,1307333083,1,2,0
34935493@N04,4379,30,1308214239,1308214239,1,1,0
34938885@N08,4380,1,1383973386,1383998347,3,1,24961
34964115@N00,4381,15,1424659003,1424659003,1,2,0
34964115@N00,4381,4,1424649814,1424649814,1,2,0
35002274@N02,4382,8,1236415756,1236415756,1,1,0
35016968@N07,4383,26,1233886035,1233886035,1,1,0
35034346886@N01,4384,24,1451728058,1451728058,1,1,0
35034347347@N01,4385,24,1247210567,1247210567,1,2,0
35034347347@N01,4385,29,1247206724,1247222447,2,2,15723
35034347782@N01,4386,27,1367822779,1367822779,1,2,0
35034347782@N01,4386,28,1367822771,1367822771,1,2,0
35034348340@N01,4387,28,1333368829,1333368829,1,1,0
35068332@N00,4388,27,1200186078,1200196858,3,1,10780
35068332@N00,4389,27,1213395842,1213398894,3,1,3052
35068332@N00,4390,15,1309952408,1309954906,4,1,2498
35068332@N00,4391,27,1310031250,1310031250,1,1,0
35068332@N00,4392,18,1380879164,1380879164,1,3,0
35068332@N00,4392,29,1380861693,1380861693,1,3,0
35068332@N00,4392,15,1380854741,1380854741,1,3,0
35068332@N00,4393,29,1380962841,1380962841,1,1,0
35085650@N00,4394,17,1279377558,1279377558,1,1,0
35085650@N00,4395,17,1279421912,1279424858,3,1,2946
35125112@N02,4396,23,1238362848,1238362848,1,1,0
35136866@N03,4397,31,1429076911,1429076911,1,1,0
35137530@N00,4398,23,1231066747,1231066747,1,1,0
35149878@N08,4399,26,1354418517,1354418517,1,1,0
35172613@N00,4400,28,1292397718,1292399626,26,1,1908
35172613@N00,4401,7,1314774146,1314774146,1,2,0
35172613@N00,4401,26,1314773382,1314773648,3,2,266
35172613@N00,4402,21,1323156844,1323157217,3,3,373
35172613@N00,4402,31,1323156247,1323156247,1,3,0
35172613@N00,4402,25,1323156891,1323157683,3,3,792
35172613@N00,4403,11,1350276812,1350280411,2,5,3599
35172613@N00,4403,26,1350273332,1350273357,2,5,25
35172613@N00,4403,21,1350276091,1350276172,2,5,81
35172613@N00,4403,20,1350267616,1350267616,1,5,0
35172613@N00,4403,29,1350277793,1350282319,2,5,4526
35172613@N00,4404,11,1355200013,1355200013,1,5,0
35172613@N00,4404,26,1355198288,1355198376,2,5,88
35172613@N00,4404,7,1355199866,1355199977,2,5,111
35172613@N00,4404,13,1355199349,1355199349,1,5,0
35172613@N00,4404,29,1355210042,1355210413,5,5,371
35172613@N00,4405,30,1360410283,1360410283,1,1,0
35172613@N00,4406,26,1362287404,1362300289,5,3,12885
35172613@N00,4406,18,1362300297,1362300297,1,3,0
35172613@N00,4406,29,1362292057,1362292057,1,3,0
35172613@N00,4407,22,1411970371,1411970371,1,1,0
35176540@N05,4408,28,1371860493,1371860493,1,1,0
35176540@N05,4409,15,1371902008,1371902008,1,2,0
35176540@N05,4409,27,1371901855,1371901855,1,2,0
35181047@N04,4410,17,1283941434,1283941638,3,10,204
35181047@N04,4410,21,1283933703,1283933703,1,10,0
35181047@N04,4410,7,1283936083,1283936083,1,10,0
35181047@N04,4410,6,1283935141,1283935154,3,10,13
35181047@N04,4410,16,1283932747,1283932796,4,10,49
35181047@N04,4410,1,1283931461,1283931814,8,10,353
35181047@N04,4410,23,1283936833,1283942698,2,10,5865
35181047@N04,4410,26,1283937854,1283938502,18,10,648
35181047@N04,4410,28,1283931920,1283942260,20,10,10340
35181047@N04,4410,5,1283933973,1283934511,4,10,538
35237090871@N01,4411,25,1196468541,1196469677,3,1,1136
35237090871@N01,4412,1,1206754911,1206754911,1,7,0
35237090871@N01,4412,17,1206775501,1206775501,1,7,0
35237090871@N01,4412,7,1206783081,1206783081,1,7,0
35237090871@N01,4412,28,1206789848,1206789896,2,7,48
35237090871@N01,4412,25,1206780149,1206781452,3,7,1303
35237090871@N01,4412,30,1206786098,1206786098,1,7,0
35237090871@N01,4412,26,1206755627,1206789462,2,7,33835
35237091648@N01,4413,28,1229724484,1229724484,1,1,0
35237098292@N01,4414,28,1294551077,1294579874,2,1,28797
35237099571@N01,4415,28,1324616517,1324628512,4,1,11995
35237099571@N01,4416,20,1328351274,1328351319,2,3,45
35237099571@N01,4416,3,1328356658,1328356658,1,3,0
35237099571@N01,4416,17,1328359202,1328359202,1,3,0
35237099571@N01,4417,28,1330524421,1330538126,4,1,13705
35237099571@N01,4418,28,1344500848,1344500848,1,1,0
35237099571@N01,4419,17,1356095974,1356095974,1,1,0
35258228@N00,4420,29,1357897993,1357898125,2,1,132
35258228@N00,4421,28,1372600130,1372600130,1,1,0
35258228@N00,4422,18,1378461887,1378461887,1,1,0
35261188@N00,4423,28,1304204155,1304204294,2,2,139
35261188@N00,4423,16,1304208256,1304208256,1,2,0
35263184@N05,4424,30,1250587804,1250587804,1,9,0
35263184@N05,4424,29,1250592842,1250592957,2,9,115
35263184@N05,4424,21,1250587153,1250587153,1,9,0
35263184@N05,4424,28,1250580200,1250608648,18,9,28448
35263184@N05,4424,4,1250581854,1250622951,8,9,41097
35263184@N05,4424,6,1250623040,1250623057,2,9,17
35263184@N05,4424,16,1250580272,1250580272,1,9,0
35263184@N05,4424,26,1250580401,1250580422,2,9,21
35263184@N05,4424,8,1250580855,1250580855,1,9,0
35306697@N07,4425,27,1366413839,1366413839,1,2,0
35306697@N07,4425,18,1366426147,1366426147,1,2,0
35306697@N07,4426,1,1377398170,1377398170,1,2,0
35306697@N07,4426,29,1377404545,1377404545,1,2,0
35306697@N07,4427,17,1382709644,1382709644,1,1,0
35344579@N00,4428,13,1461314459,1461314459,1,1,0
35351453@N02,4429,22,1262296776,1262296776,1,2,0
35351453@N02,4429,30,1262283980,1262283980,1,2,0
35371784@N00,4430,15,1278830718,1278831084,3,2,366
35371784@N00,4430,24,1278832620,1278835892,7,2,3272
35371784@N00,4431,24,1278896513,1278899028,2,1,2515
35371784@N00,4432,18,1279003160,1279003184,2,2,24
35371784@N00,4432,24,1278990740,1278990877,2,2,137
35371784@N00,4433,22,1279068945,1279076340,2,4,7395
35371784@N00,4433,12,1279067603,1279067603,1,4,0
35371784@N00,4433,13,1279069908,1279072285,9,4,2377
35371784@N00,4433,24,1279067588,1279067591,2,4,3
35371784@N00,4434,30,1279159277,1279159277,1,2,0
35371784@N00,4434,31,1279161579,1279163157,3,2,1578
35387868@N00,4435,29,1261972703,1261972703,1,2,0
35387868@N00,4435,13,1261967186,1261967186,1,2,0
35421783@N04,4436,1,1301223417,1301223498,3,1,81
35426585@N04,4437,1,1325452855,1325452955,2,1,100
35439195@N08,4438,16,1263015152,1263015152,1,1,0
35439195@N08,4439,1,1268484110,1268484110,1,1,0
35439195@N08,4440,31,1278302175,1278302175,1,1,0
35439195@N08,4441,29,1281778606,1281778606,1,1,0
35439195@N08,4442,16,1284108632,1284108632,1,1,0
35439195@N08,4443,26,1286618847,1286618847,1,1,0
35439195@N08,4444,6,1287204040,1287204040,1,1,0
35439195@N08,4445,24,1295230587,1295230587,1,1,0
35468135814@N01,4446,4,1278502979,1278502979,1,1,0
35468135814@N01,4447,26,1416076311,1416076311,1,1,0
35468150569@N01,4448,15,1329379604,1329379604,1,2,0
35468150569@N01,4448,17,1329396109,1329396109,1,2,0
35481620@N00,4449,28,1290825737,1290825737,1,1,0
35498711@N04,4450,13,1304855987,1304855987,1,6,0
35498711@N04,4450,3,1304822909,1304822909,1,6,0
35498711@N04,4450,26,1304824263,1304824263,1,6,0
35498711@N04,4450,29,1304844565,1304844928,2,6,363
35498711@N04,4450,27,1304840182,1304840182,1,6,0
35498711@N04,4450,11,1304856151,1304856151,1,6,0
35498711@N04,4451,13,1305099176,1305099287,2,1,111
35498711@N04,4452,13,1376888400,1376892602,3,5,4202
35498711@N04,4452,20,1376892601,1376892601,1,5,0
35498711@N04,4452,12,1376888402,1376888402,1,5,0
35498711@N04,4452,22,1376880600,1376880601,2,5,1
35498711@N04,4452,27,1376888403,1376892600,3,5,4197
35577481@N08,4453,16,1247800463,1247806293,2,1,5830
35577481@N08,4454,13,1293083872,1293089000,2,2,5128
35577481@N08,4454,20,1293104154,1293106281,3,2,2127
35577481@N08,4455,29,1317560345,1317560345,1,1,0
35577481@N08,4456,26,1325687196,1325688464,2,1,1268
35577481@N08,4457,6,1327235534,1327235534,1,1,0
35577481@N08,4458,28,1329988431,1329988431,1,1,0
35577481@N08,4459,16,1330459416,1330459416,1,1,0
35595560@N00,4460,28,1325139204,1325139204,1,1,0
35595560@N00,4461,3,1330920422,1330920422,1,1,0
35599995@N04,4462,23,1231674288,1231674288,1,6,0
35599995@N04,4462,29,1231674891,1231681329,3,6,6438
35599995@N04,4462,26,1231686237,1231691975,15,6,5738
35599995@N04,4462,30,1231688650,1231688671,3,6,21
35599995@N04,4462,1,1231673749,1231673757,2,6,8
35599995@N04,4462,4,1231682292,1231692111,2,6,9819
35599995@N04,4463,10,1231844937,1231844937,1,3,0
35599995@N04,4463,30,1231852250,1231852250,1,3,0
35599995@N04,4463,12,1231840147,1231840147,1,3,0
35616624@N05,4464,16,1316851988,1316851988,1,1,0
35659651@N00,4465,29,1363518700,1363518700,1,1,0
35727288@N00,4466,24,1292262029,1292262029,1,1,0
35727989@N00,4467,22,1450251283,1450251283,1,2,0
35727989@N00,4467,11,1450240592,1450240592,1,2,0
35727989@N00,4468,31,1450306108,1450306108,1,6,0
35727989@N00,4468,27,1450299521,1450299521,1,6,0
35727989@N00,4468,13,1450342104,1450342104,1,6,0
35727989@N00,4468,29,1450314900,1450314900,1,6,0
35727989@N00,4468,28,1450344420,1450347740,2,6,3320
35727989@N00,4468,24,1450300266,1450309489,2,6,9223
35727989@N00,4469,15,1450405206,1450405206,1,2,0
35727989@N00,4469,28,1450402438,1450402438,1,2,0
35736481@N00,4470,26,1300321113,1300364584,55,1,43471
35737816@N04,4471,28,1387363552,1387363552,1,1,0
35737816@N04,4472,25,1387447600,1387447600,1,1,0
35795945@N02,4473,11,1242286265,1242286265,1,12,0
35795945@N02,4473,20,1242286955,1242287423,6,12,468
35795945@N02,4473,9,1242286197,1242286216,2,12,19
35795945@N02,4473,30,1242286546,1242287528,3,12,982
35795945@N02,4473,15,1242285700,1242285700,1,12,0
35795945@N02,4473,22,1242287144,1242287144,1,12,0
35795945@N02,4473,21,1242286025,1242286025,1,12,0
35795945@N02,4473,29,1242286765,1242286867,5,12,102
35795945@N02,4473,24,1242285881,1242285881,1,12,0
35795945@N02,4473,12,1242285825,1242285899,2,12,74
35795945@N02,4473,5,1242286143,1242286149,2,12,6
35795945@N02,4473,16,1242285599,1242285599,1,12,0
35795945@N02,4474,4,1242555997,1242555997,1,11,0
35795945@N02,4474,3,1242555831,1242555831,1,11,0
35795945@N02,4474,30,1242556620,1242556620,1,11,0
35795945@N02,4474,22,1242557017,1242557033,2,11,16
35795945@N02,4474,26,1242554180,1242554180,1,11,0
35795945@N02,4474,1,1242557558,1242557558,1,11,0
35795945@N02,4474,29,1242556591,1242556591,1,11,0
35795945@N02,4474,31,1242556402,1242556944,2,11,542
35795945@N02,4474,10,1242556476,1242556476,1,11,0
35795945@N02,4474,9,1242556124,1242556124,1,11,0
35795945@N02,4474,7,1242556061,1242556061,1,11,0
35795945@N02,4475,4,1244843343,1244843351,5,12,8
35795945@N02,4475,26,1244843371,1244844514,9,12,1143
35795945@N02,4475,9,1244843342,1244843368,8,12,26
35795945@N02,4475,31,1244843302,1244844508,6,12,1206
35795945@N02,4475,30,1244843308,1244843308,1,12,0
35795945@N02,4475,6,1244843373,1244843375,2,12,2
35795945@N02,4475,28,1244843408,1244843408,1,12,0
35795945@N02,4475,22,1244843319,1244843325,3,12,6
35795945@N02,4475,17,1244843403,1244843403,1,12,0
35795945@N02,4475,12,1244843402,1244843402,1,12,0
35795945@N02,4475,8,1244843356,1244843356,1,12,0
35795945@N02,4475,10,1244843328,1244843340,3,12,12
35795945@N02,4476,28,1250759693,1250759889,4,5,196
35795945@N02,4476,20,1250759048,1250759176,7,5,128
35795945@N02,4476,1,1250758768,1250759924,5,5,1156
35795945@N02,4476,12,1250759682,1250759682,1,5,0
35795945@N02,4476,18,1250759462,1250759466,2,5,4
35795945@N02,4477,11,1273365198,1273365585,4,4,387
35795945@N02,4477,31,1273365920,1273365932,2,4,12
35795945@N02,4477,25,1273363990,1273365032,25,4,1042
35795945@N02,4477,16,1273363544,1273363700,7,4,156
35795945@N02,4478,11,1274949879,1274949946,3,6,67
35795945@N02,4478,29,1274950071,1274951356,21,6,1285
35795945@N02,4478,23,1274951462,1274951462,1,6,0
35795945@N02,4478,1,1274952353,1274952399,3,6,46
35795945@N02,4478,17,1274949464,1274949464,1,6,0
35795945@N02,4478,16,1274949038,1274949038,1,6,0
35795945@N02,4479,31,1276391751,1276392305,4,5,554
35795945@N02,4479,21,1276390826,1276390833,2,5,7
35795945@N02,4479,29,1276392643,1276396052,21,5,3409
35795945@N02,4479,17,1276390501,1276390501,1,5,0
35795945@N02,4479,30,1276391693,1276391697,2,5,4
35795945@N02,4480,29,1280527124,1280527124,1,1,0
35815643@N00,4481,8,1193480910,1193481769,11,1,859
35851138@N02,4482,28,1355927494,1355927494,1,1,0
35861125@N08,4483,29,1248277166,1248277298,6,15,132
35861125@N08,4483,13,1248297854,1248298904,12,15,1050
35861125@N08,4483,21,1248264868,1248265126,20,15,258
35861125@N08,4483,5,1248261898,1248266471,3,15,4573
35861125@N08,4483,7,1248261848,1248301476,6,15,39628
35861125@N08,4483,28,1248260702,1248290349,95,15,29647
35861125@N08,4483,27,1248267893,1248267893,1,15,0
35861125@N08,4483,17,1248279316,1248279367,4,15,51
35861125@N08,4483,11,1248300726,1248303244,16,15,2518
35861125@N08,4483,16,1248267036,1248267810,6,15,774
35861125@N08,4483,4,1248263404,1248266453,11,15,3049
35861125@N08,4483,15,1248271957,1248272595,4,15,638
35861125@N08,4483,26,1248261095,1248295390,23,15,34295
35861125@N08,4483,18,1248294056,1248294794,15,15,738
35861125@N08,4483,24,1248266741,1248270383,8,15,3642
35861125@N08,4484,4,1248370934,1248370934,1,1,0
35872939@N00,4485,25,1252384623,1252386147,11,5,1524
35872939@N00,4485,1,1252380221,1252380221,1,5,0
35872939@N00,4485,28,1252380444,1252408973,13,5,28529
35872939@N00,4485,13,1252389615,1252402438,11,5,12823
35872939@N00,4485,26,1252380964,1252380964,1,5,0
35872939@N00,4486,28,1302313988,1302333454,21,1,19466
35922097@N00,4487,27,1378004048,1378004048,1,1,0
35942475@N05,4488,26,1289966720,1289973297,2,1,6577
35942475@N05,4489,16,1290040278,1290040278,1,1,0
35942475@N05,4490,26,1290340035,1290348777,2,1,8742
35942475@N05,4491,26,1292501512,1292508675,7,1,7163
35942475@N05,4492,26,1292814143,1292814143,1,1,0
35942475@N05,4493,26,1293022611,1293029149,7,1,6538
35942475@N05,4494,26,1294131929,1294131929,1,1,0
35942475@N05,4495,26,1294710452,1294739637,6,1,29185
35942475@N05,4496,26,1295261296,1295271923,5,1,10627
35942475@N05,4497,26,1296201171,1296204081,3,1,2910
35942475@N05,4498,26,1297385477,1297424479,12,1,39002
35942475@N05,4499,26,1299370481,1299401835,7,1,31354
35942475@N05,4500,26,1301009736,1301014154,4,1,4418
35942475@N05,4501,26,1301387363,1301399083,4,1,11720
35942475@N05,4502,18,1354578694,1354578694,1,1,0
35942475@N05,4503,18,1363035696,1363035696,1,1,0
35942475@N05,4504,3,1366324611,1366324611,1,1,0
35942475@N05,4505,27,1366664234,1366664234,1,1,0
35942475@N05,4506,29,1376010291,1376010291,1,1,0
35942475@N05,4507,14,1379725887,1379725887,1,1,0
35942475@N05,4508,18,1380332891,1380332891,1,1,0
35945797@N05,4509,5,1353372295,1353372295,2,7,0
35945797@N05,4509,21,1353372352,1353372352,2,7,0
35945797@N05,4509,12,1353372653,1353372653,2,7,0
35945797@N05,4509,26,1353369285,1353369417,4,7,132
35945797@N05,4509,31,1353370826,1353370826,1,7,0
35945797@N05,4509,3,1353372132,1353372132,3,7,0
35945797@N05,4509,28,1353368661,1353368661,2,7,0
35969374@N06,4510,1,1234720768,1234720768,1,1,0
36015194@N00,4511,27,1346066721,1346066721,1,1,0
36029045@N00,4512,3,1300515478,1300515478,1,2,0
36029045@N00,4512,9,1300512146,1300512146,1,2,0
36029045@N00,4513,26,1300585686,1300585686,1,1,0
36029045@N00,4514,6,1357530189,1357530189,1,1,0
36030204@N08,4515,26,1231058294,1231058294,1,1,0
36033182@N00,4516,12,1210381161,1210381161,1,1,0
36033323@N03,4517,29,1235706183,1235706183,1,1,0
36064583@N03,4518,26,1466653025,1466653025,1,1,0
36084672@N00,4519,28,1362797600,1362817484,3,1,19884
36121294@N06,4520,13,1267018412,1267018563,3,5,151
36121294@N06,4520,26,1267009820,1267010056,2,5,236
36121294@N06,4520,28,1267009253,1267009260,2,5,7
36121294@N06,4520,1,1267007685,1267007685,1,5,0
36121294@N06,4520,25,1267018199,1267018199,1,5,0
36141784@N05,4521,13,1372736568,1372736568,1,1,0
36179078@N03,4522,14,1377995631,1377995631,1,1,0
36179078@N03,4523,1,1385815590,1385815590,1,1,0
36179078@N03,4524,17,1386854222,1386854222,1,1,0
36179078@N03,4525,1,1386946741,1386946741,1,1,0
36179078@N03,4526,25,1387379819,1387379819,1,1,0
36179078@N03,4527,15,1391956026,1391956026,1,1,0
36179078@N03,4528,19,1416307426,1416307426,1,1,0
36179078@N03,4529,19,1418398200,1418398200,1,1,0
36179078@N03,4530,18,1425389028,1425389028,1,1,0
36179078@N03,4531,23,1426846920,1426847531,2,1,611
36187047@N05,4532,23,1215900605,1215900605,1,1,0
36190203@N07,4533,26,1293808001,1293808001,1,1,0
36209531@N07,4534,28,1409142315,1409142315,1,1,0
36231632@N00,4535,28,1414629068,1414629068,1,1,0
36234234@N05,4536,26,1349498947,1349498947,1,3,0
36234234@N05,4536,19,1349499225,1349499225,1,3,0
36234234@N05,4536,24,1349500103,1349500103,1,3,0
36234234@N05,4537,3,1389063768,1389063768,1,1,0
36244940@N07,4538,31,1256872215,1256872215,1,1,0
36244940@N07,4539,26,1256934024,1256934024,1,1,0
36244940@N07,4540,3,1301216951,1301217001,3,6,50
36244940@N07,4540,16,1301213010,1301221077,2,6,8067
36244940@N07,4540,25,1301217101,1301217101,1,6,0
36244940@N07,4540,28,1301224827,1301224827,1,6,0
36244940@N07,4540,12,1301217185,1301217185,1,6,0
36244940@N07,4540,26,1301212911,1301221072,3,6,8161
36244940@N07,4541,18,1301275288,1301275288,1,9,0
36244940@N07,4541,20,1301275270,1301275270,1,9,0
36244940@N07,4541,10,1301279763,1301279763,1,9,0
36244940@N07,4541,30,1301276350,1301302688,7,9,26338
36244940@N07,4541,27,1301302774,1301302774,1,9,0
36244940@N07,4541,16,1301316568,1301316568,1,9,0
36244940@N07,4541,7,1301315265,1301315265,1,9,0
36244940@N07,4541,26,1301315762,1301316810,4,9,1048
36244940@N07,4541,6,1301315622,1301315622,1,9,0
36244940@N07,4542,30,1301393988,1301393988,1,3,0
36244940@N07,4542,16,1301392859,1301402042,2,3,9183
36244940@N07,4542,26,1301384076,1301384197,2,3,121
36244940@N07,4543,16,1301683497,1301683497,1,2,0
36244940@N07,4543,26,1301654780,1301654780,1,2,0
36258343@N03,4544,26,1366980325,1366980325,1,1,0
36258343@N03,4545,26,1441375289,1441375289,1,1,0
36277109@N03,4546,30,1398280285,1398280285,1,1,0
36330825967@N01,4547,30,1213679273,1213679273,1,3,0
36330825967@N01,4547,7,1213701602,1213701602,1,3,0
36330825967@N01,4547,20,1213681104,1213721330,3,3,40226
36330825967@N01,4548,13,1213768686,1213770331,2,1,1645
36330825967@N01,4549,7,1213799334,1213799369,2,1,35
36330825967@N01,4550,13,1213852610,1213852610,1,2,0
36330825967@N01,4550,24,1213866393,1213866398,2,2,5
36330825967@N01,4551,29,1227374599,1227374599,1,1,0
36330825967@N01,4552,15,1227524818,1227524818,1,5,0
36330825967@N01,4552,18,1227518574,1227518574,1,5,0
36330825967@N01,4552,21,1227511512,1227511512,1,5,0
36330825967@N01,4552,17,1227504205,1227508119,3,5,3914
36330825967@N01,4552,24,1227546894,1227547704,4,5,810
36330825967@N01,4553,16,1227589495,1227589495,1,1,0
36330825967@N01,4554,28,1273795985,1273795985,1,1,0
36330825967@N01,4555,28,1273877210,1273877210,1,1,0
36330825967@N01,4556,28,1273929141,1273929141,1,1,0
36330825967@N01,4557,28,1273965598,1273965598,1,1,0
36330825967@N01,4558,25,1289595267,1289595293,4,1,26
36330825967@N01,4559,18,1289695883,1289695895,2,2,12
36330825967@N01,4559,17,1289680579,1289680579,1,2,0
36330825967@N01,4560,18,1311299282,1311299282,1,1,0
36330825967@N01,4561,17,1311369667,1311372701,2,1,3034
36330825967@N01,4562,18,1311423305,1311423305,1,1,0
36330825967@N01,4563,17,1311455905,1311455905,1,1,0
36330825967@N01,4564,30,1357872611,1357872660,2,1,49
36330825967@N01,4565,12,1357940381,1357940434,2,3,53
36330825967@N01,4565,17,1357938981,1357939769,3,3,788
36330825967@N01,4565,5,1357948395,1357948395,1,3,0
36330825967@N01,4566,17,1358026918,1358027705,2,2,787
36330825967@N01,4566,27,1358036995,1358036995,1,2,0
36330825967@N01,4567,17,1358120509,1358120509,1,1,0
36330825967@N01,4568,29,1371962214,1371962214,1,3,0
36330825967@N01,4568,1,1371964763,1371964763,1,3,0
36330825967@N01,4568,20,1371964773,1371964773,1,3,0
36330825967@N01,4569,15,1372125285,1372125285,1,3,0
36330825967@N01,4569,17,1372109684,1372125277,2,3,15593
36330825967@N01,4569,19,1372117827,1372117827,1,3,0
36330825967@N01,4570,1,1372162433,1372162433,1,1,0
36330825967@N01,4571,17,1389312291,1389312291,1,1,0
36330825967@N01,4572,9,1389388534,1389388534,1,1,0
36330825967@N01,4573,12,1389427183,1389427183,1,1,0
36330825967@N01,4574,12,1389478880,1389481400,2,1,2520
36330825967@N01,4575,7,1464643720,1464643754,3,5,34
36330825967@N01,4575,1,1464641014,1464641014,1,5,0
36330825967@N01,4575,28,1464643110,1464643110,1,5,0
36330825967@N01,4575,18,1464658722,1464658722,1,5,0
36330825967@N01,4575,30,1464658774,1464658774,1,5,0
36330825967@N01,4576,3,1464772992,1464772992,1,3,0
36330825967@N01,4576,18,1464779882,1464779886,3,3,4
36330825967@N01,4576,11,1464770317,1464770317,1,3,0
36330825967@N01,4577,12,1464820010,1464826149,2,1,6139
36330825967@N01,4578,20,1464915817,1464915817,1,3,0
36330825967@N01,4578,1,1464913547,1464913547,1,3,0
36330825967@N01,4578,28,1464940700,1464940700,1,3,0
36330825967@N01,4579,26,1465003559,1465003640,2,3,81
36330825967@N01,4579,23,1465002334,1465002334,1,3,0
36330825967@N01,4579,6,1464991149,1464991149,1,3,0
36342378@N02,4580,27,1392770463,1392770463,1,1,0
36399194@N03,4581,19,1416105173,1416105173,1,1,0
36423739@N02,4582,15,1353387671,1353387671,1,3,0
36423739@N02,4582,16,1353387667,1353387667,1,3,0
36423739@N02,4582,18,1353390530,1353390530,1,3,0
36454787@N08,4583,28,1245303200,1245319000,75,1,15800
36454787@N08,4584,27,1245415636,1245417585,69,1,1949
36454787@N08,4585,28,1245547068,1245558827,85,1,11759
36459656@N00,4586,26,1285925678,1285934420,5,1,8742
36459656@N00,4587,25,1292327130,1292327130,1,3,0
36459656@N00,4587,26,1292323584,1292335279,2,3,11695
36459656@N00,4587,28,1292322880,1292322939,3,3,59
36470826@N06,4588,19,1351330721,1351330721,1,1,0
36470826@N06,4589,20,1362810731,1362810731,1,3,0
36470826@N06,4589,26,1362802526,1362802526,1,3,0
36470826@N06,4589,17,1362799288,1362799288,1,3,0
36492333@N02,4590,28,1217904254,1217917703,2,1,13449
36507580@N06,4591,26,1300686843,1300686843,1,1,0
36521978714@N01,4592,31,1437881844,1437881844,1,2,0
36521978714@N01,4592,14,1437881989,1437881989,1,2,0
36559368@N07,4593,26,1285912326,1285912436,2,6,110
36559368@N07,4593,21,1285892048,1285892048,1,6,0
36559368@N07,4593,25,1285892174,1285892419,3,6,245
36559368@N07,4593,24,1285908071,1285908286,2,6,215
36559368@N07,4593,3,1285888217,1285888385,2,6,168
36559368@N07,4593,29,1285894313,1285894313,1,6,0
36559368@N07,4594,3,1286027710,1286027710,1,1,0
36594324@N02,4595,9,1386636259,1386636271,2,1,12
36604767@N00,4596,14,1220087859,1220087859,1,1,0
36618387@N06,4597,1,1458264163,1458265608,4,1,1445
36618387@N06,4598,30,1458374396,1458374396,1,1,0
36669200@N05,4599,1,1394951162,1394951162,1,1,0
36671802@N04,4600,26,1468629125,1468629342,3,1,217
36671802@N04,4601,26,1468680008,1468684637,15,1,4629
36671802@N04,4602,26,1468890193,1468899681,6,1,9488
36671802@N04,4603,26,1468939052,1468939836,8,1,784
36675721@N03,4604,10,1269999692,1270031827,33,1,32135
36675721@N03,4605,10,1270087801,1270099772,8,1,11971
36675721@N03,4606,10,1270163187,1270192208,10,1,29021
36679351@N00,4607,18,1207965486,1208000533,80,1,35047
36679351@N00,4608,18,1212976212,1213014690,52,1,38478
36679351@N00,4609,18,1213059088,1213059088,1,1,0
36679351@N00,4610,18,1213267358,1213267358,1,1,0
36679351@N00,4611,18,1213389772,1213446859,70,1,57087
36679351@N00,4612,18,1213490789,1213514001,11,1,23212
36679351@N00,4613,18,1222994629,1223037212,175,1,42583
36679351@N00,4614,18,1231283419,1231293372,22,1,9953
36783109@N04,4615,28,1358729205,1358729205,1,1,0
36823514@N08,4616,17,1343817745,1343817745,1,1,0
36823514@N08,4617,28,1343880220,1343880220,1,1,0
36846553@N03,4618,30,1255166879,1255166879,1,1,0
36870866@N04,4619,3,1269510573,1269510637,3,2,64
36870866@N04,4619,28,1269511791,1269512915,8,2,1124
36909370@N06,4620,28,1297419459,1297419459,1,1,0
36909370@N06,4621,28,1309312857,1309312857,1,1,0
36909370@N06,4622,20,1317191660,1317191660,1,2,0
36909370@N06,4622,13,1317189087,1317189087,1,2,0
36909370@N06,4623,26,1321248519,1321255219,3,1,6700
36909370@N06,4624,16,1350197847,1350197847,1,1,0
36911028@N00,4625,21,1338348035,1338348035,1,3,0
36911028@N00,4625,16,1338335672,1338335672,1,3,0
36911028@N00,4625,29,1338343833,1338343833,1,3,0
36911028@N00,4626,29,1338380679,1338380679,1,1,0
36911028@N00,4627,26,1341818203,1341818203,1,1,0
36911028@N00,4628,30,1341886570,1341886570,1,1,0
36911028@N00,4629,25,1416304548,1416304548,1,2,0
36911028@N00,4629,30,1416296736,1416296736,1,2,0
36911028@N00,4630,19,1416456084,1416456084,1,3,0
36911028@N00,4630,18,1416469136,1416469136,1,3,0
36911028@N00,4630,20,1416469011,1416469011,1,3,0
36911028@N00,4631,13,1442049999,1442049999,1,2,0
36911028@N00,4631,27,1442023034,1442023034,1,2,0
36911028@N00,4632,29,1442150891,1442150891,1,1,0
36942952@N00,4633,25,1200736812,1200736812,1,1,0
36942952@N00,4634,15,1201254426,1201254426,1,1,0
36942952@N00,4635,15,1203061602,1203061602,1,1,0
36942952@N00,4636,31,1206952689,1206952689,1,1,0
36942952@N00,4637,1,1211376368,1211376368,1,2,0
36942952@N00,4637,24,1211381721,1211381721,1,2,0
36942952@N00,4638,18,1211448127,1211448127,1,7,0
36942952@N00,4638,21,1211444514,1211444514,1,7,0
36942952@N00,4638,25,1211444295,1211444295,1,7,0
36942952@N00,4638,22,1211443826,1211443826,1,7,0
36942952@N00,4638,28,1211444751,1211448390,2,7,3639
36942952@N00,4638,1,1211444980,1211445144,2,7,164
36942952@N00,4638,29,1211444158,1211444158,1,7,0
36942952@N00,4639,1,1212038129,1212038129,1,1,0
36942952@N00,4640,28,1214443261,1214443568,3,1,307
36942952@N00,4641,24,1216977999,1216977999,1,3,0
36942952@N00,4641,23,1216980836,1216980939,2,3,103
36942952@N00,4641,26,1216978604,1216978714,2,3,110
36942952@N00,4642,15,1221362874,1221363071,2,1,197
36942952@N00,4643,18,1221569515,1221569590,2,1,75
36942952@N00,4644,28,1221906928,1221906928,1,6,0
36942952@N00,4644,16,1221907529,1221907635,2,6,106
36942952@N00,4644,24,1221906013,1221908048,2,6,2035
36942952@N00,4644,15,1221907725,1221907888,2,6,163
36942952@N00,4644,17,1221911690,1221911989,5,6,299
36942952@N00,4644,26,1221906096,1221907387,4,6,1291
36942952@N00,4645,31,1223634932,1223634932,1,2,0
36942952@N00,4645,30,1223634478,1223634510,2,2,32
36942952@N00,4646,1,1225519515,1225519515,1,5,0
36942952@N00,4646,3,1225520396,1225520984,2,5,588
36942952@N00,4646,30,1225521084,1225521903,6,5,819
36942952@N00,4646,21,1225520109,1225521280,2,5,1171
36942952@N00,4646,20,1225519225,1225523055,3,5,3830
36942952@N00,4647,1,1226208902,1226215217,4,7,6315
36942952@N00,4647,28,1226214070,1226214070,1,7,0
36942952@N00,4647,16,1226214376,1226214695,2,7,319
36942952@N00,4647,31,1226213682,1226213682,1,7,0
36942952@N00,4647,15,1226213937,1226213937,1,7,0
36942952@N00,4647,29,1226212734,1226215254,2,7,2520
36942952@N00,4647,30,1226212461,1226212461,1,7,0
36942952@N00,4648,25,1235987994,1235989786,5,3,1792
36942952@N00,4648,21,1235988381,1235988381,1,3,0
36942952@N00,4648,26,1235990013,1235990013,1,3,0
36942952@N00,4649,12,1236940762,1236940762,1,3,0
36942952@N00,4649,30,1236940459,1236940562,3,3,103
36942952@N00,4649,26,1236940416,1236940416,1,3,0
36942952@N00,4650,22,1242129085,1242129085,1,3,0
36942952@N00,4650,30,1242121064,1242132906,6,3,11842
36942952@N00,4650,23,1242128440,1242128440,1,3,0
36942952@N00,4651,28,1244814143,1244814143,1,1,0
36942952@N00,4652,29,1246155794,1246159193,2,3,3399
36942952@N00,4652,26,1246144575,1246144575,1,3,0
36942952@N00,4652,23,1246178912,1246178912,1,3,0
36942952@N00,4653,5,1246264242,1246267451,3,6,3209
36942952@N00,4653,18,1246268074,1246268074,1,6,0
36942952@N00,4653,22,1246268548,1246268548,1,6,0
36942952@N00,4653,26,1246263921,1246264088,2,6,167
36942952@N00,4653,3,1246267536,1246267536,1,6,0
36942952@N00,4653,23,1246269241,1246273158,7,6,3917
36942952@N00,4654,29,1246355081,1246364232,4,4,9151
36942952@N00,4654,18,1246354828,1246364474,4,4,9646
36942952@N00,4654,23,1246354673,1246361248,2,4,6575
36942952@N00,4654,19,1246355342,1246361071,2,4,5729
36942952@N00,4655,22,1251954938,1251954938,1,3,0
36942952@N00,4655,21,1251964312,1251964312,1,3,0
36942952@N00,4655,17,1251961848,1251962428,2,3,580
36942952@N00,4656,29,1252739783,1252741189,2,3,1406
36942952@N00,4656,1,1252739082,1252739082,1,3,0
36942952@N00,4656,23,1252753690,1252753690,1,3,0
36942952@N00,4657,1,1255232439,1255233860,4,2,1421
36942952@N00,4657,26,1255235230,1255235248,2,2,18
36942952@N00,4658,30,1256722122,1256722122,1,1,0
36942952@N00,4659,17,1256807353,1256807357,3,2,4
36942952@N00,4659,20,1256807358,1256807358,1,2,0
36942952@N00,4660,12,1257057458,1257057480,2,4,22
36942952@N00,4660,27,1257057470,1257057470,1,4,0
36942952@N00,4660,19,1257057452,1257057452,1,4,0
36942952@N00,4660,24,1257057460,1257057460,1,4,0
36942952@N00,4661,23,1259125269,1259152548,2,2,27279
36942952@N00,4661,28,1259152475,1259152560,3,2,85
36942952@N00,4662,29,1259317210,1259317210,1,1,0
36942952@N00,4663,25,1259487511,1259487536,2,1,25
36942952@N00,4664,20,1269398032,1269400158,2,12,2126
36942952@N00,4664,29,1269385978,1269400214,5,12,14236
36942952@N00,4664,23,1269385280,1269402804,7,12,17524
36942952@N00,4664,22,1269386517,1269398771,5,12,12254
36942952@N00,4664,16,1269392699,1269392699,1,12,0
36942952@N00,4664,28,1269390775,1269392545,3,12,1770
36942952@N00,4664,17,1269393222,1269399526,3,12,6304
36942952@N00,4664,19,1269389939,1269389939,1,12,0
36942952@N00,4664,24,1269395928,1269395928,1,12,0
36942952@N00,4664,30,1269389786,1269389786,1,12,0
36942952@N00,4664,1,1269390893,1269404118,4,12,13225
36942952@N00,4664,12,1269396134,1269396134,1,12,0
36942952@N00,4665,20,1289603024,1289603024,1,4,0
36942952@N00,4665,29,1289603745,1289604296,5,4,551
36942952@N00,4665,28,1289604843,1289605068,2,4,225
36942952@N00,4665,1,1289598641,1289606968,6,4,8327
36942952@N00,4666,29,1298259078,1298259078,1,5,0
36942952@N00,4666,18,1298258491,1298258493,2,5,2
36942952@N00,4666,28,1298254196,1298254957,2,5,761
36942952@N00,4666,30,1298258211,1298261117,2,5,2906
36942952@N00,4666,1,1298254621,1298254621,1,5,0
36942952@N00,4667,20,1301371208,1301371210,2,10,2
36942952@N00,4667,29,1301381454,1301383661,4,10,2207
36942952@N00,4667,31,1301364999,1301364999,1,10,0
36942952@N00,4667,23,1301369916,1301369916,1,10,0
36942952@N00,4667,28,1301360918,1301381168,4,10,20250
36942952@N00,4667,3,1301368773,1301368773,1,10,0
36942952@N00,4667,19,1301370654,1301370815,2,10,161
36942952@N00,4667,26,1301365574,1301368279,7,10,2705
36942952@N00,4667,1,1301388884,1301388884,1,10,0
36942952@N00,4667,15,1301366272,1301368016,7,10,1744
36942952@N00,4668,20,1306116964,1306116964,1,2,0
36942952@N00,4668,27,1306132986,1306134768,27,2,1782
36942952@N00,4669,20,1328377971,1328390760,6,13,12789
36942952@N00,4669,23,1328379686,1328389277,21,13,9591
36942952@N00,4669,17,1328384342,1328391691,3,13,7349
36942952@N00,4669,27,1328385786,1328385786,1,13,0
36942952@N00,4669,28,1328389656,1328390158,3,13,502
36942952@N00,4669,29,1328380715,1328381611,4,13,896
36942952@N00,4669,24,1328385207,1328385216,2,13,9
36942952@N00,4669,30,1328386315,1328386315,1,13,0
36942952@N00,4669,26,1328372576,1328386369,6,13,13793
36942952@N00,4669,1,1328391731,1328392220,6,13,489
36942952@N00,4669,7,1328372319,1328372319,1,13,0
36942952@N00,4669,12,1328382869,1328382869,1,13,0
36942952@N00,4669,15,1328384499,1328391583,4,13,7084
36942952@N00,4670,16,1329306159,1329306159,1,1,0
36942952@N00,4671,14,1398583765,1398583765,1,4,0
36942952@N00,4671,29,1398586390,1398589498,2,4,3108
36942952@N00,4671,23,1398578929,1398579085,2,4,156
36942952@N00,4671,31,1398585212,1398585225,2,4,13
36942952@N00,4672,28,1409303762,1409304671,2,4,909
36942952@N00,4672,26,1409308195,1409308289,4,4,94
36942952@N00,4672,29,1409305835,1409305835,1,4,0
36942952@N00,4672,18,1409307957,1409307986,2,4,29
36942952@N00,4673,29,1413454037,1413454037,1,1,0
36942952@N00,4674,30,1419233984,1419233984,1,4,0
36942952@N00,4674,28,1419233062,1419234944,8,4,1882
36942952@N00,4674,19,1419234113,1419234113,1,4,0
36942952@N00,4674,26,1419233673,1419233803,2,4,130
36942952@N00,4675,28,1420264032,1420270864,4,7,6832
36942952@N00,4675,19,1420266531,1420269572,5,7,3041
36942952@N00,4675,26,1420270312,1420270312,1,7,0
36942952@N00,4675,29,1420267935,1420269479,2,7,1544
36942952@N00,4675,23,1420264263,1420268678,24,7,4415
36942952@N00,4675,31,1420268053,1420268053,1,7,0
36942952@N00,4675,22,1420268221,1420268221,1,7,0
36942952@N00,4676,1,1429759479,1429759715,2,4,236
36942952@N00,4676,16,1429763041,1429763041,1,4,0
36942952@N00,4676,27,1429760546,1429769657,4,4,9111
36942952@N00,4676,17,1429760871,1429762866,12,4,1995
36987405@N02,4677,27,1340941394,1340941394,1,2,0
36987405@N02,4677,17,1340939591,1340939591,1,2,0
36987405@N02,4678,25,1340973130,1340973130,1,2,0
36987405@N02,4678,21,1340971880,1340971880,1,2,0
36987405@N02,4679,27,1341317429,1341317429,1,2,0
36987405@N02,4679,26,1341317649,1341317649,1,2,0
37032567@N05,4680,28,1329087224,1329087224,1,4,0
37032567@N05,4680,13,1329099024,1329099024,1,4,0
37032567@N05,4680,18,1329107309,1329107309,1,4,0
37032567@N05,4680,3,1329089395,1329089395,1,4,0
37047749@N04,4681,1,1355821263,1355821263,1,1,0
37114630@N05,4682,1,1379720572,1379720572,1,1,0
37158363@N08,4683,3,1379170366,1379170366,1,1,0
37167805@N00,4684,17,1219561668,1219561668,1,1,0
37168969@N00,4685,28,1357038723,1357038723,1,1,0
37216856@N00,4686,15,1374637543,1374637543,1,1,0
37225678@N06,4687,3,1277914908,1277914908,1,1,0
37225678@N06,4688,7,1277960305,1277960305,1,1,0
37227722@N02,4689,4,1400214602,1400233071,2,1,18469
37236988@N03,4690,26,1330486129,1330489657,2,1,3528
37258140@N04,4691,28,1354745433,1354745433,1,1,0
37258140@N04,4692,20,1354852596,1354852596,1,3,0
37258140@N04,4692,28,1354834121,1354889470,3,3,55349
37258140@N04,4692,12,1354845110,1354845110,1,3,0
37258140@N04,4693,13,1354976663,1354976663,1,1,0
37319092@N00,4694,29,1270969690,1270970149,2,1,459
37344578@N02,4695,26,1263608764,1263609571,5,2,807
37344578@N02,4695,25,1263614896,1263614896,1,2,0
37344578@N02,4696,23,1263683783,1263683783,1,2,0
37344578@N02,4696,28,1263684306,1263684306,1,2,0
37363832@N03,4697,29,1323569952,1323569952,1,1,0
37363832@N03,4698,25,1323943832,1323943832,1,4,0
37363832@N03,4698,28,1323916224,1323916224,1,4,0
37363832@N03,4698,7,1323944033,1323944033,1,4,0
37363832@N03,4698,26,1323943973,1323943973,1,4,0
37363832@N03,4699,3,1327818079,1327818079,1,2,0
37363832@N03,4699,31,1327808878,1327808878,1,2,0
37363832@N03,4700,24,1345962000,1345962000,1,2,0
37363832@N03,4700,16,1345950840,1345950840,1,2,0
37363832@N03,4701,27,1346817869,1346817869,1,2,0
37363832@N03,4701,28,1346816747,1346816747,1,2,0
37363832@N03,4702,20,1348993893,1348993893,1,2,0
37363832@N03,4702,28,1348993460,1348993460,1,2,0
37363832@N03,4703,28,1353228718,1353228718,1,1,0
37363832@N03,4704,22,1354420255,1354420255,1,1,0
37363832@N03,4705,26,1354705596,1354705596,1,1,0
37363832@N03,4706,20,1355120300,1355120300,1,5,0
37363832@N03,4706,18,1355103175,1355107293,2,5,4118
37363832@N03,4706,25,1355120930,1355120930,1,5,0
37363832@N03,4706,13,1355120769,1355120769,1,5,0
37363832@N03,4706,28,1355103276,1355103276,1,5,0
37363832@N03,4707,13,1370164774,1370164774,1,1,0
37363832@N03,4708,9,1370334467,1370334467,1,1,0
37363832@N03,4709,28,1370772747,1370772747,1,1,0
37363832@N03,4710,14,1370831986,1370831986,1,1,0
37363832@N03,4711,18,1372334966,1372334966,1,1,0
37363832@N03,4712,1,1377512407,1377512407,1,1,0
37363832@N03,4713,28,1379570180,1379570180,1,1,0
37363832@N03,4714,1,1379838298,1379838298,1,1,0
37363832@N03,4715,1,1384932379,1384932379,1,1,0
37363832@N03,4716,1,1386544216,1386544216,1,1,0
37363832@N03,4717,1,1386760774,1386760774,1,1,0
37364998@N05,4718,14,1376565433,1376565433,1,1,0
37364998@N05,4719,7,1376600710,1376600710,1,1,0
37364998@N05,4720,26,1376777056,1376777056,1,1,0
37364998@N05,4721,27,1377426198,1377426198,1,1,0
37364998@N05,4722,1,1377826753,1377826753,1,1,0
37364998@N05,4723,1,1378517590,1378517590,1,1,0
37364998@N05,4724,17,1378778055,1378778055,1,1,0
37366843@N07,4725,30,1325828181,1325828181,1,1,0
37369621@N00,4726,28,1332980629,1332980629,1,2,0
37369621@N00,4726,26,1332984182,1332984182,1,2,0
37369621@N00,4727,1,1334935997,1334935997,1,1,0
37376032@N00,4728,19,1417931661,1417931661,1,1,0
37376032@N00,4729,26,1418019697,1418020081,2,3,384
37376032@N00,4729,29,1418017217,1418017217,1,3,0
37376032@N00,4729,19,1417991451,1418036372,4,3,44921
37376032@N00,4730,28,1418123316,1418123316,1,1,0
37376032@N00,4731,19,1418208974,1418208974,1,1,0
37376032@N00,4732,19,1418250498,1418293653,3,2,43155
37376032@N00,4732,28,1418297782,1418297782,1,2,0
37382345@N08,4733,27,1345381888,1345381888,1,8,0
37382345@N08,4733,20,1345374178,1345374178,1,8,0
37382345@N08,4733,16,1345371043,1345371170,2,8,127
37382345@N08,4733,17,1345377707,1345377707,1,8,0
37382345@N08,4733,14,1345375158,1345375158,1,8,0
37382345@N08,4733,22,1345374585,1345374585,1,8,0
37382345@N08,4733,1,1345370437,1345385483,2,8,15046
37382345@N08,4733,26,1345370835,1345370835,1,8,0
37382345@N08,4734,10,1347180821,1347180821,1,1,0
37382345@N08,4735,23,1358146739,1358147103,8,4,364
37382345@N08,4735,16,1358148797,1358148890,2,4,93
37382345@N08,4735,30,1358149802,1358157858,25,4,8056
37382345@N08,4735,26,1358148992,1358149018,2,4,26
37382345@N08,4736,15,1360645027,1360645486,2,4,459
37382345@N08,4736,28,1360636545,1360650518,6,4,13973
37382345@N08,4736,30,1360634300,1360634300,1,4,0
37382345@N08,4736,1,1360642349,1360642432,2,4,83
37382345@N08,4737,24,1361096685,1361096685,1,2,0
37382345@N08,4737,15,1361101352,1361103289,22,2,1937
37382345@N08,4738,12,1365313212,1365313212,1,5,0
37382345@N08,4738,5,1365314841,1365314841,1,5,0
37382345@N08,4738,28,1365329725,1365329725,1,5,0
37382345@N08,4738,1,1365311377,1365330201,2,5,18824
37382345@N08,4738,27,1365313055,1365313055,1,5,0
37382345@N08,4739,24,1366459041,1366459041,1,9,0
37382345@N08,4739,16,1366451044,1366463041,6,9,11997
37382345@N08,4739,28,1366440104,1366440149,2,9,45
37382345@N08,4739,17,1366441689,1366441689,1,9,0
37382345@N08,4739,15,1366442105,1366460319,5,9,18214
37382345@N08,4739,19,1366447699,1366447699,1,9,0
37382345@N08,4739,1,1366440034,1366440034,1,9,0
37382345@N08,4739,27,1366440474,1366462599,2,9,22125
37382345@N08,4739,26,1366451356,1366463528,4,9,12172
37382345@N08,4740,30,1368837649,1368837649,1,14,0
37382345@N08,4740,28,1368861438,1368861438,1,14,0
37382345@N08,4740,26,1368836798,1368883161,9,14,46363
37382345@N08,4740,3,1368835340,1368835340,1,14,0
37382345@N08,4740,27,1368832807,1368832807,1,14,0
37382345@N08,4740,15,1368836243,1368877897,8,14,41654
37382345@N08,4740,29,1368839480,1368839480,1,14,0
37382345@N08,4740,12,1368835727,1368869612,5,14,33885
37382345@N08,4740,1,1368857055,1368857055,1,14,0
37382345@N08,4740,17,1368868104,1368868104,1,14,0
37382345@N08,4740,22,1368838653,1368838653,1,14,0
37382345@N08,4740,24,1368834041,1368867649,6,14,33608
37382345@N08,4740,16,1368842257,1368881402,4,14,39145
37382345@N08,4740,20,1368839617,1368839617,1,14,0
37382345@N08,4741,28,1370321068,1370343853,3,4,22785
37382345@N08,4741,3,1370323831,1370323831,1,4,0
37382345@N08,4741,21,1370325894,1370327047,6,4,1153
37382345@N08,4741,13,1370324206,1370324712,2,4,506
37382345@N08,4742,3,1371292555,1371292555,1,5,0
37382345@N08,4742,21,1371292348,1371292348,1,5,0
37382345@N08,4742,27,1371289376,1371289376,1,5,0
37382345@N08,4742,6,1371292731,1371292822,2,5,91
37382345@N08,4742,26,1371293178,1371293354,2,5,176
37382345@N08,4743,28,1371951588,1371959683,3,3,8095
37382345@N08,4743,1,1371963436,1371963436,1,3,0
37382345@N08,4743,23,1371952076,1371954939,8,3,2863
37382345@N08,4744,28,1372652361,1372652361,1,7,0
37382345@N08,4744,21,1372655830,1372655830,1,7,0
37382345@N08,4744,29,1372655061,1372655061,1,7,0
37382345@N08,4744,1,1372651974,1372659007,3,7,7033
37382345@N08,4744,22,1372654321,1372654738,2,7,417
37382345@N08,4744,23,1372667081,1372667081,1,7,0
37382345@N08,4744,13,1372657048,1372657048,1,7,0
37382345@N08,4745,30,1372738558,1372738558,1,8,0
37382345@N08,4745,15,1372763341,1372763341,1,8,0
37382345@N08,4745,6,1372746798,1372746798,1,8,0
37382345@N08,4745,18,1372735642,1372735642,1,8,0
37382345@N08,4745,1,1372748608,1372751032,2,8,2424
37382345@N08,4745,29,1372737116,1372738320,3,8,1204
37382345@N08,4745,17,1372762078,1372762163,2,8,85
37382345@N08,4745,16,1372748175,1372748175,1,8,0
37382345@N08,4746,30,1373343980,1373344231,2,8,251
37382345@N08,4746,28,1373341529,1373341709,2,8,180
37382345@N08,4746,26,1373351140,1373352040,11,8,900
37382345@N08,4746,3,1373342127,1373342885,2,8,758
37382345@N08,4746,18,1373347392,1373347432,2,8,40
37382345@N08,4746,12,1373341845,1373341999,3,8,154
37382345@N08,4746,1,1373340412,1373360390,5,8,19978
37382345@N08,4746,16,1373341795,1373352300,2,8,10505
37382345@N08,4747,29,1373720561,1373720576,2,4,15
37382345@N08,4747,11,1373716120,1373716402,5,4,282
37382345@N08,4747,31,1373720431,1373720441,2,4,10
37382345@N08,4747,20,1373721331,1373721331,1,4,0
37382345@N08,4748,28,1374407697,1374407697,1,2,0
37382345@N08,4748,15,1374408824,1374410664,12,2,1840
37382345@N08,4749,26,1375964987,1375964987,1,3,0
37382345@N08,4749,18,1375966081,1375966081,1,3,0
37382345@N08,4749,1,1375970123,1375970146,2,3,23
37382345@N08,4750,16,1378633940,1378634244,2,4,304
37382345@N08,4750,26,1378633191,1378633191,1,4,0
37382345@N08,4750,29,1378639691,1378640686,4,4,995
37382345@N08,4750,18,1378638534,1378638534,1,4,0
37382345@N08,4751,20,1382874587,1382874587,1,1,0
37382345@N08,4752,26,1387889045,1387890497,3,1,1452
37382345@N08,4753,1,1388901069,1388901069,1,3,0
37382345@N08,4753,21,1388921135,1388921135,1,3,0
37382345@N08,4753,13,1388923287,1388923287,1,3,0
37382345@N08,4754,16,1391835480,1391835527,2,2,47
37382345@N08,4754,26,1391835713,1391835776,2,2,63
37382345@N08,4755,28,1393027085,1393027085,1,2,0
37382345@N08,4755,1,1393019128,1393027215,7,2,8087
37382345@N08,4756,28,1393136600,1393136619,3,3,19
37382345@N08,4756,1,1393134808,1393143215,43,3,8407
37382345@N08,4756,22,1393137590,1393137971,2,3,381
37382345@N08,4757,26,1395568574,1395568574,2,1,0
37382345@N08,4758,16,1395629503,1395629503,1,2,0
37382345@N08,4758,21,1395630800,1395630800,1,2,0
37382345@N08,4759,6,1398070743,1398070743,1,10,0
37382345@N08,4759,11,1398067929,1398067929,1,10,0
37382345@N08,4759,7,1398068690,1398069134,4,10,444
37382345@N08,4759,30,1398059915,1398065895,6,10,5980
37382345@N08,4759,3,1398070502,1398070502,1,10,0
37382345@N08,4759,5,1398069252,1398070054,4,10,802
37382345@N08,4759,20,1398053942,1398056698,4,10,2756
37382345@N08,4759,26,1398061864,1398062056,2,10,192
37382345@N08,4759,1,1398044767,1398044932,2,10,165
37382345@N08,4759,15,1398046708,1398046708,1,10,0
37382345@N08,4760,8,1401087349,1401087349,1,5,0
37382345@N08,4760,20,1401089265,1401089265,1,5,0
37382345@N08,4760,16,1401087043,1401087043,1,5,0
37382345@N08,4760,28,1401084330,1401085647,17,5,1317
37382345@N08,4760,26,1401087803,1401087803,1,5,0
37382345@N08,4761,20,1402890758,1402890758,1,5,0
37382345@N08,4761,28,1402872987,1402885665,5,5,12678
37382345@N08,4761,18,1402874906,1402874906,1,5,0
37382345@N08,4761,1,1402875308,1402891882,7,5,16574
37382345@N08,4761,26,1402877889,1402879086,5,5,1197
37382345@N08,4762,28,1403916922,1403916922,1,2,0
37382345@N08,4762,26,1403919072,1403919072,1,2,0
37382345@N08,4763,20,1404447116,1404447912,3,2,796
37382345@N08,4763,29,1404450342,1404450342,1,2,0
37382345@N08,4764,8,1404698464,1404698628,3,10,164
37382345@N08,4764,12,1404695494,1404695494,1,10,0
37382345@N08,4764,20,1404691795,1404691795,1,10,0
37382345@N08,4764,28,1404688595,1404699487,2,10,10892
37382345@N08,4764,23,1404689317,1404689317,1,10,0
37382345@N08,4764,16,1404696475,1404696475,1,10,0
37382345@N08,4764,18,1404689654,1404689718,2,10,64
37382345@N08,4764,1,1404688336,1404688336,1,10,0
37382345@N08,4764,26,1404689053,1404699117,2,10,10064
37382345@N08,4764,21,1404694186,1404694186,1,10,0
37382345@N08,4765,15,1404818670,1404823564,13,1,4894
37382345@N08,4766,20,1405146307,1405146888,3,2,581
37382345@N08,4766,22,1405145234,1405145283,5,2,49
37413911@N07,4767,26,1302349634,1302349634,1,1,0
37413911@N07,4768,26,1302393379,1302393379,1,1,0
37413911@N07,4769,29,1311937398,1311937398,1,1,0
37413911@N07,4770,28,1318020869,1318034732,2,1,13863
37423919@N00,4771,17,1240909165,1240909165,1,2,0
37423919@N00,4771,28,1240909859,1240909859,2,2,0
37423919@N00,4772,1,1405397957,1405397957,1,1,0
37423919@N00,4773,25,1408462043,1408462043,1,1,0
37447227@N03,4774,20,1322884086,1322884086,1,1,0
37473564@N00,4775,26,1316415618,1316415650,2,1,32
37495946@N04,4776,29,1352028949,1352028949,1,1,0
37495946@N04,4777,18,1452153632,1452153632,1,1,0
37495946@N04,4778,26,1470926182,1470926252,2,1,70
37513581@N03,4779,15,1236745377,1236745377,1,1,0
37513581@N03,4780,26,1237547138,1237547138,1,1,0
37541876@N06,4781,13,1380539148,1380539148,1,2,0
37541876@N06,4781,1,1380544946,1380544946,1,2,0
37575596@N07,4782,29,1369924983,1369925878,10,1,895
37645295@N00,4783,29,1249015250,1249015250,1,2,0
37645295@N00,4783,1,1249013666,1249013666,1,2,0
37665974@N07,4784,16,1448520541,1448520541,1,1,0
37665974@N07,4785,17,1449716980,1449716980,1,1,0
37711141@N05,4786,17,1205962884,1205962900,2,1,16
37711141@N05,4787,17,1206027662,1206027670,2,1,8
37718676626@N01,4788,16,1356661120,1356661176,14,1,56
37763182@N03,4789,19,1196305186,1196305667,2,5,481
37763182@N03,4789,16,1196310524,1196311035,3,5,511
37763182@N03,4789,27,1196311257,1196311257,1,5,0
37763182@N03,4789,13,1196308261,1196308261,1,5,0
37763182@N03,4789,26,1196318227,1196318227,2,5,0
37763182@N03,4790,1,1212221197,1212221197,1,1,0
37763182@N03,4791,30,1213233134,1213233134,1,2,0
37763182@N03,4791,26,1213235327,1213235327,1,2,0
37763182@N03,4792,22,1213623191,1213623191,1,1,0
37763182@N03,4793,16,1215674320,1215674320,1,1,0
37763182@N03,4794,22,1222384535,1222384535,1,1,0
37763182@N03,4795,30,1224213237,1224216135,2,1,2898
37763182@N03,4796,30,1228452683,1228452683,1,1,0
37763182@N03,4797,20,1235800682,1235800682,1,2,0
37763182@N03,4797,19,1235797553,1235797553,1,2,0
37763182@N03,4798,30,1239938869,1239939408,2,3,539
37763182@N03,4798,19,1239934309,1239961033,2,3,26724
37763182@N03,4798,24,1239940191,1239940556,3,3,365
37763182@N03,4799,28,1264128924,1264128924,1,1,0
37763182@N03,4800,3,1264491764,1264491764,1,3,0
37763182@N03,4800,20,1264485402,1264485402,1,3,0
37763182@N03,4800,17,1264494599,1264494599,1,3,0
37763182@N03,4801,20,1271418655,1271418655,1,3,0
37763182@N03,4801,19,1271414147,1271414147,1,3,0
37763182@N03,4801,26,1271421735,1271422031,3,3,296
37763182@N03,4802,23,1278469138,1278469138,1,2,0
37763182@N03,4802,1,1278463365,1278463572,3,2,207
37763182@N03,4803,29,1279029087,1279029087,1,1,0
37763182@N03,4804,23,1279102314,1279104303,5,1,1989
37763182@N03,4805,27,1280021339,1280021339,1,1,0
37763182@N03,4806,28,1281445047,1281445047,1,1,0
37763182@N03,4807,28,1281697666,1281697666,1,2,0
37763182@N03,4807,29,1281698782,1281698789,2,2,7
37763182@N03,4808,29,1282826069,1282826903,2,1,834
37763182@N03,4809,21,1283418943,1283419287,15,10,344
37763182@N03,4809,27,1283421731,1283421846,3,10,115
37763182@N03,4809,30,1283415681,1283415987,3,10,306
37763182@N03,4809,22,1283414681,1283414681,1,10,0
37763182@N03,4809,13,1283417608,1283418804,5,10,1196
37763182@N03,4809,31,1283416614,1283416762,2,10,148
37763182@N03,4809,16,1283413426,1283427077,10,10,13651
37763182@N03,4809,25,1283384995,1283385374,6,10,379
37763182@N03,4809,26,1283382749,1283382749,1,10,0
37763182@N03,4809,12,1283419718,1283419718,1,10,0
37763182@N03,4810,7,1283781357,1283781389,2,4,32
37763182@N03,4810,29,1283772310,1283772310,1,4,0
37763182@N03,4810,30,1283772438,1283773073,2,4,635
37763182@N03,4810,26,1283775412,1283775417,2,4,5
37763182@N03,4811,12,1284097104,1284097104,1,2,0
37763182@N03,4811,30,1284103482,1284103953,4,2,471
37763182@N03,4812,19,1284702030,1284702708,6,8,678
37763182@N03,4812,13,1284697034,1284707048,2,8,10014
37763182@N03,4812,29,1284704881,1284704945,3,8,64
37763182@N03,4812,26,1284706345,1284706345,1,8,0
37763182@N03,4812,3,1284706602,1284706664,2,8,62
37763182@N03,4812,20,1284700393,1284701398,5,8,1005
37763182@N03,4812,30,1284704773,1284704773,1,8,0
37763182@N03,4812,18,1284704417,1284704533,4,8,116
37763182@N03,4813,22,1285288935,1285288935,1,5,0
37763182@N03,4813,28,1285290948,1285291100,4,5,152
37763182@N03,4813,31,1285286578,1285289321,4,5,2743
37763182@N03,4813,29,1285289332,1285289332,1,5,0
37763182@N03,4813,20,1285286846,1285286846,1,5,0
37763182@N03,4814,19,1286423338,1286423338,1,3,0
37763182@N03,4814,26,1286431468,1286431468,1,3,0
37763182@N03,4814,30,1286428981,1286428981,1,3,0
37763182@N03,4815,17,1287049172,1287049222,2,10,50
37763182@N03,4815,22,1287016150,1287016150,1,10,0
37763182@N03,4815,19,1287011219,1287011219,1,10,0
37763182@N03,4815,26,1287017747,1287018307,5,10,560
37763182@N03,4815,27,1287048718,1287048718,1,10,0
37763182@N03,4815,30,1287016706,1287016706,1,10,0
37763182@N03,4815,14,1287015586,1287015706,2,10,120
37763182@N03,4815,28,1287009690,1287009690,1,10,0
37763182@N03,4815,18,1287013530,1287013562,2,10,32
37763182@N03,4815,20,1287038891,1287038960,2,10,69
37763182@N03,4816,29,1287820175,1287820192,2,3,17
37763182@N03,4816,28,1287823146,1287823146,1,3,0
37763182@N03,4816,20,1287809628,1287809628,1,3,0
37763182@N03,4817,26,1289021194,1289021274,2,1,80
37763182@N03,4818,22,1289196062,1289196062,1,2,0
37763182@N03,4818,20,1289193697,1289201060,5,2,7363
37763182@N03,4819,21,1289460831,1289460831,1,3,0
37763182@N03,4819,28,1289457644,1289457644,1,3,0
37763182@N03,4819,16,1289452797,1289453681,14,3,884
37763182@N03,4820,24,1290773872,1290774414,14,1,542
37763182@N03,4821,26,1291346561,1291346561,1,1,0
37763182@N03,4822,26,1291703878,1291705372,20,1,1494
37763182@N03,4823,21,1292136707,1292138021,16,1,1314
37763182@N03,4824,25,1292246586,1292247453,9,1,867
37763182@N03,4825,7,1293021779,1293021779,1,4,0
37763182@N03,4825,28,1293018072,1293018072,1,4,0
37763182@N03,4825,17,1293021033,1293021033,1,4,0
37763182@N03,4825,23,1293023685,1293023685,1,4,0
37763182@N03,4826,27,1295764812,1295764812,1,4,0
37763182@N03,4826,13,1295769738,1295769738,1,4,0
37763182@N03,4826,26,1295762658,1295762658,1,4,0
37763182@N03,4826,17,1295765191,1295765191,1,4,0
37763182@N03,4827,13,1296005520,1296005520,1,1,0
37763182@N03,4828,16,1302615172,1302615172,1,5,0
37763182@N03,4828,29,1302608149,1302609247,5,5,1098
37763182@N03,4828,1,1302607220,1302607220,1,5,0
37763182@N03,4828,28,1302616886,1302616886,1,5,0
37763182@N03,4828,20,1302611840,1302611840,1,5,0
37763182@N03,4829,29,1305537206,1305537206,1,1,0
37763182@N03,4830,3,1308729934,1308729934,1,2,0
37763182@N03,4830,24,1308730984,1308730984,1,2,0
37763182@N03,4831,15,1316747822,1316747822,1,1,0
37763182@N03,4832,28,1317199156,1317199156,1,3,0
37763182@N03,4832,20,1317200788,1317200788,1,3,0
37763182@N03,4832,1,1317198649,1317199199,5,3,550
37763182@N03,4833,23,1327041330,1327042034,2,1,704
37763182@N03,4834,29,1328266249,1328266249,1,1,0
37763182@N03,4835,12,1330239728,1330239728,1,1,0
37763182@N03,4836,17,1330682710,1330682710,1,1,0
37763182@N03,4837,16,1331191063,1331191063,1,1,0
37763646@N06,4838,16,1409009460,1409009460,1,1,0
37763949@N00,4839,4,1329494603,1329494603,1,1,0
37763949@N00,4840,26,1355712688,1355712688,1,2,0
37763949@N00,4840,25,1355713080,1355713080,1,2,0
37836851@N08,4841,28,1341919604,1341919604,1,1,0
37869753@N06,4842,20,1301540524,1301540524,1,4,0
37869753@N06,4842,28,1301551845,1301551845,1,4,0
37869753@N06,4842,22,1301538739,1301538739,1,4,0
37869753@N06,4842,14,1301539058,1301539058,1,4,0
37869753@N06,4843,7,1327210991,1327210991,1,4,0
37869753@N06,4843,20,1327207954,1327207954,1,4,0
37869753@N06,4843,28,1327203921,1327204068,2,4,147
37869753@N06,4843,26,1327210588,1327210588,1,4,0
37869753@N06,4844,8,1332636058,1332636058,1,3,0
37869753@N06,4844,22,1332633246,1332633246,1,3,0
37869753@N06,4844,14,1332633650,1332633650,1,3,0
37869753@N06,4845,21,1332727465,1332727465,1,3,0
37869753@N06,4845,26,1332727659,1332727922,2,3,263
37869753@N06,4845,13,1332721581,1332721581,1,3,0
37869753@N06,4846,21,1334891343,1334891343,1,6,0
37869753@N06,4846,1,1334881662,1334881662,1,6,0
37869753@N06,4846,28,1334882787,1334900042,6,6,17255
37869753@N06,4846,19,1334885903,1334885903,1,6,0
37869753@N06,4846,26,1334891871,1334894025,5,6,2154
37869753@N06,4846,18,1334894428,1334894717,3,6,289
37869753@N06,4847,28,1339564975,1339565991,17,4,1016
37869753@N06,4847,11,1339542275,1339542275,1,4,0
37869753@N06,4847,25,1339552959,1339552963,2,4,4
37869753@N06,4847,30,1339541777,1339541777,1,4,0
37869753@N06,4848,12,1344905091,1344905091,1,2,0
37869753@N06,4848,15,1344905076,1344905076,1,2,0
37869753@N06,4849,20,1347876228,1347880240,3,2,4012
37869753@N06,4849,28,1347883900,1347883995,3,2,95
37869753@N06,4850,25,1350011385,1350011930,2,4,545
37869753@N06,4850,1,1350007925,1350008417,2,4,492
37869753@N06,4850,28,1350021792,1350023142,2,4,1350
37869753@N06,4850,23,1350022545,1350022545,1,4,0
37869753@N06,4851,25,1352689660,1352689660,1,4,0
37869753@N06,4851,13,1352690678,1352690899,2,4,221
37869753@N06,4851,1,1352686924,1352686924,1,4,0
37869753@N06,4851,28,1352702903,1352704342,6,4,1439
37869753@N06,4852,28,1355546178,1355551784,19,1,5606
37869753@N06,4853,1,1355617232,1355617291,2,1,59
37869753@N06,4854,25,1361665508,1361666682,4,3,1174
37869753@N06,4854,26,1361667727,1361668200,3,3,473
37869753@N06,4854,1,1361663694,1361671871,5,3,8177
37869753@N06,4855,26,1365378120,1365378120,1,1,0
37869753@N06,4856,28,1374910980,1374910980,1,2,0
37869753@N06,4856,18,1374885332,1374885368,2,2,36
37869753@N06,4857,26,1375570098,1375570098,1,3,0
37869753@N06,4857,1,1375565855,1375569149,11,3,3294
37869753@N06,4857,28,1375569471,1375583668,2,3,14197
37869753@N06,4858,26,1379806106,1379810675,4,2,4569
37869753@N06,4858,28,1379815782,1379815782,1,2,0
37869753@N06,4859,1,1382238250,1382238259,2,2,9
37869753@N06,4859,20,1382241749,1382241749,1,2,0
37869753@N06,4860,19,1387421302,1387421302,1,2,0
37869753@N06,4860,11,1387423359,1387423359,1,2,0
37869753@N06,4861,26,1391653448,1391653461,2,2,13
37869753@N06,4861,23,1391677185,1391677185,1,2,0
37869753@N06,4862,26,1393549612,1393549817,5,1,205
37869753@N06,4863,28,1402636228,1402638057,6,2,1829
37869753@N06,4863,23,1402627220,1402627220,1,2,0
37869753@N06,4864,18,1408755086,1408755086,1,1,0
37869753@N06,4865,28,1411708936,1411708936,1,2,0
37869753@N06,4865,18,1411708302,1411708305,2,2,3
37869753@N06,4866,3,1412674974,1412674974,1,1,0
37869753@N06,4867,1,1416025941,1416026376,7,1,435
37869753@N06,4868,1,1425168488,1425168488,1,2,0
37869753@N06,4868,26,1425164666,1425165115,3,2,449
37869753@N06,4869,1,1436412026,1436414904,4,1,2878
37869753@N06,4870,26,1441023789,1441024626,8,1,837
37869753@N06,4871,28,1441945343,1441945343,1,1,0
37869753@N06,4872,23,1442703929,1442703929,1,3,0
37869753@N06,4872,22,1442704226,1442707141,4,3,2915
37869753@N06,4872,28,1442702685,1442702685,1,3,0
37869753@N06,4873,26,1446111850,1446112218,2,2,368
37869753@N06,4873,20,1446104506,1446108821,5,2,4315
37869753@N06,4874,16,1451981022,1451981022,1,2,0
37869753@N06,4874,26,1451973934,1451974289,3,2,355
37869753@N06,4875,1,1453527387,1453528165,4,1,778
37893053@N02,4876,17,1429426346,1429426350,2,2,4
37893053@N02,4876,29,1429412137,1429412139,4,2,2
37908430@N02,4877,18,1434238068,1434238068,1,4,0
37908430@N02,4877,22,1434236037,1434236037,1,4,0
37908430@N02,4877,28,1434237350,1434237350,1,4,0
37908430@N02,4877,1,1434236128,1434237333,4,4,1205
37908430@N02,4878,26,1434281660,1434282689,5,1,1029
37912374286@N01,4879,28,1244103246,1244103246,1,3,0
37912374286@N01,4879,29,1244101684,1244101684,1,3,0
37912374286@N01,4879,16,1244095218,1244095218,1,3,0
37912374286@N01,4880,12,1266705073,1266705073,1,4,0
37912374286@N01,4880,16,1266709842,1266709842,1,4,0
37912374286@N01,4880,21,1266705794,1266705794,1,4,0
37912374286@N01,4880,29,1266721120,1266721120,1,4,0
37912374286@N01,4881,20,1291346105,1291346105,1,1,0
37912374286@N01,4882,23,1431768012,1431768564,2,3,552
37912374286@N01,4882,16,1431769757,1431769757,1,3,0
37912374286@N01,4882,18,1431762099,1431762099,1,3,0
37912374286@N01,4883,20,1462585638,1462585638,1,2,0
37912374286@N01,4883,28,1462593112,1462593562,2,2,450
37913092@N00,4884,1,1382407717,1382429664,2,2,21947
37913092@N00,4884,30,1382412364,1382412364,1,2,0
37961843@N00,4885,19,1415425361,1415425361,1,1,0
37983522@N02,4886,24,1260143120,1260143120,1,1,0
37994498834@N01,4887,23,1417921760,1417921760,1,4,0
37994498834@N01,4887,15,1417945062,1417945062,1,4,0
37994498834@N01,4887,19,1417919829,1417926204,2,4,6375
37994498834@N01,4887,1,1417919967,1417919967,1,4,0
37996583849@N01,4888,28,1342443558,1342443558,1,1,0
37996583849@N01,4889,26,1357296824,1357296824,1,1,0
37996583849@N01,4890,3,1368188493,1368188493,1,1,0
37996583849@N01,4891,1,1370514379,1370514379,1,1,0
37996583849@N01,4892,1,1371122681,1371122681,1,1,0
37996583849@N01,4893,1,1372153961,1372153961,1,1,0
37996583849@N01,4894,1,1373522545,1373522545,1,1,0
37996583849@N01,4895,23,1386219599,1386219599,1,1,0
37996583849@N01,4896,27,1413189030,1413189030,1,1,0
37996615892@N01,4897,11,1290995615,1290995615,1,1,0
37996622233@N01,4898,1,1305965769,1305965769,1,4,0
37996622233@N01,4898,16,1305956192,1305956192,1,4,0
37996622233@N01,4898,26,1305956785,1305956785,1,4,0
37996622233@N01,4898,25,1305944834,1305944834,1,4,0
37996631812@N01,4899,21,1455260554,1455260561,2,2,7
37996631812@N01,4899,16,1455258193,1455259200,4,2,1007
37996631812@N01,4900,15,1455338578,1455338997,2,6,419
37996631812@N01,4900,17,1455337848,1455337854,3,6,6
37996631812@N01,4900,28,1455355097,1455357243,11,6,2146
37996631812@N01,4900,4,1455335959,1455335961,2,6,2
37996631812@N01,4900,22,1455336491,1455336492,2,6,1
37996631812@N01,4900,31,1455336057,1455336239,3,6,182
37996635091@N01,4901,25,1428017274,1428017274,1,2,0
37996635091@N01,4901,17,1428021704,1428022326,2,2,622
38067879@N08,4902,11,1336881401,1336881401,1,3,0
38067879@N08,4902,29,1336907688,1336907688,1,3,0
38067879@N08,4902,14,1336883649,1336883649,1,3,0
38067879@N08,4903,27,1337043236,1337043236,1,1,0
38067879@N08,4904,5,1337077116,1337077116,1,3,0
38067879@N08,4904,6,1337075589,1337075589,1,3,0
38067879@N08,4904,28,1337089164,1337089164,1,3,0
38067879@N08,4905,20,1338446755,1338446755,1,1,0
38067879@N08,4906,30,1339128680,1339128680,1,1,0
38067879@N08,4907,30,1354250479,1354250479,1,1,0
38067879@N08,4908,26,1354446364,1354446364,1,3,0
38067879@N08,4908,7,1354427048,1354427048,1,3,0
38067879@N08,4908,24,1354427033,1354427033,1,3,0
38067879@N08,4909,28,1354493080,1354493080,1,1,0
38067879@N08,4910,25,1354568817,1354568817,1,1,0
38067879@N08,4911,29,1354677899,1354677899,1,1,0
38067879@N08,4912,18,1382780003,1382780003,1,2,0
38067879@N08,4912,30,1382762276,1382762276,1,2,0
38067879@N08,4913,20,1382920034,1382920034,1,1,0
38067879@N08,4914,29,1397732160,1397732160,1,2,0
38067879@N08,4914,16,1397710533,1397710533,1,2,0
38067879@N08,4915,5,1397872721,1397887791,2,1,15070
38067879@N08,4916,29,1434113182,1434113182,1,1,0
38067879@N08,4917,27,1436671969,1436671969,1,1,0
38067879@N08,4918,29,1462178214,1462178214,1,1,0
38084526@N06,4919,16,1275139038,1275139038,1,3,0
38084526@N06,4919,26,1275147622,1275147622,1,3,0
38084526@N06,4919,1,1275135943,1275135943,1,3,0
38084526@N06,4920,26,1275398249,1275398249,1,1,0
38084526@N06,4921,24,1275656249,1275656549,2,5,300
38084526@N06,4921,17,1275656185,1275656185,1,5,0
38084526@N06,4921,21,1275654087,1275656078,2,5,1991
38084526@N06,4921,26,1275653945,1275653945,1,5,0
38084526@N06,4921,10,1275653842,1275653842,1,5,0
38084526@N06,4922,11,1276329049,1276329049,1,1,0
38084526@N06,4923,28,1287061693,1287061693,1,1,0
38084526@N06,4924,25,1318578418,1318578418,1,1,0
38096226@N08,4925,16,1277720735,1277720735,1,2,0
38096226@N08,4925,18,1277698244,1277698244,1,2,0
38102706@N05,4926,29,1267801731,1267801731,1,1,0
38102706@N05,4927,24,1267914252,1267930379,9,18,16127
38102706@N05,4927,1,1267909429,1267967122,12,18,57693
38102706@N05,4927,8,1267911718,1267913916,11,18,2198
38102706@N05,4927,4,1267912945,1267912945,1,18,0
38102706@N05,4927,19,1267920117,1267921205,3,18,1088
38102706@N05,4927,21,1267913138,1267930638,9,18,17500
38102706@N05,4927,3,1267913176,1267913176,1,18,0
38102706@N05,4927,7,1267912978,1267913110,4,18,132
38102706@N05,4927,29,1267919978,1267951703,36,18,31725
38102706@N05,4927,15,1267917588,1267961681,11,18,44093
38102706@N05,4927,13,1267930687,1267932310,8,18,1623
38102706@N05,4927,18,1267936697,1267938511,5,18,1814
38102706@N05,4927,26,1267911301,1267948160,13,18,36859
38102706@N05,4927,28,1267909738,1267966151,17,18,56413
38102706@N05,4927,12,1267913195,1267928568,5,18,15373
38102706@N05,4927,27,1267911253,1267961450,35,18,50197
38102706@N05,4927,16,1267910978,1267961668,27,18,50690
38102706@N05,4927,11,1267931008,1267931008,1,18,0
38102706@N05,4928,1,1268025052,1268025903,6,8,851
38102706@N05,4928,8,1268029322,1268030441,7,8,1119
38102706@N05,4928,21,1268035694,1268037427,14,8,1733
38102706@N05,4928,18,1268028434,1268028434,1,8,0
38102706@N05,4928,26,1268029278,1268029293,2,8,15
38102706@N05,4928,28,1268007183,1268028288,11,8,21105
38102706@N05,4928,27,1268028360,1268039979,7,8,11619
38102706@N05,4928,16,1268026343,1268040206,12,8,13863
38102706@N05,4929,17,1306224852,1306224852,1,1,0
38102706@N05,4930,28,1306462777,1306465246,2,7,2469
38102706@N05,4930,29,1306458564,1306461129,6,7,2565
38102706@N05,4930,12,1306455783,1306455842,4,7,59
38102706@N05,4930,16,1306456849,1306456849,1,7,0
38102706@N05,4930,1,1306462756,1306462932,5,7,176
38102706@N05,4930,14,1306460693,1306460936,2,7,243
38102706@N05,4930,15,1306456045,1306456241,4,7,196
38102706@N05,4931,30,1400713872,1400713872,1,1,0
38102706@N05,4932,1,1400972432,1400972432,1,1,0
38116435@N00,4933,26,1262842707,1262843162,2,1,455
38116435@N00,4934,18,1277964199,1277964224,2,2,25
38116435@N00,4934,31,1277943338,1277943338,1,2,0
38116435@N00,4935,16,1283756400,1283756400,1,1,0
38116435@N00,4936,16,1284102000,1284102000,1,1,0
38116435@N00,4937,4,1287888105,1287888105,1,4,0
38116435@N00,4937,11,1287888013,1287888013,1,4,0
38116435@N00,4937,20,1287880026,1287880026,1,4,0
38116435@N00,4937,26,1287889976,1287889976,1,4,0
38116435@N00,4938,12,1294109315,1294109315,1,2,0
38116435@N00,4938,26,1294109051,1294109051,1,2,0
38116435@N00,4939,29,1295235906,1295236049,2,1,143
38116435@N00,4940,12,1297651459,1297651459,1,3,0
38116435@N00,4940,20,1297649851,1297649851,1,3,0
38116435@N00,4940,26,1297650275,1297650408,2,3,133
38116435@N00,4941,26,1299849474,1299849474,1,1,0
38116435@N00,4942,18,1305013546,1305013546,1,3,0
38116435@N00,4942,19,1305011627,1305011627,1,3,0
38116435@N00,4942,16,1305015456,1305015456,1,3,0
38116435@N00,4943,22,1318321362,1318321362,1,1,0
38116435@N00,4944,28,1322652655,1322652655,1,1,0
38116435@N00,4945,23,1322827043,1322827043,1,1,0
38116435@N00,4946,26,1322975309,1322975309,1,1,0
38116435@N00,4947,16,1340435151,1340435151,1,1,0
38116435@N00,4948,20,1340534887,1340534887,1,1,0
38116435@N00,4949,5,1340612850,1340612850,1,1,0
38116435@N00,4950,26,1357629566,1357629566,1,1,0
38117207@N03,4951,28,1339985718,1340030541,39,1,44823
38149231@N02,4952,15,1294543749,1294543754,2,1,5
38224505@N04,4953,1,1380763985,1380763985,1,1,0
38231195@N04,4954,16,1360286362,1360286723,3,4,361
38231195@N04,4954,28,1360282733,1360282733,1,4,0
38231195@N04,4954,27,1360286786,1360286799,3,4,13
38231195@N04,4954,12,1360283302,1360283310,4,4,8
38231195@N04,4955,1,1360323881,1360323881,1,1,0
38235069@N00,4956,29,1324690661,1324690694,4,10,33
38235069@N00,4956,15,1324683062,1324683100,3,10,38
38235069@N00,4956,26,1324676682,1324676682,1,10,0
38235069@N00,4956,27,1324696174,1324696189,4,10,15
38235069@N00,4956,20,1324683757,1324683871,3,10,114
38235069@N00,4956,13,1324711725,1324711725,1,10,0
38235069@N00,4956,24,1324686577,1324686597,3,10,20
38235069@N00,4956,1,1324683445,1324683445,1,10,0
38235069@N00,4956,16,1324676240,1324676254,2,10,14
38235069@N00,4956,28,1324675614,1324703264,31,10,27650
38235069@N00,4957,18,1324935338,1324959832,9,5,24494
38235069@N00,4957,19,1324959809,1324959932,4,5,123
38235069@N00,4957,23,1324935377,1324935419,3,5,42
38235069@N00,4957,30,1324940694,1324948721,3,5,8027
38235069@N00,4957,28,1324932506,1324932514,2,5,8
38235069@N00,4958,20,1325116481,1325116481,1,3,0
38235069@N00,4958,24,1325120718,1325120749,2,3,31
38235069@N00,4958,28,1325125505,1325125866,6,3,361
38235069@N00,4959,1,1329088812,1329088856,4,1,44
38235069@N00,4960,8,1334361338,1334361388,4,4,50
38235069@N00,4960,28,1334370326,1334370357,3,4,31
38235069@N00,4960,21,1334382180,1334382221,4,4,41
38235069@N00,4960,24,1334356443,1334356443,1,4,0
38235069@N00,4961,13,1339381113,1339381136,4,2,23
38235069@N00,4961,15,1339385461,1339385472,4,2,11
38235069@N00,4962,28,1346134640,1346134650,2,3,10
38235069@N00,4962,18,1346135257,1346135257,1,3,0
38235069@N00,4962,31,1346134817,1346134955,7,3,138
38235069@N00,4963,18,1349437801,1349437801,1,1,0
38235069@N00,4964,22,1349491788,1349491788,1,1,0
38235069@N00,4965,28,1358645587,1358645639,6,3,52
38235069@N00,4965,17,1358645529,1358645529,1,3,0
38235069@N00,4965,15,1358650984,1358653067,17,3,2083
38235069@N00,4966,26,1359716521,1359716521,1,1,0
38235069@N00,4967,28,1359800861,1359800861,1,2,0
38235069@N00,4967,30,1359806111,1359806148,2,2,37
38235069@N00,4968,21,1365818275,1365818983,13,3,708
38235069@N00,4968,30,1365812534,1365812562,8,3,28
38235069@N00,4968,19,1365823847,1365823955,5,3,108
38235069@N00,4969,26,1371612698,1371612782,3,5,84
38235069@N00,4969,22,1371618460,1371618460,1,5,0
38235069@N00,4969,29,1371601675,1371601675,1,5,0
38235069@N00,4969,28,1371600907,1371601685,12,5,778
38235069@N00,4969,11,1371605436,1371605454,3,5,18
38235069@N00,4970,23,1374716082,1374716440,4,5,358
38235069@N00,4970,4,1374728491,1374729035,4,5,544
38235069@N00,4970,30,1374719448,1374726195,10,5,6747
38235069@N00,4970,26,1374727784,1374727784,1,5,0
38235069@N00,4970,28,1374713953,1374752939,15,5,38986
38235069@N00,4971,15,1377397625,1377397625,1,2,0
38235069@N00,4971,24,1377396451,1377396501,4,2,50
38235069@N00,4972,14,1377560272,1377560402,2,1,130
38235069@N00,4973,18,1378199827,1378199866,4,2,39
38235069@N00,4973,13,1378194857,1378195137,9,2,280
38235069@N00,4974,23,1380934920,1380935742,8,7,822
38235069@N00,4974,16,1380925559,1380928371,19,7,2812
38235069@N00,4974,30,1380933435,1380935919,20,7,2484
38235069@N00,4974,22,1380941821,1380969096,5,7,27275
38235069@N00,4974,31,1380935461,1380935493,3,7,32
38235069@N00,4974,27,1380925478,1380926163,5,7,685
38235069@N00,4974,13,1380932941,1380932941,1,7,0
38235069@N00,4975,1,1385186571,1385188044,12,3,1473
38235069@N00,4975,26,1385195660,1385195693,5,3,33
38235069@N00,4975,28,1385193359,1385194182,13,3,823
38235069@N00,4976,20,1385864250,1385864739,7,2,489
38235069@N00,4976,29,1385861756,1385861771,3,2,15
38235069@N00,4977,15,1422001989,1422002016,2,8,27
38235069@N00,4977,25,1421999156,1421999164,3,8,8
38235069@N00,4977,23,1421993123,1422001478,5,8,8355
38235069@N00,4977,4,1422006860,1422007429,12,8,569
38235069@N00,4977,11,1422006826,1422006826,1,8,0
38235069@N00,4977,22,1421998066,1421998066,1,8,0
38235069@N00,4977,26,1421999138,1421999138,1,8,0
38235069@N00,4977,31,1421998034,1421998034,1,8,0
38235069@N00,4978,23,1437085239,1437085239,1,6,0
38235069@N00,4978,1,1437095305,1437096895,12,6,1590
38235069@N00,4978,22,1437085957,1437139468,3,6,53511
38235069@N00,4978,18,1437101620,1437101621,2,6,1
38235069@N00,4978,26,1437086362,1437100755,7,6,14393
38235069@N00,4978,28,1437090084,1437131613,30,6,41529
38235069@N00,4979,22,1437173317,1437173319,2,1,2
38235069@N00,4980,11,1438672627,1438672692,11,3,65
38235069@N00,4980,20,1438673317,1438673346,9,3,29
38235069@N00,4980,1,1438662263,1438662302,2,3,39
38235069@N00,4981,26,1443785348,1443785348,1,1,0
38235069@N00,4982,22,1443840668,1443840668,1,2,0
38235069@N00,4982,26,1443846761,1443846790,2,2,29
38235069@N00,4983,28,1448061193,1448061193,1,3,0
38235069@N00,4983,13,1448074660,1448074668,4,3,8
38235069@N00,4983,1,1448096888,1448096925,2,3,37
38235069@N00,4984,28,1452125113,1452149504,11,9,24391
38235069@N00,4984,27,1452132739,1452132739,1,9,0
38235069@N00,4984,15,1452135562,1452138131,9,9,2569
38235069@N00,4984,22,1452144802,1452145081,6,9,279
38235069@N00,4984,17,1452138138,1452138208,8,9,70
38235069@N00,4984,13,1452141772,1452142428,6,9,656
38235069@N00,4984,14,1452145115,1452145873,18,9,758
38235069@N00,4984,1,1452138533,1452138539,3,9,6
38235069@N00,4984,16,1452132735,1452133509,2,9,774
38235069@N00,4985,28,1453599362,1453600953,13,12,1591
38235069@N00,4985,31,1453592459,1453597892,12,12,5433
38235069@N00,4985,18,1453598559,1453598861,6,12,302
38235069@N00,4985,15,1453589974,1453589992,2,12,18
38235069@N00,4985,26,1453587530,1453587547,3,12,17
38235069@N00,4985,23,1453598905,1453598984,3,12,79
38235069@N00,4985,22,1453596520,1453596610,3,12,90
38235069@N00,4985,20,1453594027,1453596178,22,12,2151
38235069@N00,4985,13,1453590839,1453590866,3,12,27
38235069@N00,4985,24,1453588731,1453589016,4,12,285
38235069@N00,4985,14,1453596879,1453597303,5,12,424
38235069@N00,4985,30,1453592759,1453593299,13,12,540
38235069@N00,4986,29,1458342120,1458344322,3,5,2202
38235069@N00,4986,21,1458345387,1458347065,3,5,1678
38235069@N00,4986,31,1458341237,1458341294,7,5,57
38235069@N00,4986,20,1458342132,1458342915,11,5,783
38235069@N00,4986,30,1458338596,1458341562,15,5,2966
38235069@N00,4987,21,1460771698,1460771698,1,7,0
38235069@N00,4987,31,1460778262,1460778268,2,7,6
38235069@N00,4987,18,1460765619,1460765673,5,7,54
38235069@N00,4987,26,1460766726,1460775984,18,7,9258
38235069@N00,4987,13,1460770586,1460770586,1,7,0
38235069@N00,4987,16,1460774298,1460775346,3,7,1048
38235069@N00,4987,30,1460777214,1460777249,3,7,35
38235069@N00,4988,22,1464409460,1464409550,9,2,90
38235069@N00,4988,23,1464412008,1464412078,3,2,70
38235069@N00,4989,26,1466165336,1466165359,3,1,23
38235069@N00,4990,18,1466238342,1466238342,1,1,0
38235069@N00,4991,10,1470536248,1470536248,1,14,0
38235069@N00,4991,12,1470533921,1470534316,15,14,395
38235069@N00,4991,23,1470530036,1470541977,7,14,11941
38235069@N00,4991,16,1470533371,1470533459,2,14,88
38235069@N00,4991,28,1470529515,1470529712,5,14,197
38235069@N00,4991,30,1470539237,1470539381,3,14,144
38235069@N00,4991,29,1470539698,1470539791,4,14,93
38235069@N00,4991,21,1470535027,1470535027,1,14,0
38235069@N00,4991,26,1470533156,1470533716,6,14,560
38235069@N00,4991,25,1470535200,1470535208,4,14,8
38235069@N00,4991,11,1470535976,1470536198,7,14,222
38235069@N00,4991,20,1470540462,1470540568,7,14,106
38235069@N00,4991,18,1470529634,1470533081,4,14,3447
38235069@N00,4991,13,1470535284,1470535407,3,14,123
38258553@N03,4992,24,1289962034,1289962034,1,1,0
38259817@N06,4993,28,1245281015,1245284372,116,1,3357
38376245@N04,4994,11,1243225773,1243225773,1,1,0
38376245@N04,4995,13,1253432351,1253432351,1,1,0
38376245@N04,4996,30,1256912035,1256912035,1,1,0
38376245@N04,4997,17,1306060179,1306060179,1,1,0
38376245@N04,4998,15,1327467075,1327467075,1,2,0
38376245@N04,4998,21,1327454098,1327454110,2,2,12
38376245@N04,4999,28,1330604824,1330604824,1,1,0
38376245@N04,5000,26,1335854177,1335854177,1,1,0
38376245@N04,5001,26,1338866460,1338866460,1,1,0
38376245@N04,5002,28,1338955225,1338955225,1,2,0
38376245@N04,5002,26,1338955223,1338955223,1,2,0
38376245@N04,5003,20,1348636813,1348638171,2,1,1358
38387241@N02,5004,13,1276222302,1276222642,4,14,340
38387241@N02,5004,8,1276220214,1276220848,2,14,634
38387241@N02,5004,26,1276219952,1276257242,24,14,37290
38387241@N02,5004,24,1276221138,1276221448,4,14,310
38387241@N02,5004,5,1276220202,1276220202,1,14,0
38387241@N02,5004,15,1276221230,1276221290,2,14,60
38387241@N02,5004,19,1276227502,1276227866,6,14,364
38387241@N02,5004,10,1276228898,1276229996,9,14,1098
38387241@N02,5004,23,1276227464,1276227464,1,14,0
38387241@N02,5004,12,1276220950,1276221716,4,14,766
38387241@N02,5004,30,1276223380,1276223768,13,14,388
38387241@N02,5004,28,1276218662,1276219368,5,14,706
38387241@N02,5004,21,1276221892,1276221954,2,14,62
38387241@N02,5004,25,1276221948,1276221948,1,14,0
38393814@N07,5005,26,1310446522,1310446522,1,3,0
38393814@N07,5005,22,1310421398,1310421398,1,3,0
38393814@N07,5005,15,1310437171,1310437171,1,3,0
38399068@N03,5006,28,1323128960,1323128960,1,1,0
38501353@N00,5007,26,1255051394,1255066703,7,1,15309
38501353@N00,5008,26,1301268551,1301268551,1,1,0
38501353@N00,5009,26,1305424224,1305447529,14,1,23305
38501353@N00,5010,26,1318417323,1318421964,5,1,4641
38501353@N00,5011,26,1342760162,1342761416,5,1,1254
38501353@N00,5012,26,1353065208,1353072411,5,1,7203
38501353@N00,5013,26,1353115804,1353120141,9,1,4337
38501353@N00,5014,26,1387016217,1387016217,1,1,0
38501353@N00,5015,26,1433563754,1433568206,14,1,4452
38507778@N00,5016,18,1437452076,1437452076,1,1,0
38637960@N00,5017,28,1460811955,1460812112,2,2,157
38637960@N00,5017,22,1460815013,1460815013,1,2,0
38662033@N08,5018,26,1318576155,1318576570,6,8,415
38662033@N08,5018,1,1318572950,1318573149,8,8,199
38662033@N08,5018,21,1318578323,1318578323,1,8,0
38662033@N08,5018,31,1318579896,1318579896,1,8,0
38662033@N08,5018,29,1318579651,1318579651,1,8,0
38662033@N08,5018,10,1318591502,1318591514,2,8,12
38662033@N08,5018,16,1318590084,1318590084,1,8,0
38662033@N08,5018,28,1318591991,1318592086,4,8,95
38662033@N08,5019,26,1323505136,1323505136,1,4,0
38662033@N08,5019,25,1323505618,1323505618,1,4,0
38662033@N08,5019,16,1323519270,1323519270,1,4,0
38662033@N08,5019,28,1323504751,1323519628,7,4,14877
38662490@N00,5020,28,1350611226,1350611226,1,1,0
38662490@N00,5021,29,1383908274,1383908274,1,2,0
38662490@N00,5021,28,1383906172,1383906172,1,2,0
38664640@N00,5022,26,1220491477,1220491477,1,1,0
38690067@N04,5023,24,1275363194,1275380869,15,21,17675
38690067@N04,5023,17,1275354831,1275396761,12,21,41930
38690067@N04,5023,29,1275352164,1275367907,12,21,15743
38690067@N04,5023,28,1275350587,1275350663,3,21,76
38690067@N04,5023,26,1275359882,1275373961,16,21,14079
38690067@N04,5023,15,1275379649,1275382067,8,21,2418
38690067@N04,5023,16,1275359751,1275362222,7,21,2471
38690067@N04,5023,12,1275354305,1275380797,8,21,26492
38690067@N04,5023,30,1275353828,1275373896,11,21,20068
38690067@N04,5023,19,1275361300,1275361505,10,21,205
38690067@N04,5023,27,1275354723,1275383683,10,21,28960
38690067@N04,5023,13,1275375739,1275377402,8,21,1663
38690067@N04,5023,18,1275350739,1275361802,17,21,11063
38690067@N04,5023,31,1275353902,1275368541,7,21,14639
38690067@N04,5023,20,1275352418,1275352418,1,21,0
38690067@N04,5023,22,1275368179,1275368179,1,21,0
38690067@N04,5023,1,1275350476,1275350516,3,21,40
38690067@N04,5023,25,1275374425,1275375930,12,21,1505
38690067@N04,5023,23,1275350764,1275361973,13,21,11209
38690067@N04,5023,21,1275374275,1275374275,1,21,0
38690067@N04,5023,11,1275354053,1275354053,1,21,0
38730049@N08,5024,6,1188010565,1188017518,5,2,6953
38730049@N08,5024,9,1188014184,1188018186,5,2,4002
38730049@N08,5025,6,1188091781,1188091781,1,2,0
38730049@N08,5025,9,1188078397,1188101477,9,2,23080
38730049@N08,5026,6,1188186260,1188213531,2,2,27271
38730049@N08,5026,9,1188170641,1188214928,5,2,44287
38730049@N08,5027,6,1188253278,1188271614,4,1,18336
38730049@N08,5028,9,1197937242,1197980039,12,1,42797
38730049@N08,5029,9,1198021552,1198048714,6,1,27162
38730049@N08,5030,9,1198160759,1198160759,1,1,0
38730049@N08,5031,9,1219026005,1219034247,8,1,8242
38730049@N08,5032,9,1219096980,1219120026,4,1,23046
38730049@N08,5033,9,1219186182,1219213662,3,1,27480
38730049@N08,5034,9,1219271238,1219297630,4,1,26392
38730049@N08,5035,9,1230872222,1230877912,2,2,5690
38730049@N08,5035,6,1230870793,1230904331,9,2,33538
38730049@N08,5036,9,1230984116,1230991551,3,1,7435
38730049@N08,5037,9,1231028569,1231054726,6,2,26157
38730049@N08,5037,6,1231042905,1231050634,4,2,7729
38730049@N08,5038,9,1231115588,1231115775,3,2,187
38730049@N08,5038,6,1231115753,1231115753,1,2,0
38730049@N08,5039,9,1253757519,1253785980,5,1,28461
38730049@N08,5040,9,1253835382,1253884026,5,1,48644
38730049@N08,5041,1,1253922265,1253922265,1,1,0
38730049@N08,5042,9,1254008499,1254009185,2,1,686
38730049@N08,5043,9,1254056181,1254058160,3,1,1979
38730049@N08,5044,9,1254096417,1254113249,8,1,16832
38730049@N08,5045,6,1260944750,1260953776,5,2,9026
38730049@N08,5045,9,1260953594,1260969806,5,2,16212
38730049@N08,5046,6,1261028350,1261030397,4,2,2047
38730049@N08,5046,9,1261009935,1261009935,1,2,0
38730049@N08,5047,6,1261092706,1261119939,6,2,27233
38730049@N08,5047,9,1261110033,1261110033,1,2,0
38730049@N08,5048,9,1281247621,1281258247,2,1,10626
38730049@N08,5049,9,1281309437,1281342665,4,1,33228
38730049@N08,5050,9,1281420477,1281437761,5,1,17284
38730049@N08,5051,9,1281478365,1281521132,6,1,42767
38730049@N08,5052,9,1281566497,1281570358,6,1,3861
38730049@N08,5053,9,1286769745,1286796351,5,1,26606
38730049@N08,5054,9,1286851476,1286858492,5,1,7016
38730049@N08,5055,1,1286932922,1286932995,4,2,73
38730049@N08,5055,9,1286933293,1286942619,8,2,9326
38730049@N08,5056,9,1287015004,1287055722,5,1,40718
38730049@N08,5057,9,1287090117,1287112576,14,1,22459
38730049@N08,5058,9,1292213312,1292220277,2,1,6965
38730049@N08,5059,9,1292284514,1292307841,6,1,23327
38730049@N08,5060,9,1292366755,1292418330,10,1,51575
38730049@N08,5061,9,1292448822,1292507915,12,1,59093
38730049@N08,5062,9,1302494869,1302511628,3,2,16759
38730049@N08,5062,6,1302504012,1302505819,4,2,1807
38730049@N08,5063,9,1302588846,1302607930,6,2,19084
38730049@N08,5063,6,1302580552,1302608526,9,2,27974
38730049@N08,5064,9,1302650128,1302695336,9,2,45208
38730049@N08,5064,6,1302648426,1302669324,4,2,20898
38730049@N08,5065,9,1302737118,1302737307,3,2,189
38730049@N08,5065,6,1302737341,1302737341,1,2,0
38730049@N08,5066,9,1307313840,1307314260,2,2,420
38730049@N08,5066,6,1307312300,1307338347,2,2,26047
38730049@N08,5067,6,1307399669,1307450362,8,1,50693
38730049@N08,5068,9,1319228409,1319268682,23,1,40273
38730049@N08,5069,9,1319371962,1319372144,2,1,182
38730049@N08,5070,9,1319403729,1319404689,2,1,960
38730049@N08,5071,9,1323761512,1323761512,1,1,0
38730049@N08,5072,6,1323832627,1323845611,3,2,12984
38730049@N08,5072,9,1323813016,1323847097,4,2,34081
38730049@N08,5073,6,1323900535,1323960334,7,2,59799
38730049@N08,5073,9,1323903125,1323960613,9,2,57488
38730049@N08,5074,9,1338275098,1338275098,1,1,0
38730049@N08,5075,9,1338330670,1338376641,12,1,45971
38730049@N08,5076,9,1338416105,1338450406,5,1,34301
38730049@N08,5077,6,1345505437,1345529084,7,2,23647
38730049@N08,5077,9,1345503590,1345520691,3,2,17101
38730049@N08,5078,6,1345638462,1345638462,1,1,0
38730049@N08,5079,6,1345705448,1345718622,7,2,13174
38730049@N08,5079,9,1345714150,1345718533,5,2,4383
38730049@N08,5080,9,1349670012,1349696788,11,1,26776
38730049@N08,5081,9,1349736433,1349763107,7,1,26674
38730049@N08,5082,9,1349823886,1349830274,2,1,6388
38730049@N08,5083,9,1355796288,1355833504,18,2,37216
38730049@N08,5083,6,1355794296,1355805499,8,2,11203
38730049@N08,5084,9,1355959069,1355993283,13,2,34214
38730049@N08,5084,6,1355950646,1355989481,5,2,38835
38730049@N08,5085,9,1356062677,1356076392,2,2,13715
38730049@N08,5085,6,1356063920,1356077433,6,2,13513
38730049@N08,5086,6,1365392252,1365392252,1,1,0
38730049@N08,5087,9,1365545132,1365547803,3,2,2671
38730049@N08,5087,6,1365541857,1365563553,3,2,21696
38730049@N08,5088,9,1369710315,1369720458,10,1,10143
38730049@N08,5089,9,1369778762,1369810138,17,1,31376
38730049@N08,5090,9,1369906419,1369912827,5,1,6408
38730049@N08,5091,9,1376894611,1376914541,7,2,19930
38730049@N08,5091,6,1376890185,1376914853,10,2,24668
38730049@N08,5092,9,1376987156,1376987156,1,3,0
38730049@N08,5092,6,1376961871,1376974229,4,3,12358
38730049@N08,5092,1,1376969899,1376969899,1,3,0
38730049@N08,5093,9,1377033611,1377081738,9,2,48127
38730049@N08,5093,6,1377033903,1377062067,2,2,28164
38730049@N08,5094,9,1377144199,1377158274,5,2,14075
38730049@N08,5094,6,1377148371,1377161653,3,2,13282
38730049@N08,5095,9,1379499849,1379499849,1,1,0
38730049@N08,5096,9,1379559205,1379578802,7,2,19597
38730049@N08,5096,6,1379559278,1379579430,9,2,20152
38730049@N08,5097,9,1379628812,1379680292,15,2,51480
38730049@N08,5097,6,1379645918,1379677331,16,2,31413
38730049@N08,5098,9,1385292854,1385292854,1,2,0
38730049@N08,5098,6,1385292871,1385292871,1,2,0
38730049@N08,5099,9,1385334644,1385364359,6,2,29715
38730049@N08,5099,6,1385332186,1385387072,16,2,54886
38730049@N08,5100,6,1385442273,1385473769,3,2,31496
38730049@N08,5100,9,1385463677,1385474680,3,2,11003
38730049@N08,5101,6,1385508918,1385536878,5,2,27960
38730049@N08,5101,9,1385508949,1385562859,9,2,53910
38730049@N08,5102,6,1396234181,1396242091,3,2,7910
38730049@N08,5102,9,1396239867,1396261991,2,2,22124
38730049@N08,5103,6,1396305970,1396326025,2,2,20055
38730049@N08,5103,9,1396305966,1396344244,4,2,38278
38730049@N08,5104,6,1396383968,1396429145,12,2,45177
38730049@N08,5104,9,1396389830,1396431823,10,2,41993
38730049@N08,5105,6,1396492844,1396517729,4,2,24885
38730049@N08,5105,9,1396517982,1396528957,8,2,10975
38730049@N08,5106,6,1401689436,1401696203,11,2,6767
38730049@N08,5106,9,1401688549,1401696984,6,2,8435
38730049@N08,5107,6,1401772274,1401791715,6,2,19441
38730049@N08,5107,9,1401765519,1401785447,8,2,19928
38730049@N08,5108,6,1401831689,1401871434,5,2,39745
38730049@N08,5108,9,1401856478,1401858989,2,2,2511
38730049@N08,5109,6,1401931752,1401974231,12,3,42479
38730049@N08,5109,9,1401931664,1401975445,15,3,43781
38730049@N08,5109,1,1401975698,1401975698,1,3,0
38730049@N08,5110,9,1408507238,1408531248,6,1,24010
38730049@N08,5111,9,1408592864,1408607269,3,1,14405
38730049@N08,5112,9,1408659430,1408704019,17,1,44589
38730049@N08,5113,9,1414552834,1414556973,5,2,4139
38730049@N08,5113,6,1414556367,1414556367,1,2,0
38730049@N08,5114,9,1414629032,1414654400,14,1,25368
38730049@N08,5115,9,1414701148,1414733834,7,1,32686
38730049@N08,5116,9,1418699417,1418733602,16,1,34185
38730049@N08,5117,9,1418772661,1418821623,29,1,48962
38730049@N08,5118,9,1418863095,1418911436,49,1,48341
38730049@N08,5119,9,1427159959,1427191217,21,1,31258
38730049@N08,5120,9,1427224900,1427278613,25,1,53713
38730049@N08,5121,9,1427332274,1427368669,17,1,36395
38730049@N08,5122,9,1432624931,1432627699,3,2,2768
38730049@N08,5122,6,1432639708,1432640383,6,2,675
38730049@N08,5123,9,1432670279,1432728226,32,2,57947
38730049@N08,5123,6,1432725560,1432726224,10,2,664
38730049@N08,5124,9,1432777697,1432816365,14,2,38668
38730049@N08,5124,6,1432810978,1432812079,6,2,1101
38730049@N08,5125,6,1433149445,1433149930,6,2,485
38730049@N08,5125,9,1433128252,1433151839,18,2,23587
38730049@N08,5126,9,1433203898,1433213846,9,1,9948
38730049@N08,5127,9,1439871980,1439902145,36,2,30165
38730049@N08,5127,6,1439891940,1439892448,2,2,508
38730049@N08,5128,9,1439934686,1439988582,46,2,53896
38730049@N08,5128,6,1439978282,1439985476,10,2,7194
38730049@N08,5129,9,1440031959,1440078644,55,2,46685
38730049@N08,5129,6,1440064361,1440064960,5,2,599
38730049@N08,5130,6,1443008781,1443009267,3,2,486
38730049@N08,5130,9,1442983115,1443007848,21,2,24733
38730049@N08,5131,6,1443088791,1443088986,2,2,195
38730049@N08,5131,9,1443065100,1443094810,48,2,29710
38730049@N08,5132,9,1443132711,1443165838,24,1,33127
38730049@N08,5133,9,1443229164,1443229658,6,1,494
38730049@N08,5134,9,1448178008,1448178241,2,1,233
38730049@N08,5135,6,1448281114,1448281265,3,2,151
38730049@N08,5135,9,1448227588,1448282549,57,2,54961
38730049@N08,5136,6,1448348400,1448348615,4,2,215
38730049@N08,5136,9,1448339435,1448369834,23,2,30399
38730049@N08,5137,9,1448399595,1448456988,22,1,57393
38730049@N08,5138,6,1459749178,1459771107,54,1,21929
38730049@N08,5139,6,1459821755,1459857619,80,1,35864
38730049@N08,5140,6,1459890667,1459943839,68,1,53172
38730049@N08,5141,6,1459990415,1459995222,7,1,4807
38730049@N08,5142,1,1468040021,1468040423,4,1,402
38730049@N08,5143,6,1471754278,1471787774,88,1,33496
38730049@N08,5144,6,1471821296,1471870895,135,1,49599
38731688@N06,5145,26,1364683531,1364690305,2,1,6774
38731688@N06,5146,1,1384071796,1384071796,1,1,0
38739245@N06,5147,10,1368490432,1368490432,1,1,0
38739245@N06,5148,10,1368523511,1368537409,27,1,13898
38765937@N03,5149,25,1380096816,1380096816,1,1,0
38765937@N03,5150,18,1380781032,1380781032,1,1,0
38794272@N04,5151,29,1313931260,1313940731,51,1,9471
38794272@N04,5152,29,1313975858,1313982110,49,1,6252
38794272@N04,5153,28,1314106741,1314160180,221,1,53439
38797526@N05,5154,10,1249387345,1249387345,1,1,0
38825115@N04,5155,21,1329453185,1329453185,1,1,0
38879474@N04,5156,21,1277919362,1277919362,1,2,0
38879474@N04,5156,20,1277930176,1277930176,1,2,0
38894291@N00,5157,24,1412736114,1412736114,1,1,0
38913499@N08,5158,16,1442999490,1442999490,1,5,0
38913499@N08,5158,24,1443000775,1443000775,1,5,0
38913499@N08,5158,1,1442974527,1442974527,1,5,0
38913499@N08,5158,13,1442977540,1442977540,1,5,0
38913499@N08,5158,31,1442984251,1442984251,1,5,0
38937312@N00,5159,29,1447585710,1447585710,1,1,0
38949505@N05,5160,28,1356829747,1356829747,1,2,0
38949505@N05,5160,1,1356827508,1356827508,1,2,0
38949505@N05,5161,28,1457128594,1457128594,1,1,0
38953180@N04,5162,16,1261032565,1261032584,2,2,19
38953180@N04,5162,10,1260997951,1261050718,146,2,52767
38964012@N06,5163,15,1404365477,1404365554,2,9,77
38964012@N06,5163,25,1404370303,1404373064,3,9,2761
38964012@N06,5163,17,1404363487,1404363487,1,9,0
38964012@N06,5163,21,1404369173,1404369173,1,9,0
38964012@N06,5163,13,1404373470,1404373757,2,9,287
38964012@N06,5163,26,1404357563,1404357684,5,9,121
38964012@N06,5163,7,1404376020,1404376020,1,9,0
38964012@N06,5163,27,1404359101,1404359311,2,9,210
38964012@N06,5163,29,1404381368,1404381368,1,9,0
39007581@N07,5164,19,1418451565,1418451565,1,1,0
39024895@N00,5165,26,1219451050,1219451085,3,2,35
39024895@N00,5165,30,1219446140,1219457124,17,2,10984
39024895@N00,5166,1,1219540709,1219540716,2,2,7
39024895@N00,5166,28,1219545907,1219546155,8,2,248
39024895@N00,5167,10,1241819213,1241832394,84,1,13181
39024895@N00,5168,10,1241908759,1241912760,46,1,4001
39024895@N00,5169,10,1242461887,1242462198,2,1,311
39024895@N00,5170,10,1254717433,1254723364,4,1,5931
39024895@N00,5171,10,1254783770,1254794703,4,1,10933
39024895@N00,5172,10,1267221423,1267258113,376,1,36690
39024895@N00,5173,10,1267312043,1267313532,18,1,1489
39024895@N00,5174,29,1278638973,1278639130,10,2,157
39024895@N00,5174,6,1278628175,1278633379,19,2,5204
39024895@N00,5175,13,1278753387,1278753892,5,4,505
39024895@N00,5175,29,1278721041,1278753338,10,4,32297
39024895@N00,5175,28,1278725162,1278754526,11,4,29364
39024895@N00,5175,27,1278754208,1278754311,5,4,103
39024895@N00,5176,29,1316308060,1316308181,10,2,121
39024895@N00,5176,31,1316307995,1316308013,4,2,18
39024895@N00,5177,10,1326676251,1326676302,6,2,51
39024895@N00,5177,31,1326673848,1326675512,34,2,1664
39038543@N08,5178,25,1360477245,1360477516,2,1,271
39038543@N08,5179,25,1412055124,1412055124,1,1,0
39038543@N08,5180,20,1431490812,1431490812,1,1,0
39066378@N08,5181,1,1406604427,1406625629,3,1,21202
39066378@N08,5182,26,1428290152,1428290971,4,3,819
39066378@N08,5182,1,1428309698,1428309698,1,3,0
39066378@N08,5182,25,1428296209,1428296209,1,3,0
39073297@N04,5183,26,1266051997,1266051997,1,1,0
39095070@N02,5184,29,1280550369,1280550369,1,1,0
39095070@N02,5185,29,1281139714,1281139714,1,1,0
39095070@N02,5186,29,1281178354,1281181172,7,1,2818
39095070@N02,5187,29,1281483546,1281483546,1,1,0
39101963@N00,5188,12,1228891085,1228891085,1,5,0
39101963@N00,5188,27,1228891070,1228891070,1,5,0
39101963@N00,5188,13,1228891982,1228891982,1,5,0
39101963@N00,5188,1,1228890672,1228890672,1,5,0
39101963@N00,5188,14,1228891862,1228891862,1,5,0
39101963@N00,5189,28,1229137661,1229137661,1,6,0
39101963@N00,5189,29,1229137690,1229137710,2,6,20
39101963@N00,5189,31,1229137699,1229137699,1,6,0
39101963@N00,5189,14,1229137719,1229137719,1,6,0
39101963@N00,5189,26,1229137670,1229137681,2,6,11
39101963@N00,5189,23,1229137729,1229137729,1,6,0
39146060@N00,5190,15,1192276309,1192276316,3,8,7
39146060@N00,5190,6,1192276319,1192276319,1,8,0
39146060@N00,5190,31,1192277202,1192277202,1,8,0
39146060@N00,5190,17,1192276302,1192276305,2,8,3
39146060@N00,5190,26,1192276720,1192277217,3,8,497
39146060@N00,5190,29,1192276701,1192277209,3,8,508
39146060@N00,5190,30,1192276705,1192276716,4,8,11
39146060@N00,5190,16,1192276307,1192276307,1,8,0
39146060@N00,5191,30,1192924174,1192924180,2,1,6
39146060@N00,5192,15,1201944338,1201944338,1,5,0
39146060@N00,5192,24,1201944786,1201946046,6,5,1260
39146060@N00,5192,20,1201942408,1201942408,1,5,0
39146060@N00,5192,17,1201946450,1201946810,4,5,360
39146060@N00,5192,12,1201945938,1201945938,1,5,0
39146060@N00,5193,28,1205558044,1205561378,10,1,3334
39146060@N00,5194,24,1209735113,1209735381,3,2,268
39146060@N00,5194,29,1209734289,1209734289,1,2,0
39146060@N00,5195,17,1209790724,1209791244,3,3,520
39146060@N00,5195,26,1209770318,1209787491,9,3,17173
39146060@N00,5195,30,1209787068,1209789014,14,3,1946
39146060@N00,5196,14,1209875136,1209875136,1,7,0
39146060@N00,5196,11,1209873126,1209873126,1,7,0
39146060@N00,5196,13,1209879890,1209880062,3,7,172
39146060@N00,5196,18,1209886876,1209886882,2,7,6
39146060@N00,5196,23,1209877096,1209877644,3,7,548
39146060@N00,5196,29,1209882502,1209895884,3,7,13382
39146060@N00,5196,19,1209886122,1209886358,6,7,236
39146060@N00,5197,24,1211509874,1211511308,17,1,1434
39146060@N00,5198,24,1216129761,1216129761,1,2,0
39146060@N00,5198,29,1216129631,1216129677,8,2,46
39146060@N00,5199,15,1216296970,1216298435,8,3,1465
39146060@N00,5199,20,1216297030,1216297043,5,3,13
39146060@N00,5199,29,1216297016,1216297025,2,3,9
39146060@N00,5200,28,1224189135,1224189135,1,3,0
39146060@N00,5200,1,1224186669,1224191542,12,3,4873
39146060@N00,5200,23,1224189610,1224190643,8,3,1033
39146060@N00,5201,25,1227040388,1227042079,17,1,1691
39146060@N00,5202,25,1233905690,1233906111,13,1,421
39146060@N00,5203,25,1234478592,1234479320,25,3,728
39146060@N00,5203,26,1234476130,1234476130,1,3,0
39146060@N00,5203,1,1234475948,1234475948,1,3,0
39146060@N00,5204,11,1235087928,1235087928,1,4,0
39146060@N00,5204,25,1235084920,1235085310,5,4,390
39146060@N00,5204,26,1235089400,1235089408,2,4,8
39146060@N00,5204,16,1235086211,1235086211,1,4,0
39146060@N00,5205,20,1237503655,1237503731,3,1,76
39146060@N00,5206,1,1238663017,1238663017,1,1,0
39146060@N00,5207,1,1238918412,1238918412,1,4,0
39146060@N00,5207,22,1238918381,1238918384,2,4,3
39146060@N00,5207,29,1238918388,1238918408,5,4,20
39146060@N00,5207,19,1238918394,1238918415,8,4,21
39146060@N00,5208,30,1241230399,1241234058,17,4,3659
39146060@N00,5208,26,1241221335,1241221335,1,4,0
39146060@N00,5208,3,1241223140,1241223341,8,4,201
39146060@N00,5208,23,1241227697,1241227709,2,4,12
39146060@N00,5209,1,1243574500,1243574500,1,1,0
39146060@N00,5210,24,1244937086,1244938862,8,2,1776
39146060@N00,5210,28,1244953747,1244953747,1,2,0
39146060@N00,5211,28,1248250256,1248250371,2,1,115
39146060@N00,5212,26,1248609874,1248609874,1,1,0
39146060@N00,5213,14,1249200501,1249200501,1,1,0
39146060@N00,5214,24,1251538234,1251549837,23,1,11603
39146060@N00,5215,24,1253361897,1253363645,5,1,1748
39146060@N00,5216,17,1253833871,1253836828,2,2,2957
39146060@N00,5216,29,1253837951,1253837951,1,2,0
39146060@N00,5217,1,1254436106,1254446475,7,1,10369
39146060@N00,5218,22,1255511332,1255512862,3,4,1530
39146060@N00,5218,30,1255514832,1255514832,1,4,0
39146060@N00,5218,14,1255513452,1255513452,1,4,0
39146060@N00,5218,26,1255514402,1255515230,2,4,828
39146060@N00,5219,20,1256292470,1256292470,1,3,0
39146060@N00,5219,1,1256292463,1256292463,1,3,0
39146060@N00,5219,17,1256292465,1256292465,1,3,0
39146060@N00,5220,1,1258185621,1258185624,2,2,3
39146060@N00,5220,28,1258185627,1258185632,4,2,5
39146060@N00,5221,25,1259825145,1259825145,1,4,0
39146060@N00,5221,1,1259825148,1259825168,2,4,20
39146060@N00,5221,13,1259825129,1259825142,6,4,13
39146060@N00,5221,28,1259825149,1259825165,7,4,16
39146060@N00,5222,1,1261127308,1261127330,9,2,22
39146060@N00,5222,28,1261127309,1261127316,5,2,7
39146060@N00,5223,23,1266546521,1266546521,1,3,0
39146060@N00,5223,30,1266546527,1266546527,1,3,0
39146060@N00,5223,31,1266546512,1266546518,2,3,6
39146060@N00,5224,17,1268525516,1268525524,3,1,8
39146060@N00,5225,24,1273292233,1273292233,1,1,0
39146060@N00,5226,25,1276416610,1276418880,2,4,2270
39146060@N00,5226,27,1276414321,1276414321,1,4,0
39146060@N00,5226,9,1276416072,1276416072,1,4,0
39146060@N00,5226,26,1276402665,1276403232,2,4,567
39146060@N00,5227,29,1276752993,1276753794,2,2,801
39146060@N00,5227,18,1276754243,1276754274,2,2,31
39146060@N00,5228,29,1296553949,1296553949,1,6,0
39146060@N00,5228,17,1296553807,1296553807,1,6,0
39146060@N00,5228,30,1296554039,1296554039,1,6,0
39146060@N00,5228,27,1296553755,1296553755,1,6,0
39146060@N00,5228,31,1296553906,1296553988,2,6,82
39146060@N00,5228,15,1296553701,1296553845,2,6,144
39149225@N08,5229,21,1445733219,1445733219,1,6,0
39149225@N08,5229,26,1445727920,1445727920,1,6,0
39149225@N08,5229,19,1445737685,1445737685,1,6,0
39149225@N08,5229,11,1445722136,1445722136,1,6,0
39149225@N08,5229,20,1445722518,1445722518,1,6,0
39149225@N08,5229,1,1445738947,1445738947,1,6,0
39149225@N08,5230,20,1457945399,1457945399,1,1,0
39175339@N07,5231,28,1251788168,1251788168,1,1,0
39205971@N03,5232,1,1286576895,1286576895,1,1,0
39301531@N03,5233,29,1418956458,1418956458,1,1,0
39311404@N00,5234,29,1216545343,1216545343,1,7,0
39311404@N00,5234,13,1216567678,1216567678,1,7,0
39311404@N00,5234,5,1216560865,1216560865,1,7,0
39311404@N00,5234,1,1216539026,1216539026,1,7,0
39311404@N00,5234,30,1216541028,1216541028,1,7,0
39311404@N00,5234,31,1216548460,1216548993,2,7,533
39311404@N00,5234,26,1216559064,1216560001,3,7,937
39337740@N00,5235,29,1341316721,1341316721,1,2,0
39337740@N00,5235,21,1341317924,1341317924,1,2,0
39345936@N00,5236,26,1223610863,1223622852,9,1,11989
39358979@N03,5237,28,1333172832,1333172832,1,1,0
39358979@N03,5238,21,1335163239,1335163239,1,1,0
39358979@N03,5239,16,1344680707,1344680707,1,1,0
39358979@N03,5240,28,1358623786,1358623786,1,1,0
39360988@N05,5241,28,1318510207,1318510207,1,1,0
39372984@N02,5242,30,1354309901,1354309901,1,1,0
39375531@N08,5243,22,1339496201,1339496201,1,1,0
39403274@N00,5244,26,1245194016,1245206669,2,4,12653
39403274@N00,5244,1,1245212211,1245212211,1,4,0
39403274@N00,5244,28,1245212114,1245212114,1,4,0
39403274@N00,5244,16,1245206478,1245206478,1,4,0
39437618@N04,5245,28,1261295071,1261309278,2,1,14207
39438001@N00,5246,22,1223096438,1223100632,4,18,4194
39438001@N00,5246,15,1223106003,1223106561,3,18,558
39438001@N00,5246,27,1223104561,1223104561,1,18,0
39438001@N00,5246,1,1223085740,1223085740,1,18,0
39438001@N00,5246,28,1223127027,1223127027,1,18,0
39438001@N00,5246,13,1223086314,1223090899,11,18,4585
39438001@N00,5246,30,1223101159,1223101186,2,18,27
39438001@N00,5246,8,1223109548,1223123333,4,18,13785
39438001@N00,5246,26,1223086029,1223086134,3,18,105
39438001@N00,5246,14,1223093095,1223093236,3,18,141
39438001@N00,5246,12,1223124363,1223124363,1,18,0
39438001@N00,5246,20,1223093549,1223124220,8,18,30671
39438001@N00,5246,31,1223086786,1223086786,1,18,0
39438001@N00,5246,29,1223094235,1223094235,1,18,0
39438001@N00,5246,18,1223103028,1223103426,2,18,398
39438001@N00,5246,11,1223087119,1223087119,1,18,0
39438001@N00,5246,19,1223093876,1223094114,5,18,238
39438001@N00,5246,3,1223111429,1223111429,1,18,0
39438001@N00,5247,18,1223175446,1223175446,1,7,0
39438001@N00,5247,1,1223168278,1223168278,1,7,0
39438001@N00,5247,17,1223170902,1223170902,1,7,0
39438001@N00,5247,8,1223171802,1223171802,1,7,0
39438001@N00,5247,16,1223172363,1223172363,1,7,0
39438001@N00,5247,29,1223177071,1223177142,2,7,71
39438001@N00,5247,19,1223175059,1223175059,1,7,0
39438001@N00,5248,28,1223263686,1223263694,2,6,8
39438001@N00,5248,26,1223253865,1223253865,1,6,0
39438001@N00,5248,29,1223261795,1223261795,1,6,0
39438001@N00,5248,3,1223260422,1223260579,4,6,157
39438001@N00,5248,5,1223257341,1223257341,1,6,0
39438001@N00,5248,7,1223256294,1223256562,3,6,268
39449616@N06,5249,31,1221624034,1221624034,1,1,0
39457011@N00,5250,16,1254362137,1254362137,1,8,0
39457011@N00,5250,12,1254363310,1254363310,1,8,0
39457011@N00,5250,31,1254368159,1254371233,3,8,3074
39457011@N00,5250,29,1254370528,1254370528,1,8,0
39457011@N00,5250,30,1254368134,1254368134,1,8,0
39457011@N00,5250,24,1254362106,1254362106,1,8,0
39457011@N00,5250,21,1254363772,1254364788,2,8,1016
39457011@N00,5250,1,1254357609,1254357627,2,8,18
39471939@N00,5251,4,1238366376,1238370198,2,9,3822
39471939@N00,5251,28,1238371876,1238371981,2,9,105
39471939@N00,5251,1,1238372172,1238372172,1,9,0
39471939@N00,5251,11,1238365260,1238365420,2,9,160
39471939@N00,5251,7,1238366347,1238370767,8,9,4420
39471939@N00,5251,3,1238368827,1238368827,1,9,0
39471939@N00,5251,6,1238369691,1238371215,6,9,1524
39471939@N00,5251,25,1238366378,1238366769,2,9,391
39471939@N00,5251,21,1238367910,1238367910,1,9,0
39471939@N00,5252,16,1238439714,1238439721,2,4,7
39471939@N00,5252,1,1238439190,1238439345,3,4,155
39471939@N00,5252,26,1238439831,1238439831,1,4,0
39471939@N00,5252,13,1238440157,1238440157,1,4,0
39523405@N00,5253,26,1303959787,1303959787,1,1,0
39523405@N00,5254,26,1303989504,1303989504,1,1,0
39523405@N00,5255,26,1304152409,1304152409,1,1,0
39527581@N07,5256,1,1190169932,1190169932,1,1,0
39527581@N07,5257,31,1262264400,1262264400,1,1,0
39527581@N07,5258,26,1323330179,1323330179,1,1,0
39527581@N07,5259,26,1335179497,1335179497,1,1,0
39527581@N07,5260,18,1367212606,1367212606,1,1,0
39527581@N07,5261,31,1382265780,1382265780,1,1,0
39527581@N07,5262,18,1382308201,1382308201,1,1,0
39527581@N07,5263,1,1385962899,1385962899,1,2,0
39527581@N07,5263,18,1385963138,1385963138,1,2,0
39527581@N07,5264,7,1444806461,1444806461,1,1,0
39527581@N07,5265,26,1444881308,1444881308,1,1,0
39539890@N02,5266,26,1286780750,1286780750,1,5,0
39539890@N02,5266,31,1286779981,1286779981,1,5,0
39539890@N02,5266,21,1286779512,1286779512,1,5,0
39539890@N02,5266,11,1286779507,1286779507,1,5,0
39539890@N02,5266,9,1286778505,1286778505,1,5,0
39561617@N03,5267,14,1307075330,1307075330,1,2,0
39561617@N03,5267,4,1307077543,1307077543,1,2,0
39561617@N03,5268,1,1369536031,1369536031,1,1,0
39713096@N04,5269,1,1219091861,1219091861,1,1,0
39713096@N04,5270,26,1377314004,1377348751,8,1,34747
39713096@N04,5271,26,1377384459,1377390119,2,1,5660
39713096@N04,5272,26,1377420732,1377424279,6,1,3547
39713096@N04,5273,26,1377554025,1377588629,7,1,34604
39713096@N04,5274,26,1377643723,1377651220,4,1,7497
39713096@N04,5275,26,1377768001,1377778095,4,1,10094
39726265@N00,5276,28,1239956539,1239975018,16,2,18479
39726265@N00,5276,29,1239959047,1239971232,25,2,12185
39726265@N00,5277,13,1240107112,1240107281,5,6,169
39726265@N00,5277,21,1240102703,1240102703,1,6,0
39726265@N00,5277,9,1240102859,1240102875,3,6,16
39726265@N00,5277,18,1240102099,1240102099,1,6,0
39726265@N00,5277,29,1240103484,1240105241,9,6,1757
39726265@N00,5277,26,1240102454,1240102615,7,6,161
39758738@N03,5278,28,1290737065,1290737065,1,1,0
39758738@N03,5279,16,1388450468,1388450468,1,1,0
39758738@N03,5280,1,1388510584,1388510584,1,1,0
39763571@N07,5281,26,1350296840,1350296840,1,1,0
39763571@N07,5282,28,1355705707,1355705707,1,1,0
39766433@N00,5283,24,1196579545,1196579545,1,1,0
39766433@N00,5284,17,1197011969,1197011969,1,2,0
39766433@N00,5284,3,1197016288,1197016288,1,2,0
39796133@N00,5285,29,1306070379,1306070379,1,1,0
39796133@N00,5286,16,1306113513,1306113513,1,1,0
39796133@N00,5287,3,1306204009,1306204009,1,2,0
39796133@N00,5287,13,1306198002,1306198002,1,2,0
39827687@N05,5288,3,1323921600,1323921600,4,1,0
39827687@N05,5289,3,1328234103,1328246855,7,1,12752
39827687@N05,5290,3,1328320281,1328327708,12,1,7427
39827687@N05,5291,3,1350029976,1350038973,3,1,8997
39827687@N05,5292,3,1350162442,1350162442,1,1,0
39857329@N04,5293,8,1276777423,1276777423,1,1,0
39892743@N04,5294,28,1321011688,1321011688,1,1,0
39892743@N04,5295,28,1325046546,1325046546,1,1,0
39892743@N04,5296,28,1328344516,1328344516,1,1,0
39892743@N04,5297,18,1331278148,1331278148,1,1,0
39894601@N00,5298,24,1252883757,1252883757,1,5,0
39894601@N00,5298,1,1252880137,1252883256,2,5,3119
39894601@N00,5298,6,1252888140,1252894554,22,5,6414
39894601@N00,5298,12,1252886749,1252887391,2,5,642
39894601@N00,5298,25,1252899249,1252899249,1,5,0
39932512@N00,5299,26,1304215144,1304215195,5,1,51
39953677@N06,5300,15,1343480286,1343480286,1,2,0
39953677@N06,5300,28,1343467293,1343502149,3,2,34856
39953677@N06,5301,28,1344006808,1344006808,1,1,0
39953677@N06,5302,1,1369570113,1369570113,1,1,0
39953677@N06,5303,1,1370403091,1370403091,1,3,0
39953677@N06,5303,28,1370397282,1370397282,1,3,0
39953677@N06,5303,4,1370424350,1370424350,1,3,0
39953677@N06,5304,26,1371960420,1371960420,1,3,0
39953677@N06,5304,23,1371957977,1371958402,2,3,425
39953677@N06,5304,17,1371953220,1371953220,1,3,0
39953677@N06,5305,13,1375592299,1375592299,1,2,0
39953677@N06,5305,1,1375588585,1375588585,1,2,0
39953677@N06,5306,1,1382229979,1382229979,1,2,0
39953677@N06,5306,20,1382231403,1382231403,1,2,0
39953677@N06,5307,5,1382267460,1382267460,1,2,0
39953677@N06,5307,1,1382267569,1382267569,1,2,0
39953677@N06,5308,29,1383028919,1383028919,1,4,0
39953677@N06,5308,26,1383053324,1383053324,1,4,0
39953677@N06,5308,1,1383019488,1383019488,1,4,0
39953677@N06,5308,28,1383053586,1383053586,1,4,0
39953677@N06,5309,26,1383377345,1383377418,2,4,73
39953677@N06,5309,3,1383390244,1383390244,1,4,0
39953677@N06,5309,17,1383387221,1383387221,1,4,0
39953677@N06,5309,1,1383386323,1383386323,1,4,0
39953677@N06,5310,1,1384575559,1384575559,1,1,0
39953677@N06,5311,1,1384617131,1384617131,1,1,0
39953677@N06,5312,1,1385250931,1385296670,6,4,45739
39953677@N06,5312,18,1385256439,1385256439,1,4,0
39953677@N06,5312,11,1385294488,1385294488,1,4,0
39953677@N06,5312,17,1385263002,1385263002,1,4,0
39953677@N06,5313,1,1391848798,1391852218,2,1,3420
39953677@N06,5314,1,1394327797,1394349563,4,2,21766
39953677@N06,5314,30,1394326751,1394326751,1,2,0
39976152@N00,5315,29,1329803063,1329803063,1,1,0
39976152@N00,5316,20,1330113892,1330113892,1,1,0
39980698@N02,5317,13,1386328435,1386328435,1,1,0
39980698@N02,5318,26,1386421578,1386421578,1,1,0
40033932@N00,5319,26,1468367275,1468367275,1,1,0
40086524@N03,5320,30,1470300380,1470300380,1,11,0
40086524@N03,5320,18,1470297426,1470297426,1,11,0
40086524@N03,5320,25,1470287921,1470288368,5,11,447
40086524@N03,5320,23,1470297358,1470307286,3,11,9928
40086524@N03,5320,28,1470276922,1470309463,8,11,32541
40086524@N03,5320,29,1470297717,1470297717,1,11,0
40086524@N03,5320,13,1470282972,1470287897,6,11,4925
40086524@N03,5320,26,1470277100,1470307764,4,11,30664
40086524@N03,5320,19,1470297980,1470305767,5,11,7787
40086524@N03,5320,15,1470291808,1470293499,5,11,1691
40086524@N03,5320,24,1470279023,1470279215,5,11,192
40086524@N03,5321,20,1470735586,1470736450,4,8,864
40086524@N03,5321,23,1470744881,1470746430,3,8,1549
40086524@N03,5321,29,1470733103,1470733103,1,8,0
40086524@N03,5321,16,1470744409,1470744409,1,8,0
40086524@N03,5321,26,1470744482,1470744482,1,8,0
40086524@N03,5321,19,1470737529,1470746434,9,8,8905
40086524@N03,5321,15,1470742827,1470742827,1,8,0
40086524@N03,5321,24,1470744086,1470744090,2,8,4
40128058@N02,5322,27,1243699911,1243699911,1,1,0
40128058@N02,5323,27,1243778682,1243778682,1,1,0
40128058@N02,5324,27,1308470517,1308470517,1,1,0
40135057@N03,5325,18,1422673907,1422673907,1,1,0
40144079@N00,5326,22,1259045916,1259046293,9,3,377
40144079@N00,5326,28,1259023033,1259023063,8,3,30
40144079@N00,5326,15,1259033870,1259035458,5,3,1588
40144079@N00,5327,22,1260678359,1260678367,2,3,8
40144079@N00,5327,28,1260666532,1260666550,2,3,18
40144079@N00,5327,6,1260682504,1260682526,4,3,22
40144079@N00,5328,28,1266372949,1266379538,30,3,6589
40144079@N00,5328,26,1266377907,1266377925,3,3,18
40144079@N00,5328,16,1266377189,1266377193,2,3,4
40144079@N00,5329,22,1266992197,1266993776,21,5,1579
40144079@N00,5329,28,1266982728,1266983093,9,5,365
40144079@N00,5329,16,1266973199,1266973218,5,5,19
40144079@N00,5329,21,1266973785,1266973957,9,5,172
40144079@N00,5329,24,1266977822,1266977827,2,5,5
40144079@N00,5330,23,1271922839,1271923473,7,3,634
40144079@N00,5330,29,1271926800,1271926820,5,3,20
40144079@N00,5330,28,1271916300,1271916339,2,3,39
40144079@N00,5331,29,1274586272,1274586281,2,2,9
40144079@N00,5331,6,1274579720,1274579762,5,2,42
40144079@N00,5332,16,1277690212,1277690314,5,2,102
40144079@N00,5332,22,1277699359,1277699419,9,2,60
40144079@N00,5333,28,1283920052,1283922138,3,1,2086
40144079@N00,5334,28,1290919749,1290921038,21,2,1289
40144079@N00,5334,25,1290907508,1290907981,6,2,473
40144079@N00,5335,14,1291946896,1291947309,19,2,413
40144079@N00,5335,7,1291951636,1291953158,11,2,1522
40144079@N00,5336,13,1295486861,1295488298,19,1,1437
40144079@N00,5337,30,1295591706,1295591756,3,3,50
40144079@N00,5337,11,1295588008,1295591357,7,3,3349
40144079@N00,5337,31,1295591645,1295593627,8,3,1982
40144079@N00,5338,11,1304825361,1304828143,25,1,2782
40144079@N00,5339,13,1306896947,1306897750,14,4,803
40144079@N00,5339,21,1306896239,1306896243,2,4,4
40144079@N00,5339,1,1306890398,1306890830,6,4,432
40144079@N00,5339,4,1306897950,1306897950,1,4,0
40144079@N00,5340,28,1307926540,1307928830,10,1,2290
40144079@N00,5341,6,1329792639,1329793147,4,3,508
40144079@N00,5341,7,1329792636,1329792636,1,3,0
40144079@N00,5341,29,1329778456,1329781664,7,3,3208
40160086@N05,5342,27,1356347946,1356348242,5,5,296
40160086@N05,5342,25,1356353785,1356353785,1,5,0
40160086@N05,5342,16,1356347941,1356348355,3,5,414
40160086@N05,5342,28,1356348660,1356348705,3,5,45
40160086@N05,5342,26,1356352100,1356352100,1,5,0
40160086@N05,5343,14,1356402955,1356402955,1,2,0
40160086@N05,5343,13,1356412111,1356412111,1,2,0
40164336@N00,5344,27,1205060092,1205060092,1,1,0
40170821@N06,5345,26,1421903066,1421903066,1,1,0
40185495@N00,5346,6,1356156124,1356156124,1,5,0
40185495@N00,5346,26,1356146458,1356156377,2,5,9919
40185495@N00,5346,21,1356148753,1356148924,2,5,171
40185495@N00,5346,28,1356158761,1356158761,1,5,0
40185495@N00,5346,25,1356147040,1356149746,4,5,2706
40262057@N06,5347,10,1243235208,1243235459,2,5,251
40262057@N06,5347,12,1243203793,1243204304,5,5,511
40262057@N06,5347,17,1243205658,1243205672,2,5,14
40262057@N06,5347,30,1243233466,1243235201,7,5,1735
40262057@N06,5347,31,1243234327,1243234736,2,5,409
40262057@N06,5348,19,1243316878,1243317665,3,6,787
40262057@N06,5348,12,1243291180,1243291180,1,6,0
40262057@N06,5348,25,1243298821,1243299954,15,6,1133
40262057@N06,5348,22,1243331110,1243331110,1,6,0
40262057@N06,5348,17,1243291301,1243291711,2,6,410
40262057@N06,5348,24,1243290764,1243291180,5,6,416
40262057@N06,5349,10,1243408228,1243410615,7,10,2387
40262057@N06,5349,15,1243401977,1243401977,1,10,0
40262057@N06,5349,26,1243403200,1243411511,8,10,8311
40262057@N06,5349,12,1243401970,1243403001,5,10,1031
40262057@N06,5349,21,1243403174,1243403277,2,10,103
40262057@N06,5349,23,1243422637,1243425008,3,10,2371
40262057@N06,5349,22,1243425913,1243426244,21,10,331
40262057@N06,5349,29,1243404308,1243406655,4,10,2347
40262057@N06,5349,17,1243402041,1243402041,1,10,0
40262057@N06,5349,30,1243422744,1243422975,4,10,231
40262057@N06,5350,31,1252664792,1252668113,43,2,3321
40262057@N06,5350,19,1252653981,1252653981,1,2,0
40262057@N06,5351,26,1259814834,1259838840,101,18,24006
40262057@N06,5351,13,1259818793,1259818793,1,18,0
40262057@N06,5351,25,1259817567,1259819070,54,18,1503
40262057@N06,5351,9,1259815980,1259815980,1,18,0
40262057@N06,5351,29,1259811918,1259825063,2,18,13145
40262057@N06,5351,27,1259820822,1259820822,1,18,0
40262057@N06,5351,7,1259816065,1259817311,5,18,1246
40262057@N06,5351,16,1259836602,1259836643,6,18,41
40262057@N06,5351,28,1259807154,1259839446,16,18,32292
40262057@N06,5351,22,1259813837,1259813859,3,18,22
40262057@N06,5351,18,1259808377,1259824772,2,18,16395
40262057@N06,5351,1,1259806899,1259807127,3,18,228
40262057@N06,5351,11,1259816588,1259816588,1,18,0
40262057@N06,5351,20,1259812122,1259813530,25,18,1408
40262057@N06,5351,30,1259814003,1259814024,3,18,21
40262057@N06,5351,6,1259815493,1259816108,14,18,615
40262057@N06,5351,12,1259817344,1259817526,3,18,182
40262057@N06,5351,17,1259822212,1259823576,10,18,1364
40262057@N06,5352,3,1259910395,1259910470,2,13,75
40262057@N06,5352,26,1259880814,1259881332,26,13,518
40262057@N06,5352,23,1259922560,1259922560,1,13,0
40262057@N06,5352,29,1259881747,1259931130,54,13,49383
40262057@N06,5352,16,1259880862,1259880947,3,13,85
40262057@N06,5352,30,1259931040,1259931044,3,13,4
40262057@N06,5352,28,1259880520,1259904844,22,13,24324
40262057@N06,5352,10,1259909538,1259909822,8,13,284
40262057@N06,5352,1,1259905814,1259906674,65,13,860
40262057@N06,5352,31,1259929915,1259931206,37,13,1291
40262057@N06,5352,20,1259881939,1259882570,43,13,631
40262057@N06,5352,25,1259911155,1259916165,19,13,5010
40262057@N06,5352,12,1259880838,1259880954,2,13,116
40262057@N06,5353,25,1260013551,1260014499,6,7,948
40262057@N06,5353,21,1260011264,1260012918,3,7,1654
40262057@N06,5353,30,1259990580,1259995612,5,7,5032
40262057@N06,5353,22,1259989680,1259989683,2,7,3
40262057@N06,5353,20,1259979265,1259988246,24,7,8981
40262057@N06,5353,18,1259986617,1259986680,2,7,63
40262057@N06,5353,19,1259986372,1259986551,6,7,179
40262057@N06,5354,16,1260104070,1260104070,1,8,0
40262057@N06,5354,26,1260085143,1260109706,7,8,24563
40262057@N06,5354,23,1260066076,1260066741,3,8,665
40262057@N06,5354,29,1260069409,1260081696,29,8,12287
40262057@N06,5354,10,1260084733,1260084733,1,8,0
40262057@N06,5354,20,1260070032,1260071635,7,8,1603
40262057@N06,5354,28,1260109606,1260109741,2,8,135
40262057@N06,5354,7,1260084989,1260089160,9,8,4171
40262057@N06,5355,29,1309852868,1309866456,30,4,13588
40262057@N06,5355,27,1309856406,1309859194,27,4,2788
40262057@N06,5355,31,1309862517,1309865157,25,4,2640
40262057@N06,5355,20,1309854633,1309855577,15,4,944
40262057@N06,5356,26,1309925214,1309925429,10,12,215
40262057@N06,5356,25,1309920673,1309920928,9,12,255
40262057@N06,5356,29,1309914106,1309929425,24,12,15319
40262057@N06,5356,23,1309931151,1309932268,13,12,1117
40262057@N06,5356,27,1309905034,1309905885,9,12,851
40262057@N06,5356,7,1309943908,1309944631,4,12,723
40262057@N06,5356,30,1309914102,1309914102,1,12,0
40262057@N06,5356,28,1309911449,1309911484,6,12,35
40262057@N06,5356,17,1309907980,1309909251,7,12,1271
40262057@N06,5356,10,1309944836,1309945709,6,12,873
40262057@N06,5356,5,1309943269,1309944105,4,12,836
40262057@N06,5356,20,1309912720,1309914007,12,12,1287
40262057@N06,5357,25,1310014251,1310014851,11,1,600
40262057@N06,5358,3,1310083730,1310085241,6,7,1511
40262057@N06,5358,29,1310089541,1310095728,10,7,6187
40262057@N06,5358,27,1310108940,1310108949,2,7,9
40262057@N06,5358,30,1310100554,1310100694,7,7,140
40262057@N06,5358,16,1310104440,1310104507,5,7,67
40262057@N06,5358,5,1310084824,1310086132,6,7,1308
40262057@N06,5358,12,1310082812,1310083931,27,7,1119
40262057@N06,5359,16,1310203705,1310203720,2,10,15
40262057@N06,5359,26,1310173407,1310217044,6,10,43637
40262057@N06,5359,23,1310205677,1310205677,1,10,0
40262057@N06,5359,29,1310188770,1310216674,10,10,27904
40262057@N06,5359,27,1310198666,1310210562,5,10,11896
40262057@N06,5359,31,1310215893,1310216156,9,10,263
40262057@N06,5359,5,1310170948,1310171159,2,10,211
40262057@N06,5359,30,1310186591,1310186604,2,10,13
40262057@N06,5359,12,1310170894,1310210219,4,10,39325
40262057@N06,5359,19,1310188676,1310190848,8,10,2172
40262057@N06,5360,16,1320314212,1320314212,1,1,0
40262057@N06,5361,25,1321066497,1321079316,35,18,12819
40262057@N06,5361,29,1321010654,1321051613,15,18,40959
40262057@N06,5361,24,1321062342,1321062345,6,18,3
40262057@N06,5361,11,1321056423,1321057788,5,18,1365
40262057@N06,5361,20,1321052706,1321088827,12,18,36121
40262057@N06,5361,12,1321062110,1321063828,10,18,1718
40262057@N06,5361,10,1321054348,1321054584,8,18,236
40262057@N06,5361,9,1321059005,1321059005,1,18,0
40262057@N06,5361,17,1321005776,1321048590,23,18,42814
40262057@N06,5361,31,1321010449,1321011759,62,18,1310
40262057@N06,5361,4,1321057677,1321057875,5,18,198
40262057@N06,5361,27,1321002082,1321013861,7,18,11779
40262057@N06,5361,7,1321058240,1321058259,3,18,19
40262057@N06,5361,1,1321045801,1321045826,2,18,25
40262057@N06,5361,28,1321001864,1321046131,10,18,44267
40262057@N06,5361,5,1321058626,1321058626,1,18,0
40262057@N06,5361,14,1321009347,1321009389,2,18,42
40262057@N06,5361,26,1321016869,1321091328,10,18,74459
40262057@N06,5362,29,1321152821,1321152826,2,7,5
40262057@N06,5362,26,1321177849,1321178347,13,7,498
40262057@N06,5362,20,1321156355,1321158487,18,7,2132
40262057@N06,5362,12,1321163001,1321163037,3,7,36
40262057@N06,5362,17,1321178823,1321178848,2,7,25
40262057@N06,5362,1,1321137144,1321137144,1,7,0
40262057@N06,5362,3,1321168550,1321174651,4,7,6101
40262057@N06,5363,29,1321231030,1321232382,5,7,1352
40262057@N06,5363,26,1321228390,1321257130,11,7,28740
40262057@N06,5363,20,1321228962,1321230814,10,7,1852
40262057@N06,5363,17,1321235431,1321235439,3,7,8
40262057@N06,5363,31,1321232241,1321232264,2,7,23
40262057@N06,5363,1,1321245600,1321245600,1,7,0
40262057@N06,5363,28,1321249012,1321254395,30,7,5383
40277798@N08,5364,26,1275828750,1275828750,1,1,0
40291653@N08,5365,25,1305608147,1305608147,1,5,0
40291653@N08,5365,13,1305610179,1305610179,1,5,0
40291653@N08,5365,20,1305621396,1305621396,1,5,0
40291653@N08,5365,12,1305626614,1305626614,1,5,0
40291653@N08,5365,26,1305605468,1305626475,2,5,21007
40294731@N06,5366,7,1277462783,1277462783,1,1,0
40364661@N00,5367,1,1390166392,1390166392,1,1,0
40364968@N04,5368,16,1325453230,1325479826,106,1,26596
40371941@N00,5369,28,1353488233,1353488233,1,4,0
40371941@N00,5369,18,1353487031,1353487031,1,4,0
40371941@N00,5369,26,1353487827,1353488192,3,4,365
40371941@N00,5369,15,1353500951,1353501187,2,4,236
40404453@N04,5370,1,1342867402,1342867532,6,1,130
40414712@N00,5371,28,1288957834,1288958516,2,1,682
40414712@N00,5372,1,1289002939,1289027304,2,5,24365
40414712@N00,5372,24,1289013346,1289013346,1,5,0
40414712@N00,5372,15,1289041741,1289041741,1,5,0
40414712@N00,5372,26,1289033198,1289033198,1,5,0
40414712@N00,5372,28,1289026793,1289038423,4,5,11630
40414712@N00,5373,1,1289098875,1289098875,1,2,0
40414712@N00,5373,29,1289100201,1289100201,1,2,0
40414712@N00,5374,10,1315468723,1315468723,1,1,0
40429316@N00,5375,18,1451085576,1451091612,2,1,6036
40429316@N00,5376,18,1451126098,1451126948,2,2,850
40429316@N00,5376,25,1451127033,1451127033,1,2,0
40432809@N05,5377,30,1256867736,1256867736,1,2,0
40432809@N05,5377,20,1256881381,1256881381,1,2,0
40482053@N07,5378,30,1395551996,1395551996,1,1,0
40503355@N00,5379,26,1252100320,1252100320,1,1,0
40522857@N07,5380,12,1321748787,1321748787,1,1,0
40542539@N00,5381,1,1325118273,1325118273,1,1,0
40563308@N02,5382,29,1236993391,1236995019,3,1,1628
40563308@N02,5383,29,1243734047,1243734459,2,3,412
40563308@N02,5383,16,1243737263,1243737263,1,3,0
40563308@N02,5383,17,1243746012,1243746012,1,3,0
40563308@N02,5384,29,1245538130,1245539404,2,1,1274
40563308@N02,5385,12,1253399379,1253399379,1,7,0
40563308@N02,5385,3,1253398564,1253398564,1,7,0
40563308@N02,5385,30,1253405804,1253405804,1,7,0
40563308@N02,5385,26,1253409517,1253409782,3,7,265
40563308@N02,5385,18,1253407199,1253407199,1,7,0
40563308@N02,5385,5,1253398561,1253398561,1,7,0
40563308@N02,5385,22,1253403621,1253403621,1,7,0
40563308@N02,5386,20,1254093736,1254093736,1,4,0
40563308@N02,5386,28,1254088753,1254105459,2,4,16706
40563308@N02,5386,5,1254089401,1254089401,1,4,0
40563308@N02,5386,12,1254090240,1254090240,1,4,0
40563308@N02,5387,29,1258247666,1258247666,1,3,0
40563308@N02,5387,10,1258257297,1258257297,1,3,0
40563308@N02,5387,18,1258258974,1258258974,1,3,0
40563308@N02,5388,20,1261545960,1261545960,1,2,0
40563308@N02,5388,25,1261533683,1261533683,1,2,0
40563308@N02,5389,20,1263683552,1263684173,6,8,621
40563308@N02,5389,29,1263683142,1263683258,2,8,116
40563308@N02,5389,30,1263680108,1263680108,1,8,0
40563308@N02,5389,15,1263687014,1263706721,6,8,19707
40563308@N02,5389,26,1263680645,1263680694,3,8,49
40563308@N02,5389,1,1263679602,1263679602,1,8,0
40563308@N02,5389,18,1263680135,1263680135,1,8,0
40563308@N02,5389,16,1263686442,1263686442,1,8,0
40563308@N02,5390,19,1269748440,1269748440,1,2,0
40563308@N02,5390,20,1269748442,1269748442,1,2,0
40563308@N02,5391,6,1270502553,1270502553,1,6,0
40563308@N02,5391,7,1270502501,1270502501,1,6,0
40563308@N02,5391,30,1270511327,1270511327,1,6,0
40563308@N02,5391,1,1270521015,1270521029,2,6,14
40563308@N02,5391,23,1270507838,1270507838,1,6,0
40563308@N02,5391,29,1270504863,1270516175,3,6,11312
40563308@N02,5392,4,1276825639,1276825639,1,3,0
40563308@N02,5392,20,1276821098,1276821597,2,3,499
40563308@N02,5392,13,1276826230,1276826230,1,3,0
40563308@N02,5393,18,1279078259,1279078259,1,1,0
40563308@N02,5394,30,1280015864,1280015864,1,7,0
40563308@N02,5394,4,1280010870,1280010870,1,7,0
40563308@N02,5394,10,1280016353,1280016353,1,7,0
40563308@N02,5394,20,1280013483,1280013483,1,7,0
40563308@N02,5394,15,1280017549,1280017549,1,7,0
40563308@N02,5394,25,1280009468,1280009468,1,7,0
40563308@N02,5394,11,1280011330,1280011330,1,7,0
40563308@N02,5395,29,1280047450,1280047450,1,1,0
40563308@N02,5396,18,1282348514,1282348514,1,4,0
40563308@N02,5396,9,1282361282,1282361295,2,4,13
40563308@N02,5396,28,1282376837,1282376850,2,4,13
40563308@N02,5396,29,1282344469,1282350148,2,4,5679
40563308@N02,5397,12,1284762103,1284762103,1,1,0
40563308@N02,5398,13,1289019320,1289019320,1,1,0
40563308@N02,5399,26,1289083405,1289083405,1,1,0
40563308@N02,5400,18,1292110955,1292110955,1,7,0
40563308@N02,5400,12,1292102991,1292102991,1,7,0
40563308@N02,5400,30,1292105685,1292105685,1,7,0
40563308@N02,5400,29,1292107243,1292111020,4,7,3777
40563308@N02,5400,10,1292114114,1292114114,1,7,0
40563308@N02,5400,11,1292114112,1292114112,1,7,0
40563308@N02,5400,26,1292112876,1292112884,2,7,8
40563308@N02,5401,18,1294445676,1294445676,1,2,0
40563308@N02,5401,19,1294444025,1294444025,1,2,0
40563308@N02,5402,24,1301187938,1301188180,2,3,242
40563308@N02,5402,28,1301190837,1301190837,1,3,0
40563308@N02,5402,26,1301188744,1301188744,1,3,0
40563308@N02,5403,30,1301799058,1301799058,1,1,0
40563308@N02,5404,30,1303117738,1303117738,1,2,0
40563308@N02,5404,29,1303112792,1303114370,5,2,1578
40563308@N02,5405,12,1303165809,1303165809,1,4,0
40563308@N02,5405,30,1303173417,1303173446,2,4,29
40563308@N02,5405,1,1303162989,1303162989,1,4,0
40563308@N02,5405,26,1303175551,1303175614,2,4,63
40563308@N02,5406,14,1303257625,1303257743,12,5,118
40563308@N02,5406,10,1303253112,1303253112,1,5,0
40563308@N02,5406,31,1303259545,1303259545,1,5,0
40563308@N02,5406,11,1303250735,1303250826,2,5,91
40563308@N02,5406,29,1303255108,1303259555,4,5,4447
40563308@N02,5407,30,1303294954,1303294954,1,2,0
40563308@N02,5407,29,1303292453,1303295062,2,2,2609
40563308@N02,5408,1,1303379429,1303379429,1,2,0
40563308@N02,5408,28,1303355761,1303355824,8,2,63
40563308@N02,5409,19,1310858073,1310858073,1,1,0
40563308@N02,5410,28,1311572147,1311572482,4,1,335
40563308@N02,5411,17,1316304022,1316304022,1,2,0
40563308@N02,5411,20,1316301396,1316301396,1,2,0
40563308@N02,5412,6,1367558476,1367558476,1,1,0
40563308@N02,5413,29,1374191980,1374192042,3,2,62
40563308@N02,5413,12,1374187547,1374187547,1,2,0
40563308@N02,5414,28,1379130596,1379130662,2,5,66
40563308@N02,5414,29,1379120325,1379120647,2,5,322
40563308@N02,5414,31,1379125209,1379125209,1,5,0
40563308@N02,5414,16,1379153285,1379153285,1,5,0
40563308@N02,5414,18,1379129563,1379129563,1,5,0
40563308@N02,5415,9,1399605525,1399605525,1,1,0
40579602@N00,5416,4,1195735857,1195735857,1,8,0
40579602@N00,5416,31,1195731528,1195731931,3,8,403
40579602@N00,5416,29,1195703537,1195729397,4,8,25860
40579602@N00,5416,3,1195735949,1195735949,1,8,0
40579602@N00,5416,23,1195703886,1195703886,1,8,0
40579602@N00,5416,26,1195735172,1195735172,1,8,0
40579602@N00,5416,9,1195735401,1195735401,1,8,0
40579602@N00,5416,28,1195714707,1195735970,13,8,21263
40579602@N00,5417,30,1258764657,1258769641,9,3,4984
40579602@N00,5417,23,1258761550,1258761550,1,3,0
40579602@N00,5417,28,1258759201,1258759201,1,3,0
40579602@N00,5418,27,1277518245,1277518253,2,1,8
40629276@N07,5419,28,1383454703,1383454703,1,1,0
40629276@N07,5420,19,1401059921,1401059921,1,1,0
40708728@N04,5421,29,1297486810,1297486810,1,1,0
40708728@N04,5422,1,1299414913,1299414913,1,1,0
40708728@N04,5423,10,1313319120,1313319120,1,2,0
40708728@N04,5423,24,1313318146,1313318146,1,2,0
40708728@N04,5424,13,1316931740,1316931740,1,5,0
40708728@N04,5424,4,1316943810,1316943810,1,5,0
40708728@N04,5424,6,1316953181,1316953181,1,5,0
40708728@N04,5424,19,1316948479,1316948479,1,5,0
40708728@N04,5424,22,1316938388,1316938388,1,5,0
40708728@N04,5425,4,1317373004,1317373004,1,1,0
40708728@N04,5426,22,1317546524,1317546524,1,1,0
40708728@N04,5427,7,1318756335,1318756335,1,3,0
40708728@N04,5427,15,1318764663,1318764663,1,3,0
40708728@N04,5427,16,1318765154,1318765154,1,3,0
40708728@N04,5428,28,1319975709,1319976984,3,7,1275
40708728@N04,5428,1,1319977545,1319977545,1,7,0
40708728@N04,5428,29,1319973033,1319973033,1,7,0
40708728@N04,5428,30,1319974895,1319974895,1,7,0
40708728@N04,5428,20,1319973121,1319973121,1,7,0
40708728@N04,5428,11,1319967009,1319967009,1,7,0
40708728@N04,5428,26,1319974044,1319974253,2,7,209
40708728@N04,5429,8,1320552435,1320552435,1,2,0
40708728@N04,5429,22,1320575575,1320575575,1,2,0
40708728@N04,5430,29,1321783960,1321783960,1,2,0
40708728@N04,5430,28,1321798115,1321798122,2,2,7
40708728@N04,5431,23,1324394060,1324394060,1,1,0
40708728@N04,5432,29,1326020650,1326020650,1,1,0
40708728@N04,5433,20,1329722910,1329722910,1,1,0
40708728@N04,5434,23,1333027161,1333027161,1,1,0
40708728@N04,5435,29,1333892925,1333893434,2,3,509
40708728@N04,5435,8,1333892309,1333892309,1,3,0
40708728@N04,5435,17,1333891172,1333891172,1,3,0
40708728@N04,5436,14,1336913353,1336913353,1,1,0
40708728@N04,5437,28,1338215884,1338216127,2,1,243
40708728@N04,5438,27,1343568154,1343568154,1,1,0
40708728@N04,5439,1,1350823129,1350823129,1,3,0
40708728@N04,5439,23,1350801734,1350801734,1,3,0
40708728@N04,5439,28,1350822677,1350822677,1,3,0
40708728@N04,5440,28,1352037038,1352037463,2,4,425
40708728@N04,5440,27,1352035675,1352035675,1,4,0
40708728@N04,5440,13,1352031246,1352033887,4,4,2641
40708728@N04,5440,24,1352034735,1352034735,1,4,0
40708728@N04,5441,22,1353851941,1353851941,1,1,0
40708728@N04,5442,9,1359292408,1359292408,1,4,0
40708728@N04,5442,16,1359293296,1359293296,1,4,0
40708728@N04,5442,28,1359293939,1359293939,1,4,0
40708728@N04,5442,26,1359293103,1359293103,1,4,0
40708728@N04,5443,28,1364564782,1364566114,3,1,1332
40732565660@N01,5444,24,1241087058,1241087251,3,6,193
40732565660@N01,5444,27,1241085540,1241090164,10,6,4624
40732565660@N01,5444,15,1241087653,1241087653,1,6,0
40732565660@N01,5444,26,1241057685,1241057685,1,6,0
40732565660@N01,5444,16,1241088409,1241089195,4,6,786
40732565660@N01,5444,13,1241061645,1241078879,6,6,17234
40732565660@N01,5445,21,1241144679,1241146923,30,7,2244
40732565660@N01,5445,29,1241154532,1241154532,1,7,0
40732565660@N01,5445,28,1241170186,1241170186,1,7,0
40732565660@N01,5445,23,1241162519,1241163296,3,7,777
40732565660@N01,5445,7,1241150215,1241150223,2,7,8
40732565660@N01,5445,11,1241167910,1241167956,4,7,46
40732565660@N01,5445,13,1241146766,1241149042,25,7,2276
40732565660@N01,5446,7,1241230460,1241253855,10,3,23395
40732565660@N01,5446,16,1241255136,1241272595,7,3,17459
40732565660@N01,5446,4,1241252598,1241252598,1,3,0
40732565660@N01,5447,28,1241324959,1241346941,6,1,21982
40733386@N02,5448,28,1337950982,1337950982,1,1,0
40785688@N08,5449,31,1341893803,1341893803,1,1,0
40868192@N07,5450,22,1248178058,1248178058,1,1,0
40868192@N07,5451,26,1248228341,1248229754,4,1,1413
40868192@N07,5452,26,1248318822,1248318822,1,6,0
40868192@N07,5452,20,1248314538,1248315671,2,6,1133
40868192@N07,5452,25,1248322953,1248322953,1,6,0
40868192@N07,5452,18,1248317243,1248317815,2,6,572
40868192@N07,5452,28,1248317111,1248327753,2,6,10642
40868192@N07,5452,29,1248316165,1248316943,2,6,778
40868192@N07,5453,30,1248432371,1248432449,2,1,78
40868192@N07,5454,6,1248477404,1248477404,1,5,0
40868192@N07,5454,13,1248483287,1248483287,1,5,0
40868192@N07,5454,7,1248477300,1248478408,2,5,1108
40868192@N07,5454,25,1248484454,1248485309,3,5,855
40868192@N07,5454,29,1248502773,1248509538,7,5,6765
40868192@N07,5455,26,1248565855,1248566278,5,4,423
40868192@N07,5455,20,1248578235,1248578235,1,4,0
40868192@N07,5455,30,1248566497,1248566497,1,4,0
40868192@N07,5455,5,1248564432,1248564432,1,4,0
40879331@N06,5456,15,1385167186,1385167186,1,2,0
40879331@N06,5456,3,1385172152,1385172152,1,2,0
40879331@N06,5457,27,1407330599,1407330599,1,1,0
40879331@N06,5458,18,1446947740,1446947740,1,1,0
40904999@N05,5459,15,1354670909,1354670909,1,1,0
40910200@N06,5460,20,1329381468,1329381985,4,1,517
40910200@N06,5461,26,1329468848,1329469462,15,1,614
40910200@N06,5462,28,1329542134,1329542134,1,2,0
40910200@N06,5462,29,1329547099,1329547099,1,2,0
40910200@N06,5463,28,1331511656,1331511656,1,2,0
40910200@N06,5463,26,1331514060,1331514060,1,2,0
40910200@N06,5464,11,1331597694,1331600394,2,2,2700
40910200@N06,5464,3,1331599663,1331599663,1,2,0
40910200@N06,5465,18,1331715313,1331715313,1,2,0
40910200@N06,5465,29,1331727609,1331727609,1,2,0
40910200@N06,5466,20,1349838844,1349841582,10,6,2738
40910200@N06,5466,15,1349830215,1349830304,2,6,89
40910200@N06,5466,29,1349836538,1349838531,4,6,1993
40910200@N06,5466,23,1349836198,1349836198,1,6,0
40910200@N06,5466,1,1349825035,1349825932,3,6,897
40910200@N06,5466,21,1349832252,1349832615,3,6,363
40910200@N06,5467,28,1349912784,1349914930,2,3,2146
40910200@N06,5467,17,1349935673,1349935673,1,3,0
40910200@N06,5467,12,1349917896,1349918133,2,3,237
40910200@N06,5468,31,1350014319,1350014319,1,5,0
40910200@N06,5468,1,1350005835,1350005835,1,5,0
40910200@N06,5468,30,1350011508,1350014720,2,5,3212
40910200@N06,5468,14,1350018814,1350018814,1,5,0
40910200@N06,5468,26,1350031140,1350031140,1,5,0
40938484@N02,5469,7,1293329102,1293329102,1,2,0
40938484@N02,5469,3,1293351825,1293351825,1,2,0
40938484@N02,5470,25,1324602525,1324625903,2,1,23378
40938484@N02,5471,12,1365208697,1365208697,1,2,0
40938484@N02,5471,25,1365217415,1365217415,1,2,0
40964166@N05,5472,12,1252576418,1252576429,3,9,11
40964166@N05,5472,31,1252579770,1252579967,2,9,197
40964166@N05,5472,22,1252579777,1252582581,2,9,2804
40964166@N05,5472,30,1252579194,1252579665,3,9,471
40964166@N05,5472,28,1252603980,1252603980,1,9,0
40964166@N05,5472,24,1252596666,1252596685,3,9,19
40964166@N05,5472,16,1252593253,1252593253,1,9,0
40964166@N05,5472,17,1252597859,1252597859,1,9,0
40964166@N05,5472,10,1252578210,1252578339,6,9,129
40990827@N06,5473,17,1313834327,1313834327,1,1,0
41047258@N00,5474,21,1255148980,1255148980,1,2,0
41047258@N00,5474,29,1255152523,1255152523,1,2,0
41047258@N00,5475,18,1289096298,1289096298,1,2,0
41047258@N00,5475,17,1289105062,1289105062,1,2,0
41047258@N00,5476,31,1335670205,1335670205,1,7,0
41047258@N00,5476,23,1335674017,1335674017,1,7,0
41047258@N00,5476,11,1335686541,1335686541,1,7,0
41047258@N00,5476,30,1335668973,1335672831,2,7,3858
41047258@N00,5476,13,1335678099,1335678255,4,7,156
41047258@N00,5476,1,1335684390,1335684493,2,7,103
41047258@N00,5476,20,1335666391,1335666391,1,7,0
41085159@N00,5477,15,1462504847,1462504847,1,1,0
41090954@N07,5478,1,1371017898,1371017898,1,2,0
41090954@N07,5478,22,1371025883,1371025883,1,2,0
41125479@N07,5479,17,1287277360,1287277360,1,2,0
41125479@N07,5479,9,1287280921,1287280921,1,2,0
41125479@N07,5480,20,1287882479,1287904040,2,1,21561
41126359@N00,5481,23,1286723337,1286723337,1,1,0
41126359@N00,5482,26,1330843080,1330869357,2,1,26277
41126359@N00,5483,22,1331010889,1331010889,1,1,0
41131248@N00,5484,26,1449714337,1449716483,5,1,2146
41145933@N07,5485,29,1337909534,1337910064,2,1,530
41175571@N06,5486,26,1197845442,1197858079,2,1,12637
41175571@N06,5487,26,1198020273,1198020301,2,1,28
41175571@N06,5488,26,1222468158,1222501779,9,1,33621
41175571@N06,5489,26,1222563085,1222563085,1,1,0
41175571@N06,5490,26,1222651436,1222651732,7,1,296
41175571@N06,5491,26,1223428857,1223428857,1,1,0
41175571@N06,5492,26,1227136538,1227142686,5,1,6148
41175571@N06,5493,26,1227251838,1227252047,2,1,209
41175571@N06,5494,26,1227304419,1227305538,14,1,1119
41175571@N06,5495,26,1233791509,1233792134,4,1,625
41175571@N06,5496,26,1249377849,1249378885,7,1,1036
41175571@N06,5497,26,1249462904,1249462904,1,1,0
41175571@N06,5498,26,1252275559,1252280654,2,1,5095
41175571@N06,5499,26,1252373819,1252384062,9,1,10243
41184184@N00,5500,27,1314581488,1314581488,1,9,0
41184184@N00,5500,3,1314607465,1314607834,7,9,369
41184184@N00,5500,24,1314586250,1314586250,1,9,0
41184184@N00,5500,25,1314608133,1314608251,3,9,118
41184184@N00,5500,9,1314607313,1314607313,1,9,0
41184184@N00,5500,18,1314602488,1314602503,2,9,15
41184184@N00,5500,13,1314609325,1314613990,3,9,4665
41184184@N00,5500,1,1314619656,1314619656,1,9,0
41184184@N00,5500,29,1314578782,1314604160,2,9,25378
41197583@N00,5501,19,1208531108,1208531108,1,7,0
41197583@N00,5501,23,1208524373,1208524373,1,7,0
41197583@N00,5501,24,1208539263,1208539263,1,7,0
41197583@N00,5501,22,1208521961,1208524011,4,7,2050
41197583@N00,5501,31,1208521000,1208521000,1,7,0
41197583@N00,5501,17,1208555247,1208555309,3,7,62
41197583@N00,5501,7,1208547497,1208547514,2,7,17
41197583@N00,5502,3,1208602353,1208602353,1,2,0
41197583@N00,5502,13,1208603952,1208604319,2,2,367
41197583@N00,5503,26,1208689248,1208689248,1,1,0
41236077@N02,5504,26,1299815784,1299815784,1,1,0
41254815@N02,5505,26,1408256569,1408256666,2,2,97
41254815@N02,5505,29,1408255678,1408255678,1,2,0
41254815@N02,5506,13,1429315613,1429317311,4,4,1698
41254815@N02,5506,10,1429314108,1429314108,1,4,0
41254815@N02,5506,31,1429322401,1429322401,1,4,0
41254815@N02,5506,4,1429318593,1429318593,1,4,0
41259174@N07,5507,28,1359598430,1359598430,1,1,0
41266898@N04,5508,27,1293065350,1293065350,1,2,0
41266898@N04,5508,15,1293073529,1293073529,1,2,0
41266898@N04,5509,16,1293109243,1293109243,1,3,0
41266898@N04,5509,20,1293112046,1293112349,2,3,303
41266898@N04,5509,26,1293114483,1293115404,3,3,921
41266898@N04,5510,1,1293153603,1293153797,2,1,194
41278086@N00,5511,26,1256019126,1256019126,1,1,0
41287971@N08,5512,29,1339738178,1339738178,1,1,0
41296706@N00,5513,27,1307344595,1307346420,3,1,1825
41371213@N04,5514,22,1451635898,1451635898,1,7,0
41371213@N04,5514,15,1451636641,1451636641,1,7,0
41371213@N04,5514,20,1451627641,1451627641,1,7,0
41371213@N04,5514,18,1451606837,1451639262,7,7,32425
41371213@N04,5514,27,1451638357,1451638357,1,7,0
41371213@N04,5514,7,1451638922,1451638922,1,7,0
41371213@N04,5514,19,1451629466,1451629466,1,7,0
41372842@N00,5515,18,1350517554,1350517554,1,1,0
41453183@N05,5516,20,1351670282,1351670282,1,10,0
41453183@N05,5516,16,1351677543,1351677543,1,10,0
41453183@N05,5516,29,1351671755,1351671755,1,10,0
41453183@N05,5516,1,1351677914,1351685730,2,10,7816
41453183@N05,5516,28,1351682482,1351687684,12,10,5202
41453183@N05,5516,17,1351676186,1351676278,2,10,92
41453183@N05,5516,26,1351684595,1351684605,2,10,10
41453183@N05,5516,22,1351672128,1351672289,7,10,161
41453183@N05,5516,12,1351675480,1351675480,1,10,0
41453183@N05,5516,15,1351675762,1351675762,1,10,0
41453183@N05,5517,26,1351755519,1351755611,2,3,92
41453183@N05,5517,28,1351755660,1351755741,3,3,81
41453183@N05,5517,15,1351752793,1351752908,2,3,115
41453183@N05,5518,26,1351956151,1351959178,4,7,3027
41453183@N05,5518,3,1351957777,1351959787,2,7,2010
41453183@N05,5518,5,1351959739,1351959750,2,7,11
41453183@N05,5518,11,1351957975,1351957975,1,7,0
41453183@N05,5518,7,1351957068,1351959624,3,7,2556
41453183@N05,5518,15,1351956515,1351956515,1,7,0
41453183@N05,5518,4,1351958276,1351958525,3,7,249
41453183@N05,5519,26,1352012557,1352012582,2,9,25
41453183@N05,5519,29,1352009633,1352011919,12,9,2286
41453183@N05,5519,23,1352012401,1352012401,1,9,0
41453183@N05,5519,28,1352011612,1352011612,1,9,0
41453183@N05,5519,25,1352013041,1352013041,1,9,0
41453183@N05,5519,27,1352001174,1352003501,2,9,2327
41453183@N05,5519,18,1352011721,1352012525,8,9,804
41453183@N05,5519,19,1352009252,1352011798,2,9,2546
41453183@N05,5519,4,1352007592,1352007682,6,9,90
41453183@N05,5520,23,1352711731,1352711731,1,8,0
41453183@N05,5520,26,1352692813,1352693163,14,8,350
41453183@N05,5520,25,1352715750,1352715750,1,8,0
41453183@N05,5520,24,1352718530,1352720005,4,8,1475
41453183@N05,5520,16,1352692920,1352692920,1,8,0
41453183@N05,5520,28,1352707254,1352711287,4,8,4033
41453183@N05,5520,30,1352697950,1352697984,2,8,34
41453183@N05,5520,29,1352693466,1352713188,22,8,19722
41453183@N05,5521,28,1377306965,1377306965,1,1,0
41476650@N00,5522,29,1408691643,1408691643,1,1,0
41476650@N00,5523,26,1420771878,1420771878,1,2,0
41476650@N00,5523,14,1420778288,1420778288,1,2,0
41476650@N00,5524,3,1420840944,1420840944,1,2,0
41476650@N00,5524,18,1420854653,1420854653,1,2,0
41476650@N00,5525,7,1420887788,1420887788,1,1,0
41476650@N00,5526,22,1433553316,1433553316,1,1,0
41494703@N06,5527,14,1409529952,1409529952,1,1,0
41516706@N03,5528,23,1267166199,1267166199,1,2,0
41516706@N03,5528,28,1267165928,1267165928,1,2,0
41516706@N03,5529,8,1291097035,1291097035,1,4,0
41516706@N03,5529,20,1291079969,1291079969,1,4,0
41516706@N03,5529,23,1291085124,1291085124,1,4,0
41516706@N03,5529,26,1291094736,1291097277,2,4,2541
41516706@N03,5530,16,1317771342,1317771342,1,4,0
41516706@N03,5530,18,1317768810,1317768810,1,4,0
41516706@N03,5530,26,1317771433,1317771433,1,4,0
41516706@N03,5530,19,1317768881,1317768881,1,4,0
41540189@N05,5531,29,1334372786,1334372786,1,2,0
41540189@N05,5531,26,1334375775,1334375775,1,2,0
41540189@N05,5532,28,1350186315,1350186315,1,4,0
41540189@N05,5532,20,1350191233,1350191233,1,4,0
41540189@N05,5532,27,1350184567,1350184567,1,4,0
41540189@N05,5532,14,1350191209,1350191214,2,4,5
41548074@N04,5533,28,1392799996,1392799996,1,1,0
41548074@N04,5534,26,1392866092,1392866092,1,1,0
41556385@N06,5535,17,1241241750,1241241750,1,3,0
41556385@N06,5535,25,1241256772,1241256772,1,3,0
41556385@N06,5535,30,1241230254,1241230254,1,3,0
41556385@N06,5536,28,1241432334,1241432334,1,1,0
41556385@N06,5537,29,1306127130,1306127130,1,8,0
41556385@N06,5537,28,1306136839,1306136839,1,8,0
41556385@N06,5537,16,1306125662,1306125662,1,8,0
41556385@N06,5537,1,1306133099,1306133099,1,8,0
41556385@N06,5537,25,1306134715,1306134715,1,8,0
41556385@N06,5537,26,1306133635,1306133635,1,8,0
41556385@N06,5537,23,1306133334,1306135883,2,8,2549
41556385@N06,5537,13,1306133705,1306133705,1,8,0
41615479@N05,5538,1,1448039295,1448039295,1,1,0
41623624@N05,5539,5,1305967417,1305967417,1,2,0
41623624@N05,5539,17,1305947159,1305947159,1,2,0
41781191@N00,5540,25,1451523092,1451523092,1,1,0
41781191@N00,5541,18,1451624358,1451624358,1,1,0
41848523@N00,5542,28,1279626066,1279626190,2,1,124
41848523@N00,5543,29,1307170820,1307170820,1,1,0
41848523@N00,5544,26,1307277465,1307277465,1,3,0
41848523@N00,5544,28,1307282522,1307282522,1,3,0
41848523@N00,5544,29,1307274640,1307274640,1,3,0
41848523@N00,5545,25,1307412921,1307412921,1,5,0
41848523@N00,5545,1,1307410408,1307410408,1,5,0
41848523@N00,5545,16,1307410795,1307410795,1,5,0
41848523@N00,5545,10,1307416140,1307416140,1,5,0
41848523@N00,5545,8,1307411648,1307411648,1,5,0
41848523@N00,5546,26,1317616652,1317616652,1,1,0
41848523@N00,5547,23,1343099207,1343099207,1,1,0
41879028@N03,5548,16,1417661361,1417662409,4,1,1048
41879028@N03,5549,24,1421201184,1421201184,1,2,0
41879028@N03,5549,16,1421204034,1421204034,1,2,0
41894174086@N01,5550,22,1227317559,1227326382,4,7,8823
41894174086@N01,5550,30,1227323665,1227323933,3,7,268
41894174086@N01,5550,18,1227321840,1227322200,3,7,360
41894174086@N01,5550,15,1227336910,1227336910,1,7,0
41894174086@N01,5550,29,1227316019,1227316033,2,7,14
41894174086@N01,5550,31,1227317382,1227317382,1,7,0
41894174086@N01,5550,20,1227316234,1227316964,3,7,730
41894174086@N01,5551,3,1227480864,1227509953,2,11,29089
41894174086@N01,5551,22,1227492884,1227492884,2,11,0
41894174086@N01,5551,27,1227486601,1227486601,1,11,0
41894174086@N01,5551,12,1227478126,1227509500,2,11,31374
41894174086@N01,5551,16,1227489433,1227489433,1,11,0
41894174086@N01,5551,28,1227481921,1227481921,1,11,0
41894174086@N01,5551,21,1227509794,1227509794,1,11,0
41894174086@N01,5551,31,1227491870,1227492060,2,11,190
41894174086@N01,5551,26,1227510568,1227510568,1,11,0
41894174086@N01,5551,7,1227510085,1227510085,1,11,0
41894174086@N01,5551,24,1227479153,1227518297,2,11,39144
41896017@N05,5552,26,1387243189,1387243189,1,1,0
41915459@N08,5553,1,1383137982,1383137982,1,1,0
41927385@N00,5554,11,1323931024,1323931024,1,2,0
41927385@N00,5554,28,1323933962,1323933962,1,2,0
41996875@N05,5555,8,1407294837,1407294837,1,13,0
41996875@N05,5555,21,1407304307,1407304308,2,13,1
41996875@N05,5555,7,1407296273,1407296376,4,13,103
41996875@N05,5555,11,1407297863,1407297873,2,13,10
41996875@N05,5555,6,1407294838,1407294838,1,13,0
41996875@N05,5555,4,1407286603,1407287085,11,13,482
41996875@N05,5555,13,1407307768,1407308992,12,13,1224
41996875@N05,5555,14,1407288565,1407293375,18,13,4810
41996875@N05,5555,22,1407289091,1407293195,3,13,4104
41996875@N05,5555,28,1407301070,1407324437,3,13,23367
41996875@N05,5555,1,1407284620,1407284622,2,13,2
41996875@N05,5555,26,1407285188,1407305891,53,13,20703
41996875@N05,5555,25,1407311343,1407311714,15,13,371
42033249@N08,5556,26,1331333151,1331333151,1,1,0
42045401@N00,5557,28,1292972339,1292972339,1,1,0
42118699@N08,5558,1,1202789767,1202789767,1,2,0
42118699@N08,5558,26,1202778767,1202778767,1,2,0
42118699@N08,5559,29,1208746326,1208746326,1,1,0
42118699@N08,5560,16,1226793073,1226793073,1,1,0
42118699@N08,5561,6,1241680748,1241680748,1,2,0
42118699@N08,5561,31,1241657967,1241657967,1,2,0
42118699@N08,5562,18,1252303313,1252303313,1,1,0
42118699@N08,5563,29,1254129978,1254130425,2,1,447
42118699@N08,5564,8,1282634349,1282634349,1,4,0
42118699@N08,5564,26,1282634943,1282636653,4,4,1710
42118699@N08,5564,10,1282628034,1282628034,1,4,0
42118699@N08,5564,4,1282605093,1282606146,2,4,1053
42118699@N08,5565,29,1286172291,1286172291,1,1,0
42118699@N08,5566,16,1301485365,1301485365,1,2,0
42118699@N08,5566,30,1301489332,1301489399,2,2,67
42118699@N08,5567,1,1301531269,1301531269,1,1,0
42118699@N08,5568,18,1311756297,1311756868,3,2,571
42118699@N08,5568,27,1311748835,1311748835,1,2,0
42118699@N08,5569,3,1311812838,1311813209,3,3,371
42118699@N08,5569,30,1311808326,1311809718,3,3,1392
42118699@N08,5569,27,1311817319,1311820457,2,3,3138
42118699@N08,5570,31,1321261285,1321261285,1,3,0
42118699@N08,5570,4,1321256608,1321256608,1,3,0
42118699@N08,5570,27,1321251350,1321252522,2,3,1172
42118699@N08,5571,26,1321351495,1321351514,2,1,19
42118699@N08,5572,11,1321429028,1321429028,1,4,0
42118699@N08,5572,26,1321439187,1321439282,2,4,95
42118699@N08,5572,16,1321439943,1321439943,1,4,0
42118699@N08,5572,18,1321439709,1321439709,1,4,0
42118699@N08,5573,21,1340519966,1340519966,1,1,0
42118699@N08,5574,12,1358061699,1358061699,1,1,0
42118699@N08,5575,22,1358126912,1358126912,1,4,0
42118699@N08,5575,31,1358126956,1358126956,1,4,0
42118699@N08,5575,4,1358145705,1358145705,1,4,0
42118699@N08,5575,28,1358128337,1358128337,1,4,0
42118699@N08,5576,24,1358302410,1358302410,1,1,0
42118699@N08,5577,5,1362478520,1362478779,2,2,259
42118699@N08,5577,29,1362475774,1362475774,1,2,0
42118699@N08,5578,29,1362536570,1362536570,1,1,0
42118699@N08,5579,26,1372234722,1372234722,1,1,0
42118699@N08,5580,12,1375514819,1375514980,2,3,161
42118699@N08,5580,28,1375517158,1375517158,1,3,0
42118699@N08,5580,26,1375516673,1375517087,2,3,414
42118699@N08,5581,15,1379559157,1379559157,1,2,0
42118699@N08,5581,13,1379562893,1379565324,2,2,2431
42118699@N08,5582,26,1460118394,1460118394,1,1,0
42118699@N08,5583,25,1460174249,1460174249,1,3,0
42118699@N08,5583,15,1460168141,1460168141,1,3,0
42118699@N08,5583,16,1460176668,1460176668,1,3,0
42153022@N00,5584,10,1248768796,1248781348,16,1,12552
42153022@N00,5585,10,1248821193,1248960597,574,1,139404
42185804@N02,5586,10,1252304269,1252304269,1,1,0
42185804@N02,5587,17,1254040537,1254040537,1,4,0
42185804@N02,5587,27,1254013824,1254013824,1,4,0
42185804@N02,5587,24,1254041028,1254041028,1,4,0
42185804@N02,5587,15,1254040537,1254040537,1,4,0
42185804@N02,5588,24,1254998292,1254998292,2,1,0
42185804@N02,5589,17,1255276504,1255276504,1,1,0
42205475@N00,5590,28,1188185645,1188185654,2,1,9
42247438@N07,5591,26,1409397776,1409397776,1,1,0
42278743@N05,5592,26,1370494138,1370508194,8,1,14056
42285744@N02,5593,22,1307354327,1307354327,1,1,0
42285744@N02,5594,19,1311461406,1311461406,1,1,0
42299049@N06,5595,6,1256772763,1256773720,6,1,957
42299049@N06,5596,6,1257229132,1257231508,2,1,2376
42299049@N06,5597,6,1258419057,1258419173,3,1,116
42299049@N06,5598,6,1261052407,1261052407,1,1,0
42299049@N06,5599,6,1261797204,1261797204,1,1,0
42299049@N06,5600,6,1276240378,1276240378,1,1,0
42299049@N06,5601,6,1276336977,1276336977,2,1,0
42299049@N06,5602,6,1276504933,1276504933,1,1,0
42299049@N06,5603,6,1285507917,1285507917,1,1,0
42299049@N06,5604,6,1293188721,1293188721,1,1,0
42300125@N03,5605,7,1401155577,1401155577,1,1,0
42424870@N00,5606,1,1216984828,1216984828,1,1,0
42424870@N00,5607,1,1217050358,1217070284,2,1,19926
42429171@N07,5608,25,1227770501,1227770501,1,4,0
42429171@N07,5608,28,1227767956,1227767956,1,4,0
42429171@N07,5608,8,1227768732,1227768732,1,4,0
42429171@N07,5608,26,1227768486,1227768596,3,4,110
42429171@N07,5609,26,1238323036,1238323036,1,1,0
42429171@N07,5610,22,1255237061,1255237086,2,1,25
42504117@N06,5611,12,1278914135,1278914135,1,2,0
42504117@N06,5611,31,1278914138,1278914138,1,2,0
42504117@N06,5612,31,1284206721,1284206721,1,1,0
42504117@N06,5613,9,1326678182,1326693312,2,1,15130
42504117@N06,5614,9,1337132990,1337132990,1,2,0
42504117@N06,5614,10,1337132955,1337132955,1,2,0
42504117@N06,5615,9,1405841036,1405841060,18,4,24
42504117@N06,5615,16,1405841035,1405841035,1,4,0
42504117@N06,5615,10,1405841039,1405841040,2,4,1
42504117@N06,5615,26,1405841047,1405841047,1,4,0
42504117@N06,5616,17,1408511821,1408511821,1,2,0
42504117@N06,5616,9,1408511821,1408511821,1,2,0
42504117@N06,5617,9,1409639231,1409639231,1,1,0
42504117@N06,5618,9,1415153342,1415153342,2,1,0
42504117@N06,5619,9,1417486259,1417486259,1,1,0
42504117@N06,5620,26,1461043238,1461047720,6,4,4482
42504117@N06,5620,28,1461062999,1461063078,9,4,79
42504117@N06,5620,17,1461030927,1461030937,2,4,10
42504117@N06,5620,1,1461062902,1461064877,2,4,1975
42504117@N06,5621,30,1461119727,1461121898,4,6,2171
42504117@N06,5621,18,1461123454,1461123485,4,6,31
42504117@N06,5621,26,1461106062,1461119096,16,6,13034
42504117@N06,5621,17,1461116165,1461116166,2,6,1
42504117@N06,5621,24,1461108996,1461108996,1,6,0
42504117@N06,5621,16,1461108722,1461108722,1,6,0
42531502@N04,5622,19,1412680199,1412680199,1,1,0
42627344@N00,5623,15,1312336456,1312336456,1,1,0
42656047@N06,5624,26,1403503888,1403510705,51,1,6817
42656047@N06,5625,26,1447642213,1447642213,1,1,0
42837274@N07,5626,16,1394691328,1394691328,1,4,0
42837274@N07,5626,4,1394701731,1394701731,1,4,0
42837274@N07,5626,15,1394691876,1394695925,2,4,4049
42837274@N07,5626,7,1394703053,1394703053,1,4,0
42837274@N07,5627,12,1394865010,1394865010,1,6,0
42837274@N07,5627,17,1394868357,1394870093,2,6,1736
42837274@N07,5627,15,1394871294,1394871294,1,6,0
42837274@N07,5627,26,1394878942,1394880275,5,6,1333
42837274@N07,5627,29,1394859178,1394860065,2,6,887
42837274@N07,5627,8,1394874715,1394874715,1,6,0
42852007@N07,5628,12,1322728267,1322728267,1,1,0
42889019@N00,5629,22,1252594207,1252594481,5,3,274
42889019@N00,5629,13,1252607773,1252607773,1,3,0
42889019@N00,5629,24,1252610588,1252610599,2,3,11
42892117@N04,5630,28,1253833370,1253835015,15,1,1645
42906530@N00,5631,25,1286779854,1286779854,1,1,0
42912996@N00,5632,28,1314055835,1314055835,1,1,0
42912996@N00,5633,20,1317348514,1317348543,2,3,29
42912996@N00,5633,12,1317345175,1317345731,2,3,556
42912996@N00,5633,17,1317341552,1317341552,1,3,0
42912996@N00,5634,20,1328838452,1328838452,1,4,0
42912996@N00,5634,27,1328835257,1328835257,1,4,0
42912996@N00,5634,28,1328829123,1328843736,3,4,14613
42912996@N00,5634,22,1328840228,1328840228,1,4,0
42912996@N00,5635,26,1332025856,1332025892,2,6,36
42912996@N00,5635,30,1332026555,1332026555,1,6,0
42912996@N00,5635,28,1332021522,1332036014,2,6,14492
42912996@N00,5635,21,1332026082,1332026082,1,6,0
42912996@N00,5635,18,1332030450,1332030450,1,6,0
42912996@N00,5635,7,1332025951,1332025951,1,6,0
42912996@N00,5636,28,1336274221,1336274221,1,2,0
42912996@N00,5636,7,1336272381,1336272381,1,2,0
42912996@N00,5637,29,1347016902,1347016902,1,4,0
42912996@N00,5637,26,1347011103,1347011103,1,4,0
42912996@N00,5637,27,1347011914,1347011914,1,4,0
42912996@N00,5637,18,1347011108,1347011108,1,4,0
42912996@N00,5638,20,1348978136,1348978136,1,4,0
42912996@N00,5638,16,1348983680,1348983680,1,4,0
42912996@N00,5638,30,1348978651,1348985111,2,4,6460
42912996@N00,5638,28,1348970914,1348970914,1,4,0
42912996@N00,5639,28,1349018505,1349018505,1,1,0
42912996@N00,5640,18,1349150477,1349170794,2,4,20317
42912996@N00,5640,28,1349163321,1349175181,4,4,11860
42912996@N00,5640,27,1349170630,1349170630,1,4,0
42912996@N00,5640,30,1349158828,1349158828,1,4,0
42912996@N00,5641,28,1355019191,1355035316,5,4,16125
42912996@N00,5641,26,1355035206,1355035206,1,4,0
42912996@N00,5641,29,1355028115,1355028115,1,4,0
42912996@N00,5641,20,1355025295,1355025295,1,4,0
42912996@N00,5642,29,1355620969,1355620969,1,1,0
42912996@N00,5643,28,1359071303,1359089245,2,1,17942
42912996@N00,5644,28,1359261127,1359261127,1,2,0
42912996@N00,5644,26,1359257675,1359257675,1,2,0
42912996@N00,5645,28,1363301995,1363313637,3,2,11642
42912996@N00,5645,10,1363303975,1363303975,1,2,0
42912996@N00,5646,1,1366930735,1366952027,3,2,21292
42912996@N00,5646,15,1366932428,1366944908,2,2,12480
42912996@N00,5647,1,1368574058,1368574058,1,4,0
42912996@N00,5647,16,1368581892,1368581892,1,4,0
42912996@N00,5647,26,1368577107,1368577107,1,4,0
42912996@N00,5647,27,1368580849,1368580849,1,4,0
42912996@N00,5648,1,1370132249,1370142943,2,4,10694
42912996@N00,5648,25,1370132070,1370132070,1,4,0
42912996@N00,5648,3,1370132448,1370132448,1,4,0
42912996@N00,5648,13,1370138078,1370138078,1,4,0
42912996@N00,5649,1,1371903811,1371903811,1,1,0
42912996@N00,5650,1,1371948219,1371948219,1,1,0
42912996@N00,5651,1,1378008924,1378008924,1,1,0
42912996@N00,5652,18,1381391296,1381391296,1,4,0
42912996@N00,5652,28,1381381219,1381381219,1,4,0
42912996@N00,5652,20,1381370058,1381370058,1,4,0
42912996@N00,5652,1,1381368351,1381392769,3,4,24418
42912996@N00,5653,26,1385262367,1385262367,1,2,0
42912996@N00,5653,1,1385258657,1385258657,1,2,0
42912996@N00,5654,20,1386462419,1386462419,1,2,0
42912996@N00,5654,1,1386462542,1386476659,2,2,14117
42912996@N00,5655,18,1388802435,1388802435,1,2,0
42912996@N00,5655,1,1388789703,1388812011,3,2,22308
42912996@N00,5656,7,1396134323,1396134323,1,2,0
42912996@N00,5656,27,1396137119,1396137119,1,2,0
42912996@N00,5657,28,1397908079,1397908079,1,2,0
42912996@N00,5657,5,1397888913,1397888913,1,2,0
42912996@N00,5658,19,1403945465,1403956568,3,1,11103
42912996@N00,5659,19,1417907684,1417907684,1,1,0
42985936@N08,5660,31,1422235386,1422235386,1,2,0
42985936@N08,5660,13,1422241599,1422241599,1,2,0
42995562@N00,5661,1,1374917914,1374918003,3,1,89
43006884@N05,5662,1,1259632414,1259632442,2,1,28
43017856@N00,5663,17,1350865800,1350865800,1,1,0
43017856@N00,5664,28,1350896722,1350896722,1,1,0
43040292@N08,5665,20,1262651720,1262651720,1,9,0
43040292@N08,5665,25,1262658982,1262659420,3,9,438
43040292@N08,5665,26,1262667325,1262669559,3,9,2234
43040292@N08,5665,14,1262652055,1262652172,4,9,117
43040292@N08,5665,22,1262652551,1262652551,1,9,0
43040292@N08,5665,17,1262678608,1262678608,1,9,0
43040292@N08,5665,11,1262656449,1262656449,1,9,0
43040292@N08,5665,16,1262665412,1262676077,4,9,10665
43040292@N08,5665,13,1262660732,1262661199,3,9,467
43082306@N00,5666,30,1278994360,1278994360,1,3,0
43082306@N00,5666,21,1279016096,1279016096,1,3,0
43082306@N00,5666,26,1278992492,1278993493,2,3,1001
43082306@N00,5667,20,1279079106,1279079106,1,4,0
43082306@N00,5667,22,1279079451,1279079451,1,4,0
43082306@N00,5667,28,1279077534,1279077534,1,4,0
43082306@N00,5667,29,1279084756,1279084756,1,4,0
43082306@N00,5668,25,1279210597,1279210597,1,1,0
43082306@N00,5669,15,1279244896,1279244896,1,1,0
43082306@N00,5670,20,1279360374,1279360518,3,3,144
43082306@N00,5670,26,1279336557,1279336557,1,3,0
43082306@N00,5670,1,1279354758,1279363661,2,3,8903
43082306@N00,5671,26,1311221167,1311221167,1,2,0
43082306@N00,5671,1,1311240837,1311240837,1,2,0
43082306@N00,5672,28,1311326973,1311326973,1,1,0
43082306@N00,5673,8,1311511050,1311511050,1,2,0
43082306@N00,5673,5,1311509350,1311509350,1,2,0
43082306@N00,5674,29,1346055175,1346055175,1,2,0
43082306@N00,5674,12,1346058573,1346058573,1,2,0
43082306@N00,5675,26,1346396185,1346396185,1,1,0
43082306@N00,5676,29,1379784418,1379784418,1,1,0
43082306@N00,5677,8,1405582755,1405582755,1,1,0
43086147@N08,5678,21,1374029963,1374029963,1,1,0
43108539@N03,5679,28,1298021156,1298021156,1,3,0
43108539@N03,5679,19,1298026698,1298026698,1,3,0
43108539@N03,5679,16,1298023418,1298023418,1,3,0
43108539@N03,5680,4,1298245463,1298245463,1,2,0
43108539@N03,5680,3,1298235967,1298235967,1,2,0
43108539@N03,5681,15,1306950918,1306950918,1,1,0
43126866@N06,5682,18,1244866608,1244866608,1,1,0
43157990@N00,5683,14,1337233196,1337233317,2,2,121
43157990@N00,5683,22,1337231857,1337231984,2,2,127
43157990@N00,5684,13,1337379588,1337379588,1,2,0
43157990@N00,5684,26,1337377839,1337377839,1,2,0
43168774@N04,5685,1,1417671834,1417671839,3,8,5
43168774@N04,5685,3,1417687291,1417687291,1,8,0
43168774@N04,5685,6,1417687745,1417687745,1,8,0
43168774@N04,5685,22,1417679090,1417679090,1,8,0
43168774@N04,5685,17,1417683612,1417684121,4,8,509
43168774@N04,5685,26,1417687865,1417688518,7,8,653
43168774@N04,5685,27,1417683945,1417683947,2,8,2
43168774@N04,5685,21,1417687302,1417687302,1,8,0
43171170@N06,5686,29,1293596723,1293596723,1,3,0
43171170@N06,5686,16,1293599175,1293599175,2,3,0
43171170@N06,5686,20,1293599166,1293599166,1,3,0
43195406@N05,5687,1,1294383656,1294383656,1,1,0
43195725@N00,5688,9,1255008344,1255008344,1,1,0
43195725@N00,5689,26,1255091863,1255091863,1,1,0
43195725@N00,5690,1,1255195259,1255195259,1,1,0
43195725@N00,5691,28,1300421526,1300421526,1,3,0
43195725@N00,5691,17,1300396333,1300444097,2,3,47764
43195725@N00,5691,30,1300411953,1300411953,1,3,0
43195725@N00,5692,18,1300501562,1300501562,1,5,0
43195725@N00,5692,20,1300500307,1300500307,1,5,0
43195725@N00,5692,29,1300496971,1300496971,1,5,0
43195725@N00,5692,24,1300490965,1300524282,2,5,33317
43195725@N00,5692,10,1300488544,1300493490,4,5,4946
43195725@N00,5693,7,1312614721,1312614721,1,9,0
43195725@N00,5693,28,1312632386,1312632386,1,9,0
43195725@N00,5693,25,1312635382,1312635382,1,9,0
43195725@N00,5693,17,1312585208,1312585208,1,9,0
43195725@N00,5693,20,1312597535,1312625171,5,9,27636
43195725@N00,5693,29,1312603131,1312603753,2,9,622
43195725@N00,5693,27,1312626487,1312626691,3,9,204
43195725@N00,5693,30,1312599537,1312600491,3,9,954
43195725@N00,5693,1,1312639589,1312639589,1,9,0
43195725@N00,5694,26,1323341866,1323342419,2,2,553
43195725@N00,5694,3,1323309322,1323328032,2,2,18710
43195725@N00,5695,26,1323384302,1323384302,1,4,0
43195725@N00,5695,29,1323410736,1323410811,2,4,75
43195725@N00,5695,30,1323410085,1323410088,2,4,3
43195725@N00,5695,1,1323381329,1323381329,1,4,0
43195725@N00,5696,26,1351208931,1351219456,2,1,10525
43195725@N00,5697,17,1351342717,1351342717,1,3,0
43195725@N00,5697,5,1351330145,1351330145,1,3,0
43195725@N00,5697,27,1351328045,1351328045,1,3,0
43195725@N00,5698,20,1351378221,1351378221,1,3,0
43195725@N00,5698,22,1351387209,1351387209,1,3,0
43195725@N00,5698,10,1351383315,1351383315,1,3,0
43195725@N00,5699,30,1351424985,1351426076,2,1,1091
43195725@N00,5700,30,1361496256,1361496256,1,2,0
43195725@N00,5700,24,1361496284,1361496284,1,2,0
43195725@N00,5701,26,1367029317,1367033686,4,3,4369
43195725@N00,5701,30,1367027968,1367027968,1,3,0
43195725@N00,5701,19,1367034801,1367034801,1,3,0
43195725@N00,5702,31,1367068287,1367068287,1,2,0
43195725@N00,5702,30,1367068289,1367068481,2,2,192
43195725@N00,5703,12,1367134508,1367134855,2,2,347
43195725@N00,5703,23,1367120191,1367120191,1,2,0
43195725@N00,5704,28,1367210156,1367210156,1,2,0
43195725@N00,5704,31,1367208408,1367208408,1,2,0
43195725@N00,5705,16,1367297244,1367299609,2,3,2365
43195725@N00,5705,27,1367301950,1367301950,1,3,0
43195725@N00,5705,30,1367316006,1367316006,1,3,0
43195725@N00,5706,1,1373616914,1373616914,1,5,0
43195725@N00,5706,10,1373594575,1373594575,1,5,0
43195725@N00,5706,16,1373601454,1373602134,2,5,680
43195725@N00,5706,17,1373612985,1373612985,1,5,0
43195725@N00,5706,22,1373619181,1373619181,1,5,0
43195725@N00,5707,28,1373699335,1373699335,1,2,0
43195725@N00,5707,9,1373718784,1373718784,1,2,0
43195725@N00,5708,3,1373790265,1373790265,1,3,0
43195725@N00,5708,27,1373803358,1373803358,1,3,0
43195725@N00,5708,18,1373796253,1373796253,1,3,0
43195725@N00,5709,23,1373842382,1373844010,2,2,1628
43195725@N00,5709,28,1373841963,1373841963,1,2,0
43195725@N00,5710,18,1380333463,1380333463,1,1,0
43195725@N00,5711,18,1380370601,1380378028,2,1,7427
43195725@N00,5712,26,1380409990,1380409990,1,1,0
43195725@N00,5713,30,1380460035,1380460121,2,1,86
43195725@N00,5714,3,1380521498,1380521498,1,1,0
43195725@N00,5715,31,1380589604,1380589604,1,3,0
43195725@N00,5715,22,1380587222,1380587222,1,3,0
43195725@N00,5715,20,1380587622,1380588203,2,3,581
43195725@N00,5716,10,1380629925,1380629925,1,2,0
43195725@N00,5716,26,1380627274,1380629191,3,2,1917
43195725@N00,5717,22,1414272817,1414274967,2,7,2150
43195725@N00,5717,12,1414296873,1414296873,1,7,0
43195725@N00,5717,1,1414294763,1414294763,1,7,0
43195725@N00,5717,16,1414285429,1414285429,1,7,0
43195725@N00,5717,27,1414328104,1414328104,1,7,0
43195725@N00,5717,26,1414297254,1414297254,1,7,0
43195725@N00,5717,10,1414304794,1414304794,1,7,0
43195725@N00,5718,26,1417668270,1417668270,1,1,0
43195725@N00,5719,28,1417875552,1417875552,1,1,0
43195725@N00,5720,26,1417935084,1417935084,1,2,0
43195725@N00,5720,18,1417906598,1417906598,1,2,0
43195725@N00,5721,26,1429941708,1429941708,1,1,0
43195725@N00,5722,30,1430016383,1430016383,1,1,0
43195725@N00,5723,10,1430204213,1430204213,1,1,0
43195725@N00,5724,7,1434002571,1434002571,1,1,0
43195725@N00,5725,26,1434092896,1434092896,1,1,0
43195725@N00,5726,17,1434199675,1434199675,1,1,0
43195725@N00,5727,26,1434259435,1434259435,1,3,0
43195725@N00,5727,31,1434270650,1434270650,1,3,0
43195725@N00,5727,9,1434269408,1434269408,1,3,0
43195725@N00,5728,10,1440574753,1440574753,1,1,0
43195725@N00,5729,30,1441187842,1441187842,1,1,0
43207034@N06,5730,1,1440984817,1440984817,1,1,0
43232455@N07,5731,1,1424416793,1424416793,1,1,0
43232455@N07,5732,15,1425539512,1425539540,2,5,28
43232455@N07,5732,29,1425531189,1425531189,1,5,0
43232455@N07,5732,17,1425542575,1425542575,1,5,0
43232455@N07,5732,26,1425524942,1425543494,6,5,18552
43232455@N07,5732,16,1425542841,1425543373,4,5,532
43232455@N07,5733,1,1426756924,1426757769,7,4,845
43232455@N07,5733,30,1426746906,1426747483,2,4,577
43232455@N07,5733,16,1426737270,1426737296,2,4,26
43232455@N07,5733,28,1426732050,1426732085,2,4,35
43246079@N05,5734,29,1322204957,1322205851,5,1,894
43246079@N05,5735,17,1323695395,1323695403,3,3,8
43246079@N05,5735,31,1323676983,1323676983,1,3,0
43246079@N05,5735,21,1323684250,1323684250,1,3,0
43246079@N05,5736,13,1332563413,1332565986,11,2,2573
43246079@N05,5736,4,1332562967,1332563051,2,2,84
43246079@N05,5737,17,1338091712,1338119365,4,1,27653
43246079@N05,5738,17,1342273713,1342273713,1,2,0
43246079@N05,5738,29,1342252721,1342252721,1,2,0
43246079@N05,5739,24,1347688261,1347688967,2,2,706
43246079@N05,5739,23,1347692060,1347692085,3,2,25
43246079@N05,5740,26,1350698616,1350698690,7,4,74
43246079@N05,5740,13,1350699244,1350699249,2,4,5
43246079@N05,5740,21,1350705209,1350705422,6,4,213
43246079@N05,5740,22,1350700282,1350700282,1,4,0
43246079@N05,5741,28,1350739086,1350739086,1,3,0
43246079@N05,5741,17,1350738487,1350738487,1,3,0
43246079@N05,5741,20,1350734416,1350736719,12,3,2303
43246079@N05,5742,29,1360376245,1360379619,9,1,3374
43246079@N05,5743,17,1360411775,1360411780,3,1,5
43246079@N05,5744,17,1367656415,1367656415,1,3,0
43246079@N05,5744,31,1367643889,1367644061,6,3,172
43246079@N05,5744,20,1367644443,1367644449,2,3,6
43246079@N05,5745,28,1377152919,1377152929,2,3,10
43246079@N05,5745,12,1377157710,1377157710,1,3,0
43246079@N05,5745,17,1377156269,1377156284,2,3,15
43246079@N05,5746,26,1387001226,1387001421,3,2,195
43246079@N05,5746,21,1387002073,1387002217,5,2,144
43246079@N05,5747,14,1404827983,1404827989,2,1,6
43246079@N05,5748,27,1417173183,1417173183,1,6,0
43246079@N05,5748,26,1417174235,1417174372,5,6,137
43246079@N05,5748,25,1417169940,1417170432,12,6,492
43246079@N05,5748,17,1417173146,1417173184,6,6,38
43246079@N05,5748,29,1417158177,1417158177,1,6,0
43246079@N05,5748,30,1417150688,1417152164,2,6,1476
43246079@N05,5749,27,1422087145,1422087150,3,5,5
43246079@N05,5749,26,1422058528,1422058528,1,5,0
43246079@N05,5749,16,1422087096,1422087096,1,5,0
43246079@N05,5749,17,1422068124,1422068124,1,5,0
43246079@N05,5749,31,1422085870,1422085870,1,5,0
43246079@N05,5750,28,1422146077,1422146077,1,1,0
43246079@N05,5751,29,1423625208,1423625225,3,4,17
43246079@N05,5751,1,1423623565,1423623571,2,4,6
43246079@N05,5751,28,1423623762,1423630194,7,4,6432
43246079@N05,5751,23,1423625377,1423626079,3,4,702
43300377@N07,5752,28,1324681739,1324681739,1,1,0
43300377@N07,5753,28,1327733241,1327733241,1,1,0
43317782@N00,5754,26,1203982843,1203986873,36,1,4030
43317782@N00,5755,5,1213908527,1213908527,1,10,0
43317782@N00,5755,31,1213909012,1213909098,2,10,86
43317782@N00,5755,26,1213909283,1213909283,1,10,0
43317782@N00,5755,12,1213909130,1213909130,1,10,0
43317782@N00,5755,24,1213908570,1213908578,2,10,8
43317782@N00,5755,18,1213909117,1213909123,2,10,6
43317782@N00,5755,29,1213908959,1213908959,1,10,0
43317782@N00,5755,28,1213909192,1213909231,2,10,39
43317782@N00,5755,11,1213908536,1213908536,1,10,0
43317782@N00,5755,4,1213909169,1213909169,1,10,0
43317782@N00,5756,6,1224283056,1224285326,10,6,2270
43317782@N00,5756,1,1224281748,1224281877,2,6,129
43317782@N00,5756,26,1224283511,1224285766,6,6,2255
43317782@N00,5756,16,1224285810,1224285810,1,6,0
43317782@N00,5756,14,1224280234,1224280234,1,6,0
43317782@N00,5756,28,1224282054,1224286024,6,6,3970
43317782@N00,5757,1,1238105820,1238119826,3,8,14006
43317782@N00,5757,20,1238124380,1238124380,1,8,0
43317782@N00,5757,26,1238121570,1238121570,1,8,0
43317782@N00,5757,16,1238106401,1238150199,9,8,43798
43317782@N00,5757,15,1238130254,1238130265,2,8,11
43317782@N00,5757,29,1238125562,1238127700,5,8,2138
43317782@N00,5757,28,1238119903,1238154542,3,8,34639
43317782@N00,5757,27,1238108016,1238108016,1,8,0
43317782@N00,5758,1,1264799369,1264799415,3,12,46
43317782@N00,5758,20,1264806949,1264807404,5,12,455
43317782@N00,5758,26,1264809150,1264809210,3,12,60
43317782@N00,5758,16,1264799747,1264811837,4,12,12090
43317782@N00,5758,10,1264803031,1264805340,3,12,2309
43317782@N00,5758,12,1264804532,1264804572,4,12,40
43317782@N00,5758,22,1264808429,1264808429,1,12,0
43317782@N00,5758,19,1264813070,1264813070,1,12,0
43317782@N00,5758,17,1264800534,1264801485,5,12,951
43317782@N00,5758,29,1264806084,1264806550,4,12,466
43317782@N00,5758,28,1264799510,1264799510,1,12,0
43317782@N00,5758,27,1264809644,1264809644,1,12,0
43317782@N00,5759,16,1264845019,1264845347,5,2,328
43317782@N00,5759,28,1264846646,1264848100,9,2,1454
43317782@N00,5760,16,1264896754,1264896774,2,1,20
43317782@N00,5761,20,1291420065,1291421299,5,7,1234
43317782@N00,5761,29,1291418934,1291419174,4,7,240
43317782@N00,5761,16,1291425497,1291425497,1,7,0
43317782@N00,5761,28,1291414895,1291448373,2,7,33478
43317782@N00,5761,26,1291425470,1291466746,4,7,41276
43317782@N00,5761,30,1291423497,1291423497,1,7,0
43317782@N00,5761,1,1291414735,1291447112,10,7,32377
43317782@N00,5762,16,1318395380,1318395380,1,4,0
43317782@N00,5762,28,1318395609,1318395609,1,4,0
43317782@N00,5762,26,1318394733,1318394733,1,4,0
43317782@N00,5762,1,1318396135,1318396135,1,4,0
43337914@N00,5763,16,1438309201,1438309201,1,1,0
43425779@N04,5764,21,1323491676,1323491688,5,1,12
43425779@N04,5765,22,1323826756,1323826756,1,1,0
43477272@N00,5766,20,1319685565,1319685565,1,2,0
43477272@N00,5766,23,1319699142,1319699142,1,2,0
43477272@N00,5767,18,1319783571,1319783705,3,1,134
43494963@N03,5768,26,1351553677,1351553994,5,2,317
43494963@N03,5768,28,1351553029,1351553178,3,2,149
43494963@N03,5769,16,1424251311,1424251311,1,1,0
43494963@N03,5770,28,1451397446,1451400598,21,5,3152
43494963@N03,5770,26,1451401572,1451406994,2,5,5422
43494963@N03,5770,13,1451372014,1451372014,1,5,0
43494963@N03,5770,1,1451366643,1451397370,3,5,30727
43494963@N03,5770,29,1451402287,1451402301,2,5,14
43535605@N00,5771,1,1310800129,1310800129,1,2,0
43535605@N00,5771,20,1310802489,1310802489,1,2,0
43535605@N00,5772,28,1315716869,1315716900,2,5,31
43535605@N00,5772,24,1315709525,1315714878,6,5,5353
43535605@N00,5772,27,1315710802,1315711048,2,5,246
43535605@N00,5772,13,1315716200,1315716206,2,5,6
43535605@N00,5772,25,1315716217,1315716217,1,5,0
43554368@N08,5773,26,1254490994,1254490994,1,3,0
43554368@N08,5773,16,1254490740,1254490740,1,3,0
43554368@N08,5773,7,1254492084,1254492106,2,3,22
43554368@N08,5774,27,1254538004,1254538005,2,2,1
43554368@N08,5774,10,1254527887,1254527887,1,2,0
43579472@N00,5775,1,1195877702,1195877760,3,4,58
43579472@N00,5775,28,1195877693,1195877754,6,4,61
43579472@N00,5775,21,1195877735,1195877735,1,4,0
43579472@N00,5775,23,1195877728,1195877728,1,4,0
43590398@N04,5776,20,1357090369,1357090369,1,1,0
43590398@N04,5777,28,1384515938,1384515938,1,1,0
43652558@N00,5778,12,1432866900,1432866900,1,1,0
43652558@N00,5779,28,1445756654,1445771208,4,6,14554
43652558@N00,5779,1,1445756360,1445756533,3,6,173
43652558@N00,5779,21,1445773188,1445774869,2,6,1681
43652558@N00,5779,20,1445761908,1445761908,1,6,0
43652558@N00,5779,26,1445757875,1445757875,1,6,0
43652558@N00,5779,25,1445766601,1445767231,3,6,630
43671228@N00,5780,1,1282743115,1282743115,1,1,0
43671228@N00,5781,1,1282823572,1282823572,1,1,0
43671228@N00,5782,1,1290378789,1290380498,3,1,1709
43671228@N00,5783,1,1290416556,1290416556,1,1,0
43675529@N00,5784,15,1284096461,1284096461,1,1,0
43675529@N00,5785,31,1378201503,1378201503,1,2,0
43675529@N00,5785,26,1378208493,1378208493,1,2,0
43679955@N05,5786,1,1266297231,1266297415,4,9,184
43679955@N05,5786,23,1266301621,1266303079,10,9,1458
43679955@N05,5786,20,1266305506,1266306561,7,9,1055
43679955@N05,5786,17,1266299394,1266299484,3,9,90
43679955@N05,5786,26,1266301446,1266307557,10,9,6111
43679955@N05,5786,29,1266303374,1266305297,6,9,1923
43679955@N05,5786,18,1266301372,1266301372,1,9,0
43679955@N05,5786,28,1266297345,1266308615,4,9,11270
43679955@N05,5786,16,1266307522,1266307522,1,9,0
43716681@N00,5787,30,1273470270,1273470270,1,1,0
43716681@N00,5788,30,1280103446,1280103446,1,1,0
43716681@N00,5789,30,1280204316,1280204352,2,1,36
43716681@N00,5790,30,1280272820,1280293325,9,1,20505
43716681@N00,5791,30,1280555629,1280555629,2,1,0
43716681@N00,5792,30,1282105387,1282105387,1,1,0
43716681@N00,5793,30,1282603163,1282603163,1,1,0
43725348@N00,5794,26,1329455237,1329456830,9,5,1593
43725348@N00,5794,27,1329454859,1329454859,1,5,0
43725348@N00,5794,11,1329459254,1329459432,6,5,178
43725348@N00,5794,9,1329463792,1329463792,1,5,0
43725348@N00,5794,4,1329460247,1329464535,15,5,4288
43725348@N00,5795,18,1336551652,1336555151,4,5,3499
43725348@N00,5795,28,1336549001,1336550606,5,5,1605
43725348@N00,5795,7,1336559393,1336559393,1,5,0
43725348@N00,5795,10,1336558323,1336558383,5,5,60
43725348@N00,5795,23,1336559400,1336559400,1,5,0
43725348@N00,5796,18,1336887781,1336887781,1,7,0
43725348@N00,5796,29,1336876746,1336876755,2,7,9
43725348@N00,5796,26,1336871403,1336871539,3,7,136
43725348@N00,5796,30,1336875618,1336877131,7,7,1513
43725348@N00,5796,15,1336881711,1336881711,1,7,0
43725348@N00,5796,11,1336873756,1336873756,1,7,0
43725348@N00,5796,23,1336887736,1336887736,1,7,0
43725348@N00,5797,10,1337910983,1337916150,4,3,5167
43725348@N00,5797,11,1337910621,1337917702,11,3,7081
43725348@N00,5797,13,1337921331,1337921495,4,3,164
43725348@N00,5798,10,1339235513,1339235519,2,3,6
43725348@N00,5798,27,1339228112,1339228149,2,3,37
43725348@N00,5798,11,1339234312,1339234326,2,3,14
43725348@N00,5799,28,1341122441,1341141591,5,6,19150
43725348@N00,5799,24,1341131050,1341131623,13,6,573
43725348@N00,5799,26,1341122533,1341123075,3,6,542
43725348@N00,5799,30,1341136786,1341136786,1,6,0
43725348@N00,5799,20,1341137208,1341137230,3,6,22
43725348@N00,5799,23,1341138438,1341138462,2,6,24
43725348@N00,5800,7,1342867005,1342867005,1,5,0
43725348@N00,5800,31,1342863869,1342863869,1,5,0
43725348@N00,5800,1,1342858989,1342858989,1,5,0
43725348@N00,5800,28,1342858998,1342862851,3,5,3853
43725348@N00,5800,11,1342866591,1342866613,2,5,22
43725348@N00,5801,23,1343991776,1343991809,2,3,33
43725348@N00,5801,28,1343988595,1343988618,3,3,23
43725348@N00,5801,11,1343993753,1343994561,4,3,808
43725348@N00,5802,7,1345200244,1345202735,6,4,2491
43725348@N00,5802,28,1345197617,1345197647,4,4,30
43725348@N00,5802,10,1345202529,1345202529,1,4,0
43725348@N00,5802,11,1345202727,1345202727,1,4,0
43725348@N00,5803,28,1353204226,1353204245,3,3,19
43725348@N00,5803,10,1353207045,1353207055,2,3,10
43725348@N00,5803,11,1353208483,1353208486,2,3,3
43725348@N00,5804,4,1356581913,1356584634,5,6,2721
43725348@N00,5804,13,1356574356,1356577788,6,6,3432
43725348@N00,5804,7,1356587092,1356588550,11,6,1458
43725348@N00,5804,10,1356572200,1356589826,5,6,17626
43725348@N00,5804,6,1356588534,1356588650,3,6,116
43725348@N00,5804,11,1356573042,1356573529,3,6,487
43725348@N00,5805,22,1357868320,1357868454,3,2,134
43725348@N00,5805,1,1357867002,1357867002,1,2,0
43725348@N00,5806,6,1359600370,1359600391,2,4,21
43725348@N00,5806,4,1359601063,1359601074,2,4,11
43725348@N00,5806,28,1359593533,1359593533,1,4,0
43725348@N00,5806,13,1359601733,1359603520,15,4,1787
43726999@N06,5807,5,1387910679,1387910679,1,5,0
43726999@N06,5807,26,1387921601,1387921601,1,5,0
43726999@N06,5807,25,1387898553,1387917394,3,5,18841
43726999@N06,5807,28,1387907634,1387923769,4,5,16135
43726999@N06,5807,17,1387880623,1387880623,1,5,0
43726999@N06,5808,1,1427781369,1427782765,2,7,1396
43726999@N06,5808,25,1427757870,1427758660,2,7,790
43726999@N06,5808,16,1427784366,1427784366,1,7,0
43726999@N06,5808,7,1427788908,1427788908,1,7,0
43726999@N06,5808,23,1427776701,1427776701,1,7,0
43726999@N06,5808,28,1427794133,1427794133,1,7,0
43726999@N06,5808,10,1427764777,1427764777,1,7,0
43824287@N02,5809,28,1356106210,1356106210,1,1,0
43825182@N00,5810,6,1229757467,1229757467,1,2,0
43825182@N00,5810,28,1229763562,1229763562,1,2,0
43825182@N00,5811,16,1278154599,1278154599,1,2,0
43825182@N00,5811,5,1278148144,1278148144,1,2,0
43825182@N00,5812,26,1282732210,1282732210,1,1,0
43825182@N00,5813,26,1288171656,1288171656,1,1,0
43825182@N00,5814,28,1289987335,1289987335,1,2,0
43825182@N00,5814,1,1289987436,1289995829,2,2,8393
43825182@N00,5815,26,1291777209,1291777209,1,3,0
43825182@N00,5815,28,1291803949,1291803949,1,3,0
43825182@N00,5815,1,1291803501,1291803501,1,3,0
43825182@N00,5816,23,1294841187,1294841187,1,2,0
43825182@N00,5816,1,1294827079,1294827079,1,2,0
43825182@N00,5817,25,1308028461,1308028477,4,1,16
43825182@N00,5818,7,1317690847,1317690847,1,1,0
43825182@N00,5819,4,1321326321,1321326321,1,2,0
43825182@N00,5819,1,1321317809,1321317811,2,2,2
43825182@N00,5820,25,1322633803,1322633803,1,1,0
43825182@N00,5821,26,1323320107,1323320107,1,1,0
43825182@N00,5822,27,1327932375,1327932375,1,4,0
43825182@N00,5822,1,1327920812,1327920831,4,4,19
43825182@N00,5822,3,1327926282,1327926286,2,4,4
43825182@N00,5822,21,1327926273,1327926273,1,4,0
43825182@N00,5823,4,1331529412,1331529416,2,1,4
43825182@N00,5824,7,1335924037,1335924037,1,1,0
43825182@N00,5825,13,1337844491,1337844491,1,1,0
43825182@N00,5826,17,1371447232,1371447232,1,1,0
43825182@N00,5827,29,1372329333,1372329333,1,1,0
43826697@N08,5828,28,1411202585,1411202585,1,1,0
43826697@N08,5829,19,1411345055,1411345055,1,1,0
43841868@N05,5830,24,1284708331,1284708331,1,8,0
43841868@N05,5830,26,1284715936,1284727780,26,8,11844
43841868@N05,5830,28,1284693502,1284693545,2,8,43
43841868@N05,5830,29,1284711096,1284711096,1,8,0
43841868@N05,5830,15,1284693848,1284699860,8,8,6012
43841868@N05,5830,27,1284702555,1284702555,1,8,0
43841868@N05,5830,1,1284693474,1284693474,1,8,0
43841868@N05,5830,16,1284706624,1284715210,2,8,8586
43942132@N00,5831,1,1289350710,1289350710,1,1,0
43942132@N00,5832,18,1434839883,1434839883,1,1,0
43942132@N00,5833,18,1437900181,1437900181,1,1,0
43942132@N00,5834,18,1441545807,1441545807,1,1,0
43942132@N00,5835,28,1442100618,1442100618,1,1,0
43942132@N00,5836,18,1450012224,1450012224,1,1,0
43942132@N00,5837,18,1453720299,1453720299,1,1,0
43944357@N00,5838,27,1201139312,1201139558,4,2,246
43944357@N00,5838,24,1201135142,1201136402,4,2,1260
44029976@N00,5839,22,1319181834,1319182020,2,5,186
44029976@N00,5839,28,1319187259,1319187259,1,5,0
44029976@N00,5839,27,1319185864,1319185864,1,5,0
44029976@N00,5839,20,1319182333,1319182333,1,5,0
44029976@N00,5839,14,1319181766,1319181766,1,5,0
44065701@N00,5840,19,1416057120,1416057120,1,1,0
44065701@N00,5841,18,1444600312,1444610603,2,1,10291
44065701@N00,5842,18,1454112826,1454120039,2,2,7213
44065701@N00,5842,17,1454103519,1454103519,1,2,0
44118591@N00,5843,16,1225589161,1225592703,3,1,3542
44124316579@N01,5844,27,1401670517,1401670517,1,3,0
44124316579@N01,5844,26,1401660095,1401660101,2,3,6
44124316579@N01,5844,1,1401658550,1401658550,1,3,0
44124329770@N01,5845,13,1219817044,1219817725,4,6,681
44124329770@N01,5845,21,1219815245,1219815955,10,6,710
44124329770@N01,5845,22,1219809023,1219809119,2,6,96
44124329770@N01,5845,18,1219797978,1219797982,2,6,4
44124329770@N01,5845,1,1219790324,1219792674,2,6,2350
44124329770@N01,5845,28,1219835651,1219837057,9,6,1406
44124329770@N01,5846,14,1408354831,1408354867,6,1,36
44124364198@N01,5847,18,1358068712,1358068712,1,1,0
44124364198@N01,5848,30,1359773619,1359773619,1,1,0
44124364198@N01,5849,29,1363251286,1363252588,2,1,1302
44124364198@N01,5850,13,1381736070,1381736070,1,1,0
44124364198@N01,5851,3,1418705850,1418705850,1,1,0
44124364198@N01,5852,28,1432387831,1432387831,1,1,0
44124364198@N01,5853,23,1437535707,1437535707,1,1,0
44124364198@N01,5854,23,1461578273,1461578273,1,1,0
44124364198@N01,5855,28,1463883781,1463883781,1,1,0
44124364198@N01,5856,30,1469276583,1469276583,1,5,0
44124364198@N01,5856,18,1469279515,1469279515,1,5,0
44124364198@N01,5856,28,1469274715,1469274715,1,5,0
44124364198@N01,5856,23,1469279931,1469279931,1,5,0
44124364198@N01,5856,26,1469281041,1469281041,1,5,0
44124377471@N01,5857,7,1292229201,1292229201,1,4,0
44124377471@N01,5857,3,1292224670,1292224670,1,4,0
44124377471@N01,5857,30,1292223200,1292223200,1,4,0
44124377471@N01,5857,29,1292234814,1292234814,1,4,0
44124377471@N01,5858,30,1292324977,1292324977,1,1,0
44124377471@N01,5859,25,1299217202,1299217202,1,3,0
44124377471@N01,5859,13,1299219108,1299219108,1,3,0
44124377471@N01,5859,17,1299226996,1299226996,1,3,0
44124377471@N01,5860,25,1312863393,1312863393,1,1,0
44124377471@N01,5861,30,1320193642,1320193642,1,8,0
44124377471@N01,5861,13,1320213686,1320217380,11,8,3694
44124377471@N01,5861,28,1320209773,1320209773,1,8,0
44124377471@N01,5861,18,1320194532,1320209634,3,8,15102
44124377471@N01,5861,19,1320208923,1320208931,2,8,8
44124377471@N01,5861,7,1320216140,1320216140,1,8,0
44124377471@N01,5861,20,1320208916,1320212184,9,8,3268
44124377471@N01,5861,27,1320197181,1320197181,1,8,0
44124377471@N01,5862,19,1320278071,1320278071,1,1,0
44124377471@N01,5863,30,1328441422,1328441422,1,3,0
44124377471@N01,5863,7,1328429430,1328429430,1,3,0
44124377471@N01,5863,5,1328435474,1328435474,1,3,0
44124377471@N01,5864,14,1352009005,1352009005,1,2,0
44124377471@N01,5864,23,1352019700,1352019700,1,2,0
44124377471@N01,5865,7,1357793188,1357793188,1,3,0
44124377471@N01,5865,3,1357793256,1357793256,1,3,0
44124377471@N01,5865,17,1357811084,1357811084,1,3,0
44124377471@N01,5866,31,1364444649,1364444649,1,1,0
44124377471@N01,5867,7,1373522334,1373522334,1,3,0
44124377471@N01,5867,3,1373527845,1373527845,1,3,0
44124377471@N01,5867,5,1373522386,1373522386,1,3,0
44124377471@N01,5868,31,1384236086,1384236086,1,1,0
44124377471@N01,5869,27,1420546080,1420546080,1,1,0
44124415797@N01,5870,13,1357360888,1357360888,1,2,0
44124415797@N01,5870,3,1357376944,1357376944,1,2,0
44124415797@N01,5871,13,1357953801,1357953801,1,1,0
44124426205@N01,5872,1,1317891860,1317904778,5,1,12918
44124426205@N01,5873,1,1317945822,1318079935,34,1,134113
44124426205@N01,5874,1,1318110759,1318110759,1,1,0
44124426205@N01,5875,1,1318143640,1318168497,5,1,24857
44124426205@N01,5876,1,1318204737,1318250749,10,1,46012
44124426205@N01,5877,1,1318289574,1318342880,8,1,53306
44124426205@N01,5878,18,1447327215,1447327215,1,2,0
44124426205@N01,5878,23,1447320649,1447320649,1,2,0
44124426205@N01,5879,14,1447357801,1447357865,2,5,64
44124426205@N01,5879,20,1447357631,1447357907,2,5,276
44124426205@N01,5879,18,1447369810,1447380782,3,5,10972
44124426205@N01,5879,8,1447357135,1447357135,1,5,0
44124426205@N01,5879,26,1447357032,1447357054,2,5,22
44124426205@N01,5880,18,1447484291,1447484291,1,1,0
44124426205@N01,5881,25,1447646607,1447657656,2,3,11049
44124426205@N01,5881,18,1447657646,1447674785,3,3,17139
44124426205@N01,5881,3,1447670429,1447670429,1,3,0
44124426205@N01,5882,18,1447723901,1447723901,1,1,0
44124426205@N01,5883,18,1448249985,1448249985,1,1,0
44124473586@N01,5884,27,1340885805,1340885805,1,2,0
44124473586@N01,5884,7,1340885816,1340885816,1,2,0
44124473586@N01,5885,28,1340960933,1340960933,1,1,0
44124473586@N01,5886,27,1341070333,1341071847,2,6,1514
44124473586@N01,5886,17,1341071540,1341071540,1,6,0
44124473586@N01,5886,1,1341073489,1341073489,1,6,0
44124473586@N01,5886,28,1341073819,1341073819,1,6,0
44124473586@N01,5886,15,1341073559,1341073559,1,6,0
44124473586@N01,5886,30,1341068132,1341068132,1,6,0
44124473586@N01,5887,28,1341213673,1341240206,2,3,26533
44124473586@N01,5887,7,1341234862,1341234862,1,3,0
44124473586@N01,5887,24,1341213918,1341213918,1,3,0
44124484402@N01,5888,29,1247891634,1247891634,1,1,0
44152828@N06,5889,30,1255927165,1255927165,1,2,0
44152828@N06,5889,17,1255933002,1255933002,1,2,0
44164246@N00,5890,27,1273126252,1273126460,4,11,208
44164246@N00,5890,29,1273132061,1273132141,3,11,80
44164246@N00,5890,4,1273145158,1273145840,9,11,682
44164246@N00,5890,26,1273130326,1273130326,1,11,0
44164246@N00,5890,13,1273135675,1273144638,57,11,8963
44164246@N00,5890,28,1273125711,1273125743,5,11,32
44164246@N00,5890,23,1273130423,1273130432,2,11,9
44164246@N00,5890,7,1273145574,1273145574,1,11,0
44164246@N00,5890,16,1273130038,1273130044,2,11,6
44164246@N00,5890,5,1273145475,1273145538,3,11,63
44164246@N00,5890,6,1273145864,1273146270,15,11,406
44164246@N00,5891,21,1273236393,1273239121,11,12,2728
44164246@N00,5891,27,1273225231,1273225297,6,12,66
44164246@N00,5891,29,1273225361,1273232891,8,12,7530
44164246@N00,5891,26,1273234040,1273236187,19,12,2147
44164246@N00,5891,13,1273236665,1273238419,21,12,1754
44164246@N00,5891,30,1273231897,1273231897,1,12,0
44164246@N00,5891,28,1273224378,1273224450,4,12,72
44164246@N00,5891,7,1273234950,1273235452,3,12,502
44164246@N00,5891,8,1273234147,1273239448,9,12,5301
44164246@N00,5891,16,1273224689,1273239604,17,12,14915
44164246@N00,5891,5,1273236245,1273236267,3,12,22
44164246@N00,5891,3,1273236214,1273236219,2,12,5
44169189@N06,5892,26,1357618088,1357618211,4,13,123
44169189@N06,5892,25,1357612396,1357612477,3,13,81
44169189@N06,5892,21,1357614800,1357614827,2,13,27
44169189@N06,5892,13,1357614959,1357615917,10,13,958
44169189@N06,5892,28,1357607589,1357607871,4,13,282
44169189@N06,5892,18,1357622793,1357632526,2,13,9733
44169189@N06,5892,4,1357613866,1357613866,1,13,0
44169189@N06,5892,17,1357609842,1357610216,4,13,374
44169189@N06,5892,10,1357620516,1357620516,1,13,0
44169189@N06,5892,16,1357608145,1357608145,1,13,0
44169189@N06,5892,12,1357608546,1357634758,8,13,26212
44169189@N06,5892,5,1357613995,1357614400,3,13,405
44169189@N06,5892,1,1357607506,1357645925,5,13,38419
44169189@N06,5893,18,1357709575,1357715404,2,8,5829
44169189@N06,5893,25,1357722720,1357722897,5,8,177
44169189@N06,5893,26,1357713643,1357713766,2,8,123
44169189@N06,5893,13,1357703654,1357704361,11,8,707
44169189@N06,5893,14,1357698098,1357699375,5,8,1277
44169189@N06,5893,10,1357720602,1357720602,1,8,0
44169189@N06,5893,5,1357711610,1357713641,2,8,2031
44169189@N06,5893,8,1357711104,1357711109,2,8,5
44175133@N00,5894,17,1348873245,1348873395,2,4,150
44175133@N00,5894,29,1348856156,1348856156,1,4,0
44175133@N00,5894,30,1348858234,1348858234,1,4,0
44175133@N00,5894,15,1348864577,1348864850,2,4,273
44188899@N00,5895,23,1340943863,1340945903,3,1,2040
44225859@N00,5896,28,1188806828,1188806828,1,1,0
44275181@N00,5897,20,1425722495,1425722495,1,1,0
44279418@N00,5898,3,1206419079,1206420457,7,6,1378
44279418@N00,5898,30,1206421974,1206422027,3,6,53
44279418@N00,5898,22,1206412894,1206412894,1,6,0
44279418@N00,5898,26,1206396245,1206396259,2,6,14
44279418@N00,5898,6,1206420863,1206420863,1,6,0
44279418@N00,5898,17,1206417401,1206417401,1,6,0
44279418@N00,5899,16,1206488219,1206488219,1,1,0
44281290@N06,5900,26,1199307726,1199307726,1,1,0
44312671@N03,5901,28,1325147854,1325147854,1,1,0
44312671@N03,5902,26,1326809642,1326809642,1,1,0
44315537@N03,5903,20,1376478736,1376478736,1,1,0
44319460@N06,5904,12,1324616569,1324616569,1,1,0
44356659@N00,5905,8,1195650000,1195650014,14,1,14
44356659@N00,5906,8,1195696058,1195696058,1,1,0
44404893@N00,5907,26,1241915062,1241915062,2,1,0
44404893@N00,5908,24,1303267820,1303267820,1,1,0
44412006@N00,5909,26,1338817034,1338817034,1,1,0
44412893@N02,5910,18,1439514352,1439520619,2,3,6267
44412893@N02,5910,1,1439515166,1439515166,1,3,0
44412893@N02,5910,23,1439515069,1439515069,1,3,0
44433267@N07,5911,22,1353551438,1353551438,1,2,0
44433267@N07,5911,23,1353560848,1353560848,1,2,0
44476715@N00,5912,28,1347025151,1347025151,1,2,0
44476715@N00,5912,26,1347025022,1347025022,1,2,0
44476715@N00,5913,26,1350675903,1350675903,1,1,0
44476715@N00,5914,28,1354599255,1354599603,2,2,348
44476715@N00,5914,25,1354586885,1354586885,1,2,0
44476715@N00,5915,18,1355640756,1355640756,1,4,0
44476715@N00,5915,28,1355646281,1355646281,1,4,0
44476715@N00,5915,1,1355647258,1355647327,2,4,69
44476715@N00,5915,29,1355638058,1355638058,1,4,0
44476715@N00,5916,28,1359247428,1359268700,4,3,21272
44476715@N00,5916,1,1359268960,1359268960,1,3,0
44476715@N00,5916,27,1359262876,1359262876,1,3,0
44476715@N00,5917,30,1359776626,1359776681,2,3,55
44476715@N00,5917,29,1359773207,1359773207,1,3,0
44476715@N00,5917,28,1359783708,1359783708,1,3,0
44504403@N00,5918,19,1246583177,1246583177,1,1,0
44545287@N07,5919,22,1267069293,1267069293,1,1,0
44547231@N00,5920,14,1236316258,1236316258,1,1,0
44596751@N00,5921,3,1313847009,1313847009,1,1,0
44606632@N02,5922,20,1255919947,1255919947,1,1,0
44606632@N02,5923,28,1283253010,1283254960,6,1,1950
44606632@N02,5924,28,1284370051,1284370051,1,1,0
44606632@N02,5925,26,1290592804,1290592804,1,3,0
44606632@N02,5925,28,1290591503,1290594387,3,3,2884
44606632@N02,5925,1,1290582559,1290582559,1,3,0
44606632@N02,5926,16,1294105629,1294105629,1,2,0
44606632@N02,5926,29,1294097678,1294097678,1,2,0
44616109@N08,5927,27,1377909998,1377909998,1,4,0
44616109@N08,5927,26,1377912312,1377912312,1,4,0
44616109@N08,5927,25,1377916017,1377916017,1,4,0
44616109@N08,5927,1,1377908550,1377908550,1,4,0
44616109@N08,5928,1,1391744628,1391744628,1,1,0
44666755@N07,5929,1,1415612654,1415612654,1,1,0
44734355@N07,5930,3,1291643758,1291647184,3,2,3426
44734355@N07,5930,18,1291649626,1291649626,1,2,0
44743972@N00,5931,27,1408158911,1408158948,2,1,37
44783403@N05,5932,26,1376481493,1376484437,2,1,2944
44795208@N00,5933,30,1304058843,1304060348,3,6,1505
44795208@N00,5933,27,1304056235,1304082200,2,6,25965
44795208@N00,5933,16,1304064226,1304064226,1,6,0
44795208@N00,5933,18,1304061196,1304061196,1,6,0
44795208@N00,5933,26,1304035926,1304035926,1,6,0
44795208@N00,5933,17,1304052364,1304054662,2,6,2298
44835587@N05,5934,1,1421397588,1421397588,1,1,0
44835587@N05,5935,1,1421433091,1421456740,2,1,23649
44835587@N05,5936,1,1421489893,1421489928,3,1,35
44835587@N05,5937,1,1421523671,1421529237,16,1,5566
44835587@N05,5938,1,1421562437,1421573669,2,1,11232
44888637@N00,5939,7,1221557580,1221557590,2,1,10
44891756@N00,5940,28,1230620013,1230620013,1,2,0
44891756@N00,5940,26,1230620034,1230620034,1,2,0
44934431@N00,5941,13,1306039651,1306039651,1,2,0
44934431@N00,5941,28,1306064609,1306064609,1,2,0
44934431@N00,5942,26,1306110641,1306110641,1,1,0
44941607@N00,5943,29,1339898543,1339900934,5,4,2391
44941607@N00,5943,14,1339912815,1339912815,1,4,0
44941607@N00,5943,16,1339918967,1339918967,1,4,0
44941607@N00,5943,22,1339912220,1339912220,1,4,0
44941607@N00,5944,22,1341843799,1341843799,1,1,0
44947832@N03,5945,22,1320030837,1320030837,1,1,0
44957651@N00,5946,13,1210398308,1210398308,1,2,0
44957651@N00,5946,12,1210399383,1210399383,1,2,0
44957651@N00,5947,26,1210510884,1210510884,1,2,0
44957651@N00,5947,17,1210507355,1210507355,1,2,0
44957651@N00,5948,29,1210770033,1210770033,1,2,0
44957651@N00,5948,12,1210770021,1210770021,1,2,0
44957651@N00,5949,25,1233987923,1233987923,1,1,0
44957651@N00,5950,23,1242469594,1242469645,2,1,51
44957651@N00,5951,17,1267424831,1267424831,1,1,0
44957651@N00,5952,26,1278671904,1278671904,1,1,0
44957651@N00,5953,26,1291693186,1291693186,1,2,0
44957651@N00,5953,28,1291709663,1291709663,1,2,0
44957651@N00,5954,25,1301576062,1301576062,1,2,0
44957651@N00,5954,22,1301547632,1301549820,3,2,2188
44957651@N00,5955,31,1307726474,1307726750,2,2,276
44957651@N00,5955,25,1307724547,1307724623,2,2,76
44957651@N00,5956,28,1323013689,1323013741,2,2,52
44957651@N00,5956,13,1323027033,1323027033,1,2,0
44957651@N00,5957,22,1323104706,1323104706,1,2,0
44957651@N00,5957,1,1323098487,1323098487,1,2,0
44957651@N00,5958,13,1337115334,1337115334,1,1,0
44957651@N00,5959,16,1378109365,1378109365,1,2,0
44957651@N00,5959,1,1378089563,1378089563,1,2,0
44957651@N00,5960,31,1379577690,1379577690,1,3,0
44957651@N00,5960,12,1379569794,1379569794,1,3,0
44957651@N00,5960,1,1379569292,1379569292,1,3,0
44957651@N00,5961,28,1385963704,1385963704,1,1,0
44957651@N00,5962,30,1419829531,1419829531,1,1,0
44957651@N00,5963,22,1420607990,1420607990,1,1,0
44957651@N00,5964,11,1421280116,1421280116,1,3,0
44957651@N00,5964,4,1421279995,1421279995,1,3,0
44957651@N00,5964,21,1421280225,1421280225,1,3,0
44991103@N05,5965,26,1287870349,1287908629,44,1,38280
45007004@N00,5966,26,1192061224,1192080014,10,1,18790
45032460@N06,5967,17,1420239581,1420244221,2,12,4640
45032460@N06,5967,31,1420254710,1420254710,1,12,0
45032460@N06,5967,16,1420268739,1420268975,2,12,236
45032460@N06,5967,28,1420239601,1420271571,4,12,31970
45032460@N06,5967,9,1420248503,1420248503,1,12,0
45032460@N06,5967,13,1420247397,1420247466,3,12,69
45032460@N06,5967,27,1420245978,1420245978,1,12,0
45032460@N06,5967,20,1420250397,1420253521,3,12,3124
45032460@N06,5967,18,1420259113,1420260778,4,12,1665
45032460@N06,5967,25,1420270680,1420270680,1,12,0
45032460@N06,5967,29,1420260871,1420260871,1,12,0
45032460@N06,5967,26,1420248653,1420271155,4,12,22502
45032460@N06,5968,1,1452896311,1452896312,2,4,1
45032460@N06,5968,16,1452930116,1452930116,1,4,0
45032460@N06,5968,28,1452930051,1452930051,1,4,0
45032460@N06,5968,14,1452902013,1452903653,9,4,1640
45032460@N06,5969,28,1453013713,1453020423,3,2,6710
45032460@N06,5969,15,1453016121,1453028031,7,2,11910
45032460@N06,5970,18,1453078114,1453078114,1,3,0
45032460@N06,5970,27,1453070248,1453070248,1,3,0
45032460@N06,5970,28,1453086139,1453086157,3,3,18
45056833@N05,5971,18,1289111613,1289111613,1,5,0
45056833@N05,5971,30,1289111601,1289111601,1,5,0
45056833@N05,5971,28,1289111604,1289111604,1,5,0
45056833@N05,5971,15,1289111616,1289113808,2,5,2192
45056833@N05,5971,16,1289111608,1289111608,1,5,0
45067258@N00,5972,29,1339225652,1339225652,1,2,0
45067258@N00,5972,31,1339225963,1339225963,1,2,0
45067258@N00,5973,31,1340295465,1340295465,1,1,0
45067258@N00,5974,1,1342836134,1342836804,15,1,670
45067258@N00,5975,13,1342939671,1342942200,4,3,2529
45067258@N00,5975,28,1342944425,1342946112,4,3,1687
45067258@N00,5975,4,1342939679,1342939679,1,3,0
45067258@N00,5976,26,1353116564,1353116564,1,2,0
45067258@N00,5976,17,1353115419,1353115419,1,2,0
45067258@N00,5977,30,1359169469,1359174707,2,1,5238
45067258@N00,5978,26,1366340575,1366340579,2,1,4
45067258@N00,5979,18,1376266650,1376266650,1,1,0
45067258@N00,5980,16,1439550158,1439550158,1,2,0
45067258@N00,5980,18,1439550682,1439550735,4,2,53
45067258@N00,5981,28,1439728705,1439730354,41,1,1649
45067258@N00,5982,28,1439786342,1439786471,4,1,129
45104424@N00,5983,28,1200965181,1200965181,1,10,0
45104424@N00,5983,23,1200955097,1200955097,1,10,0
45104424@N00,5983,16,1200959399,1200959929,2,10,530
45104424@N00,5983,27,1200980107,1200980161,2,10,54
45104424@N00,5983,22,1200944533,1200944541,2,10,8
45104424@N00,5983,18,1200946692,1200946692,1,10,0
45104424@N00,5983,20,1200945532,1200945532,1,10,0
45104424@N00,5983,10,1200940063,1200940063,1,10,0
45104424@N00,5983,26,1200966053,1200969275,2,10,3222
45104424@N00,5983,19,1200946266,1200946432,2,10,166
45104424@N00,5984,15,1295392390,1295392390,1,3,0
45104424@N00,5984,10,1295384526,1295384526,1,3,0
45104424@N00,5984,26,1295396554,1295396554,1,3,0
45104424@N00,5985,16,1328118642,1328118642,1,2,0
45104424@N00,5985,30,1328143733,1328143733,1,2,0
45121853@N06,5986,3,1361081483,1361081483,1,3,0
45121853@N06,5986,1,1361070522,1361070522,1,3,0
45121853@N06,5986,21,1361081630,1361098869,5,3,17239
45121853@N06,5987,30,1364803217,1364803217,1,1,0
45121853@N06,5988,1,1369559241,1369559241,1,1,0
45121853@N06,5989,28,1388497805,1388497805,1,1,0
45130440@N03,5990,26,1362445147,1362445147,1,1,0
45130440@N03,5991,1,1369275639,1369275639,1,2,0
45130440@N03,5991,13,1369298235,1369298235,1,2,0
45130440@N03,5992,18,1380279501,1380279501,1,3,0
45130440@N03,5992,1,1380260962,1380260962,1,3,0
45130440@N03,5992,28,1380267113,1380271941,2,3,4828
45130440@N03,5993,23,1383616522,1383616522,1,2,0
45130440@N03,5993,26,1383604690,1383604690,1,2,0
45130440@N03,5994,19,1416636447,1416636447,1,1,0
45130440@N03,5995,18,1432195050,1432195050,1,1,0
45267362@N03,5996,20,1415934931,1415942144,6,7,7213
45267362@N03,5996,18,1415925133,1415932776,17,7,7643
45267362@N03,5996,1,1415940710,1415964922,4,7,24212
45267362@N03,5996,25,1415950497,1415958799,2,7,8302
45267362@N03,5996,15,1415946486,1415946486,1,7,0
45267362@N03,5996,26,1415932163,1415932163,1,7,0
45267362@N03,5996,28,1415938708,1415957493,10,7,18785
45303279@N00,5997,26,1193139149,1193139191,2,2,42
45303279@N00,5997,20,1193138697,1193139361,2,2,664
45303279@N00,5998,10,1194350082,1194350082,1,1,0
45303279@N00,5999,1,1202033215,1202033215,1,2,0
45303279@N00,5999,26,1202035017,1202035017,1,2,0
45303279@N00,6000,26,1228202532,1228219152,2,1,16620
45303279@N00,6001,26,1228727202,1228727209,4,1,7
45303279@N00,6002,26,1233013905,1233013933,2,1,28
45303279@N00,6003,26,1233186681,1233186681,1,1,0
45303279@N00,6004,26,1235000069,1235003801,9,1,3732
45303279@N00,6005,26,1235345002,1235346656,9,1,1654
45303279@N00,6006,26,1235514627,1235519015,12,1,4388
45303279@N00,6007,19,1236038033,1236038033,1,2,0
45303279@N00,6007,26,1236039468,1236040699,3,2,1231
45303279@N00,6008,24,1236396790,1236396790,1,1,0
45303279@N00,6009,26,1237243005,1237243005,1,1,0
45303279@N00,6010,26,1237846245,1237852098,16,1,5853
45303279@N00,6011,26,1251266610,1251290276,17,1,23666
45303279@N00,6012,26,1252464225,1252464704,6,1,479
45303279@N00,6013,26,1262326991,1262328648,26,1,1657
45303279@N00,6014,26,1263167739,1263176385,44,1,8646
45303279@N00,6015,26,1264376810,1264394008,82,1,17198
45303279@N00,6016,26,1265506609,1265506835,2,1,226
45303279@N00,6017,26,1266303830,1266303880,2,1,50
45303279@N00,6018,26,1267057018,1267062973,11,1,5955
45303279@N00,6019,26,1270290335,1270291329,14,1,994
45323160@N00,6020,5,1210817537,1210817947,4,4,410
45323160@N00,6020,21,1210817168,1210817264,2,4,96
45323160@N00,6020,20,1210801543,1210801543,1,4,0
45323160@N00,6020,26,1210818793,1210818793,1,4,0
45323160@N00,6021,1,1210908638,1210908638,1,1,0
45323160@N00,6022,28,1211084355,1211084355,1,1,0
45352977@N05,6023,29,1350780829,1350780829,1,4,0
45352977@N05,6023,30,1350785672,1350785672,1,4,0
45352977@N05,6023,14,1350781930,1350782503,2,4,573
45352977@N05,6023,1,1350778651,1350778651,1,4,0
45352977@N05,6024,26,1366009128,1366009179,2,1,51
45352977@N05,6025,29,1369200995,1369200995,1,10,0
45352977@N05,6025,18,1369198206,1369203419,3,10,5213
45352977@N05,6025,14,1369210338,1369210338,1,10,0
45352977@N05,6025,26,1369180455,1369180455,1,10,0
45352977@N05,6025,7,1369184328,1369184328,1,10,0
45352977@N05,6025,3,1369185355,1369185355,1,10,0
45352977@N05,6025,28,1369180153,1369180153,1,10,0
45352977@N05,6025,1,1369179971,1369179971,1,10,0
45352977@N05,6025,24,1369188808,1369188808,1,10,0
45352977@N05,6025,4,1369181847,1369182883,2,10,1036
45352977@N05,6026,25,1369278071,1369278071,1,5,0
45352977@N05,6026,16,1369272923,1369274074,2,5,1151
45352977@N05,6026,26,1369275889,1369276192,2,5,303
45352977@N05,6026,27,1369281642,1369281642,1,5,0
45352977@N05,6026,15,1369283451,1369283451,1,5,0
45352977@N05,6027,28,1381380695,1381380695,1,4,0
45352977@N05,6027,1,1381373686,1381373686,1,4,0
45352977@N05,6027,20,1381382630,1381382630,1,4,0
45352977@N05,6027,24,1381383778,1381383778,1,4,0
45352977@N05,6028,29,1384746680,1384746680,1,7,0
45352977@N05,6028,14,1384742332,1384742332,1,7,0
45352977@N05,6028,7,1384749642,1384750127,2,7,485
45352977@N05,6028,3,1384753082,1384753082,1,7,0
45352977@N05,6028,28,1384736964,1384736964,1,7,0
45352977@N05,6028,1,1384735461,1384763704,3,7,28243
45352977@N05,6028,24,1384753447,1384753447,1,7,0
45352977@N05,6029,13,1385014808,1385014808,1,3,0
45352977@N05,6029,26,1385007007,1385007007,1,3,0
45352977@N05,6029,28,1384994992,1384994992,1,3,0
45352977@N05,6030,1,1397015798,1397015798,1,3,0
45352977@N05,6030,29,1397023528,1397023528,1,3,0
45352977@N05,6030,30,1397025543,1397025543,1,3,0
45352977@N05,6031,20,1402972918,1402972918,1,3,0
45352977@N05,6031,19,1402966128,1402966128,1,3,0
45352977@N05,6031,14,1402980355,1402986862,2,3,6507
45352977@N05,6032,19,1405483098,1405483098,1,1,0
45352977@N05,6033,3,1409535185,1409535185,1,3,0
45352977@N05,6033,19,1409535137,1409535137,1,3,0
45352977@N05,6033,4,1409548901,1409548901,1,3,0
45352977@N05,6034,19,1414028399,1414050871,3,3,22472
45352977@N05,6034,30,1414033837,1414040856,2,3,7019
45352977@N05,6034,23,1414040855,1414040855,1,3,0
45352977@N05,6035,18,1427075180,1427082109,2,1,6929
45352977@N05,6036,18,1431395189,1431410419,3,1,15230
45352977@N05,6037,18,1434850177,1434870484,2,1,20307
45352977@N05,6038,20,1435110402,1435110402,1,1,0
45352977@N05,6039,18,1441603337,1441610099,2,1,6762
45352977@N05,6040,17,1441932313,1441932313,1,3,0
45352977@N05,6040,29,1441939077,1441939077,1,3,0
45352977@N05,6040,18,1441929597,1441938960,2,3,9363
45352977@N05,6041,30,1442105158,1442105158,1,1,0
45423318@N00,6042,26,1227936293,1227936388,2,3,95
45423318@N00,6042,3,1227921560,1227921581,3,3,21
45423318@N00,6042,28,1227917908,1227917908,1,3,0
45423318@N00,6043,5,1465177194,1465177194,1,8,0
45423318@N00,6043,21,1465178920,1465207621,8,8,28701
45423318@N00,6043,1,1465175448,1465175448,1,8,0
45423318@N00,6043,11,1465183119,1465183134,2,8,15
45423318@N00,6043,13,1465181759,1465182033,6,8,274
45423318@N00,6043,18,1465202252,1465202252,1,8,0
45423318@N00,6043,29,1465187142,1465189898,3,8,2756
45423318@N00,6043,25,1465178908,1465178909,2,8,1
45462443@N08,6044,26,1278044172,1278044172,1,1,0
45518929@N07,6045,28,1357001883,1357003689,18,1,1806
45539802@N03,6046,18,1430125920,1430125920,1,1,0
45539802@N03,6047,18,1449459905,1449459905,1,1,0
45553905@N00,6048,13,1238572195,1238572195,1,4,0
45553905@N00,6048,24,1238567458,1238567458,1,4,0
45553905@N00,6048,31,1238562642,1238562685,2,4,43
45553905@N00,6048,25,1238568881,1238568881,1,4,0
45553905@N00,6049,18,1243771896,1243771896,1,3,0
45553905@N00,6049,15,1243742660,1243744060,6,3,1400
45553905@N00,6049,16,1243738555,1243765711,2,3,27156
45553905@N00,6050,1,1243920473,1243920773,2,1,300
45553905@N00,6051,1,1275436027,1275436227,2,9,200
45553905@N00,6051,29,1275481668,1275482671,6,9,1003
45553905@N00,6051,26,1275463810,1275464470,11,9,660
45553905@N00,6051,16,1275436294,1275436294,1,9,0
45553905@N00,6051,21,1275465685,1275465685,1,9,0
45553905@N00,6051,3,1275465458,1275465578,6,9,120
45553905@N00,6051,24,1275437600,1275447096,7,9,9496
45553905@N00,6051,20,1275441744,1275475141,2,9,33397
45553905@N00,6051,6,1275465015,1275465015,1,9,0
45553905@N00,6052,1,1288075406,1288075409,2,1,3
45561435@N00,6053,13,1206147765,1206147765,1,1,0
45571875@N06,6054,25,1368155901,1368155901,1,1,0
45571875@N06,6055,26,1368197260,1368197260,1,3,0
45571875@N06,6055,27,1368205647,1368205744,2,3,97
45571875@N06,6055,15,1368186730,1368186730,1,3,0
45571875@N06,6056,26,1368607140,1368607266,2,2,126
45571875@N06,6056,1,1368631956,1368631956,1,2,0
45577837@N02,6057,16,1363365930,1363365930,1,1,0
45613511@N00,6058,24,1433648835,1433648835,1,1,0
45620944@N07,6059,29,1260956305,1260956471,3,3,166
45620944@N07,6059,25,1260962406,1260962565,3,3,159
45620944@N07,6059,26,1260953179,1260963865,2,3,10686
45692745@N00,6060,29,1209193457,1209193457,1,1,0
45744548@N03,6061,1,1300712400,1300712400,1,1,0
45749280@N00,6062,25,1285756226,1285756587,4,8,361
45749280@N00,6062,20,1285751318,1285779679,16,8,28361
45749280@N00,6062,29,1285751084,1285764395,3,8,13311
45749280@N00,6062,1,1285745599,1285745599,1,8,0
45749280@N00,6062,13,1285756743,1285756743,1,8,0
45749280@N00,6062,18,1285747395,1285747395,1,8,0
45749280@N00,6062,28,1285745871,1285747011,3,8,1140
45749280@N00,6062,12,1285757049,1285758648,5,8,1599
45749280@N00,6063,20,1285838229,1285838229,1,6,0
45749280@N00,6063,29,1285836465,1285836771,5,6,306
45749280@N00,6063,26,1285835614,1285841677,7,6,6063
45749280@N00,6063,1,1285845084,1285851226,6,6,6142
45749280@N00,6063,5,1285853874,1285853874,1,6,0
45749280@N00,6063,28,1285834648,1285855297,3,6,20649
45749280@N00,6064,1,1315982408,1315985829,23,1,3421
45749280@N00,6065,20,1316140515,1316140572,3,1,57
45749280@N00,6066,29,1316177042,1316188393,27,3,11351
45749280@N00,6066,1,1316189454,1316189454,1,3,0
45749280@N00,6066,28,1316188854,1316189288,5,3,434
45749280@N00,6067,28,1316247373,1316247451,2,1,78
45756179@N03,6068,22,1253183133,1253183133,1,1,0
45767882@N08,6069,19,1415588746,1415588746,1,1,0
45775305@N07,6070,28,1363059554,1363059554,1,1,0
45871224@N03,6071,26,1386474450,1386499878,3,1,25428
45871224@N03,6072,26,1386581634,1386581634,1,1,0
45871224@N03,6073,26,1393221781,1393223323,3,1,1542
45871224@N03,6074,26,1394082162,1394083509,4,1,1347
45871224@N03,6075,26,1394605023,1394605023,1,1,0
45871224@N03,6076,26,1414130511,1414130780,2,1,269
45875573@N08,6077,29,1310029318,1310029318,1,1,0
45875573@N08,6078,29,1325914305,1325914305,1,3,0
45875573@N08,6078,12,1325919566,1325919566,1,3,0
45875573@N08,6078,3,1325919653,1325919653,1,3,0
45906008@N00,6079,28,1254352770,1254387429,11,1,34659
45906008@N00,6080,28,1254441722,1254441722,1,1,0
45906008@N00,6081,25,1385781106,1385781140,2,4,34
45906008@N00,6081,26,1385778878,1385778878,1,4,0
45906008@N00,6081,29,1385788080,1385788080,1,4,0
45906008@N00,6081,13,1385782808,1385782808,1,4,0
45923298@N00,6082,28,1338432294,1338472813,4,10,40519
45923298@N00,6082,30,1338468978,1338468978,1,10,0
45923298@N00,6082,22,1338488215,1338488215,1,10,0
45923298@N00,6082,27,1338463087,1338463087,1,10,0
45923298@N00,6082,20,1338437478,1338437478,1,10,0
45923298@N00,6082,16,1338463334,1338463334,1,10,0
45923298@N00,6082,17,1338445868,1338445868,1,10,0
45923298@N00,6082,24,1338448076,1338463141,2,10,15065
45923298@N00,6082,1,1338432025,1338451211,3,10,19186
45923298@N00,6082,29,1338452333,1338473160,3,10,20827
45936466@N05,6083,1,1391386413,1391386413,1,1,0
45936466@N05,6084,1,1392957248,1392957248,1,1,0
45952470@N04,6085,12,1199560579,1199560646,2,1,67
45962202@N05,6086,28,1353465145,1353486134,3,1,20989
45978658@N06,6087,26,1341553665,1341553665,1,1,0
46009759@N07,6088,28,1325417641,1325417641,1,1,0
46026530@N04,6089,26,1384163378,1384163378,1,1,0
46027550@N00,6090,15,1187958158,1187958158,1,1,0
46027550@N00,6091,15,1188050400,1188050429,29,1,29
46027550@N00,6092,15,1199011035,1199020693,5,1,9658
46027550@N00,6093,15,1199097866,1199106321,3,1,8455
46027550@N00,6094,15,1221811554,1221817805,13,1,6251
46027550@N00,6095,15,1221899090,1221913643,15,1,14553
46027550@N00,6096,15,1223633481,1223637069,2,1,3588
46027550@N00,6097,15,1223711366,1223719983,8,1,8617
46027550@N00,6098,15,1223795243,1223795243,1,1,0
46027550@N00,6099,25,1227686329,1227687446,3,2,1117
46027550@N00,6099,27,1227685279,1227685279,1,2,0
46027550@N00,6100,15,1232182500,1232191863,9,1,9363
46027550@N00,6101,25,1233820510,1233820510,1,1,0
46027550@N00,6102,15,1244795183,1244797689,6,1,2506
46027550@N00,6103,1,1245034702,1245034702,1,1,0
46027550@N00,6104,15,1246612839,1246622164,3,1,9325
46027550@N00,6105,15,1246698756,1246710805,11,1,12049
46027550@N00,6106,15,1253790251,1253791262,7,1,1011
46027550@N00,6107,15,1253871684,1253872370,5,1,686
46027550@N00,6108,18,1259401464,1259401464,1,1,0
46027550@N00,6109,25,1265446773,1265446773,1,1,0
46027550@N00,6110,17,1267085514,1267087118,2,1,1604
46027550@N00,6111,24,1299904885,1299905005,2,1,120
46027550@N00,6112,27,1325313540,1325313540,1,1,0
46027550@N00,6113,15,1415585434,1415585434,1,1,0
46050386@N03,6114,13,1266207252,1266207252,1,3,0
46050386@N03,6114,20,1266207255,1266207255,1,3,0
46050386@N03,6114,28,1266207242,1266207242,1,3,0
46050386@N03,6115,28,1266750513,1266750513,1,3,0
46050386@N03,6115,25,1266750521,1266750521,1,3,0
46050386@N03,6115,19,1266750516,1266750516,1,3,0
46050386@N03,6116,31,1268612602,1268612602,1,14,0
46050386@N03,6116,24,1268609000,1268610883,10,14,1883
46050386@N03,6116,14,1268605229,1268605229,1,14,0
46050386@N03,6116,22,1268616847,1268618288,5,14,1441
46050386@N03,6116,27,1268607837,1268646622,10,14,38785
46050386@N03,6116,23,1268657551,1268657551,1,14,0
46050386@N03,6116,4,1268611920,1268611920,1,14,0
46050386@N03,6116,1,1268607212,1268627242,3,14,20030
46050386@N03,6116,20,1268615195,1268658359,13,14,43164
46050386@N03,6116,19,1268618989,1268620146,10,14,1157
46050386@N03,6116,28,1268607324,1268646020,4,14,38696
46050386@N03,6116,17,1268607910,1268649480,4,14,41570
46050386@N03,6116,29,1268620272,1268620371,2,14,99
46050386@N03,6116,16,1268607871,1268607871,1,14,0
46050386@N03,6117,22,1268711157,1268711467,3,12,310
46050386@N03,6117,26,1268698546,1268706565,21,12,8019
46050386@N03,6117,27,1268699706,1268718756,3,12,19050
46050386@N03,6117,13,1268702350,1268704271,16,12,1921
46050386@N03,6117,18,1268713177,1268713306,2,12,129
46050386@N03,6117,1,1268719531,1268720046,12,12,515
46050386@N03,6117,20,1268708892,1268708897,2,12,5
46050386@N03,6117,15,1268699775,1268699775,1,12,0
46050386@N03,6117,28,1268698317,1268719493,7,12,21176
46050386@N03,6117,25,1268701216,1268702232,21,12,1016
46050386@N03,6117,5,1268705524,1268705918,5,12,394
46050386@N03,6117,16,1268698700,1268699451,5,12,751
46050386@N03,6118,22,1306314755,1306314755,1,6,0
46050386@N03,6118,13,1306310870,1306310904,3,6,34
46050386@N03,6118,1,1306307119,1306319216,2,6,12097
46050386@N03,6118,25,1306310319,1306310319,1,6,0
46050386@N03,6118,10,1306311312,1306313302,17,6,1990
46050386@N03,6118,29,1306315704,1306317079,3,6,1375
46050386@N03,6119,21,1306381427,1306382449,12,16,1022
46050386@N03,6119,8,1306374919,1306375045,2,16,126
46050386@N03,6119,31,1306384669,1306384669,1,16,0
46050386@N03,6119,11,1306382225,1306382346,12,16,121
46050386@N03,6119,26,1306379768,1306402322,4,16,22554
46050386@N03,6119,27,1306372031,1306374029,3,16,1998
46050386@N03,6119,13,1306382718,1306388717,14,16,5999
46050386@N03,6119,12,1306388946,1306388971,4,16,25
46050386@N03,6119,18,1306394574,1306395459,6,16,885
46050386@N03,6119,3,1306381075,1306381075,1,16,0
46050386@N03,6119,19,1306377652,1306378659,7,16,1007
46050386@N03,6119,28,1306391291,1306399669,15,16,8378
46050386@N03,6119,5,1306374981,1306375034,2,16,53
46050386@N03,6119,10,1306375142,1306375368,3,16,226
46050386@N03,6119,29,1306396187,1306396218,2,16,31
46050386@N03,6119,16,1306391021,1306391389,15,16,368
46077647@N00,6120,24,1214965285,1214965285,1,6,0
46077647@N00,6120,29,1214968242,1214968242,1,6,0
46077647@N00,6120,23,1214968631,1214968631,1,6,0
46077647@N00,6120,26,1214968899,1214968899,1,6,0
46077647@N00,6120,1,1214971837,1214971850,2,6,13
46077647@N00,6120,21,1214965478,1214965478,1,6,0
46077647@N00,6121,25,1242813197,1242814347,7,2,1150
46077647@N00,6121,29,1242817811,1242817811,1,2,0
46097191@N00,6122,26,1276821808,1276845860,40,1,24052
46097191@N00,6123,26,1278924647,1278931367,18,1,6720
46097854@N00,6124,28,1379668814,1379668814,1,1,0
46097854@N00,6125,28,1381661513,1381661513,1,3,0
46097854@N00,6125,15,1381640346,1381640346,1,3,0
46097854@N00,6125,1,1381636870,1381661426,3,3,24556
46097854@N00,6126,29,1383273273,1383273273,1,1,0
46097854@N00,6127,27,1383457374,1383457374,1,3,0
46097854@N00,6127,23,1383441958,1383441958,1,3,0
46097854@N00,6127,15,1383451978,1383451978,1,3,0
46097854@N00,6128,26,1384476820,1384476820,1,6,0
46097854@N00,6128,20,1384504243,1384504243,1,6,0
46097854@N00,6128,19,1384481975,1384481975,1,6,0
46097854@N00,6128,27,1384474908,1384474908,1,6,0
46097854@N00,6128,29,1384479286,1384479286,1,6,0
46097854@N00,6128,1,1384473543,1384473543,1,6,0
46097854@N00,6129,16,1422426064,1422426064,1,1,0
46097854@N00,6130,30,1443686029,1443686029,1,3,0
46097854@N00,6130,18,1443680180,1443680180,1,3,0
46097854@N00,6130,29,1443685231,1443685231,1,3,0
46121254@N00,6131,31,1334195349,1334195361,2,1,12
46196249@N00,6132,7,1402184990,1402184990,1,1,0
46196249@N00,6133,15,1450225041,1450225041,1,2,0
46196249@N00,6133,28,1450222868,1450222868,1,2,0
46277726@N00,6134,28,1223881214,1223881214,1,3,0
46277726@N00,6134,22,1223893620,1223893620,1,3,0
46277726@N00,6134,26,1223893472,1223893472,1,3,0
46283533@N08,6135,14,1204959367,1204959367,1,1,0
46283533@N08,6136,17,1254474579,1254474579,1,1,0
46283533@N08,6137,30,1282998896,1282998896,1,1,0
46283533@N08,6138,26,1290585196,1290586047,2,1,851
46283533@N08,6139,28,1308897076,1308897076,1,1,0
46283533@N08,6140,14,1312934471,1312934471,1,2,0
46283533@N08,6140,20,1312934248,1312934248,1,2,0
46283533@N08,6141,26,1322379372,1322379372,1,1,0
46283533@N08,6142,26,1331940810,1331940810,1,1,0
46283533@N08,6143,16,1336809597,1336809597,1,2,0
46283533@N08,6143,12,1336809528,1336809969,2,2,441
46283533@N08,6144,16,1337923183,1337923807,3,1,624
46283533@N08,6145,4,1343303269,1343303269,1,1,0
46283533@N08,6146,29,1351334116,1351334116,1,1,0
46283533@N08,6147,1,1353475970,1353476385,2,1,415
46283533@N08,6148,12,1413531721,1413531721,1,1,0
46283533@N08,6149,24,1415600567,1415600567,1,1,0
46283533@N08,6150,26,1415959607,1415959607,1,1,0
46283533@N08,6151,26,1416368559,1416368559,1,1,0
46283533@N08,6152,24,1417673475,1417673475,1,1,0
46283533@N08,6153,1,1419058607,1419059516,4,1,909
46283533@N08,6154,31,1421561604,1421561604,1,1,0
46300970@N06,6155,16,1430649036,1430649036,1,1,0
46344160@N07,6156,19,1415576628,1415581799,2,1,5171
46344319@N08,6157,26,1382224812,1382224812,1,2,0
46344319@N08,6157,25,1382225612,1382225612,1,2,0
46353666@N03,6158,26,1392952076,1392976535,9,4,24459
46353666@N03,6158,7,1392957787,1392957787,1,4,0
46353666@N03,6158,28,1392974510,1392974510,1,4,0
46353666@N03,6158,10,1392952291,1392952291,1,4,0
46353666@N03,6159,26,1393051592,1393052994,5,4,1402
46353666@N03,6159,7,1393054493,1393054493,1,4,0
46353666@N03,6159,22,1393054825,1393054825,1,4,0
46353666@N03,6159,28,1393060912,1393070500,5,4,9588
46453719@N00,6160,21,1388869306,1388869306,1,2,0
46453719@N00,6160,16,1388868761,1388868761,1,2,0
46508645@N00,6161,1,1374806155,1374806155,1,1,0
46542299@N06,6162,20,1385621133,1385621133,1,1,0
46559377@N00,6163,3,1346140176,1346140176,1,1,0
46580267@N08,6164,31,1416211061,1416211061,1,1,0
46602694@N00,6165,29,1378001588,1378001588,1,1,0
46602694@N00,6166,12,1378034485,1378034485,1,1,0
46631270@N00,6167,28,1262036451,1262036451,1,1,0
46631270@N00,6168,3,1262069835,1262069851,2,1,16
46631270@N00,6169,9,1300251502,1300251512,3,4,10
46631270@N00,6169,5,1300251570,1300251572,2,4,2
46631270@N00,6169,26,1300249998,1300256754,3,4,6756
46631270@N00,6169,3,1300251396,1300251539,9,4,143
46649528@N04,6170,26,1316342723,1316342723,1,1,0
46677727@N00,6171,27,1198823044,1198829536,2,1,6492
46677727@N00,6172,24,1249261246,1249261246,1,1,0
46688467@N06,6173,28,1328956403,1328956403,1,2,0
46688467@N06,6173,29,1328940675,1328940675,1,2,0
46709051@N03,6174,28,1323258916,1323258916,1,2,0
46709051@N03,6174,16,1323258581,1323258581,1,2,0
46709051@N03,6175,25,1355210871,1355210871,1,1,0
46709051@N03,6176,7,1355312854,1355313435,2,1,581
46781367@N08,6177,29,1263042001,1263042028,7,1,27
46806548@N00,6178,28,1329901693,1329901693,1,1,0
46816976@N08,6179,20,1357180928,1357181107,3,1,179
46816976@N08,6180,20,1357380378,1357380378,1,1,0
46816976@N08,6181,6,1360043998,1360044277,2,5,279
46816976@N08,6181,30,1360043777,1360043777,1,5,0
46816976@N08,6181,26,1360044146,1360044146,1,5,0
46816976@N08,6181,29,1360042618,1360043129,2,5,511
46816976@N08,6181,28,1360045157,1360045157,1,5,0
46816976@N08,6182,26,1363751782,1363752031,2,1,249
46816976@N08,6183,29,1367390619,1367390619,1,1,0
46816976@N08,6184,28,1367675134,1367675134,1,1,0
46816976@N08,6185,29,1384680918,1384680918,1,1,0
46869391@N00,6186,7,1387892215,1387892215,1,1,0
46879921@N05,6187,16,1357199650,1357199650,1,3,0
46879921@N05,6187,21,1357199053,1357199053,1,3,0
46879921@N05,6187,26,1357200502,1357200502,1,3,0
46901323@N02,6188,16,1262321098,1262321098,1,1,0
46958645@N00,6189,1,1367705523,1367705523,1,1,0
46969058@N08,6190,3,1431941753,1431941753,1,1,0
46999149@N02,6191,26,1236592609,1236592719,2,2,110
46999149@N02,6191,29,1236590672,1236590672,1,2,0
46999149@N02,6192,26,1243758738,1243758738,1,1,0
46999149@N02,6193,29,1263796117,1263796117,1,2,0
46999149@N02,6193,22,1263797109,1263797109,1,2,0
46999149@N02,6194,13,1264930108,1264931295,2,7,1187
46999149@N02,6194,14,1264916249,1264916249,1,7,0
46999149@N02,6194,17,1264932059,1264932059,1,7,0
46999149@N02,6194,22,1264916034,1264916884,4,7,850
46999149@N02,6194,16,1264911913,1264912913,3,7,1000
46999149@N02,6194,10,1264914675,1264914808,3,7,133
46999149@N02,6194,24,1264911558,1264911558,1,7,0
46999149@N02,6195,15,1332824677,1332824677,1,1,0
46999149@N02,6196,28,1355295001,1355295001,1,1,0
47081385@N00,6197,26,1202212831,1202219605,34,5,6774
47081385@N00,6197,1,1202189732,1202189732,1,5,0
47081385@N00,6197,28,1202220127,1202222471,2,5,2344
47081385@N00,6197,8,1202204342,1202212810,18,5,8468
47081385@N00,6197,18,1202213166,1202213166,1,5,0
47081385@N00,6198,1,1202920222,1202920222,1,1,0
47108349@N07,6199,30,1283410751,1283410881,3,8,130
47108349@N07,6199,28,1283407109,1283407109,1,8,0
47108349@N07,6199,16,1283407590,1283408040,3,8,450
47108349@N07,6199,27,1283407751,1283407751,1,8,0
47108349@N07,6199,26,1283396641,1283408188,3,8,11547
47108349@N07,6199,13,1283402090,1283402090,1,8,0
47108349@N07,6199,3,1283397500,1283397500,1,8,0
47108349@N07,6199,17,1283404890,1283404890,1,8,0
47145959@N05,6200,15,1320563078,1320563078,1,2,0
47145959@N05,6200,20,1320568689,1320568689,1,2,0
47145959@N05,6201,1,1402650515,1402650515,1,1,0
47205201@N07,6202,1,1343078026,1343122890,37,1,44864
47205201@N07,6203,1,1343197175,1343228606,20,1,31431
47205201@N07,6204,1,1344671155,1344671155,1,1,0
47211871@N00,6205,30,1297534707,1297545002,12,1,10295
47246716@N06,6206,21,1308308620,1308308938,2,1,318
47246716@N06,6207,21,1308354870,1308354911,2,2,41
47246716@N06,6207,26,1308354380,1308354380,1,2,0
47246716@N06,6208,26,1308450864,1308451526,2,1,662
47246716@N06,6209,28,1309403912,1309403912,1,1,0
47280789@N05,6210,1,1391298182,1391298182,1,1,0
47284527@N03,6211,5,1218789570,1218789570,1,1,0
47294204@N05,6212,26,1381536431,1381536431,1,1,0
47330515@N02,6213,28,1288254341,1288254341,1,1,0
47363316@N08,6214,28,1327636116,1327636823,2,2,707
47363316@N08,6214,26,1327635643,1327635643,1,2,0
47423151@N06,6215,20,1331105803,1331105803,1,3,0
47423151@N06,6215,26,1331105718,1331119855,2,3,14137
47423151@N06,6215,28,1331102597,1331102597,1,3,0
47423151@N06,6216,26,1331302864,1331302864,1,4,0
47423151@N06,6216,25,1331301896,1331301896,1,4,0
47423151@N06,6216,27,1331275267,1331275267,1,4,0
47423151@N06,6216,18,1331303713,1331303713,1,4,0
47423151@N06,6217,20,1409225904,1409225904,1,2,0
47423151@N06,6217,3,1409230443,1409230443,1,2,0
47423151@N06,6218,30,1409549489,1409549489,1,1,0
47423151@N06,6219,25,1410126598,1410126598,1,1,0
47462072@N00,6220,28,1361517958,1361517958,1,4,0
47462072@N00,6220,26,1361514753,1361514753,1,4,0
47462072@N00,6220,24,1361511153,1361511153,1,4,0
47462072@N00,6220,29,1361513411,1361513567,2,4,156
47462072@N00,6221,25,1386331847,1386331847,1,4,0
47462072@N00,6221,28,1386327081,1386327138,3,4,57
47462072@N00,6221,26,1386329168,1386329168,2,4,0
47462072@N00,6221,21,1386331523,1386331741,4,4,218
47487972@N06,6222,29,1401159877,1401160284,2,1,407
47554402@N00,6223,26,1283826853,1283826853,1,2,0
47554402@N00,6223,28,1283826583,1283867146,36,2,40563
47554402@N00,6224,28,1283924555,1283924555,1,1,0
47576966@N05,6225,1,1193552916,1193552971,2,5,55
47576966@N05,6225,28,1193530753,1193570257,5,5,39504
47576966@N05,6225,21,1193532360,1193535120,2,5,2760
47576966@N05,6225,12,1193530822,1193530822,1,5,0
47576966@N05,6225,19,1193546128,1193546128,1,5,0
47576966@N05,6226,28,1193615333,1193615333,1,2,0
47576966@N05,6226,25,1193622496,1193622601,2,2,105
47576966@N05,6227,28,1269094606,1269094606,1,1,0
47576966@N05,6228,28,1324943851,1324943895,2,1,44
47593397@N06,6229,20,1391299037,1391299167,2,2,130
47593397@N06,6229,5,1391296356,1391296356,1,2,0
47684716@N07,6230,30,1274360297,1274360297,1,1,0
47694179@N06,6231,4,1471398373,1471398373,1,3,0
47694179@N06,6231,15,1471394722,1471413559,5,3,18837
47694179@N06,6231,21,1471398702,1471398702,1,3,0
47694179@N06,6232,27,1471477714,1471477721,2,3,7
47694179@N06,6232,26,1471488131,1471488140,2,3,9
47694179@N06,6232,28,1471491755,1471515522,3,3,23767
47694179@N06,6233,1,1471784582,1471784582,1,2,0
47694179@N06,6233,28,1471784407,1471784510,5,2,103
47696411@N00,6234,16,1297738743,1297738743,1,2,0
47696411@N00,6234,15,1297738062,1297742735,3,2,4673
47728175@N00,6235,10,1213330778,1213331099,3,14,321
47728175@N00,6235,19,1213314226,1213314646,2,14,420
47728175@N00,6235,26,1213318190,1213322323,3,14,4133
47728175@N00,6235,7,1213339529,1213339529,1,14,0
47728175@N00,6235,13,1213341280,1213341804,2,14,524
47728175@N00,6235,17,1213317385,1213317385,1,14,0
47728175@N00,6235,20,1213325341,1213325341,1,14,0
47728175@N00,6235,31,1213324893,1213324893,1,14,0
47728175@N00,6235,24,1213360361,1213360361,1,14,0
47728175@N00,6235,22,1213335645,1213336121,3,14,476
47728175@N00,6235,23,1213318056,1213318056,1,14,0
47728175@N00,6235,16,1213318409,1213357217,4,14,38808
47728175@N00,6235,6,1213338499,1213338499,1,14,0
47728175@N00,6235,18,1213314039,1213314039,1,14,0
47731649@N00,6236,18,1348308074,1348308641,3,5,567
47731649@N00,6236,20,1348312673,1348313148,2,5,475
47731649@N00,6236,28,1348307646,1348308031,3,5,385
47731649@N00,6236,26,1348303696,1348303696,1,5,0
47731649@N00,6236,1,1348304151,1348304151,1,5,0
47731649@N00,6237,11,1348424657,1348424657,1,1,0
47731649@N00,6238,25,1348476716,1348476716,1,6,0
47731649@N00,6238,13,1348482103,1348482103,1,6,0
47731649@N00,6238,3,1348476140,1348476140,1,6,0
47731649@N00,6238,29,1348494950,1348494950,1,6,0
47731649@N00,6238,8,1348482893,1348482893,1,6,0
47731649@N00,6238,22,1348497769,1348497769,1,6,0
47736026@N04,6239,13,1336141921,1336151078,6,6,9157
47736026@N04,6239,1,1336136354,1336163280,2,6,26926
47736026@N04,6239,18,1336153152,1336153152,1,6,0
47736026@N04,6239,31,1336141009,1336141009,1,6,0
47736026@N04,6239,28,1336137330,1336159613,2,6,22283
47736026@N04,6239,16,1336154629,1336157169,2,6,2540
47747515@N06,6240,20,1283323619,1283323619,1,1,0
47776802@N06,6241,15,1430072436,1430072436,1,1,0
47841296@N07,6242,1,1392715418,1392715418,1,1,0
47845844@N05,6243,1,1375792586,1375792586,1,2,0
47845844@N05,6243,28,1375807140,1375807145,2,2,5
47877526@N04,6244,21,1294351542,1294351542,1,1,0
47894721@N02,6245,12,1333365301,1333365301,1,3,0
47894721@N02,6245,26,1333366118,1333366118,1,3,0
47894721@N02,6245,24,1333362333,1333362522,2,3,189
47894721@N02,6246,29,1334413092,1334413092,1,1,0
47923881@N05,6247,20,1377693123,1377693123,1,1,0
47931061@N08,6248,28,1402734709,1402734709,1,5,0
47931061@N08,6248,26,1402734470,1402734470,1,5,0
47931061@N08,6248,22,1402730612,1402730612,1,5,0
47931061@N08,6248,27,1402735074,1402735074,1,5,0
47931061@N08,6248,25,1402730682,1402730682,1,5,0
48060755@N06,6249,10,1284118640,1284118640,1,1,0
48081748@N00,6250,20,1316854628,1316854628,1,4,0
48081748@N00,6250,18,1316831460,1316831460,1,4,0
48081748@N00,6250,8,1316828099,1316828099,1,4,0
48081748@N00,6250,26,1316834707,1316834707,1,4,0
48081748@N00,6251,1,1379766771,1379766771,1,1,0
48096279@N00,6252,1,1220580350,1220580350,1,9,0
48096279@N00,6252,4,1220591601,1220612264,2,9,20663
48096279@N00,6252,18,1220598547,1220598547,1,9,0
48096279@N00,6252,28,1220580441,1220615055,10,9,34614
48096279@N00,6252,12,1220584342,1220587309,7,9,2967
48096279@N00,6252,16,1220580585,1220604922,6,9,24337
48096279@N00,6252,13,1220588251,1220589465,5,9,1214
48096279@N00,6252,22,1220593009,1220593491,4,9,482
48096279@N00,6252,29,1220596528,1220596528,1,9,0
48101006@N02,6253,18,1430732535,1430732535,1,1,0
48101006@N02,6254,27,1433658332,1433658332,1,1,0
48101006@N02,6255,28,1439717674,1439717674,1,1,0
48101006@N02,6256,30,1441593759,1441593759,1,1,0
48101006@N02,6257,17,1447460970,1447460970,1,1,0
48101006@N02,6258,19,1451018344,1451018344,1,1,0
48101006@N02,6259,18,1452309363,1452309363,1,1,0
48101006@N02,6260,28,1459473926,1459473926,1,1,0
48101006@N02,6261,15,1461397134,1461397134,1,1,0
48101006@N02,6262,16,1463904662,1463904662,1,1,0
48108659@N00,6263,4,1255752901,1255752901,1,9,0
48108659@N00,6263,25,1255757185,1255757185,1,9,0
48108659@N00,6263,16,1255752645,1255752662,2,9,17
48108659@N00,6263,3,1255753365,1255755464,3,9,2099
48108659@N00,6263,7,1255749189,1255749189,1,9,0
48108659@N00,6263,26,1255777563,1255777563,1,9,0
48108659@N00,6263,15,1255739765,1255740097,5,9,332
48108659@N00,6263,10,1255755677,1255755677,1,9,0
48108659@N00,6263,14,1255769253,1255769253,1,9,0
48108659@N00,6264,26,1264665364,1264665659,4,1,295
48108659@N00,6265,24,1264725233,1264727370,4,8,2137
48108659@N00,6265,25,1264735354,1264746920,7,8,11566
48108659@N00,6265,21,1264731153,1264731242,2,8,89
48108659@N00,6265,6,1264729858,1264733024,3,8,3166
48108659@N00,6265,1,1264723653,1264723861,2,8,208
48108659@N00,6265,27,1264734871,1264734871,1,8,0
48108659@N00,6265,28,1264724025,1264724025,1,8,0
48108659@N00,6265,13,1264738554,1264738554,1,8,0
48108659@N00,6266,24,1267748057,1267753225,2,4,5168
48108659@N00,6266,25,1267750399,1267750575,2,4,176
48108659@N00,6266,12,1267748361,1267748361,1,4,0
48108659@N00,6266,13,1267758481,1267758481,1,4,0
48108659@N00,6267,4,1289885428,1289885852,5,7,424
48108659@N00,6267,20,1289894429,1289894429,1,7,0
48108659@N00,6267,3,1289898045,1289898045,1,7,0
48108659@N00,6267,7,1289887717,1289888028,2,7,311
48108659@N00,6267,26,1289898006,1289898006,1,7,0
48108659@N00,6267,25,1289877913,1289897708,6,7,19795
48108659@N00,6267,21,1289897873,1289897873,1,7,0
48108659@N00,6268,30,1291011947,1291011947,1,1,0
48108659@N00,6269,3,1294377951,1294377951,1,2,0
48108659@N00,6269,28,1294399919,1294399919,1,2,0
48108659@N00,6270,12,1296096636,1296096636,1,3,0
48108659@N00,6270,7,1296090888,1296091363,2,3,475
48108659@N00,6270,15,1296100597,1296100634,2,3,37
48108659@N00,6271,31,1296192820,1296193256,5,2,436
48108659@N00,6271,6,1296195501,1296195501,1,2,0
48163256@N02,6272,16,1267682566,1267682566,1,3,0
48163256@N02,6272,6,1267679725,1267679725,1,3,0
48163256@N02,6272,7,1267680283,1267680283,1,3,0
48163256@N02,6273,16,1270202471,1270202471,1,1,0
48163256@N02,6274,15,1278640495,1278640495,1,1,0
48163256@N02,6275,16,1282193805,1282194195,3,2,390
48163256@N02,6275,28,1282194753,1282195047,6,2,294
48163256@N02,6276,16,1290828680,1290829342,2,1,662
48163256@N02,6277,26,1313661209,1313661209,1,1,0
48166800@N00,6278,26,1198241700,1198241704,4,4,4
48166800@N00,6278,28,1198241705,1198241708,3,4,3
48166800@N00,6278,25,1198241702,1198241702,1,4,0
48166800@N00,6278,29,1198241710,1198241710,1,4,0
48228348@N00,6279,28,1341791804,1341791870,3,1,66
48228348@N00,6280,19,1365835361,1365835361,1,2,0
48228348@N00,6280,13,1365844029,1365844029,1,2,0
48228348@N00,6281,27,1365905267,1365905267,1,1,0
48228348@N00,6282,22,1365940949,1365940949,1,1,0
48238299@N02,6283,26,1364765056,1364809974,27,1,44918
48241744@N00,6284,26,1347183914,1347183914,1,3,0
48241744@N00,6284,3,1347183739,1347183739,1,3,0
48241744@N00,6284,28,1347183599,1347184028,2,3,429
48241744@N00,6285,25,1350818828,1350818828,1,1,0
48271781@N00,6286,26,1354351700,1354351700,1,5,0
48271781@N00,6286,29,1354331986,1354331986,1,5,0
48271781@N00,6286,30,1354334244,1354334244,1,5,0
48271781@N00,6286,24,1354351710,1354351710,1,5,0
48271781@N00,6286,5,1354339520,1354339520,1,5,0
48271781@N00,6287,31,1354434112,1354434112,1,2,0
48271781@N00,6287,24,1354406846,1354406846,1,2,0
48274089@N04,6288,16,1327743870,1327743870,1,3,0
48274089@N04,6288,21,1327732226,1327732226,1,3,0
48274089@N04,6288,6,1327738507,1327738507,1,3,0
48275668@N02,6289,1,1351617597,1351618988,2,6,1391
48275668@N02,6289,5,1351651640,1351651640,1,6,0
48275668@N02,6289,29,1351599540,1351623558,5,6,24018
48275668@N02,6289,26,1351598712,1351647313,7,6,48601
48275668@N02,6289,30,1351614008,1351614008,1,6,0
48275668@N02,6289,18,1351604770,1351605661,2,6,891
48288698@N03,6290,26,1302246697,1302246749,4,1,52
48292212@N00,6291,8,1339333444,1339333444,1,1,0
48299681@N05,6292,17,1398604043,1398623588,2,1,19545
48326723@N08,6293,15,1359432980,1359432980,1,1,0
48335730@N00,6294,28,1285990743,1285990743,1,1,0
48335730@N00,6295,30,1313992327,1313992327,1,2,0
48335730@N00,6295,3,1313988166,1313988166,1,2,0
48378686@N04,6296,26,1382175365,1382175365,1,1,0
48384520@N00,6297,15,1257052720,1257052720,1,1,0
48407213@N00,6298,29,1323390363,1323390363,1,1,0
48418487@N02,6299,11,1278669752,1278669752,1,9,0
48418487@N02,6299,20,1278659515,1278659515,1,9,0
48418487@N02,6299,26,1278661987,1278665969,9,9,3982
48418487@N02,6299,31,1278658105,1278659146,6,9,1041
48418487@N02,6299,21,1278670005,1278670082,2,9,77
48418487@N02,6299,22,1278660766,1278660767,2,9,1
48418487@N02,6299,25,1278671040,1278671720,7,9,680
48418487@N02,6299,17,1278664869,1278664869,1,9,0
48418487@N02,6299,15,1278663969,1278664318,4,9,349
48418487@N02,6300,28,1278730622,1278765320,6,4,34698
48418487@N02,6300,1,1278730479,1278730479,1,4,0
48418487@N02,6300,26,1278736699,1278758824,4,4,22125
48418487@N02,6300,12,1278737032,1278737032,1,4,0
48418487@N02,6301,28,1279029598,1279034899,6,8,5301
48418487@N02,6301,26,1279030447,1279032672,6,8,2225
48418487@N02,6301,1,1279031092,1279031092,1,8,0
48418487@N02,6301,15,1279030718,1279030718,1,8,0
48418487@N02,6301,25,1279031536,1279031536,1,8,0
48418487@N02,6301,31,1279029723,1279033802,5,8,4079
48418487@N02,6301,11,1279031231,1279031378,2,8,147
48418487@N02,6301,12,1279032801,1279032801,1,8,0
48418487@N02,6302,28,1279095016,1279095016,1,1,0
48435643@N07,6303,18,1454635464,1454635464,1,1,0
48449302@N05,6304,1,1374544347,1374587879,12,1,43532
48456345@N00,6305,17,1270122600,1270122600,1,1,0
48495576@N02,6306,26,1333365219,1333365219,1,1,0
48495576@N02,6307,25,1336844362,1336844362,1,1,0
48495576@N02,6308,29,1344692367,1344692367,1,1,0
48532487@N00,6309,26,1247481565,1247481565,1,1,0
48569388@N00,6310,30,1357635437,1357635437,1,1,0
48600091327@N01,6311,28,1242458310,1242458310,1,1,0
48600093488@N01,6312,27,1310069471,1310069488,2,1,17
48600113426@N01,6313,20,1235389988,1235389988,1,5,0
48600113426@N01,6313,15,1235365835,1235389926,7,5,24091
48600113426@N01,6313,29,1235369646,1235389946,4,5,20300
48600113426@N01,6313,25,1235389818,1235389868,6,5,50
48600113426@N01,6313,22,1235389810,1235389810,1,5,0
48600113426@N01,6314,15,1235536612,1235536612,1,1,0
48630299@N07,6315,20,1310803439,1310803439,1,1,0
48678427@N06,6316,29,1429851984,1429863679,10,8,11695
48678427@N06,6316,19,1429851978,1429852060,3,8,82
48678427@N06,6316,16,1429840990,1429840990,1,8,0
48678427@N06,6316,20,1429853520,1429853520,1,8,0
48678427@N06,6316,27,1429842937,1429846511,6,8,3574
48678427@N06,6316,17,1429844138,1429850480,2,8,6342
48678427@N06,6316,13,1429857701,1429857701,1,8,0
48678427@N06,6316,18,1429852081,1429852357,6,8,276
48715359@N00,6317,28,1353294554,1353294554,1,1,0
48715359@N00,6318,28,1353400570,1353400570,1,4,0
48715359@N00,6318,13,1353401978,1353401978,1,4,0
48715359@N00,6318,26,1353401432,1353401432,1,4,0
48715359@N00,6318,21,1353401755,1353401755,1,4,0
48715359@N00,6319,15,1353471729,1353472618,2,4,889
48715359@N00,6319,24,1353471345,1353471499,3,4,154
48715359@N00,6319,28,1353462808,1353462808,1,4,0
48715359@N00,6319,1,1353458383,1353468415,2,4,10032
48731805@N02,6320,7,1315652925,1315652958,3,8,33
48731805@N02,6320,8,1315653324,1315653324,1,8,0
48731805@N02,6320,27,1315652709,1315652745,3,8,36
48731805@N02,6320,28,1315653276,1315653276,1,8,0
48731805@N02,6320,4,1315653294,1315653294,1,8,0
48731805@N02,6320,26,1315652868,1315652911,4,8,43
48731805@N02,6320,1,1315652662,1315652697,3,8,35
48731805@N02,6320,21,1315652766,1315652828,5,8,62
48741368@N00,6321,1,1380943206,1380943206,1,1,0
48758984@N03,6322,6,1188555237,1188555237,1,1,0
48805347@N04,6323,10,1287101408,1287143369,65,2,41961
48805347@N04,6323,30,1287114381,1287114381,1,2,0
48805347@N04,6324,30,1299971028,1299971070,2,1,42
48805347@N04,6325,1,1381187520,1381195118,4,1,7598
48812619@N00,6326,14,1266870311,1266870332,2,2,21
48812619@N00,6326,15,1266870324,1266870324,1,2,0
48813357@N06,6327,5,1299906921,1299906921,1,1,0
48813357@N06,6328,29,1300013524,1300013524,1,1,0
48826873@N08,6329,29,1452078460,1452078460,1,1,0
48826873@N08,6330,1,1452238539,1452238539,1,1,0
48837990@N00,6331,26,1392420972,1392420972,1,3,0
48837990@N00,6331,1,1392419241,1392419668,7,3,427
48837990@N00,6331,21,1392425363,1392425411,3,3,48
48837990@N00,6332,19,1392460907,1392460907,2,1,0
48837990@N00,6333,19,1392507363,1392507363,1,4,0
48837990@N00,6333,30,1392517975,1392517975,1,4,0
48837990@N00,6333,31,1392512896,1392512896,1,4,0
48837990@N00,6333,1,1392502240,1392502254,3,4,14
48842746@N04,6334,10,1290555126,1290555126,1,1,0
48871176@N08,6335,12,1253949827,1253949827,1,1,0
48871176@N08,6336,21,1269140004,1269140188,3,1,184
48871176@N08,6337,29,1272783925,1272783925,1,1,0
48871176@N08,6338,29,1273368544,1273376338,3,1,7794
48871176@N08,6339,29,1273990039,1273990145,2,1,106
48871176@N08,6340,28,1274572641,1274572641,1,3,0
48871176@N08,6340,1,1274572829,1274572907,2,3,78
48871176@N08,6340,29,1274581792,1274581836,6,3,44
48871176@N08,6341,22,1275092230,1275092230,1,2,0
48871176@N08,6341,29,1275101059,1275101119,2,2,60
48871176@N08,6342,29,1275800642,1275800642,1,1,0
48871176@N08,6343,29,1276399626,1276399626,1,1,0
48871176@N08,6344,29,1277441964,1277441964,1,1,0
48871176@N08,6345,29,1278034289,1278034676,4,1,387
48871176@N08,6346,29,1278379980,1278400159,55,1,20179
48871176@N08,6347,21,1278493537,1278493537,1,2,0
48871176@N08,6347,23,1278479295,1278479295,1,2,0
48874222@N02,6348,18,1447788341,1447788341,1,1,0
48889045669@N01,6349,20,1317875924,1317875924,1,1,0
48889052497@N01,6350,1,1407289731,1407298731,3,1,9000
48889052497@N01,6351,19,1407550801,1407550801,1,1,0
48889068621@N01,6352,14,1229752841,1229752841,1,1,0
48889068621@N01,6353,22,1237526369,1237526635,6,2,266
48889068621@N01,6353,13,1237529049,1237529145,4,2,96
48889068621@N01,6354,1,1238306331,1238306331,1,1,0
48889068621@N01,6355,22,1238896818,1238896831,2,5,13
48889068621@N01,6355,14,1238910440,1238910444,2,5,4
48889068621@N01,6355,31,1238909603,1238910529,10,5,926
48889068621@N01,6355,20,1238896979,1238896979,1,5,0
48889068621@N01,6355,23,1238908103,1238908105,2,5,2
48889068621@N01,6356,4,1239495461,1239495467,2,2,6
48889068621@N01,6356,25,1239495455,1239495455,1,2,0
48889068621@N01,6357,28,1240121315,1240121315,1,2,0
48889068621@N01,6357,30,1240121320,1240121353,5,2,33
48889068621@N01,6358,1,1244951281,1244951281,1,5,0
48889068621@N01,6358,28,1244948545,1244952394,4,5,3849
48889068621@N01,6358,29,1244959365,1244959365,1,5,0
48889068621@N01,6358,26,1244951568,1244951646,7,5,78
48889068621@N01,6358,16,1244948921,1244951550,3,5,2629
48889068621@N01,6359,28,1245572752,1245572752,1,4,0
48889068621@N01,6359,27,1245568276,1245568287,2,4,11
48889068621@N01,6359,24,1245566162,1245566162,1,4,0
48889068621@N01,6359,29,1245587489,1245588692,11,4,1203
48889068621@N01,6360,28,1247652064,1247652064,1,2,0
48889068621@N01,6360,16,1247655417,1247655426,2,2,9
48889068621@N01,6361,7,1247985347,1247985845,3,5,498
48889068621@N01,6361,26,1247984229,1247984229,1,5,0
48889068621@N01,6361,21,1247986337,1247986337,1,5,0
48889068621@N01,6361,4,1247985408,1247985527,7,5,119
48889068621@N01,6361,3,1247986530,1247987881,3,5,1351
48889068621@N01,6362,31,1251193984,1251193984,1,5,0
48889068621@N01,6362,30,1251185723,1251185723,1,5,0
48889068621@N01,6362,19,1251196623,1251196623,1,5,0
48889068621@N01,6362,13,1251190133,1251190133,1,5,0
48889068621@N01,6362,15,1251189804,1251189804,1,5,0
48889068621@N01,6363,18,1258867598,1258867598,1,6,0
48889068621@N01,6363,28,1258854791,1258854791,2,6,0
48889068621@N01,6363,19,1258855370,1258856275,4,6,905
48889068621@N01,6363,13,1258853661,1258853661,2,6,0
48889068621@N01,6363,29,1258866229,1258866454,3,6,225
48889068621@N01,6363,16,1258869291,1258870277,4,6,986
48889068621@N01,6364,31,1261283409,1261287498,25,6,4089
48889068621@N01,6364,28,1261277433,1261277433,1,6,0
48889068621@N01,6364,19,1261283875,1261287372,4,6,3497
48889068621@N01,6364,13,1261279927,1261281930,8,6,2003
48889068621@N01,6364,29,1261286978,1261286980,2,6,2
48889068621@N01,6364,22,1261281099,1261285034,12,6,3935
48889068621@N01,6365,3,1262488827,1262488827,1,1,0
48889068621@N01,6366,18,1262998981,1262998981,1,6,0
48889068621@N01,6366,27,1263009566,1263009566,1,6,0
48889068621@N01,6366,4,1263015229,1263015243,2,6,14
48889068621@N01,6366,16,1263011412,1263011412,1,6,0
48889068621@N01,6366,22,1262999240,1262999244,2,6,4
48889068621@N01,6366,29,1262999017,1262999017,1,6,0
48889068621@N01,6367,17,1267317328,1267317328,1,5,0
48889068621@N01,6367,18,1267326127,1267336445,2,5,10318
48889068621@N01,6367,7,1267323408,1267323428,3,5,20
48889068621@N01,6367,13,1267323395,1267323400,3,5,5
48889068621@N01,6367,15,1267325745,1267325753,3,5,8
48889068621@N01,6368,12,1267856974,1267856974,1,8,0
48889068621@N01,6368,7,1267864839,1267864882,4,8,43
48889068621@N01,6368,1,1267858909,1267859161,2,8,252
48889068621@N01,6368,15,1267857130,1267859192,12,8,2062
48889068621@N01,6368,24,1267857150,1267857160,4,8,10
48889068621@N01,6368,4,1267864698,1267864698,1,8,0
48889068621@N01,6368,16,1267857124,1267857210,2,8,86
48889068621@N01,6368,6,1267864683,1267864749,4,8,66
48889068621@N01,6369,7,1268391140,1268391140,1,2,0
48889068621@N01,6369,11,1268391876,1268391967,6,2,91
48889068621@N01,6370,15,1268994741,1268994762,5,2,21
48889068621@N01,6370,22,1268988395,1268988395,1,2,0
48889068621@N01,6371,13,1271565585,1271568552,12,1,2967
48889068621@N01,6372,16,1272167731,1272167731,1,3,0
48889068621@N01,6372,4,1272169455,1272169557,7,3,102
48889068621@N01,6372,26,1272167728,1272167728,1,3,0
48889068621@N01,6373,13,1275799767,1275800534,4,5,767
48889068621@N01,6373,4,1275802109,1275802118,3,5,9
48889068621@N01,6373,7,1275802060,1275802060,1,5,0
48889068621@N01,6373,11,1275802090,1275804561,4,5,2471
48889068621@N01,6373,25,1275800622,1275800622,1,5,0
48889068621@N01,6374,15,1284885235,1284885235,1,7,0
48889068621@N01,6374,20,1284872359,1284872362,2,7,3
48889068621@N01,6374,9,1284877344,1284877345,2,7,1
48889068621@N01,6374,24,1284885219,1284885219,1,7,0
48889068621@N01,6374,3,1284875200,1284875229,7,7,29
48889068621@N01,6374,4,1284874233,1284874255,3,7,22
48889068621@N01,6374,7,1284877336,1284877420,9,7,84
48889068621@N01,6375,15,1289110358,1289110382,3,9,24
48889068621@N01,6375,20,1289101183,1289101183,1,9,0
48889068621@N01,6375,29,1289102533,1289102533,1,9,0
48889068621@N01,6375,22,1289098793,1289102559,3,9,3766
48889068621@N01,6375,11,1289096022,1289111705,5,9,15683
48889068621@N01,6375,14,1289102027,1289102027,1,9,0
48889068621@N01,6375,17,1289111710,1289111759,7,9,49
48889068621@N01,6375,5,1289097942,1289097975,4,9,33
48889068621@N01,6375,19,1289089778,1289089778,1,9,0
48889081256@N01,6376,26,1213748927,1213788388,57,1,39461
48889113645@N01,6377,19,1407762388,1407762388,1,1,0
48889113645@N01,6378,20,1407811258,1407811258,1,4,0
48889113645@N01,6378,13,1407799058,1407799315,2,4,257
48889113645@N01,6378,19,1407798858,1407838979,4,4,40121
48889113645@N01,6378,17,1407808858,1407808858,1,4,0
48889119704@N01,6379,21,1244169016,1244173570,10,8,4554
48889119704@N01,6379,16,1244177503,1244177516,2,8,13
48889119704@N01,6379,27,1244182812,1244182812,1,8,0
48889119704@N01,6379,28,1244166939,1244168650,3,8,1711
48889119704@N01,6379,24,1244182038,1244182445,4,8,407
48889119704@N01,6379,15,1244181337,1244181337,1,8,0
48889119704@N01,6379,13,1244174133,1244174133,1,8,0
48889119704@N01,6379,1,1244167681,1244167726,2,8,45
48889119704@N01,6380,22,1244218857,1244218857,1,2,0
48889119704@N01,6380,1,1244212535,1244212535,1,2,0
48889119704@N01,6381,26,1244266679,1244266679,1,3,0
48889119704@N01,6381,24,1244259896,1244267407,9,3,7511
48889119704@N01,6381,17,1244263056,1244263056,1,3,0
48889119704@N01,6382,26,1244296455,1244296455,1,1,0
48889119704@N01,6383,17,1245058877,1245058877,1,1,0
48921737@N00,6384,1,1384999205,1384999205,1,1,0
48949906@N00,6385,20,1385363233,1385363257,4,5,24
48949906@N00,6385,1,1385362100,1385362921,7,5,821
48949906@N00,6385,18,1385364524,1385365514,7,5,990
48949906@N00,6385,23,1385364025,1385364852,5,5,827
48949906@N00,6385,26,1385363741,1385363741,1,5,0
48949906@N00,6386,7,1385513904,1385514126,6,17,222
48949906@N00,6386,27,1385502740,1385504158,7,17,1418
48949906@N00,6386,20,1385523754,1385527435,4,17,3681
48949906@N00,6386,5,1385513652,1385514155,5,17,503
48949906@N00,6386,24,1385504398,1385506262,9,17,1864
48949906@N00,6386,29,1385538238,1385540854,2,17,2616
48949906@N00,6386,16,1385503032,1385503032,1,17,0
48949906@N00,6386,12,1385505172,1385512303,28,17,7131
48949906@N00,6386,15,1385517726,1385533769,12,17,16043
48949906@N00,6386,18,1385519582,1385520668,8,17,1086
48949906@N00,6386,3,1385512146,1385512146,1,17,0
48949906@N00,6386,31,1385526447,1385526453,3,17,6
48949906@N00,6386,23,1385519125,1385520101,7,17,976
48949906@N00,6386,17,1385501057,1385517504,23,17,16447
48949906@N00,6386,13,1385528282,1385528309,3,17,27
48949906@N00,6386,9,1385514130,1385514130,1,17,0
48949906@N00,6386,26,1385516026,1385516871,34,17,845
48949906@N00,6387,24,1385632261,1385632261,1,4,0
48949906@N00,6387,28,1385636160,1385636240,7,4,80
48949906@N00,6387,18,1385636070,1385636070,1,4,0
48949906@N00,6387,21,1385632281,1385632374,3,4,93
48949906@N00,6388,11,1385686663,1385686663,1,6,0
48949906@N00,6388,16,1385679269,1385679269,1,6,0
48949906@N00,6388,18,1385679470,1385682677,13,6,3207
48949906@N00,6388,3,1385683626,1385683626,1,6,0
48949906@N00,6388,23,1385681219,1385682665,15,6,1446
48949906@N00,6388,26,1385679285,1385683023,15,6,3738
48983707@N00,6389,5,1201233494,1201233586,2,1,92
49025781@N00,6390,24,1426750133,1426750133,1,1,0
49025781@N00,6391,26,1433211624,1433211624,1,1,0
49025781@N00,6392,11,1439203491,1439203491,1,3,0
49025781@N00,6392,1,1439203460,1439203460,1,3,0
49025781@N00,6392,26,1439203950,1439203950,1,3,0
49059899@N00,6393,1,1220051712,1220051754,3,1,42
49059899@N00,6394,31,1233352116,1233352132,2,7,16
49059899@N00,6394,28,1233355802,1233355802,1,7,0
49059899@N00,6394,29,1233347421,1233347421,1,7,0
49059899@N00,6394,1,1233355786,1233355786,1,7,0
49059899@N00,6394,30,1233347429,1233347462,3,7,33
49059899@N00,6394,12,1233355400,1233355400,1,7,0
49059899@N00,6394,16,1233355470,1233355486,3,7,16
49059899@N00,6395,28,1248488093,1248488730,6,3,637
49059899@N00,6395,1,1248487928,1248488755,6,3,827
49059899@N00,6395,16,1248487468,1248487540,2,3,72
49059899@N00,6396,1,1249696014,1249696354,4,4,340
49059899@N00,6396,18,1249687613,1249687804,4,4,191
49059899@N00,6396,23,1249689647,1249689872,4,4,225
49059899@N00,6396,12,1249687780,1249687780,1,4,0
49072197@N02,6397,26,1303021442,1303021442,1,2,0
49072197@N02,6397,31,1303015081,1303015327,2,2,246
49072197@N02,6398,25,1312365210,1312365210,1,1,0
49072197@N02,6399,26,1312596661,1312600265,6,3,3604
49072197@N02,6399,1,1312595378,1312601290,2,3,5912
49072197@N02,6399,28,1312595183,1312595183,1,3,0
49165041@N00,6400,30,1197754889,1197755115,7,4,226
49165041@N00,6400,12,1197739615,1197739615,1,4,0
49165041@N00,6400,21,1197741504,1197742192,2,4,688
49165041@N00,6400,25,1197757226,1197767137,4,4,9911
49165041@N00,6401,30,1232366010,1232366072,4,4,62
49165041@N00,6401,23,1232366229,1232366236,2,4,7
49165041@N00,6401,28,1232366318,1232366318,1,4,0
49165041@N00,6401,18,1232366158,1232366286,8,4,128
49165041@N00,6402,31,1240399172,1240399172,1,11,0
49165041@N00,6402,29,1240390988,1240391376,3,11,388
49165041@N00,6402,24,1240396053,1240396216,4,11,163
49165041@N00,6402,23,1240390849,1240391807,2,11,958
49165041@N00,6402,28,1240390628,1240390628,1,11,0
49165041@N00,6402,12,1240397031,1240397031,1,11,0
49165041@N00,6402,21,1240394586,1240394586,1,11,0
49165041@N00,6402,20,1240391163,1240398411,4,11,7248
49165041@N00,6402,6,1240393479,1240393508,2,11,29
49165041@N00,6402,26,1240397555,1240397555,1,11,0
49165041@N00,6402,27,1240396380,1240396380,1,11,0
49165041@N00,6403,1,1249464786,1249464786,1,7,0
49165041@N00,6403,29,1249469510,1249469510,1,7,0
49165041@N00,6403,28,1249465114,1249475686,10,7,10572
49165041@N00,6403,23,1249470879,1249472157,9,7,1278
49165041@N00,6403,16,1249473679,1249474053,4,7,374
49165041@N00,6403,26,1249468350,1249472626,5,7,4276
49165041@N00,6403,27,1249472758,1249475078,5,7,2320
49165041@N00,6404,30,1251607681,1251609204,3,3,1523
49165041@N00,6404,29,1251607037,1251607037,1,3,0
49165041@N00,6404,26,1251603842,1251603915,3,3,73
49165041@N00,6405,28,1252839780,1252840115,3,1,335
49165041@N00,6406,1,1253002466,1253002471,2,5,5
49165041@N00,6406,29,1253006218,1253006218,1,5,0
49165041@N00,6406,24,1253007557,1253007557,1,5,0
49165041@N00,6406,12,1253006775,1253007231,3,5,456
49165041@N00,6406,22,1253005988,1253005988,1,5,0
49165041@N00,6407,1,1254025297,1254025297,1,5,0
49165041@N00,6407,29,1254030463,1254030463,1,5,0
49165041@N00,6407,16,1254025578,1254025578,1,5,0
49165041@N00,6407,17,1254026701,1254029324,5,5,2623
49165041@N00,6407,26,1254030076,1254030076,1,5,0
49165041@N00,6408,1,1254721149,1254721149,1,4,0
49165041@N00,6408,29,1254721172,1254721172,1,4,0
49165041@N00,6408,22,1254721280,1254721280,1,4,0
49165041@N00,6408,6,1254721307,1254721307,1,4,0
49165041@N00,6409,23,1258865142,1258866994,5,5,1852
49165041@N00,6409,28,1258874850,1258885828,4,5,10978
49165041@N00,6409,21,1258873215,1258874481,4,5,1266
49165041@N00,6409,13,1258873469,1258873999,3,5,530
49165041@N00,6409,20,1258868530,1258869071,4,5,541
49165041@N00,6410,22,1259047190,1259047190,1,4,0
49165041@N00,6410,29,1259063239,1259063241,2,4,2
49165041@N00,6410,23,1259043586,1259064107,3,4,20521
49165041@N00,6410,21,1259049314,1259050601,2,4,1287
49165041@N00,6411,30,1261115654,1261115654,1,1,0
49165041@N00,6412,28,1263371336,1263372497,15,3,1161
49165041@N00,6412,6,1263363380,1263380975,7,3,17595
49165041@N00,6412,29,1263368564,1263370896,13,3,2332
49165041@N00,6413,4,1267158972,1267159499,2,6,527
49165041@N00,6413,1,1267154266,1267155018,4,6,752
49165041@N00,6413,11,1267158711,1267158761,2,6,50
49165041@N00,6413,26,1267158166,1267158297,5,6,131
49165041@N00,6413,17,1267155788,1267156040,2,6,252
49165041@N00,6413,23,1267161964,1267162372,3,6,408
49165041@N00,6414,11,1271815841,1271815841,1,3,0
49165041@N00,6414,30,1271816168,1271816224,2,3,56
49165041@N00,6414,26,1271815423,1271815657,4,3,234
49165041@N00,6415,28,1279015576,1279018111,8,7,2535
49165041@N00,6415,1,1279005289,1279005289,1,7,0
49165041@N00,6415,16,1279012414,1279013305,4,7,891
49165041@N00,6415,23,1279005792,1279005792,1,7,0
49165041@N00,6415,30,1279009119,1279009119,1,7,0
49165041@N00,6415,12,1279009698,1279009698,1,7,0
49165041@N00,6415,15,1279010288,1279010288,1,7,0
49165041@N00,6416,27,1286588675,1286588747,4,5,72
49165041@N00,6416,29,1286589109,1286591622,3,5,2513
49165041@N00,6416,16,1286595874,1286601349,3,5,5475
49165041@N00,6416,30,1286589337,1286589337,1,5,0
49165041@N00,6416,24,1286587338,1286588172,3,5,834
49165041@N00,6417,28,1289454200,1289454938,2,2,738
49165041@N00,6417,29,1289452895,1289452895,1,2,0
49165041@N00,6418,16,1293757788,1293757861,2,2,73
49165041@N00,6418,24,1293750684,1293758697,17,2,8013
49165041@N00,6419,28,1301191639,1301200079,2,7,8440
49165041@N00,6419,1,1301200575,1301201560,5,7,985
49165041@N00,6419,30,1301193032,1301193660,3,7,628
49165041@N00,6419,26,1301191659,1301191970,3,7,311
49165041@N00,6419,29,1301199178,1301199500,5,7,322
49165041@N00,6419,15,1301196221,1301196278,2,7,57
49165041@N00,6419,24,1301195358,1301195901,2,7,543
49165041@N00,6420,16,1302324554,1302324554,1,3,0
49165041@N00,6420,24,1302327407,1302333131,27,3,5724
49165041@N00,6420,11,1302332430,1302332505,3,3,75
49165041@N00,6421,16,1305419491,1305419638,2,4,147
49165041@N00,6421,6,1305441983,1305441983,1,4,0
49165041@N00,6421,26,1305442484,1305442512,2,4,28
49165041@N00,6421,30,1305443281,1305443281,1,4,0
49165041@N00,6422,16,1306804094,1306804175,2,1,81
49165041@N00,6423,29,1306989029,1306989514,2,4,485
49165041@N00,6423,24,1306984648,1306984656,3,4,8
49165041@N00,6423,1,1306981998,1306981998,1,4,0
49165041@N00,6423,17,1306983248,1306983267,4,4,19
49165041@N00,6424,24,1328770604,1328770604,1,1,0
49169223@N00,6425,20,1342842323,1342842338,2,17,15
49169223@N00,6425,22,1342835165,1342835178,2,17,13
49169223@N00,6425,31,1342834958,1342835552,5,17,594
49169223@N00,6425,17,1342823215,1342830100,2,17,6885
49169223@N00,6425,19,1342837581,1342837581,1,17,0
49169223@N00,6425,29,1342837350,1342870796,3,17,33446
49169223@N00,6425,12,1342824647,1342830788,2,17,6141
49169223@N00,6425,21,1342825359,1342826997,14,17,1638
49169223@N00,6425,28,1342822664,1342822664,1,17,0
49169223@N00,6425,7,1342825406,1342825406,1,17,0
49169223@N00,6425,26,1342828166,1342828185,2,17,19
49169223@N00,6425,16,1342845429,1342845444,2,17,15
49169223@N00,6425,25,1342843712,1342843729,2,17,17
49169223@N00,6425,5,1342825720,1342825743,2,17,23
49169223@N00,6425,23,1342838395,1342839601,3,17,1206
49169223@N00,6425,24,1342828972,1342830808,15,17,1836
49169223@N00,6425,30,1342834079,1342837373,3,17,3294
49169223@N00,6426,22,1343091994,1343091994,1,5,0
49169223@N00,6426,29,1343130322,1343130816,6,5,494
49169223@N00,6426,12,1343103698,1343103698,1,5,0
49169223@N00,6426,28,1343091571,1343129681,4,5,38110
49169223@N00,6426,13,1343099490,1343099550,2,5,60
49169223@N00,6427,28,1343174240,1343174240,1,2,0
49169223@N00,6427,6,1343178446,1343178446,1,2,0
49201665@N08,6428,24,1308102247,1308102247,1,1,0
49221400@N00,6429,12,1331428381,1331428391,2,6,10
49221400@N00,6429,26,1331454209,1331454209,1,6,0
49221400@N00,6429,22,1331444386,1331458820,5,6,14434
49221400@N00,6429,15,1331426837,1331426837,1,6,0
49221400@N00,6429,16,1331424476,1331424476,1,6,0
49221400@N00,6429,27,1331416754,1331449506,6,6,32752
49226124@N02,6430,28,1318806363,1318829002,21,1,22639
49239262@N00,6431,26,1388921114,1388921114,1,1,0
49268359@N05,6432,26,1337752120,1337752120,1,1,0
49268359@N05,6433,7,1337820897,1337820897,1,1,0
49268359@N05,6434,13,1337904381,1337904433,3,2,52
49268359@N05,6434,28,1337926479,1337926479,1,2,0
49268359@N05,6435,20,1338002983,1338002983,1,1,0
49275237@N00,6436,30,1239503593,1239511927,11,6,8334
49275237@N00,6436,11,1239497588,1239498583,25,6,995
49275237@N00,6436,28,1239494620,1239494663,4,6,43
49275237@N00,6436,26,1239495923,1239496158,6,6,235
49275237@N00,6436,1,1239535629,1239536433,25,6,804
49275237@N00,6436,16,1239495715,1239495715,1,6,0
49304581@N02,6437,29,1292418240,1292418240,1,4,0
49304581@N02,6437,20,1292415300,1292416320,2,4,1020
49304581@N02,6437,26,1292420206,1292420206,1,4,0
49304581@N02,6437,28,1292421210,1292421210,1,4,0
49304581@N02,6438,30,1292968040,1292972963,2,2,4923
49304581@N02,6438,26,1292979285,1292979285,1,2,0
49304581@N02,6439,20,1293216993,1293216993,1,1,0
49304581@N02,6440,29,1293254343,1293254343,1,1,0
49304581@N02,6441,26,1293796739,1293796739,1,1,0
49304581@N02,6442,20,1293933247,1293933247,1,1,0
49304581@N02,6443,31,1294592517,1294592517,1,1,0
49304581@N02,6444,26,1312343588,1312343753,2,1,165
49304581@N02,6445,31,1312376038,1312376038,1,1,0
49304581@N02,6446,20,1313155739,1313155739,1,1,0
49304581@N02,6447,15,1313239277,1313239277,1,1,0
49304581@N02,6448,20,1316414185,1316414185,1,1,0
49304581@N02,6449,29,1319789942,1319789942,1,2,0
49304581@N02,6449,26,1319782306,1319782784,2,2,478
49304581@N02,6450,29,1322881441,1322886305,2,1,4864
49304581@N02,6451,31,1323252610,1323252610,1,1,0
49304581@N02,6452,19,1324034753,1324034753,1,1,0
49304581@N02,6453,24,1324108230,1324108230,1,5,0
49304581@N02,6453,16,1324132870,1324132870,1,5,0
49304581@N02,6453,29,1324126044,1324126044,1,5,0
49304581@N02,6453,19,1324096753,1324096753,1,5,0
49304581@N02,6453,1,1324091182,1324091301,2,5,119
49304581@N02,6454,19,1325335150,1325335150,1,1,0
49304581@N02,6455,22,1326004127,1326004127,1,2,0
49304581@N02,6455,19,1326021797,1326021797,1,2,0
49304581@N02,6456,26,1330544714,1330544774,2,1,60
49304581@N02,6457,23,1335945639,1335945639,1,1,0
49304581@N02,6458,28,1343985934,1343985934,1,3,0
49304581@N02,6458,23,1343998137,1343998384,2,3,247
49304581@N02,6458,30,1343986379,1343986379,1,3,0
49304581@N02,6459,18,1348294404,1348294404,1,1,0
49305593@N05,6460,18,1431078085,1431085407,3,1,7322
49305593@N05,6461,18,1431149807,1431177053,4,1,27246
49305593@N05,6462,18,1431252081,1431252317,2,1,236
49305593@N05,6463,18,1431414145,1431416604,3,1,2459
49305593@N05,6464,18,1431697459,1431699291,8,1,1832
49340262@N05,6465,26,1437257708,1437257708,1,1,0
49355124@N04,6466,29,1393902720,1393902720,1,1,0
49355871@N00,6467,1,1374585614,1374585614,1,1,0
49362482@N00,6468,19,1349477998,1349477998,1,2,0
49362482@N00,6468,29,1349481036,1349490591,3,2,9555
49364971@N04,6469,4,1273916288,1273916288,1,1,0
49425282@N00,6470,20,1259809200,1259809238,39,1,38
49427795@N00,6471,20,1354444488,1354444488,1,1,0
49451382@N00,6472,28,1243655434,1243676786,41,1,21352
49471872@N00,6473,28,1291683694,1291683799,3,10,105
49471872@N00,6473,23,1291683929,1291683929,1,10,0
49471872@N00,6473,17,1291714092,1291714092,1,10,0
49471872@N00,6473,19,1291680910,1291686843,10,10,5933
49471872@N00,6473,24,1291696096,1291696621,6,10,525
49471872@N00,6473,29,1291684453,1291691940,3,10,7487
49471872@N00,6473,26,1291691908,1291716203,2,10,24295
49471872@N00,6473,1,1291679637,1291679637,1,10,0
49471872@N00,6473,31,1291689810,1291689810,1,10,0
49471872@N00,6473,25,1291706199,1291706199,1,10,0
49502978053@N01,6474,22,1215670383,1215670383,1,4,0
49502978053@N01,6474,29,1215670142,1215670142,1,4,0
49502978053@N01,6474,30,1215670187,1215670236,3,4,49
49502978053@N01,6474,31,1215669306,1215670815,5,4,1509
49502978053@N01,6475,16,1216049636,1216049636,1,1,0
49502978053@N01,6476,30,1216094180,1216094180,1,2,0
49502978053@N01,6476,31,1216094130,1216094130,1,2,0
49502995892@N01,6477,18,1199551885,1199551885,1,3,0
49502995892@N01,6477,28,1199562415,1199562415,1,3,0
49502995892@N01,6477,16,1199561663,1199561663,1,3,0
49503008419@N01,6478,1,1381049272,1381049272,1,1,0
49503013198@N01,6479,25,1266726150,1266726150,1,1,0
49503068447@N01,6480,25,1406454534,1406454534,1,2,0
49503068447@N01,6480,26,1406433683,1406455847,14,2,22164
49503202796@N01,6481,25,1191650903,1191650903,1,5,0
49503202796@N01,6481,22,1191643001,1191644994,3,5,1993
49503202796@N01,6481,13,1191652838,1191652838,1,5,0
49503202796@N01,6481,28,1191656030,1191656030,1,5,0
49503202796@N01,6481,11,1191649205,1191649205,1,5,0
49545908@N00,6482,21,1283829522,1283829522,1,4,0
49545908@N00,6482,24,1283824381,1283824453,3,4,72
49545908@N00,6482,14,1283824375,1283824375,1,4,0
49545908@N00,6482,15,1283823310,1283823310,1,4,0
49578007@N05,6483,26,1356103888,1356103888,1,6,0
49578007@N05,6483,25,1356103879,1356103879,1,6,0
49578007@N05,6483,24,1356103871,1356103871,1,6,0
49578007@N05,6483,29,1356103911,1356103911,1,6,0
49578007@N05,6483,20,1356103918,1356103918,1,6,0
49578007@N05,6483,28,1356103925,1356103925,1,6,0
49578007@N05,6484,26,1360666221,1360666221,1,2,0
49578007@N05,6484,28,1360654876,1360654876,1,2,0
49578007@N05,6485,27,1363496543,1363496543,1,3,0
49578007@N05,6485,18,1363489342,1363489342,1,3,0
49578007@N05,6485,20,1363486991,1363486991,1,3,0
49578007@N05,6486,26,1367151897,1367152337,2,3,440
49578007@N05,6486,1,1367126913,1367126913,1,3,0
49578007@N05,6486,15,1367131465,1367150935,4,3,19470
49578007@N05,6487,26,1369418217,1369418217,1,3,0
49578007@N05,6487,1,1369416970,1369416970,1,3,0
49578007@N05,6487,27,1369421665,1369421665,1,3,0
49578007@N05,6488,27,1369482063,1369482063,1,3,0
49578007@N05,6488,7,1369479349,1369479349,1,3,0
49578007@N05,6488,14,1369474424,1369474424,1,3,0
49578007@N05,6489,1,1372483335,1372483335,1,1,0
49578007@N05,6490,4,1375621471,1375621471,1,1,0
49578007@N05,6491,17,1378628465,1378628465,1,1,0
49578007@N05,6492,27,1379768668,1379768668,1,1,0
49578007@N05,6493,29,1380358354,1380358354,1,2,0
49578007@N05,6493,27,1380364436,1380364436,1,2,0
49578007@N05,6494,30,1380946716,1380946716,1,1,0
49578007@N05,6495,29,1380977795,1380977795,1,1,0
49578007@N05,6496,20,1381054160,1381056695,2,1,2535
49578007@N05,6497,26,1382187126,1382190770,2,1,3644
49578007@N05,6498,15,1382852094,1382852094,1,1,0
49578007@N05,6499,18,1384669055,1384669055,1,1,0
49578007@N05,6500,26,1385652761,1385652761,1,1,0
49578007@N05,6501,28,1385695155,1385695155,1,1,0
49578007@N05,6502,20,1385802439,1385802439,1,1,0
49578007@N05,6503,29,1391870363,1391870363,1,1,0
49578007@N05,6504,27,1393657251,1393657251,1,2,0
49578007@N05,6504,17,1393682947,1393682947,1,2,0
49578007@N05,6505,30,1394859093,1394859093,1,2,0
49578007@N05,6505,28,1394870776,1394870776,1,2,0
49578007@N05,6506,30,1398415857,1398415857,1,1,0
49578007@N05,6507,1,1400883955,1400883955,1,3,0
49578007@N05,6507,29,1400875872,1400875872,1,3,0
49578007@N05,6507,26,1400874432,1400874432,1,3,0
49578007@N05,6508,28,1400929607,1400929607,1,1,0
49578007@N05,6509,28,1404462008,1404486056,2,3,24048
49578007@N05,6509,3,1404470778,1404470778,1,3,0
49578007@N05,6509,29,1404469158,1404469158,1,3,0
49578007@N05,6510,29,1405752407,1405752407,1,3,0
49578007@N05,6510,21,1405757507,1405757507,1,3,0
49578007@N05,6510,14,1405753057,1405753708,2,3,651
49578007@N05,6511,29,1408899053,1408899053,1,1,0
49578007@N05,6512,29,1410597613,1410597613,1,1,0
49578007@N05,6513,24,1411643705,1411647066,2,1,3361
49578007@N05,6514,26,1411827570,1411827570,1,1,0
49578007@N05,6515,30,1412427181,1412427181,1,1,0
49578007@N05,6516,27,1412525730,1412525730,1,1,0
49578007@N05,6517,18,1416036333,1416036333,1,2,0
49578007@N05,6517,25,1416051306,1416051306,1,2,0
49578007@N05,6518,25,1416668873,1416668873,1,1,0
49578007@N05,6519,28,1417167898,1417167898,1,1,0
49578007@N05,6520,23,1417941832,1417941832,1,1,0
49578007@N05,6521,26,1420101744,1420101744,1,1,0
49578007@N05,6522,26,1424092383,1424092383,1,1,0
49578007@N05,6523,26,1428329997,1428329997,1,1,0
49578007@N05,6524,29,1432374230,1432374230,1,1,0
49578007@N05,6525,28,1436024134,1436024134,1,1,0
49578007@N05,6526,18,1438489043,1438489043,1,1,0
49578007@N05,6527,28,1441627974,1441627974,1,1,0
49578007@N05,6528,18,1443839824,1443839824,1,2,0
49578007@N05,6528,30,1443834504,1443834504,1,2,0
49578007@N05,6529,15,1452399319,1452420501,2,1,21182
49578007@N05,6530,30,1452936812,1452936812,1,1,0
49578007@N05,6531,26,1453541122,1453541122,1,1,0
49608965@N07,6532,26,1321537021,1321537021,1,1,0
49657535@N06,6533,6,1271398460,1271398460,1,1,0
49693311@N02,6534,28,1242891123,1242891123,1,1,0
49693311@N02,6535,30,1248925754,1248925754,1,3,0
49693311@N02,6535,31,1248925826,1248925826,1,3,0
49693311@N02,6535,20,1248925857,1248925857,1,3,0
49693311@N02,6536,29,1250515935,1250516347,4,1,412
49693311@N02,6537,29,1259132963,1259150321,2,1,17358
49693311@N02,6538,17,1269930860,1269930860,1,3,0
49693311@N02,6538,12,1269929324,1269929324,1,3,0
49693311@N02,6538,21,1269928936,1269928936,1,3,0
49693311@N02,6539,27,1386307934,1386313866,3,1,5932
49705600@N06,6540,21,1358467219,1358467219,1,1,0
49705600@N06,6541,22,1358655656,1358655656,1,2,0
49705600@N06,6541,13,1358654110,1358654110,1,2,0
49721577@N00,6542,16,1237595732,1237595754,2,2,22
49721577@N00,6542,21,1237608477,1237608477,1,2,0
49768774@N02,6543,18,1298176607,1298176607,1,1,0
49768774@N02,6544,18,1328919509,1328919509,1,1,0
49771540@N05,6545,16,1280067857,1280067857,1,1,0
49780897@N07,6546,17,1323435025,1323435025,1,1,0
49780897@N07,6547,25,1323474369,1323474369,1,1,0
49780897@N07,6548,1,1331534590,1331534590,1,1,0
49780897@N07,6549,30,1331601009,1331601009,1,1,0
49782462@N00,6550,19,1419224027,1419224027,1,1,0
49790899@N02,6551,1,1212782400,1212782400,1,1,0
49846427@N00,6552,28,1333333868,1333333868,1,1,0
49850599@N08,6553,26,1339514068,1339545473,34,1,31405
49850599@N08,6554,26,1339767787,1339771047,2,1,3260
49850599@N08,6555,26,1339813806,1339814567,22,1,761
49850599@N08,6556,26,1339855372,1339896707,16,1,41335
49853465@N00,6557,30,1264661054,1264661054,1,3,0
49853465@N00,6557,13,1264645695,1264645695,1,3,0
49853465@N00,6557,1,1264636007,1264636007,1,3,0
49858236@N04,6558,1,1323300410,1323337224,13,2,36814
49858236@N04,6558,28,1323300662,1323308528,11,2,7866
49858236@N04,6559,19,1324468862,1324470042,3,8,1180
49858236@N04,6559,1,1324440945,1324467055,62,8,26110
49858236@N04,6559,23,1324467798,1324467798,1,8,0
49858236@N04,6559,25,1324471402,1324472113,24,8,711
49858236@N04,6559,18,1324467963,1324468476,3,8,513
49858236@N04,6559,28,1324444612,1324467159,9,8,22547
49858236@N04,6559,15,1324476784,1324476784,1,8,0
49858236@N04,6559,26,1324467519,1324467611,4,8,92
49858236@N04,6560,16,1331343133,1331344275,4,9,1142
49858236@N04,6560,13,1331344280,1331346957,9,9,2677
49858236@N04,6560,28,1331334642,1331334642,1,9,0
49858236@N04,6560,1,1331334870,1331337149,13,9,2279
49858236@N04,6560,31,1331338276,1331339439,4,9,1163
49858236@N04,6560,27,1331361056,1331374314,13,9,13258
49858236@N04,6560,23,1331337769,1331337769,1,9,0
49858236@N04,6560,21,1331355683,1331356308,3,9,625
49858236@N04,6560,29,1331339456,1331343122,35,9,3666
49876360@N07,6561,26,1392516723,1392517018,3,2,295
49876360@N07,6561,13,1392517849,1392518192,2,2,343
49876360@N07,6562,26,1393061036,1393061036,1,2,0
49876360@N07,6562,1,1393057995,1393058462,3,2,467
49876360@N07,6563,1,1394268081,1394268413,2,1,332
49876360@N07,6564,28,1394342306,1394343409,5,2,1103
49876360@N07,6564,1,1394350492,1394351279,4,2,787
49876360@N07,6565,30,1399080881,1399080881,1,2,0
49876360@N07,6565,28,1399078946,1399078946,1,2,0
49876360@N07,6566,26,1403317636,1403317636,1,3,0
49876360@N07,6566,28,1403318561,1403318561,1,3,0
49876360@N07,6566,25,1403316942,1403316942,1,3,0
49880056@N05,6567,16,1250536546,1250549889,12,1,13343
49887039@N04,6568,6,1313647895,1313647895,1,7,0
49887039@N04,6568,29,1313625982,1313627446,3,7,1464
49887039@N04,6568,28,1313656648,1313657134,3,7,486
49887039@N04,6568,26,1313620236,1313673438,5,7,53202
49887039@N04,6568,1,1313619862,1313619862,1,7,0
49887039@N04,6568,24,1313644297,1313644297,1,7,0
49887039@N04,6568,17,1313622798,1313622798,1,7,0
49887039@N04,6569,26,1313908931,1313908931,1,2,0
49887039@N04,6569,1,1313901776,1313901776,1,2,0
49887039@N04,6570,27,1314062549,1314062549,1,1,0
49887039@N04,6571,1,1340708301,1340708301,1,1,0
49887039@N04,6572,3,1340966361,1340966361,1,1,0
49887039@N04,6573,27,1341334949,1341334949,1,1,0
49887039@N04,6574,26,1342437794,1342437794,1,1,0
49897362@N02,6575,29,1288063633,1288072110,3,5,8477
49897362@N02,6575,28,1288059623,1288059650,2,5,27
49897362@N02,6575,20,1288065780,1288074877,2,5,9097
49897362@N02,6575,1,1288058930,1288059544,5,5,614
49897362@N02,6575,19,1288063965,1288063965,1,5,0
49981519@N07,6576,26,1344259837,1344259837,1,1,0
50037155@N05,6577,30,1291922188,1291922188,1,1,0
50038815@N08,6578,16,1395775982,1395776021,3,1,39
50038815@N08,6579,20,1400798069,1400798069,1,7,0
50038815@N08,6579,31,1400793478,1400801356,3,7,7878
50038815@N08,6579,7,1400793746,1400793746,1,7,0
50038815@N08,6579,9,1400793854,1400793854,1,7,0
50038815@N08,6579,26,1400793447,1400809942,5,7,16495
50038815@N08,6579,30,1400795081,1400797597,4,7,2516
50038815@N08,6579,29,1400801434,1400806061,4,7,4627
50045612@N03,6580,10,1288484267,1288489410,2,2,5143
50045612@N03,6580,11,1288476577,1288489083,3,2,12506
50069634@N06,6581,12,1340086574,1340086574,1,1,0
50145710@N05,6582,4,1323246987,1323248118,2,12,1131
50145710@N05,6582,29,1323243532,1323243532,1,12,0
50145710@N05,6582,17,1323226722,1323234378,8,12,7656
50145710@N05,6582,22,1323243080,1323243080,1,12,0
50145710@N05,6582,19,1323236129,1323237947,38,12,1818
50145710@N05,6582,25,1323248879,1323248977,3,12,98
50145710@N05,6582,15,1323232385,1323233586,11,12,1201
50145710@N05,6582,20,1323240508,1323240751,4,12,243
50145710@N05,6582,1,1323224006,1323224006,1,12,0
50145710@N05,6582,28,1323252255,1323252255,1,12,0
50145710@N05,6582,9,1323245195,1323245888,13,12,693
50145710@N05,6582,26,1323235907,1323251212,4,12,15305
50198110@N00,6583,26,1297947602,1297947618,15,4,16
50198110@N00,6583,12,1297947619,1297947623,3,4,4
50198110@N00,6583,30,1297947620,1297947621,2,4,1
50198110@N00,6583,24,1297947600,1297947601,2,4,1
50267281@N07,6584,26,1372836719,1372850398,23,1,13679
50267281@N07,6585,26,1372938915,1372942408,4,1,3493
50267281@N07,6586,26,1372976970,1372980828,2,1,3858
50267281@N07,6587,23,1429062894,1429062894,1,1,0
50267281@N07,6588,27,1429397896,1429397896,1,1,0
50267281@N07,6589,26,1431648590,1431648590,1,1,0
50267281@N07,6590,18,1437133340,1437133340,1,1,0
50267281@N07,6591,26,1442618794,1442618794,1,2,0
50267281@N07,6591,18,1442618213,1442618649,2,2,436
50267281@N07,6592,18,1442696000,1442696000,1,1,0
50267281@N07,6593,18,1442842197,1442842197,1,1,0
50267281@N07,6594,15,1448438920,1448438946,2,3,26
50267281@N07,6594,18,1448444847,1448455092,4,3,10245
50267281@N07,6594,26,1448435892,1448451036,90,3,15144
50267281@N07,6595,15,1448497596,1448497596,1,3,0
50267281@N07,6595,18,1448496912,1448496912,1,3,0
50267281@N07,6595,26,1448486900,1448496324,4,3,9424
50267281@N07,6596,26,1448538445,1448538445,1,1,0
50267281@N07,6597,18,1448973571,1448973571,1,1,0
50267281@N07,6598,18,1449146161,1449146161,1,1,0
50267281@N07,6599,18,1449405855,1449405855,1,1,0
50267281@N07,6600,18,1449664857,1449664857,1,1,0
50267281@N07,6601,26,1452921064,1452927319,46,1,6255
50267281@N07,6602,17,1452972283,1452972283,1,7,0
50267281@N07,6602,21,1452972561,1452972561,1,7,0
50267281@N07,6602,26,1452973049,1452973049,1,7,0
50267281@N07,6602,15,1452972386,1452972386,1,7,0
50267281@N07,6602,3,1452973167,1452973167,1,7,0
50267281@N07,6602,18,1452971032,1452971032,1,7,0
50267281@N07,6602,11,1452972642,1452972642,1,7,0
50267281@N07,6603,26,1453021754,1453027221,6,1,5467
50267281@N07,6604,26,1459419414,1459425672,6,1,6258
50267281@N07,6605,26,1459496232,1459519949,55,1,23717
50325355@N00,6606,26,1261521652,1261521652,1,3,0
50325355@N00,6606,6,1261523590,1261523597,2,3,7
50325355@N00,6606,28,1261521448,1261551637,20,3,30189
50325355@N00,6607,24,1288141902,1288141902,1,3,0
50325355@N00,6607,29,1288141797,1288141861,4,3,64
50325355@N00,6607,11,1288141892,1288141892,1,3,0
50325355@N00,6608,26,1322347570,1322347570,1,1,0
50325355@N00,6609,21,1333072748,1333072748,1,1,0
50367867@N07,6610,28,1351228871,1351228871,1,1,0
50367867@N07,6611,28,1351287422,1351326203,13,1,38781
50367867@N07,6612,28,1351374151,1351374159,2,1,8
50369536@N00,6613,18,1448597512,1448597512,1,1,0
50401006@N08,6614,23,1277960494,1277960494,1,1,0
50401006@N08,6615,27,1278287475,1278287475,1,4,0
50401006@N08,6615,26,1278287476,1278287476,1,4,0
50401006@N08,6615,29,1278263878,1278287466,3,4,23588
50401006@N08,6615,10,1278263903,1278263903,1,4,0
50401006@N08,6616,29,1284887492,1284887492,1,1,0
50448800@N00,6617,26,1364899681,1364899681,1,1,0
50461115@N07,6618,26,1352607142,1352607142,1,1,0
50461532@N03,6619,30,1331986884,1331988548,2,1,1664
50461532@N03,6620,29,1350721948,1350721948,1,1,0
50461532@N03,6621,26,1351074629,1351074629,1,1,0
50461532@N03,6622,1,1366267393,1366269943,2,1,2550
50461532@N03,6623,30,1367735355,1367735355,1,1,0
50500517@N03,6624,1,1275996026,1275996026,1,1,0
50500517@N03,6625,28,1276141214,1276141214,1,5,0
50500517@N03,6625,16,1276141507,1276141507,1,5,0
50500517@N03,6625,1,1276140604,1276140604,1,5,0
50500517@N03,6625,12,1276141408,1276141408,1,5,0
50500517@N03,6625,18,1276140962,1276140962,1,5,0
50507957@N04,6626,23,1376271783,1376271783,1,2,0
50507957@N04,6626,17,1376263552,1376263552,1,2,0
50507957@N04,6627,16,1376397637,1376397637,1,1,0
50514859@N00,6628,24,1229940684,1229940684,1,1,0
50514859@N00,6629,20,1230196401,1230196401,1,1,0
50519631@N03,6630,28,1314926467,1314926467,1,1,0
50576036@N00,6631,21,1361067082,1361067082,1,1,0
50576036@N00,6632,1,1380937249,1380937249,1,1,0
50576036@N00,6633,7,1397878782,1397878782,1,1,0
50616872@N07,6634,18,1441197446,1441197940,3,3,494
50616872@N07,6634,28,1441198893,1441198893,1,3,0
50616872@N07,6634,3,1441198553,1441198553,1,3,0
50616872@N07,6635,4,1441235194,1441235194,1,1,0
50616872@N07,6636,23,1441283774,1441283774,1,1,0
50631360@N00,6637,30,1340770797,1340770797,1,1,0
50637361@N07,6638,15,1336000257,1336006404,20,3,6147
50637361@N07,6638,26,1335995500,1336021352,2,3,25852
50637361@N07,6638,16,1336013126,1336013126,1,3,0
50637361@N07,6639,12,1336114777,1336114777,1,2,0
50637361@N07,6639,11,1336109916,1336109916,1,2,0
50643397@N00,6640,18,1422095142,1422095142,1,1,0
50657579@N06,6641,18,1423689206,1423689419,2,1,213
50661799@N02,6642,15,1394589616,1394590027,2,7,411
50661799@N02,6642,18,1394600260,1394600260,1,7,0
50661799@N02,6642,27,1394586048,1394602471,4,7,16423
50661799@N02,6642,16,1394583369,1394583369,1,7,0
50661799@N02,6642,1,1394583053,1394583074,2,7,21
50661799@N02,6642,26,1394600619,1394600619,1,7,0
50661799@N02,6642,17,1394603328,1394603328,1,7,0
50661799@N02,6643,24,1395106401,1395108568,3,2,2167
50661799@N02,6643,16,1395102530,1395127461,6,2,24931
50661799@N02,6644,15,1429502270,1429517597,20,3,15327
50661799@N02,6644,27,1429507243,1429521525,16,3,14282
50661799@N02,6644,17,1429502041,1429524831,222,3,22790
50679218@N00,6645,26,1371806561,1371806561,1,3,0
50679218@N00,6645,17,1371787577,1371787577,1,3,0
50679218@N00,6645,1,1371787532,1371787532,1,3,0
50728651@N04,6646,1,1427626509,1427626509,1,1,0
50730281@N03,6647,29,1330340199,1330340382,2,2,183
50730281@N03,6647,30,1330340503,1330341045,2,2,542
50742523@N05,6648,1,1308203642,1308203642,1,1,0
50751757@N00,6649,12,1279672584,1279703462,11,19,30878
50751757@N00,6649,28,1279710059,1279710073,2,19,14
50751757@N00,6649,1,1279710456,1279710528,3,19,72
50751757@N00,6649,30,1279673207,1279687190,129,19,13983
50751757@N00,6649,31,1279683232,1279684606,29,19,1374
50751757@N00,6649,27,1279700123,1279700361,5,19,238
50751757@N00,6649,26,1279685822,1279709610,9,19,23788
50751757@N00,6649,17,1279698248,1279698706,2,19,458
50751757@N00,6649,20,1279676125,1279676305,11,19,180
50751757@N00,6649,19,1279687816,1279688634,30,19,818
50751757@N00,6649,29,1279695512,1279697015,6,19,1503
50751757@N00,6649,25,1279666944,1279706681,9,19,39737
50751757@N00,6649,7,1279665208,1279666605,20,19,1397
50751757@N00,6649,16,1279698573,1279698927,18,19,354
50751757@N00,6649,13,1279668163,1279706544,50,19,38381
50751757@N00,6649,10,1279682081,1279684904,23,19,2823
50751757@N00,6649,24,1279672141,1279702858,23,19,30717
50751757@N00,6649,4,1279664734,1279708306,136,19,43572
50751757@N00,6649,21,1279696765,1279704318,36,19,7553
50751757@N00,6650,13,1279753884,1279753884,1,1,0
50751757@N00,6651,26,1279791890,1279798792,80,2,6902
50751757@N00,6651,1,1279799430,1279799454,2,2,24
50751757@N00,6652,28,1280021347,1280026793,91,1,5446
50753774@N00,6653,29,1385538003,1385552369,4,1,14366
50753774@N00,6654,29,1385638961,1385638961,1,1,0
50755881@N08,6655,11,1326666112,1326666112,1,3,0
50755881@N08,6655,17,1326665258,1326665728,6,3,470
50755881@N08,6655,27,1326665682,1326665682,1,3,0
50776394@N00,6656,7,1388140698,1388140698,1,2,0
50776394@N00,6656,15,1388138947,1388138947,1,2,0
50892381@N00,6657,4,1290655618,1290655618,1,1,0
50903038@N00,6658,1,1276763071,1276763071,1,6,0
50903038@N00,6658,21,1276768825,1276768861,2,6,36
50903038@N00,6658,30,1276767275,1276767429,2,6,154
50903038@N00,6658,24,1276768605,1276768605,1,6,0
50903038@N00,6658,26,1276765065,1276766984,2,6,1919
50903038@N00,6658,28,1276764693,1276764899,4,6,206
50972822@N08,6659,1,1388262364,1388262364,1,6,0
50972822@N08,6659,31,1388269335,1388273339,2,6,4004
50972822@N08,6659,11,1388266468,1388269817,3,6,3349
50972822@N08,6659,29,1388271095,1388271095,1,6,0
50972822@N08,6659,16,1388263259,1388269362,6,6,6103
50972822@N08,6659,26,1388263249,1388263249,1,6,0
50972822@N08,6660,18,1388361726,1388366329,2,2,4603
50972822@N08,6660,31,1388360184,1388360184,1,2,0
50972822@N08,6661,5,1388443906,1388443906,1,8,0
50972822@N08,6661,28,1388433642,1388433724,4,8,82
50972822@N08,6661,9,1388439539,1388439544,2,8,5
50972822@N08,6661,16,1388435057,1388442224,3,8,7167
50972822@N08,6661,25,1388436684,1388437383,12,8,699
50972822@N08,6661,13,1388437456,1388444368,2,8,6912
50972822@N08,6661,26,1388433782,1388433796,2,8,14
50972822@N08,6661,21,1388436617,1388436617,1,8,0
50972822@N08,6662,26,1388478883,1388480814,5,1,1931
50979393@N00,6663,20,1345856260,1345856260,1,6,0
50979393@N00,6663,24,1345887083,1345887083,1,6,0
50979393@N00,6663,18,1345852144,1345852144,1,6,0
50979393@N00,6663,17,1345848612,1345848612,1,6,0
50979393@N00,6663,19,1345859106,1345859106,1,6,0
50979393@N00,6663,26,1345896000,1345896000,1,6,0
50979393@N00,6664,26,1345941223,1345941223,1,1,0
50980974@N07,6665,30,1276068596,1276068596,1,1,0
51007277@N08,6666,1,1403347950,1403347950,1,1,0
51021602@N00,6667,11,1267059365,1267059365,1,1,0
51035569202@N01,6668,11,1273383347,1273383347,1,1,0
51035597937@N01,6669,19,1266796917,1266796917,1,1,0
51035602679@N01,6670,26,1356304526,1356304526,1,1,0
51035602679@N01,6671,26,1356346496,1356346496,1,1,0
51035620553@N01,6672,26,1270211005,1270230765,38,1,19760
51035626656@N01,6673,29,1252326901,1252327991,32,1,1090
51035626656@N01,6674,29,1252497497,1252497527,4,3,30
51035626656@N01,6674,31,1252498636,1252498649,2,3,13
51035626656@N01,6674,20,1252497882,1252503006,15,3,5124
51035708949@N01,6675,29,1211961500,1211961500,1,8,0
51035708949@N01,6675,16,1211928497,1211954215,2,8,25718
51035708949@N01,6675,24,1211930539,1211971978,22,8,41439
51035708949@N01,6675,28,1211928335,1211954006,8,8,25671
51035708949@N01,6675,21,1211936575,1211936575,1,8,0
51035708949@N01,6675,12,1211932735,1211932816,5,8,81
51035708949@N01,6675,17,1211957075,1211959457,4,8,2382
51035708949@N01,6675,8,1211928582,1211928582,1,8,0
51035708949@N01,6676,29,1395271325,1395271325,1,8,0
51035708949@N01,6676,24,1395279768,1395279768,1,8,0
51035708949@N01,6676,28,1395260311,1395260311,1,8,0
51035708949@N01,6676,6,1395283169,1395283189,2,8,20
51035708949@N01,6676,19,1395266973,1395267312,8,8,339
51035708949@N01,6676,17,1395261758,1395261758,1,8,0
51035708949@N01,6676,18,1395269271,1395269299,6,8,28
51035708949@N01,6676,26,1395263422,1395263460,4,8,38
51035708949@N01,6677,29,1395384430,1395384434,2,7,4
51035708949@N01,6677,28,1395387829,1395387919,5,7,90
51035708949@N01,6677,13,1395379284,1395382275,12,7,2991
51035708949@N01,6677,24,1395376908,1395377970,30,7,1062
51035708949@N01,6677,22,1395354005,1395354986,6,7,981
51035708949@N01,6677,17,1395375838,1395375844,2,7,6
51035708949@N01,6677,21,1395378358,1395382505,3,7,4147
51035722899@N01,6678,28,1351383954,1351383954,1,1,0
51035730365@N01,6679,29,1252729021,1252729021,1,1,0
51035734911@N01,6680,28,1245207232,1245233477,2,1,26245
51035737861@N01,6681,8,1191654068,1191654102,3,5,34
51035737861@N01,6681,17,1191667190,1191667210,2,5,20
51035737861@N01,6681,21,1191656247,1191658824,12,5,2577
51035737861@N01,6681,26,1191668983,1191669616,4,5,633
51035737861@N01,6681,6,1191653529,1191659455,6,5,5926
51035737861@N01,6682,12,1191747188,1191747198,2,2,10
51035737861@N01,6682,28,1191748126,1191748225,5,2,99
51035738424@N01,6683,16,1334588071,1334588071,1,4,0
51035738424@N01,6683,18,1334588134,1334588134,1,4,0
51035738424@N01,6683,24,1334582842,1334582842,1,4,0
51035738424@N01,6683,17,1334582375,1334582375,1,4,0
51035747872@N01,6684,28,1348036945,1348036945,1,1,0
51035767733@N01,6685,13,1269482429,1269482429,1,3,0
51035767733@N01,6685,26,1269499863,1269499863,1,3,0
51035767733@N01,6685,27,1269487144,1269487144,1,3,0
51037533@N00,6686,26,1341735185,1341735185,1,2,0
51037533@N00,6686,23,1341735508,1341735508,1,2,0
51037533@N00,6687,17,1342600665,1342600665,1,2,0
51037533@N00,6687,19,1342602029,1342602029,1,2,0
51037533@N00,6688,29,1344157507,1344157507,1,2,0
51037533@N00,6688,28,1344166256,1344166256,1,2,0
51037533@N00,6689,30,1372999933,1372999933,1,1,0
51037533@N00,6690,17,1373184537,1373184537,1,1,0
51037533@N00,6691,26,1416661012,1416661012,1,1,0
51037533@N00,6692,26,1432334037,1432337154,2,1,3117
51061791@N08,6693,28,1419459941,1419459941,1,2,0
51061791@N08,6693,26,1419460280,1419460324,2,2,44
51061791@N08,6694,26,1419492639,1419500806,2,1,8167
51064846@N07,6695,13,1405501229,1405501229,1,2,0
51064846@N07,6695,15,1405497661,1405498833,5,2,1172
51064846@N07,6696,31,1441096702,1441096702,1,2,0
51064846@N07,6696,26,1441085702,1441091933,2,2,6231
51074282@N08,6697,26,1298173915,1298208472,16,1,34557
51074282@N08,6698,26,1298373816,1298373816,1,1,0
51075626@N00,6699,16,1401719232,1401720042,3,1,810
51075626@N00,6700,19,1408508299,1408508299,1,1,0
51075626@N00,6701,19,1409582315,1409582398,2,1,83
51075626@N00,6702,19,1410532537,1410532703,2,1,166
51075626@N00,6703,18,1422418864,1422433089,3,1,14225
51075626@N00,6704,18,1433045008,1433079912,3,1,34904
51075626@N00,6705,18,1434363386,1434363386,1,1,0
51075626@N00,6706,18,1445383406,1445383406,1,1,0
51087250@N05,6707,17,1357179852,1357179852,1,2,0
51087250@N05,6707,1,1357188884,1357188887,2,2,3
51098012@N02,6708,26,1357715741,1357715741,1,1,0
51098012@N02,6709,31,1388299060,1388299060,1,1,0
51151458@N02,6710,1,1382696732,1382696732,1,1,0
51172115@N00,6711,26,1366955876,1366955876,1,5,0
51172115@N00,6711,8,1366932077,1366932077,1,5,0
51172115@N00,6711,16,1366953455,1366953455,1,5,0
51172115@N00,6711,1,1366951838,1366951838,1,5,0
51172115@N00,6711,13,1366937246,1366937246,1,5,0
51172115@N00,6712,28,1367106366,1367106567,2,2,201
51172115@N00,6712,1,1367103799,1367103799,1,2,0
51172115@N00,6713,22,1367198294,1367198294,1,2,0
51172115@N00,6713,1,1367205875,1367205875,1,2,0
51178640@N00,6714,17,1453760472,1453768689,4,5,8217
51178640@N00,6714,15,1453765308,1453765968,7,5,660
51178640@N00,6714,26,1453760345,1453760345,1,5,0
51178640@N00,6714,16,1453760342,1453760363,3,5,21
51178640@N00,6714,27,1453768856,1453768856,1,5,0
51205683@N00,6715,16,1297324166,1297324166,1,1,0
51205683@N00,6716,4,1297468020,1297468020,1,2,0
51205683@N00,6716,28,1297464044,1297464044,1,2,0
51205683@N00,6717,26,1361243584,1361243632,2,1,48
51208828@N00,6718,20,1311123426,1311123426,1,5,0
51208828@N00,6718,14,1311125664,1311125664,1,5,0
51208828@N00,6718,27,1311139305,1311149515,3,5,10210
51208828@N00,6718,29,1311130841,1311130841,1,5,0
51208828@N00,6718,26,1311132838,1311132838,1,5,0
51311897@N00,6719,14,1295264167,1295264167,1,1,0
51311897@N00,6720,28,1362268327,1362293424,27,6,25097
51311897@N00,6720,16,1362274474,1362284219,18,6,9745
51311897@N00,6720,18,1362271872,1362272602,6,6,730
51311897@N00,6720,23,1362271706,1362271827,3,6,121
51311897@N00,6720,1,1362270336,1362293628,4,6,23292
51311897@N00,6720,26,1362274546,1362274639,4,6,93
51311897@N00,6721,27,1362878002,1362878003,2,2,1
51311897@N00,6721,1,1362872658,1362872703,6,2,45
51311897@N00,6722,16,1363914393,1363914544,24,1,151
51311897@N00,6723,16,1365325946,1365325966,4,2,20
51311897@N00,6723,30,1365325176,1365325176,1,2,0
51311897@N00,6724,28,1369618912,1369618922,2,7,10
51311897@N00,6724,15,1369628772,1369629897,8,7,1125
51311897@N00,6724,4,1369618704,1369618704,1,7,0
51311897@N00,6724,23,1369623066,1369623083,2,7,17
51311897@N00,6724,21,1369631249,1369631250,2,7,1
51311897@N00,6724,1,1369632466,1369632472,2,7,6
51311897@N00,6724,26,1369616675,1369627668,9,7,10993
51311897@N00,6725,7,1377414753,1377414950,16,5,197
51311897@N00,6725,16,1377404194,1377404212,2,5,18
51311897@N00,6725,6,1377415176,1377415298,7,5,122
51311897@N00,6725,5,1377416026,1377416033,4,5,7
51311897@N00,6725,21,1377415571,1377415801,23,5,230
51311897@N00,6726,30,1399183362,1399183392,4,2,30
51311897@N00,6726,1,1399180830,1399180860,4,2,30
51311897@N00,6727,7,1402635008,1402635196,8,4,188
51311897@N00,6727,29,1402650823,1402660304,30,4,9481
51311897@N00,6727,15,1402638564,1402638659,3,4,95
51311897@N00,6727,27,1402638987,1402638987,1,4,0
51311897@N00,6728,29,1406251353,1406251353,1,7,0
51311897@N00,6728,15,1406263963,1406263970,3,7,7
51311897@N00,6728,14,1406255633,1406255882,6,7,249
51311897@N00,6728,27,1406262049,1406262049,1,7,0
51311897@N00,6728,31,1406252525,1406253118,13,7,593
51311897@N00,6728,22,1406256438,1406256457,2,7,19
51311897@N00,6728,13,1406276458,1406276469,3,7,11
51311897@N00,6729,28,1409300086,1409300189,8,1,103
51311897@N00,6730,15,1411799992,1411801846,21,2,1854
51311897@N00,6730,27,1411802014,1411802014,1,2,0
51311897@N00,6731,11,1414211638,1414211681,5,2,43
51311897@N00,6731,24,1414205595,1414205865,4,2,270
51311897@N00,6732,10,1417826666,1417826689,7,2,23
51311897@N00,6732,16,1417826162,1417826244,11,2,82
51311897@N00,6733,21,1418809958,1418810245,2,3,287
51311897@N00,6733,26,1418809511,1418809948,17,3,437
51311897@N00,6733,28,1418809033,1418809103,3,3,70
51311897@N00,6734,27,1425780585,1425780967,3,1,382
51311897@N00,6735,4,1448239330,1448239340,2,5,10
51311897@N00,6735,13,1448243151,1448245826,11,5,2675
51311897@N00,6735,26,1448258237,1448258237,1,5,0
51311897@N00,6735,16,1448259199,1448267900,9,5,8701
51311897@N00,6735,27,1448264125,1448264125,1,5,0
51311897@N00,6736,14,1449980019,1449981372,19,2,1353
51311897@N00,6736,28,1449969564,1449969584,2,2,20
51311897@N00,6737,15,1457762842,1457766870,56,2,4028
51311897@N00,6737,27,1457765468,1457765470,2,2,2
51337479@N00,6738,26,1395909176,1395909176,1,1,0
51390829@N07,6739,6,1317617368,1317617389,2,12,21
51390829@N07,6739,13,1317618088,1317618586,4,12,498
51390829@N07,6739,26,1317591114,1317617003,11,12,25889
51390829@N07,6739,16,1317591159,1317591159,1,12,0
51390829@N07,6739,28,1317590885,1317590943,3,12,58
51390829@N07,6739,23,1317591401,1317591401,1,12,0
51390829@N07,6739,17,1317597072,1317615395,2,12,18323
51390829@N07,6739,22,1317594202,1317594903,6,12,701
51390829@N07,6739,20,1317593407,1317622047,18,12,28640
51390829@N07,6739,30,1317594894,1317595285,3,12,391
51390829@N07,6739,7,1317595990,1317617501,5,12,21511
51390829@N07,6739,21,1317596081,1317618688,2,12,22607
51390829@N07,6740,28,1317768196,1317768196,1,1,0
51390829@N07,6741,28,1317802857,1317802893,2,2,36
51390829@N07,6741,26,1317802615,1317802615,1,2,0
51427230@N02,6742,19,1284022499,1284022499,1,11,0
51427230@N02,6742,5,1284017349,1284017363,2,11,14
51427230@N02,6742,28,1284015305,1284025563,3,11,10258
51427230@N02,6742,27,1284016156,1284016156,1,11,0
51427230@N02,6742,16,1284015606,1284015857,3,11,251
51427230@N02,6742,11,1284017630,1284017630,1,11,0
51427230@N02,6742,14,1284022142,1284022142,1,11,0
51427230@N02,6742,22,1284021392,1284022339,5,11,947
51427230@N02,6742,20,1284020904,1284020912,2,11,8
51427230@N02,6742,1,1284015074,1284015150,3,11,76
51427230@N02,6742,31,1284017635,1284022700,6,11,5065
51427230@N02,6743,29,1284099570,1284099879,3,12,309
51427230@N02,6743,13,1284121901,1284121901,1,12,0
51427230@N02,6743,25,1284121771,1284121771,1,12,0
51427230@N02,6743,28,1284116881,1284116953,2,12,72
51427230@N02,6743,4,1284126293,1284126293,1,12,0
51427230@N02,6743,30,1284123850,1284124937,2,12,1087
51427230@N02,6743,27,1284082162,1284082162,1,12,0
51427230@N02,6743,16,1284083659,1284121054,12,12,37395
51427230@N02,6743,18,1284098002,1284098658,10,12,656
51427230@N02,6743,26,1284083550,1284119188,3,12,35638
51427230@N02,6743,6,1284119811,1284119811,1,12,0
51427230@N02,6743,1,1284082969,1284123033,9,12,40064
51427230@N02,6744,13,1284174784,1284201842,27,9,27058
51427230@N02,6744,24,1284202509,1284204845,3,9,2336
51427230@N02,6744,7,1284197524,1284197849,2,9,325
51427230@N02,6744,21,1284199167,1284199600,3,9,433
51427230@N02,6744,11,1284176671,1284176671,1,9,0
51427230@N02,6744,6,1284196509,1284197668,7,9,1159
51427230@N02,6744,22,1284186114,1284186114,1,9,0
51427230@N02,6744,30,1284183248,1284183248,1,9,0
51427230@N02,6744,31,1284177130,1284182777,2,9,5647
51427230@N02,6745,24,1284268205,1284268619,3,4,414
51427230@N02,6745,19,1284260754,1284263528,4,4,2774
51427230@N02,6745,16,1284286590,1284286730,3,4,140
51427230@N02,6745,12,1284267987,1284267987,1,4,0
51427230@N02,6746,12,1284358797,1284358797,1,2,0
51427230@N02,6746,31,1284351779,1284351822,2,2,43
51446703@N00,6747,26,1393978338,1393995638,7,12,17300
51446703@N00,6747,25,1393990096,1393990096,1,12,0
51446703@N00,6747,1,1393976827,1393976827,1,12,0
51446703@N00,6747,19,1394000223,1394000285,3,12,62
51446703@N00,6747,20,1394000946,1394000946,1,12,0
51446703@N00,6747,29,1394003865,1394003865,1,12,0
51446703@N00,6747,3,1393986625,1393986625,1,12,0
51446703@N00,6747,28,1394007532,1394008085,4,12,553
51446703@N00,6747,11,1393988660,1393988660,1,12,0
51446703@N00,6747,13,1393990502,1393991210,2,12,708
51446703@N00,6747,4,1393984928,1393988624,2,12,3696
51446703@N00,6747,18,1393999051,1393999051,1,12,0
51544832@N06,6748,26,1356818788,1356863734,51,1,44946
51559287@N04,6749,29,1298781528,1298782789,2,1,1261
51559287@N04,6750,8,1301210767,1301210774,6,5,7
51559287@N04,6750,22,1301203770,1301205923,6,5,2153
51559287@N04,6750,28,1301210715,1301210720,4,5,5
51559287@N04,6750,6,1301203373,1301208618,3,5,5245
51559287@N04,6750,29,1301198702,1301198702,2,5,0
51565923@N00,6751,26,1245495278,1245495278,1,1,0
51565923@N00,6752,31,1248114331,1248114331,1,1,0
51579041@N00,6753,15,1246588066,1246588066,1,1,0
51585012@N06,6754,26,1370235671,1370235671,1,5,0
51585012@N06,6754,12,1370227888,1370227888,1,5,0
51585012@N06,6754,28,1370247643,1370247643,1,5,0
51585012@N06,6754,13,1370228474,1370228474,1,5,0
51585012@N06,6754,15,1370225717,1370226662,2,5,945
51588699@N00,6755,26,1228026805,1228026805,1,1,0
51588699@N00,6756,28,1228217262,1228217262,1,1,0
51588699@N00,6757,28,1228309772,1228309772,1,1,0
51588699@N00,6758,15,1243213522,1243213522,1,1,0
51588699@N00,6759,24,1318652020,1318652020,1,2,0
51588699@N00,6759,7,1318636179,1318636179,1,2,0
51588699@N00,6760,29,1319451062,1319451062,1,1,0
51588699@N00,6761,13,1322096870,1322096870,1,1,0
51588699@N00,6762,4,1322951372,1322951372,1,2,0
51588699@N00,6762,25,1322953836,1322953836,1,2,0
51588699@N00,6763,7,1346501448,1346501448,1,1,0
51588699@N00,6764,8,1347071717,1347071717,1,1,0
51588699@N00,6765,27,1368284279,1368284279,1,1,0
51588699@N00,6766,25,1370658163,1370658163,1,1,0
51588699@N00,6767,1,1371263259,1371263259,1,1,0
51588699@N00,6768,23,1371952076,1371952076,1,1,0
51588699@N00,6769,19,1372894855,1372894855,1,1,0
51588699@N00,6770,29,1373797736,1373797736,1,1,0
51588699@N00,6771,29,1377576456,1377576456,1,1,0
51588699@N00,6772,27,1399702593,1399702593,1,2,0
51588699@N00,6772,17,1399702324,1399702324,1,2,0
51594114@N04,6773,1,1336901094,1336901094,1,4,0
51594114@N04,6773,26,1336899093,1336899289,3,4,196
51594114@N04,6773,30,1336900987,1336900987,1,4,0
51594114@N04,6773,28,1336899271,1336899271,1,4,0
51652132@N04,6774,26,1391320524,1391320524,1,8,0
51652132@N04,6774,28,1391339892,1391339892,1,8,0
51652132@N04,6774,13,1391322491,1391322706,2,8,215
51652132@N04,6774,29,1391332331,1391332483,2,8,152
51652132@N04,6774,1,1391320017,1391342080,2,8,22063
51652132@N04,6774,18,1391330142,1391330142,1,8,0
51652132@N04,6774,30,1391334068,1391334837,72,8,769
51652132@N04,6774,19,1391328170,1391328556,4,8,386
51652132@N04,6775,20,1423707879,1423707879,1,4,0
51652132@N04,6775,10,1423717743,1423718085,5,4,342
51652132@N04,6775,29,1423700609,1423712532,12,4,11923
51652132@N04,6775,19,1423709243,1423709243,1,4,0
51652132@N04,6776,28,1423780491,1423780491,1,4,0
51652132@N04,6776,29,1423785065,1423793378,7,4,8313
51652132@N04,6776,15,1423797792,1423798057,3,4,265
51652132@N04,6776,24,1423799606,1423799606,1,4,0
51652132@N04,6777,28,1423967751,1423967751,1,7,0
51652132@N04,6777,12,1423974399,1423974399,1,7,0
51652132@N04,6777,26,1423968446,1423976879,2,7,8433
51652132@N04,6777,29,1423971099,1423982243,8,7,11144
51652132@N04,6777,15,1423973196,1423973319,3,7,123
51652132@N04,6777,1,1423967971,1423967971,1,7,0
51652132@N04,6777,23,1423975686,1423976389,7,7,703
51652132@N04,6778,28,1446114078,1446114078,1,11,0
51652132@N04,6778,29,1446104730,1446105783,16,11,1053
51652132@N04,6778,26,1446106800,1446112169,5,11,5369
51652132@N04,6778,20,1446070135,1446070135,1,11,0
51652132@N04,6778,13,1446099078,1446099119,3,11,41
51652132@N04,6778,31,1446100850,1446100872,2,11,22
51652132@N04,6778,22,1446071122,1446076051,3,11,4929
51652132@N04,6778,1,1446059108,1446059108,1,11,0
51652132@N04,6778,17,1446066740,1446106686,3,11,39946
51652132@N04,6778,30,1446105359,1446105436,4,11,77
51652132@N04,6778,16,1446106917,1446111677,60,11,4760
51652132@N04,6779,28,1446255160,1446255172,3,2,12
51652132@N04,6779,1,1446260974,1446262100,28,2,1126
51652132@N04,6780,10,1446377260,1446377260,1,6,0
51652132@N04,6780,29,1446377180,1446377224,3,6,44
51652132@N04,6780,26,1446381883,1446381915,4,6,32
51652132@N04,6780,20,1446331906,1446381333,12,6,49427
51652132@N04,6780,22,1446349110,1446349121,2,6,11
51652132@N04,6780,28,1446382154,1446382159,2,6,5
51652132@N04,6781,1,1446603607,1446603610,2,1,3
51779105@N04,6782,17,1419319075,1419319075,1,1,0
51824734@N04,6783,29,1364084063,1364084063,1,9,0
51824734@N04,6783,17,1364085662,1364085662,1,9,0
51824734@N04,6783,14,1364086210,1364086210,1,9,0
51824734@N04,6783,28,1364077887,1364077887,1,9,0
51824734@N04,6783,15,1364086017,1364087905,3,9,1888
51824734@N04,6783,19,1364086529,1364086529,1,9,0
51824734@N04,6783,20,1364086347,1364086347,1,9,0
51824734@N04,6783,12,1364089630,1364089630,1,9,0
51824734@N04,6783,27,1364086916,1364086916,1,9,0
51845296@N02,6784,1,1370758642,1370758642,1,1,0
51881015@N02,6785,1,1278578055,1278578059,5,1,4
51881015@N02,6786,1,1283548493,1283548493,1,1,0
51881015@N02,6787,1,1304062000,1304062000,1,1,0
51881015@N02,6788,1,1316932567,1316932693,2,1,126
51903736@N00,6789,26,1272928147,1272928149,2,18,2
51903736@N00,6789,29,1272905329,1272906884,34,18,1555
51903736@N00,6789,27,1272918087,1272918087,1,18,0
51903736@N00,6789,22,1272908404,1272908523,5,18,119
51903736@N00,6789,13,1272910227,1272921561,2,18,11334
51903736@N00,6789,8,1272928131,1272928131,1,18,0
51903736@N00,6789,28,1272903890,1272928312,5,18,24422
51903736@N00,6789,5,1272925130,1272925354,3,18,224
51903736@N00,6789,21,1272927388,1272927388,1,18,0
51903736@N00,6789,20,1272907103,1272908220,20,18,1117
51903736@N00,6789,14,1272908582,1272910015,14,18,1433
51903736@N00,6789,11,1272927213,1272928014,8,18,801
51903736@N00,6789,1,1272910712,1272910836,10,18,124
51903736@N00,6789,16,1272917819,1272918196,4,18,377
51903736@N00,6789,23,1272904542,1272904543,2,18,1
51903736@N00,6789,6,1272924922,1272926263,6,18,1341
51903736@N00,6789,12,1272919944,1272919944,1,18,0
51903736@N00,6789,30,1272905129,1272905202,6,18,73
51903736@N00,6790,4,1273012217,1273012255,2,19,38
51903736@N00,6790,24,1272982688,1272984009,12,19,1321
51903736@N00,6790,14,1273014336,1273015297,2,19,961
51903736@N00,6790,1,1273018300,1273018300,1,19,0
51903736@N00,6790,26,1273016174,1273016221,3,19,47
51903736@N00,6790,16,1273016250,1273016250,1,19,0
51903736@N00,6790,12,1273009435,1273010763,13,19,1328
51903736@N00,6790,30,1272990268,1273012843,2,19,22575
51903736@N00,6790,13,1273008734,1273008734,1,19,0
51903736@N00,6790,20,1273015340,1273015340,1,19,0
51903736@N00,6790,31,1273012581,1273012762,6,19,181
51903736@N00,6790,11,1273012368,1273012368,1,19,0
51903736@N00,6790,29,1273013243,1273015621,12,19,2378
51903736@N00,6790,3,1273012275,1273012301,4,19,26
51903736@N00,6790,27,1272985046,1272985068,3,19,22
51903736@N00,6790,28,1273003996,1273018060,3,19,14064
51903736@N00,6790,15,1273009132,1273009215,4,19,83
51903736@N00,6790,25,1273011035,1273012120,54,19,1085
51903736@N00,6790,10,1273012438,1273012500,4,19,62
51903736@N00,6791,1,1273090660,1273090660,2,1,0
51903736@N00,6792,13,1273154402,1273155366,8,2,964
51903736@N00,6792,28,1273162515,1273165343,45,2,2828
51903736@N00,6793,24,1273260945,1273263010,13,10,2065
51903736@N00,6793,13,1273263756,1273263866,3,10,110
51903736@N00,6793,20,1273237116,1273237519,3,10,403
51903736@N00,6793,14,1273242395,1273246456,14,10,4061
51903736@N00,6793,12,1273262909,1273262913,2,10,4
51903736@N00,6793,22,1273248899,1273250299,2,10,1400
51903736@N00,6793,30,1273247877,1273248698,3,10,821
51903736@N00,6793,31,1273247284,1273247498,3,10,214
51903736@N00,6793,21,1273263148,1273263148,1,10,0
51903736@N00,6793,28,1273255977,1273259576,35,10,3599
51940058@N06,6794,13,1417194725,1417194725,1,1,0
51968610@N05,6795,30,1231116245,1231116245,1,3,0
51968610@N05,6795,29,1231120045,1231120045,1,3,0
51968610@N05,6795,14,1231119525,1231119525,1,3,0
51968610@N05,6796,30,1231653664,1231653664,1,1,0
51968610@N05,6797,20,1235960199,1235960199,1,1,0
51968610@N05,6798,16,1241310192,1241310192,1,3,0
51968610@N05,6798,22,1241310192,1241310192,1,3,0
51968610@N05,6798,29,1241310192,1241310192,1,3,0
51968610@N05,6799,26,1281932744,1281932744,1,1,0
51983948@N03,6800,31,1344058989,1344058989,1,1,0
52015062@N00,6801,17,1204091947,1204096830,31,2,4883
52015062@N00,6801,28,1204096896,1204097566,3,2,670
52015062@N00,6802,26,1325503757,1325503893,2,5,136
52015062@N00,6802,16,1325495580,1325499200,6,5,3620
52015062@N00,6802,27,1325496333,1325497758,3,5,1425
52015062@N00,6802,17,1325497904,1325497976,2,5,72
52015062@N00,6802,15,1325497881,1325497881,1,5,0
52015062@N00,6803,16,1357103102,1357103126,2,3,24
52015062@N00,6803,25,1357113231,1357113231,1,3,0
52015062@N00,6803,15,1357120330,1357120330,1,3,0
52018940@N02,6804,29,1222705183,1222705183,1,4,0
52018940@N02,6804,3,1222699049,1222699049,1,4,0
52018940@N02,6804,17,1222707974,1222707974,1,4,0
52018940@N02,6804,7,1222699389,1222699389,1,4,0
52018940@N02,6805,28,1251389163,1251389163,1,2,0
52018940@N02,6805,26,1251388716,1251388971,2,2,255
52029589@N02,6806,1,1363453786,1363453786,1,1,0
52111728@N00,6807,26,1438209250,1438209292,2,1,42
52111728@N00,6808,28,1438254420,1438255398,11,2,978
52111728@N00,6808,26,1438257440,1438257440,1,2,0
52111728@N00,6809,17,1461886051,1461886051,1,1,0
52179512@N00,6810,24,1219447334,1219447367,2,2,33
52179512@N00,6810,12,1219448293,1219448293,1,2,0
52192784@N08,6811,11,1284777353,1284830037,83,1,52684
52192784@N08,6812,3,1443232111,1443232111,1,5,0
52192784@N08,6812,26,1443232830,1443232830,1,5,0
52192784@N08,6812,1,1443223397,1443223397,1,5,0
52192784@N08,6812,12,1443231204,1443231233,2,5,29
52192784@N08,6812,21,1443254967,1443254967,1,5,0
52227056@N03,6813,17,1381898632,1381898632,1,1,0
52230032@N08,6814,1,1309785831,1309785831,1,1,0
52230032@N08,6815,26,1310301547,1310301547,1,1,0
52245071@N00,6816,26,1348227872,1348227872,1,2,0
52245071@N00,6816,28,1348224789,1348224789,1,2,0
52257090@N00,6817,26,1239669735,1239697524,40,2,27789
52257090@N00,6817,17,1239675935,1239675935,1,2,0
52378595@N06,6818,26,1295751655,1295751655,1,1,0
52378595@N06,6819,11,1295792491,1295792491,1,5,0
52378595@N06,6819,6,1295792317,1295792317,1,5,0
52378595@N06,6819,16,1295794497,1295794497,1,5,0
52378595@N06,6819,7,1295792211,1295792211,1,5,0
52378595@N06,6819,26,1295793842,1295794291,3,5,449
52389201@N07,6820,7,1356507656,1356507656,1,1,0
52418815@N05,6821,8,1375796150,1375796150,1,2,0
52418815@N05,6821,28,1375789835,1375789835,1,2,0
52443338@N05,6822,26,1451258545,1451288298,7,1,29753
52447507@N06,6823,20,1415167227,1415167227,1,1,0
52447507@N06,6824,28,1415254511,1415255419,2,6,908
52447507@N06,6824,30,1415236186,1415236186,1,6,0
52447507@N06,6824,19,1415223694,1415223694,1,6,0
52447507@N06,6824,17,1415226494,1415242814,2,6,16320
52447507@N06,6824,26,1415256097,1415256097,1,6,0
52447507@N06,6824,5,1415230767,1415230767,1,6,0
52447507@N06,6825,17,1415313354,1415313354,1,2,0
52447507@N06,6825,1,1415311014,1415311014,1,2,0
52496627@N03,6826,18,1364024605,1364024605,1,2,0
52496627@N03,6826,16,1364020750,1364020750,1,2,0
52571731@N05,6827,21,1356175905,1356176496,2,3,591
52571731@N05,6827,30,1356151341,1356151341,1,3,0
52571731@N05,6827,26,1356170963,1356170963,1,3,0
52571731@N05,6828,12,1388224276,1388224276,1,7,0
52571731@N05,6828,11,1388193543,1388193543,1,7,0
52571731@N05,6828,13,1388202702,1388225429,3,7,22727
52571731@N05,6828,16,1388195591,1388200354,3,7,4763
52571731@N05,6828,30,1388188262,1388188262,1,7,0
52571731@N05,6828,26,1388186964,1388193911,6,7,6947
52571731@N05,6828,24,1388199427,1388199427,1,7,0
52572912@N06,6829,28,1279979751,1279979751,1,3,0
52572912@N06,6829,17,1279949394,1279949394,1,3,0
52572912@N06,6829,3,1279970475,1279970475,1,3,0
52582799@N00,6830,25,1317637349,1317637349,1,1,0
52592482@N03,6831,19,1408259733,1408262025,2,1,2292
52615621@N07,6832,26,1467721581,1467721738,5,10,157
52615621@N07,6832,15,1467690785,1467690812,3,10,27
52615621@N07,6832,16,1467687198,1467687198,1,10,0
52615621@N07,6832,25,1467709444,1467709446,2,10,2
52615621@N07,6832,17,1467711103,1467711784,8,10,681
52615621@N07,6832,28,1467723157,1467723217,6,10,60
52615621@N07,6832,4,1467686316,1467686316,1,10,0
52615621@N07,6832,27,1467687185,1467687599,10,10,414
52615621@N07,6832,24,1467694506,1467707093,20,10,12587
52615621@N07,6832,29,1467718862,1467718862,1,10,0
52615621@N07,6833,26,1467842212,1467861513,9,4,19301
52615621@N07,6833,8,1467861020,1467861020,1,4,0
52615621@N07,6833,28,1467861748,1467861748,1,4,0
52615621@N07,6833,1,1467842481,1467842481,1,4,0
52650694@N06,6834,17,1326767086,1326767086,1,1,0
52654544@N00,6835,19,1197777651,1197784021,3,1,6370
52654544@N00,6836,6,1197846049,1197846205,5,4,156
52654544@N00,6836,20,1197844897,1197844897,1,4,0
52654544@N00,6836,30,1197845931,1197849761,4,4,3830
52654544@N00,6836,29,1197844759,1197844855,5,4,96
52654544@N00,6837,8,1211073756,1211073756,1,8,0
52654544@N00,6837,3,1211077226,1211077226,1,8,0
52654544@N00,6837,30,1211072155,1211072155,1,8,0
52654544@N00,6837,22,1211067818,1211068263,3,8,445
52654544@N00,6837,14,1211068084,1211070795,6,8,2711
52654544@N00,6837,29,1211071326,1211080915,3,8,9589
52654544@N00,6837,31,1211070995,1211071019,2,8,24
52654544@N00,6837,19,1211071198,1211071198,1,8,0
52654544@N00,6838,19,1211152484,1211154206,2,1,1722
52654544@N00,6839,19,1227415634,1227415634,1,1,0
52654544@N00,6840,19,1227575791,1227579150,10,1,3359
52656863@N03,6841,18,1456778607,1456778607,1,1,0
52658090@N06,6842,28,1357380950,1357380950,1,2,0
52658090@N06,6842,6,1357380476,1357380476,1,2,0
52666614@N06,6843,15,1331808093,1331808093,1,1,0
52744036@N06,6844,22,1260769611,1260770036,10,2,425
52744036@N06,6844,18,1260760762,1260788606,8,2,27844
52744036@N06,6845,29,1323316136,1323325960,36,2,9824
52744036@N06,6845,18,1323311554,1323332501,63,2,20947
52744036@N06,6846,18,1325058868,1325058868,1,1,0
52744036@N06,6847,18,1325761740,1325762979,2,1,1239
52744036@N06,6848,18,1325852429,1325856239,2,1,3810
52744036@N06,6849,18,1325901164,1325901164,1,1,0
52812594@N00,6850,13,1320914338,1320914338,1,1,0
52812594@N00,6851,17,1335657239,1335657239,1,1,0
52812594@N00,6852,26,1358551259,1358551259,1,2,0
52812594@N00,6852,17,1358551266,1358551305,2,2,39
52821721@N00,6853,29,1321228651,1321228651,1,1,0
52835300@N00,6854,28,1420777931,1420777931,1,1,0
52892088@N02,6855,26,1354013559,1354013559,1,4,0
52892088@N02,6855,29,1354015941,1354015941,1,4,0
52892088@N02,6855,21,1353988702,1353988702,1,4,0
52892088@N02,6855,28,1354013635,1354013635,1,4,0
52892088@N02,6856,20,1354172854,1354172854,1,2,0
52892088@N02,6856,28,1354178744,1354178744,1,2,0
52892088@N02,6857,20,1354270869,1354270869,1,2,0
52892088@N02,6857,29,1354271825,1354271825,1,2,0
52892088@N02,6858,1,1356307665,1356307665,1,1,0
52931120@N05,6859,28,1293361351,1293361351,1,1,0
52931120@N05,6860,28,1324806439,1324806439,1,1,0
52931120@N05,6861,16,1324895498,1324906137,2,2,10639
52931120@N05,6861,26,1324905770,1324906929,2,2,1159
52931120@N05,6862,29,1324986013,1324986013,1,1,0
52931120@N05,6863,16,1356517828,1356517828,1,2,0
52931120@N05,6863,26,1356529268,1356529268,1,2,0
52931120@N05,6864,28,1356778423,1356778423,1,2,0
52931120@N05,6864,27,1356777946,1356777946,1,2,0
52931120@N05,6865,24,1419861400,1419861400,1,1,0
53054066@N02,6866,26,1404570795,1404570795,1,1,0
53079384@N06,6867,24,1431845015,1431845214,2,5,199
53079384@N06,6867,21,1431860247,1431860830,7,5,583
53079384@N06,6867,15,1431848862,1431849263,2,5,401
53079384@N06,6867,12,1431851480,1431851480,1,5,0
53079384@N06,6867,16,1431843003,1431843003,1,5,0
53079384@N06,6868,28,1432007987,1432007987,1,1,0
53139290@N08,6869,28,1330116551,1330123343,31,2,6792
53139290@N08,6869,29,1330108774,1330112397,27,2,3623
53139290@N08,6870,13,1330179201,1330182209,17,2,3008
53139290@N08,6870,29,1330193292,1330195214,18,2,1922
53139290@N08,6871,1,1330269441,1330269653,2,6,212
53139290@N08,6871,16,1330285804,1330286089,3,6,285
53139290@N08,6871,27,1330265044,1330268314,7,6,3270
53139290@N08,6871,26,1330275727,1330276246,35,6,519
53139290@N08,6871,28,1330294555,1330295591,76,6,1036
53139290@N08,6871,29,1330278910,1330280777,6,6,1867
53144287@N08,6872,27,1349061339,1349061339,1,1,0
53144287@N08,6873,16,1349180636,1349180636,1,1,0
53144287@N08,6874,27,1369729246,1369729246,1,1,0
53144287@N08,6875,18,1449889914,1449889914,1,1,0
53210986@N08,6876,19,1414746169,1414746169,1,1,0
53237949@N00,6877,28,1325033520,1325033520,1,1,0
53348255@N06,6878,26,1334538110,1334538110,1,1,0
53348255@N06,6879,29,1334648459,1334648459,1,1,0
53365974@N00,6880,28,1351306500,1351310340,7,17,3840
53365974@N00,6880,1,1351306450,1351320346,5,17,13896
53365974@N00,6880,24,1351310749,1351310852,2,17,103
53365974@N00,6880,20,1351318096,1351319218,4,17,1122
53365974@N00,6880,11,1351309222,1351310044,2,17,822
53365974@N00,6880,23,1351307045,1351308932,3,17,1887
53365974@N00,6880,18,1351319661,1351319661,1,17,0
53365974@N00,6880,21,1351310326,1351310326,1,17,0
53365974@N00,6880,17,1351314000,1351314729,2,17,729
53365974@N00,6880,8,1351310439,1351310439,1,17,0
53365974@N00,6880,30,1351308863,1351309071,3,17,208
53365974@N00,6880,16,1351315839,1351317426,2,17,1587
53365974@N00,6880,29,1351307135,1351308512,3,17,1377
53365974@N00,6880,27,1351315660,1351315804,3,17,144
53365974@N00,6880,26,1351317411,1351317411,1,17,0
53365974@N00,6880,12,1351310476,1351310476,1,17,0
53365974@N00,6880,31,1351309082,1351318142,2,17,9060
53365974@N00,6881,29,1391226664,1391226664,1,7,0
53365974@N00,6881,28,1391245439,1391245520,2,7,81
53365974@N00,6881,1,1391225969,1391239612,7,7,13643
53365974@N00,6881,20,1391228062,1391228062,1,7,0
53365974@N00,6881,23,1391241624,1391241652,2,7,28
53365974@N00,6881,26,1391244232,1391244232,1,7,0
53365974@N00,6881,3,1391244687,1391244687,1,7,0
53365974@N00,6882,5,1426392148,1426392148,1,7,0
53365974@N00,6882,29,1426385750,1426385843,3,7,93
53365974@N00,6882,28,1426374576,1426374576,1,7,0
53365974@N00,6882,20,1426379324,1426379324,1,7,0
53365974@N00,6882,4,1426392043,1426392043,1,7,0
53365974@N00,6882,30,1426378852,1426378852,1,7,0
53365974@N00,6882,26,1426377092,1426392625,8,7,15533
53412049@N03,6883,28,1363228838,1363228838,1,2,0
53412049@N03,6883,15,1363253070,1363253070,1,2,0
53416084@N02,6884,1,1369318668,1369318668,1,1,0
53463927@N05,6885,3,1279182931,1279182931,1,1,0
53484449@N00,6886,17,1311398324,1311398324,1,1,0
53493629@N00,6887,16,1321425517,1321425517,1,1,0
53500976@N04,6888,28,1349568403,1349568403,1,1,0
53529949@N02,6889,18,1287389105,1287389105,1,1,0
53529949@N02,6890,18,1291701660,1291701660,1,1,0
53530069@N02,6891,18,1453895472,1453895472,1,1,0
53536543@N06,6892,28,1286524524,1286524682,3,17,158
53536543@N06,6892,31,1286495680,1286513969,4,17,18289
53536543@N06,6892,20,1286495684,1286495684,1,17,0
53536543@N06,6892,19,1286486258,1286524867,13,17,38609
53536543@N06,6892,17,1286515632,1286547547,12,17,31915
53536543@N06,6892,12,1286489699,1286494267,3,17,4568
53536543@N06,6892,24,1286515922,1286541064,3,17,25142
53536543@N06,6892,3,1286507994,1286533598,3,17,25604
53536543@N06,6892,1,1286485071,1286485071,1,17,0
53536543@N06,6892,4,1286505660,1286539925,9,17,34265
53536543@N06,6892,10,1286487990,1286537409,13,17,49419
53536543@N06,6892,29,1286486810,1286511965,4,17,25155
53536543@N06,6892,7,1286503073,1286504064,3,17,991
53536543@N06,6892,13,1286504480,1286504813,3,17,333
53536543@N06,6892,27,1286548719,1286548725,2,17,6
53536543@N06,6892,22,1286495688,1286526867,3,17,31179
53536543@N06,6892,30,1286513088,1286513088,1,17,0
53536543@N06,6893,1,1286611840,1286612946,2,1,1106
53610434@N07,6894,26,1255233075,1255245044,8,12,11969
53610434@N07,6894,28,1255227479,1255245341,15,12,17862
53610434@N07,6894,20,1255240229,1255241660,24,12,1431
53610434@N07,6894,31,1255227881,1255240111,55,12,12230
53610434@N07,6894,24,1255232873,1255232873,1,12,0
53610434@N07,6894,9,1255244740,1255244863,2,12,123
53610434@N07,6894,30,1255235735,1255235735,1,12,0
53610434@N07,6894,22,1255233061,1255235592,3,12,2531
53610434@N07,6894,12,1255232887,1255232895,2,12,8
53610434@N07,6894,23,1255233596,1255233779,6,12,183
53610434@N07,6894,1,1255245492,1255245492,1,12,0
53610434@N07,6894,29,1255235823,1255238307,7,12,2484
53610434@N07,6895,27,1379225812,1379225812,1,1,0
53610434@N07,6896,27,1422757461,1422757461,1,2,0
53610434@N07,6896,23,1422757592,1422757592,1,2,0
53610434@N07,6897,22,1435730530,1435730530,1,2,0
53610434@N07,6897,12,1435730950,1435730950,1,2,0
53611294@N00,6898,16,1212487542,1212487542,1,1,0
53611868@N00,6899,3,1310686500,1310686500,1,2,0
53611868@N00,6899,13,1310691139,1310691139,1,2,0
53632001@N02,6900,7,1363083826,1363083826,1,1,0
53687491@N00,6901,26,1199277699,1199277699,1,1,0
53687491@N00,6902,16,1199333866,1199333866,1,6,0
53687491@N00,6902,26,1199330642,1199330642,1,6,0
53687491@N00,6902,13,1199332286,1199333225,4,6,939
53687491@N00,6902,11,1199331910,1199331910,1,6,0
53687491@N00,6902,30,1199336467,1199338429,3,6,1962
53687491@N00,6902,28,1199339541,1199340464,12,6,923
53687491@N00,6903,18,1205621810,1205622032,2,3,222
53687491@N00,6903,30,1205628392,1205628392,1,3,0
53687491@N00,6903,23,1205629666,1205629760,2,3,94
53687766@N00,6904,25,1262849743,1262849743,1,1,0
53687766@N00,6905,31,1444196363,1444197253,2,1,890
53697195@N05,6906,11,1283178209,1283178209,1,2,0
53697195@N05,6906,1,1283170297,1283170297,1,2,0
53697195@N05,6907,11,1283223517,1283223517,1,13,0
53697195@N05,6907,10,1283221117,1283224133,5,13,3016
53697195@N05,6907,18,1283214908,1283214908,1,13,0
53697195@N05,6907,27,1283232528,1283232528,1,13,0
53697195@N05,6907,24,1283230285,1283230895,2,13,610
53697195@N05,6907,4,1283223469,1283223481,2,13,12
53697195@N05,6907,25,1283224523,1283225454,7,13,931
53697195@N05,6907,22,1283243931,1283243931,1,13,0
53697195@N05,6907,28,1283238387,1283244803,4,13,6416
53697195@N05,6907,17,1283232372,1283233630,3,13,1258
53697195@N05,6907,29,1283214916,1283218692,4,13,3776
53697195@N05,6907,21,1283223464,1283223464,1,13,0
53697195@N05,6907,13,1283226032,1283229412,9,13,3380
53697195@N05,6908,13,1284184672,1284184672,1,1,0
53825050@N06,6909,4,1300163969,1300183043,2,2,19074
53825050@N06,6909,5,1300183007,1300183007,1,2,0
53856603@N00,6910,27,1346152580,1346160708,2,1,8128
53856603@N00,6911,27,1352520573,1352520573,1,1,0
53856603@N00,6912,14,1358604720,1358604720,1,2,0
53856603@N00,6912,28,1358604700,1358604700,1,2,0
53856603@N00,6913,1,1378001618,1378001618,1,1,0
53879214@N03,6914,28,1379043030,1379043030,1,1,0
53879214@N03,6915,28,1386148185,1386148185,1,2,0
53879214@N03,6915,26,1386147774,1386147774,1,2,0
53879214@N03,6916,29,1386199849,1386199849,1,1,0
53936799@N05,6917,28,1367208367,1367208367,1,2,0
53936799@N05,6917,18,1367218477,1367218477,1,2,0
53936799@N05,6918,21,1367284624,1367284624,1,1,0
53936799@N05,6919,28,1367366412,1367366412,1,1,0
53951892@N03,6920,17,1345544462,1345544462,1,2,0
53951892@N03,6920,20,1345544854,1345544854,1,2,0
53951892@N03,6921,27,1345808020,1345808020,1,1,0
53978655@N00,6922,20,1364864297,1364864297,1,2,0
53978655@N00,6922,18,1364869291,1364869291,1,2,0
53978655@N00,6923,17,1364942140,1364942140,1,1,0
54023470@N03,6924,17,1343540622,1343540622,1,1,0
54055163@N00,6925,7,1226817529,1226835087,38,1,17558
54058921@N00,6926,29,1335581364,1335587167,10,1,5803
54074878@N00,6927,19,1407072168,1407072168,1,1,0
54083450@N00,6928,4,1229596476,1229596476,1,1,0
54096110@N07,6929,18,1393757186,1393757186,1,5,0
54096110@N07,6929,26,1393743978,1393744060,8,5,82
54096110@N07,6929,3,1393762708,1393762708,1,5,0
54096110@N07,6929,16,1393745421,1393745421,1,5,0
54096110@N07,6929,20,1393733397,1393733397,1,5,0
54096110@N07,6930,18,1393834759,1393834759,1,1,0
54177414@N00,6931,17,1363051242,1363051242,1,1,0
54181771@N02,6932,10,1268952053,1268952053,1,1,0
54199003@N00,6933,28,1354272082,1354272082,1,2,0
54199003@N00,6933,26,1354269225,1354269225,1,2,0
54279502@N00,6934,24,1285934198,1285934198,1,2,0
54279502@N00,6934,4,1285933782,1285933782,1,2,0
54279502@N00,6935,17,1286089029,1286089029,1,1,0
54333779@N00,6936,13,1298609437,1298609974,3,1,537
54333941@N00,6937,10,1329200227,1329200227,1,9,0
54333941@N00,6937,17,1329181650,1329211753,4,9,30103
54333941@N00,6937,21,1329182330,1329199434,3,9,17104
54333941@N00,6937,29,1329207049,1329207049,1,9,0
54333941@N00,6937,16,1329208891,1329208891,1,9,0
54333941@N00,6937,11,1329183275,1329213553,3,9,30278
54333941@N00,6937,24,1329184199,1329184199,1,9,0
54333941@N00,6937,4,1329202611,1329202611,1,9,0
54333941@N00,6937,26,1329200256,1329200256,1,9,0
54373556@N05,6938,26,1375275946,1375275946,1,1,0
54391405@N00,6939,20,1250853225,1250853370,2,3,145
54391405@N00,6939,1,1250852240,1250852488,7,3,248
54391405@N00,6939,28,1250855876,1250856013,4,3,137
54448414@N03,6940,13,1292479197,1292479197,1,2,0
54448414@N03,6940,16,1292491600,1292491600,1,2,0
54567575@N00,6941,24,1361107830,1361107830,1,7,0
54567575@N00,6941,20,1361164821,1361164821,1,7,0
54567575@N00,6941,8,1361150265,1361150265,1,7,0
54567575@N00,6941,17,1361145604,1361145604,1,7,0
54567575@N00,6941,3,1361140557,1361140557,1,7,0
54567575@N00,6941,4,1361115941,1361116031,2,7,90
54567575@N00,6941,27,1361142750,1361185772,3,7,43022
54567575@N00,6942,14,1361229903,1361229903,1,1,0
54567575@N00,6943,26,1361269205,1361269205,1,1,0
54573569@N05,6944,26,1456882521,1456882521,1,1,0
54586304@N00,6945,16,1350567818,1350567818,1,2,0
54586304@N00,6945,25,1350551017,1350581116,4,2,30099
54594385@N04,6946,29,1250665570,1250665570,1,1,0
54594385@N04,6947,12,1308130137,1308130137,1,3,0
54594385@N04,6947,15,1308129956,1308129956,1,3,0
54594385@N04,6947,24,1308107099,1308107919,2,3,820
54594385@N04,6948,21,1308194804,1308194804,1,6,0
54594385@N04,6948,16,1308208828,1308208993,3,6,165
54594385@N04,6948,29,1308209495,1308212115,3,6,2620
54594385@N04,6948,18,1308218646,1308218646,1,6,0
54594385@N04,6948,26,1308197092,1308197092,1,6,0
54594385@N04,6948,28,1308191913,1308201768,2,6,9855
54594385@N04,6949,28,1350087894,1350087894,1,1,0
54608057@N02,6950,25,1358058511,1358058511,1,1,0
54608057@N02,6951,15,1379218418,1379218418,1,1,0
54668947@N00,6952,5,1344581982,1344581982,1,3,0
54668947@N00,6952,3,1344581057,1344581057,1,3,0
54668947@N00,6952,12,1344580997,1344580997,1,3,0
54674987@N00,6953,28,1416899097,1416899097,1,1,0
54674987@N00,6954,23,1426699016,1426699016,1,1,0
54674987@N00,6955,18,1434274721,1434274721,1,1,0
54688384@N00,6956,26,1195542132,1195542132,1,2,0
54688384@N00,6956,28,1195539531,1195539531,1,2,0
54688384@N00,6957,24,1196160094,1196160094,1,1,0
54688384@N00,6958,30,1196296535,1196296535,1,3,0
54688384@N00,6958,23,1196296554,1196296554,1,3,0
54688384@N00,6958,18,1196298731,1196298948,2,3,217
54688384@N00,6959,16,1196336248,1196336248,1,1,0
54688384@N00,6960,19,1196430278,1196430278,1,1,0
54688384@N00,6961,29,1197894033,1197894033,1,1,0
54688384@N00,6962,26,1200014090,1200014090,1,2,0
54688384@N00,6962,31,1200016657,1200016657,1,2,0
54688384@N00,6963,28,1200800083,1200800083,1,2,0
54688384@N00,6963,18,1200800220,1200800220,1,2,0
54699140@N00,6964,28,1315224576,1315224576,1,1,0
54699140@N00,6965,28,1315268225,1315303900,8,1,35675
54699140@N00,6966,28,1315464029,1315475429,15,1,11400
54717162@N00,6967,26,1199851987,1199876483,34,1,24496
54717162@N00,6968,26,1199927674,1199965894,45,1,38220
54717162@N00,6969,26,1200365550,1200375770,28,1,10220
54754394@N03,6970,26,1261430284,1261431243,3,1,959
54754394@N03,6971,26,1261524977,1261524977,1,1,0
54754394@N03,6972,26,1261591437,1261620639,9,1,29202
54754394@N03,6973,26,1299253976,1299278680,112,1,24704
54754394@N03,6974,26,1299609314,1299626491,26,1,17177
54754394@N03,6975,26,1299777494,1299784331,142,1,6837
54756230@N07,6976,28,1345178901,1345178901,1,2,0
54756230@N07,6976,18,1345178973,1345178973,1,2,0
54759987@N02,6977,26,1252300669,1252308398,29,1,7729
54842330@N05,6978,28,1438031686,1438039115,3,1,7429
54855264@N00,6979,19,1405829402,1405829402,1,1,0
54866014@N02,6980,18,1452412182,1452412182,1,1,0
54902025@N00,6981,22,1305695835,1305695835,1,3,0
54902025@N00,6981,18,1305690697,1305690697,1,3,0
54902025@N00,6981,29,1305692092,1305719529,2,3,27437
54902025@N00,6982,19,1305799250,1305799250,1,5,0
54902025@N00,6982,29,1305792865,1305798941,3,5,6076
54902025@N00,6982,17,1305803144,1305803461,3,5,317
54902025@N00,6982,20,1305786391,1305787268,2,5,877
54902025@N00,6982,1,1305779969,1305779969,1,5,0
54902025@N00,6983,19,1305910054,1305910054,1,5,0
54902025@N00,6983,3,1305907303,1305907303,1,5,0
54902025@N00,6983,23,1305908708,1305908708,1,5,0
54902025@N00,6983,16,1305907699,1305907894,2,5,195
54902025@N00,6983,18,1305909012,1305909012,1,5,0
54914189@N06,6984,28,1350173237,1350173237,1,1,0
54956677@N08,6985,1,1281602616,1281602616,1,3,0
54956677@N08,6985,15,1281616213,1281616213,1,3,0
54956677@N08,6985,28,1281613079,1281621026,3,3,7947
54956677@N08,6986,1,1281672426,1281672426,1,7,0
54956677@N08,6986,13,1281674291,1281674291,1,7,0
54956677@N08,6986,11,1281669610,1281669610,1,7,0
54956677@N08,6986,12,1281670086,1281670086,1,7,0
54956677@N08,6986,26,1281689364,1281689364,1,7,0
54956677@N08,6986,10,1281696041,1281696041,1,7,0
54956677@N08,6986,24,1281675155,1281675155,1,7,0
54956677@N08,6987,28,1281943904,1281943937,2,1,33
55008715@N00,6988,22,1247541184,1247541388,5,6,204
55008715@N00,6988,1,1247524880,1247524880,1,6,0
55008715@N00,6988,28,1247572924,1247572924,1,6,0
55008715@N00,6988,23,1247563355,1247563355,1,6,0
55008715@N00,6988,19,1247562975,1247563202,3,6,227
55008715@N00,6988,13,1247557261,1247557261,1,6,0
55028731@N03,6989,1,1355801701,1355801701,1,2,0
55028731@N03,6989,28,1355798342,1355798342,1,2,0
55028731@N03,6990,18,1355899347,1355899347,1,3,0
55028731@N03,6990,28,1355890138,1355898719,2,3,8581
55028731@N03,6990,1,1355881387,1355881387,1,3,0
55034659@N02,6991,16,1296819054,1296819054,1,1,0
55059112@N05,6992,26,1321760055,1321760055,1,1,0
55070214@N06,6993,13,1455437906,1455438094,4,15,188
55070214@N06,6993,1,1455451853,1455451976,9,15,123
55070214@N06,6993,26,1455414922,1455455420,15,15,40498
55070214@N06,6993,6,1455455533,1455455562,3,15,29
55070214@N06,6993,4,1455455739,1455455739,1,15,0
55070214@N06,6993,15,1455417375,1455423136,13,15,5761
55070214@N06,6993,11,1455437544,1455456240,3,15,18696
55070214@N06,6993,29,1455415706,1455415734,3,15,28
55070214@N06,6993,7,1455455647,1455455647,1,15,0
55070214@N06,6993,16,1455414786,1455416697,5,15,1911
55070214@N06,6993,20,1455433853,1455433910,3,15,57
55070214@N06,6993,28,1455413717,1455413743,3,15,26
55070214@N06,6993,21,1455437844,1455437844,1,15,0
55070214@N06,6993,27,1455422871,1455436917,5,15,14046
55070214@N06,6993,17,1455423161,1455423161,1,15,0
55075594@N03,6994,26,1316242574,1316242574,1,1,0
55132698@N04,6995,10,1375337277,1375363991,2,1,26714
55138121@N04,6996,29,1368181367,1368193373,34,1,12006
55217458@N00,6997,23,1327730136,1327730136,1,1,0
55217458@N00,6998,28,1327792033,1327792033,1,1,0
55217458@N00,6999,26,1327833057,1327833057,1,1,0
55217458@N00,7000,26,1327907822,1327907822,1,1,0
55217458@N00,7001,27,1327968436,1327968436,1,6,0
55217458@N00,7001,18,1327992177,1327992177,1,6,0
55217458@N00,7001,28,1327992261,1327992261,1,6,0
55217458@N00,7001,20,1327990648,1327992105,2,6,1457
55217458@N00,7001,29,1327980730,1327980730,1,6,0
55217458@N00,7001,13,1327992032,1327992032,1,6,0
55217458@N00,7002,3,1328097521,1328097521,1,2,0
55217458@N00,7002,7,1328095758,1328095758,1,2,0
55217458@N00,7003,14,1341808853,1341808853,1,1,0
55217458@N00,7004,28,1341967597,1341967597,1,1,0
55217458@N00,7005,28,1358587875,1358587875,1,1,0
55217458@N00,7006,28,1358633115,1358633246,2,1,131
55217458@N00,7007,30,1358742257,1358742257,1,5,0
55217458@N00,7007,12,1358750894,1358750894,1,5,0
55217458@N00,7007,17,1358761110,1358761245,2,5,135
55217458@N00,7007,18,1358750743,1358750743,1,5,0
55217458@N00,7007,29,1358713747,1358713929,3,5,182
55217458@N00,7008,28,1358824053,1358824053,1,1,0
55217458@N00,7009,26,1377846022,1377846022,1,1,0
55217458@N00,7010,1,1377891760,1377919591,2,1,27831
55217458@N00,7011,23,1378029287,1378029287,1,3,0
55217458@N00,7011,14,1378008091,1378008091,1,3,0
55217458@N00,7011,1,1378005831,1378007660,2,3,1829
55217458@N00,7012,15,1378094295,1378094295,1,7,0
55217458@N00,7012,25,1378098696,1378098696,1,7,0
55217458@N00,7012,1,1378088888,1378090696,2,7,1808
55217458@N00,7012,26,1378092831,1378092831,1,7,0
55217458@N00,7012,12,1378097177,1378097177,1,7,0
55217458@N00,7012,17,1378105906,1378105906,1,7,0
55217458@N00,7012,13,1378100194,1378100194,1,7,0
55217458@N00,7013,23,1378177512,1378177512,1,1,0
55217458@N00,7014,26,1389592459,1389592459,1,1,0
55217458@N00,7015,1,1389902814,1389902814,1,2,0
55217458@N00,7015,30,1389902645,1389902645,1,2,0
55217458@N00,7016,23,1389937959,1389937959,1,2,0
55217458@N00,7016,16,1389940616,1389940616,1,2,0
55217458@N00,7017,15,1390016505,1390016505,1,1,0
55217458@N00,7018,1,1390090029,1390090029,1,1,0
55217458@N00,7019,29,1409294696,1409294696,1,2,0
55217458@N00,7019,19,1409284953,1409284953,1,2,0
55217458@N00,7020,14,1416075952,1416100177,4,1,24225
55217458@N00,7021,30,1416137581,1416137581,1,1,0
55217458@N00,7022,17,1416178521,1416178521,1,1,0
55262458@N03,7023,28,1312453669,1312453669,1,1,0
55262458@N03,7024,1,1318745018,1318745018,1,1,0
55262458@N03,7025,20,1328171344,1328171344,1,1,0
55262458@N03,7026,28,1330497667,1330497667,1,1,0
55262458@N03,7027,26,1334283954,1334283954,1,1,0
55262458@N03,7028,1,1338005878,1338005878,1,1,0
55262458@N03,7029,28,1338711079,1338711079,1,1,0
55262458@N03,7030,1,1343374893,1343374893,1,1,0
55262458@N03,7031,29,1344139719,1344139719,1,1,0
55262458@N03,7032,4,1346390004,1346390004,1,1,0
55262458@N03,7033,28,1347966729,1347966729,1,1,0
55262458@N03,7034,17,1348787202,1348787202,1,1,0
55262458@N03,7035,26,1350335447,1350335447,1,1,0
55262458@N03,7036,18,1351383586,1351383586,1,1,0
55262458@N03,7037,28,1352646884,1352646884,1,1,0
55262458@N03,7038,26,1354095919,1354095919,1,1,0
55262458@N03,7039,1,1354693264,1354693264,1,1,0
55262458@N03,7040,21,1360898403,1360898403,1,2,0
55262458@N03,7040,14,1360901563,1360901563,1,2,0
55262458@N03,7041,6,1361445402,1361445402,1,1,0
55262458@N03,7042,26,1361653980,1361653980,1,1,0
55262458@N03,7043,19,1361758761,1361758761,1,2,0
55262458@N03,7043,23,1361759280,1361759280,1,2,0
55262458@N03,7044,29,1361873396,1361873396,1,3,0
55262458@N03,7044,28,1361876711,1361876711,1,3,0
55262458@N03,7044,26,1361875885,1361875885,1,3,0
55262458@N03,7045,26,1362648098,1362648098,1,1,0
55262458@N03,7046,26,1363990599,1363990951,2,1,352
55262458@N03,7047,26,1364683692,1364683692,1,1,0
55262458@N03,7048,28,1366961020,1366961020,1,1,0
55262458@N03,7049,28,1368619217,1368619217,1,2,0
55262458@N03,7049,27,1368617572,1368617572,1,2,0
55262458@N03,7050,26,1371292398,1371292398,1,1,0
55262458@N03,7051,22,1372485511,1372485511,1,1,0
55262458@N03,7052,14,1377774978,1377774978,1,1,0
55262458@N03,7053,28,1390721304,1390721304,1,1,0
55262458@N03,7054,26,1393057565,1393057565,1,2,0
55262458@N03,7054,30,1393059068,1393059068,1,2,0
55262458@N03,7055,1,1408237698,1408237698,1,1,0
55283967@N03,7056,28,1374381402,1374381402,3,1,0
55284268@N05,7057,30,1360582986,1360582986,1,2,0
55284268@N05,7057,17,1360583000,1360583000,1,2,0
55284268@N05,7058,13,1360751552,1360751552,1,1,0
55292108@N00,7059,17,1408754844,1408754844,1,1,0
55292108@N00,7060,30,1420066388,1420066388,1,1,0
55299057@N00,7061,18,1453933561,1453933561,1,1,0
55355125@N00,7062,28,1357624820,1357624820,1,1,0
55355125@N00,7063,1,1396659910,1396659910,1,2,0
55355125@N00,7063,16,1396658289,1396658289,1,2,0
55355125@N00,7064,28,1407325960,1407325960,1,1,0
55355125@N00,7065,31,1407554934,1407554934,1,2,0
55355125@N00,7065,3,1407540674,1407540674,1,2,0
55355125@N00,7066,1,1407912765,1407912765,1,1,0
55355125@N00,7067,20,1419037976,1419037976,1,1,0
55355125@N00,7068,24,1419138657,1419138657,1,1,0
55355125@N00,7069,18,1427000115,1427000115,1,1,0
55355125@N00,7070,18,1446686907,1446686907,1,1,0
55378047@N07,7071,18,1368174686,1368174686,1,1,0
55503365@N04,7072,1,1311756130,1311756130,1,1,0
55503365@N04,7073,29,1362303922,1362303922,2,3,0
55503365@N04,7073,1,1362316585,1362316983,3,3,398
55503365@N04,7073,28,1362315733,1362315733,1,3,0
55532309@N00,7074,15,1392700229,1392700229,1,2,0
55532309@N00,7074,12,1392688160,1392688160,1,2,0
55559255@N00,7075,29,1411605149,1411617973,6,8,12824
55559255@N00,7075,23,1411607620,1411607620,1,8,0
55559255@N00,7075,28,1411618194,1411618194,1,8,0
55559255@N00,7075,26,1411606580,1411606801,2,8,221
55559255@N00,7075,22,1411609740,1411615510,2,8,5770
55559255@N00,7075,30,1411608956,1411608956,1,8,0
55559255@N00,7075,1,1411605602,1411606132,3,8,530
55559255@N00,7075,31,1411609188,1411609188,1,8,0
55635429@N04,7076,28,1293087438,1293087438,1,1,0
55658943@N00,7077,29,1212005210,1212005210,1,1,0
55662771@N00,7078,29,1383794417,1383794417,1,3,0
55662771@N00,7078,11,1383786069,1383786069,1,3,0
55662771@N00,7078,18,1383787201,1383787201,1,3,0
55667779@N00,7079,20,1377515198,1377515198,1,1,0
55667779@N00,7080,25,1377582361,1377582361,1,1,0
55761287@N07,7081,26,1206965940,1206966660,4,1,720
55779593@N00,7082,17,1278387549,1278387549,1,1,0
55779593@N00,7083,28,1281316460,1281316460,1,4,0
55779593@N00,7083,29,1281325129,1281325129,1,4,0
55779593@N00,7083,30,1281326663,1281326695,2,4,32
55779593@N00,7083,12,1281329623,1281329623,1,4,0
55779593@N00,7084,28,1313323048,1313323048,1,1,0
55779593@N00,7085,26,1324290950,1324290950,1,1,0
55918322@N06,7086,20,1289721260,1289721260,1,1,0
56003994@N00,7087,29,1373079040,1373079040,1,1,0
56008930@N00,7088,30,1250489748,1250489748,1,3,0
56008930@N00,7088,13,1250479491,1250479491,1,3,0
56008930@N00,7088,29,1250489687,1250489687,1,3,0
56030526@N03,7089,28,1299837670,1299837670,1,1,0
56105245@N05,7090,1,1419984352,1419993523,2,1,9171
56115748@N00,7091,24,1318668719,1318668719,1,1,0
56127076@N00,7092,13,1355016408,1355016408,1,1,0
56169684@N02,7093,18,1356048997,1356056144,2,1,7147
56169684@N02,7094,28,1356088644,1356088644,1,1,0
56197276@N02,7095,28,1306379988,1306380611,2,1,623
56223610@N07,7096,30,1305159903,1305159903,1,1,0
56223610@N07,7097,30,1391390735,1391390735,1,1,0
56266937@N05,7098,26,1365905695,1365905695,1,1,0
56279017@N03,7099,6,1334318308,1334318308,1,1,0
56279017@N03,7100,26,1355580222,1355581624,2,2,1402
56279017@N03,7100,25,1355579618,1355579618,1,2,0
56279017@N03,7101,26,1360453811,1360489599,4,3,35788
56279017@N03,7101,28,1360453084,1360453084,1,3,0
56279017@N03,7101,16,1360476386,1360476386,1,3,0
56279017@N03,7102,26,1365249604,1365249604,1,1,0
56279017@N03,7103,26,1379836987,1379836987,1,1,0
56279017@N03,7104,24,1380928122,1380928122,1,1,0
56326087@N08,7105,3,1308393935,1308393935,1,1,0
56381376@N07,7106,18,1428214333,1428214333,1,1,0
56384399@N00,7107,3,1247702024,1247702024,1,1,0
56397884@N02,7108,28,1375948085,1375950905,5,2,2820
56397884@N02,7108,1,1375942247,1375942247,1,2,0
56404268@N05,7109,29,1368998508,1368998508,1,1,0
56404392@N02,7110,18,1442018938,1442018938,1,1,0
56482238@N06,7111,13,1293514859,1293514859,1,1,0
56673695@N00,7112,29,1368850614,1368850614,1,2,0
56673695@N00,7112,7,1368829588,1368829588,1,2,0
56697934@N03,7113,26,1319858909,1319858909,1,1,0
56697934@N03,7114,21,1325858196,1325858196,1,2,0
56697934@N03,7114,26,1325847747,1325847747,1,2,0
56726532@N06,7115,26,1383103693,1383103693,1,1,0
56731143@N00,7116,26,1260666472,1260666472,1,1,0
56731143@N00,7117,28,1260705212,1260705212,1,1,0
56779606@N04,7118,28,1348382640,1348382640,1,1,0
56789804@N00,7119,1,1465898748,1465898748,1,1,0
56946277@N00,7120,26,1349582609,1349582609,1,3,0
56946277@N00,7120,7,1349582374,1349582374,1,3,0
56946277@N00,7120,18,1349599583,1349599583,1,3,0
56961858@N00,7121,30,1363576099,1363576099,1,1,0
56972276@N06,7122,31,1213149089,1213149089,1,1,0
56986641@N03,7123,30,1319339281,1319349890,46,1,10609
56986681@N00,7124,28,1321689501,1321694720,14,2,5219
56986681@N00,7124,21,1321690403,1321690638,6,2,235
56992488@N00,7125,13,1401078918,1401078918,1,1,0
56999509@N00,7126,23,1349417606,1349417606,1,1,0
57012722@N06,7127,30,1222757747,1222761409,11,1,3662
57027565@N00,7128,17,1328829928,1328829928,1,1,0
57027565@N00,7129,28,1328923976,1328923976,1,1,0
57073634@N00,7130,14,1380621619,1380621619,1,1,0
57073634@N00,7131,29,1397978946,1397978946,1,2,0
57073634@N00,7131,1,1397981403,1397981403,1,2,0
57073634@N00,7132,27,1405595599,1405595599,1,1,0
57085766@N00,7133,16,1220758138,1220758138,1,1,0
57085766@N00,7134,29,1316934726,1316934726,1,1,0
57166455@N05,7135,20,1306635500,1306635500,1,1,0
57166455@N05,7136,18,1308392225,1308392225,1,1,0
57166455@N05,7137,26,1324625670,1324625670,1,1,0
57166455@N05,7138,27,1330174379,1330174379,1,1,0
57192250@N07,7139,28,1356094440,1356094440,1,1,0
57214140@N02,7140,28,1340336294,1340336294,1,1,0
57221649@N05,7141,26,1290781170,1290781170,1,1,0
57284198@N08,7142,28,1298328397,1298328397,1,1,0
57284198@N08,7143,17,1317424556,1317426308,3,1,1752
57343525@N04,7144,29,1363509743,1363509743,1,1,0
57392952@N00,7145,9,1333709553,1333709553,1,8,0
57392952@N00,7145,29,1333717995,1333717995,1,8,0
57392952@N00,7145,15,1333706966,1333707069,2,8,103
57392952@N00,7145,27,1333702705,1333702705,1,8,0
57392952@N00,7145,11,1333709809,1333709809,1,8,0
57392952@N00,7145,1,1333721523,1333721523,1,8,0
57392952@N00,7145,26,1333720989,1333720989,1,8,0
57392952@N00,7145,6,1333714370,1333714370,1,8,0
57392952@N00,7146,29,1333776113,1333776113,1,6,0
57392952@N00,7146,16,1333767703,1333767703,1,6,0
57392952@N00,7146,10,1333789136,1333791447,5,6,2311
57392952@N00,7146,1,1333769645,1333770015,6,6,370
57392952@N00,7146,17,1333761134,1333761134,1,6,0
57392952@N00,7146,28,1333761523,1333771026,2,6,9503
57492486@N00,7147,10,1292983911,1292983911,1,6,0
57492486@N00,7147,26,1292978245,1293014385,4,6,36140
57492486@N00,7147,28,1292977918,1292978023,2,6,105
57492486@N00,7147,25,1293007857,1293007929,3,6,72
57492486@N00,7147,18,1292991283,1292991283,1,6,0
57492486@N00,7147,20,1292982479,1292982479,1,6,0
57507256@N00,7148,28,1322210030,1322210030,1,11,0
57507256@N00,7148,15,1322196300,1322196300,1,11,0
57507256@N00,7148,29,1322202738,1322202738,1,11,0
57507256@N00,7148,17,1322187923,1322189640,2,11,1717
57507256@N00,7148,16,1322202809,1322202809,1,11,0
57507256@N00,7148,20,1322195098,1322202115,3,11,7017
57507256@N00,7148,24,1322206687,1322206687,1,11,0
57507256@N00,7148,18,1322224163,1322224209,2,11,46
57507256@N00,7148,26,1322224133,1322224133,1,11,0
57507256@N00,7148,27,1322182315,1322182315,1,11,0
57507256@N00,7148,23,1322223997,1322223997,1,11,0
57553641@N07,7149,10,1394953032,1394953032,1,1,0
57553641@N07,7150,30,1396234619,1396234619,1,1,0
57573839@N06,7151,20,1388623605,1388623605,1,2,0
57573839@N06,7151,28,1388625349,1388625349,1,2,0
57573839@N06,7152,1,1389164405,1389164405,1,1,0
57623098@N07,7153,30,1284254041,1284254041,1,1,0
57623780@N04,7154,15,1353663370,1353663370,1,2,0
57623780@N04,7154,4,1353666434,1353666969,2,2,535
57623780@N04,7155,13,1353718982,1353720111,8,3,1129
57623780@N04,7155,16,1353722504,1353749314,4,3,26810
57623780@N04,7155,21,1353720425,1353720432,2,3,7
57623780@N04,7156,31,1388723802,1388723802,1,1,0
57639181@N00,7157,28,1237424922,1237450325,5,7,25403
57639181@N00,7157,10,1237421467,1237457463,473,7,35996
57639181@N00,7157,14,1237435202,1237460231,2,7,25029
57639181@N00,7157,31,1237450759,1237450759,1,7,0
57639181@N00,7157,26,1237459605,1237459605,1,7,0
57639181@N00,7157,25,1237446225,1237446225,1,7,0
57639181@N00,7157,1,1237426889,1237426889,1,7,0
57639181@N00,7158,10,1238980941,1238980941,1,1,0
57665635@N00,7159,31,1294205009,1294205009,1,4,0
57665635@N00,7159,22,1294214461,1294214461,1,4,0
57665635@N00,7159,29,1294202148,1294215332,5,4,13184
57665635@N00,7159,13,1294207318,1294207870,3,4,552
57665635@N00,7160,26,1296111111,1296111111,1,9,0
57665635@N00,7160,30,1296102207,1296102976,2,9,769
57665635@N00,7160,17,1296107943,1296107943,1,9,0
57665635@N00,7160,18,1296110290,1296110290,1,9,0
57665635@N00,7160,27,1296108677,1296108677,1,9,0
57665635@N00,7160,29,1296101422,1296101422,1,9,0
57665635@N00,7160,20,1296099840,1296099840,1,9,0
57665635@N00,7160,7,1296112095,1296112989,2,9,894
57665635@N00,7160,16,1296112248,1296112356,2,9,108
57665635@N00,7161,26,1304503799,1304503799,1,1,0
57665635@N00,7162,27,1307229344,1307229350,2,1,6
57665635@N00,7163,28,1319356135,1319356135,1,2,0
57665635@N00,7163,20,1319353204,1319354597,5,2,1393
57665635@N00,7164,6,1422826412,1422826412,1,1,0
57667450@N03,7165,13,1415841176,1415841180,2,2,4
57667450@N03,7165,24,1415847238,1415848009,10,2,771
57667450@N03,7166,18,1417412566,1417412566,2,4,0
57667450@N03,7166,28,1417416407,1417416407,3,4,0
57667450@N03,7166,26,1417410874,1417410900,4,4,26
57667450@N03,7166,23,1417412461,1417412467,4,4,6
57731366@N00,7167,19,1402969783,1402983913,3,1,14130
57731366@N00,7168,19,1403051068,1403051068,1,1,0
57731366@N00,7169,18,1434497412,1434497412,1,1,0
57731366@N00,7170,18,1456013670,1456014416,3,1,746
57731892@N07,7171,8,1376890164,1376890164,2,1,0
57747305@N00,7172,26,1232538493,1232538493,1,1,0
57794654@N02,7173,14,1378008244,1378008244,1,1,0
57799803@N02,7174,1,1385002012,1385002012,1,2,0
57799803@N02,7174,25,1385024288,1385024288,1,2,0
57799803@N02,7175,1,1396658898,1396658898,1,1,0
57799803@N02,7176,30,1415871945,1415871945,1,2,0
57799803@N02,7176,16,1415866972,1415866972,1,2,0
57799803@N02,7177,30,1415993527,1415993527,1,1,0
57799803@N02,7178,19,1417098435,1417098435,1,1,0
57799803@N02,7179,18,1421631095,1421631095,1,1,0
57799803@N02,7180,18,1421663908,1421663908,1,1,0
57799803@N02,7181,18,1441281355,1441281355,1,1,0
57799803@N02,7182,18,1441326799,1441344727,2,1,17928
57799803@N02,7183,18,1448714679,1448714679,1,1,0
57799803@N02,7184,6,1462586349,1462586349,1,1,0
57812277@N05,7185,26,1310636216,1310636216,1,1,0
57812277@N05,7186,22,1310858072,1310858478,2,2,406
57812277@N05,7186,26,1310877238,1310877238,1,2,0
57812277@N05,7187,4,1324716118,1324716118,1,2,0
57812277@N05,7187,26,1324714602,1324714602,1,2,0
57812277@N05,7188,22,1325023387,1325023387,1,1,0
57812277@N05,7189,26,1365297115,1365297115,1,1,0
57812277@N05,7190,28,1397103683,1397103683,1,1,0
57812277@N05,7191,26,1397389292,1397389292,1,2,0
57812277@N05,7191,22,1397380779,1397382161,2,2,1382
57812277@N05,7192,1,1437383832,1437383832,1,1,0
57813268@N04,7193,25,1452410560,1452411306,2,1,746
57852884@N00,7194,18,1422228755,1422228755,1,2,0
57852884@N00,7194,4,1422233346,1422233346,1,2,0
57852884@N00,7195,16,1422314582,1422314582,1,1,0
57852884@N00,7196,16,1461058989,1461058989,1,1,0
57853113@N00,7197,26,1207890336,1207910431,94,1,20095
57856849@N08,7198,1,1302040803,1302040803,1,1,0
57868847@N04,7199,28,1293884494,1293884494,1,1,0
57869748@N00,7200,29,1412559582,1412559582,1,1,0
57869748@N00,7201,19,1412665569,1412665569,1,1,0
57869748@N00,7202,31,1412736540,1412736540,1,1,0
57885204@N00,7203,14,1367202352,1367202700,3,2,348
57885204@N00,7203,26,1367204781,1367205049,3,2,268
57885204@N00,7204,17,1380765497,1380765497,1,2,0
57885204@N00,7204,14,1380771897,1380771897,1,2,0
57885204@N00,7205,22,1398062113,1398062113,1,2,0
57885204@N00,7205,1,1398057498,1398057498,1,2,0
57938267@N00,7206,24,1205284908,1205285449,2,13,541
57938267@N00,7206,22,1205316163,1205316163,1,13,0
57938267@N00,7206,20,1205315283,1205315283,1,13,0
57938267@N00,7206,27,1205285711,1205285711,1,13,0
57938267@N00,7206,5,1205293293,1205293293,1,13,0
57938267@N00,7206,15,1205308850,1205308850,1,13,0
57938267@N00,7206,10,1205294049,1205316896,2,13,22847
57938267@N00,7206,17,1205310949,1205310949,1,13,0
57938267@N00,7206,1,1205319037,1205319086,2,13,49
57938267@N00,7206,26,1205293756,1205301014,2,13,7258
57938267@N00,7206,12,1205282728,1205282735,2,13,7
57938267@N00,7206,28,1205280488,1205318214,2,13,37726
57938267@N00,7206,9,1205289377,1205289377,1,13,0
57967471@N06,7207,28,1310083971,1310083971,1,7,0
57967471@N06,7207,27,1310097948,1310097948,1,7,0
57967471@N06,7207,29,1310128406,1310128406,1,7,0
57967471@N06,7207,26,1310104013,1310104013,1,7,0
57967471@N06,7207,14,1310112825,1310114531,2,7,1706
57967471@N06,7207,1,1310083271,1310083271,1,7,0
57967471@N06,7207,22,1310094634,1310094634,1,7,0
57967471@N06,7208,17,1310218998,1310218998,1,2,0
57967471@N06,7208,3,1310217884,1310217884,1,2,0
57967471@N06,7209,17,1310250289,1310250289,1,1,0
57967471@N06,7210,13,1310365424,1310365424,1,3,0
57967471@N06,7210,26,1310366476,1310366476,1,3,0
57967471@N06,7210,29,1310373578,1310381125,2,3,7547
57991930@N07,7211,26,1350206874,1350206874,1,5,0
57991930@N07,7211,16,1350195382,1350195382,1,5,0
57991930@N07,7211,27,1350199587,1350199587,1,5,0
57991930@N07,7211,20,1350204369,1350204369,1,5,0
57991930@N07,7211,29,1350204604,1350204604,1,5,0
57991930@N07,7212,25,1350261346,1350261872,3,2,526
57991930@N07,7212,27,1350252067,1350254265,4,2,2198
57991930@N07,7213,18,1350342225,1350342225,1,4,0
57991930@N07,7213,5,1350343343,1350343343,1,4,0
57991930@N07,7213,27,1350338155,1350338155,1,4,0
57991930@N07,7213,22,1350342398,1350342398,1,4,0
57991930@N07,7214,15,1350418407,1350418407,1,2,0
57991930@N07,7214,28,1350418303,1350418303,1,2,0
58007133@N00,7215,8,1188959293,1188980359,19,1,21066
58007133@N00,7216,8,1189471559,1189480990,28,1,9431
58007133@N00,7217,6,1193707581,1193721721,29,1,14140
58007133@N00,7218,6,1209521945,1209543995,43,1,22050
58044290@N00,7219,18,1215938703,1215938703,1,1,0
58044290@N00,7220,26,1234076447,1234076447,1,1,0
58044290@N00,7221,28,1234172274,1234172274,1,4,0
58044290@N00,7221,1,1234172234,1234172234,1,4,0
58044290@N00,7221,29,1234172308,1234172308,1,4,0
58044290@N00,7221,30,1234172335,1234172335,1,4,0
58044290@N00,7222,28,1235722236,1235729691,5,4,7455
58044290@N00,7222,10,1235732277,1235732277,1,4,0
58044290@N00,7222,26,1235733259,1235733259,1,4,0
58044290@N00,7222,31,1235731995,1235731995,1,4,0
58044290@N00,7223,19,1237102183,1237102183,1,4,0
58044290@N00,7223,28,1237093965,1237093965,1,4,0
58044290@N00,7223,10,1237102699,1237102699,1,4,0
58044290@N00,7223,18,1237100270,1237100270,1,4,0
58093080@N05,7224,21,1338784519,1338784519,1,1,0
58112562@N00,7225,3,1364849052,1364849052,1,1,0
58147831@N08,7226,12,1438939865,1438939865,1,2,0
58147831@N08,7226,23,1438945856,1438945856,1,2,0
58153317@N08,7227,22,1344249942,1344249942,1,1,0
58161527@N03,7228,3,1310979183,1310979183,1,1,0
58163347@N08,7229,26,1322627268,1322627268,1,1,0
58174503@N02,7230,20,1414559708,1414559708,1,4,0
58174503@N02,7230,27,1414576671,1414576671,1,4,0
58174503@N02,7230,12,1414575770,1414575770,1,4,0
58174503@N02,7230,19,1414557226,1414564152,2,4,6926
58197646@N00,7231,26,1312143378,1312143378,1,1,0
58263353@N06,7232,4,1303620375,1303620375,1,1,0
58276829@N06,7233,11,1302152562,1302152562,1,15,0
58276829@N06,7233,20,1302166510,1302167976,6,15,1466
58276829@N06,7233,15,1302147633,1302147633,1,15,0
58276829@N06,7233,29,1302163706,1302164047,3,15,341
58276829@N06,7233,12,1302141935,1302143402,2,15,1467
58276829@N06,7233,31,1302166438,1302166438,1,15,0
58276829@N06,7233,22,1302166260,1302166260,1,15,0
58276829@N06,7233,5,1302141793,1302155596,6,15,13803
58276829@N06,7233,25,1302144165,1302156435,9,15,12270
58276829@N06,7233,17,1302147891,1302147891,1,15,0
58276829@N06,7233,3,1302145428,1302145428,1,15,0
58276829@N06,7233,26,1302141766,1302151947,4,15,10181
58276829@N06,7233,16,1302150169,1302150169,1,15,0
58276829@N06,7233,4,1302154168,1302154168,1,15,0
58276829@N06,7233,18,1302157559,1302157559,1,15,0
58327394@N00,7234,26,1239710295,1239710295,1,1,0
58327394@N00,7235,26,1239758751,1239772234,3,1,13483
58327394@N00,7236,10,1246954879,1246954879,1,1,0
58345372@N02,7237,24,1294461220,1294462363,5,1,1143
58345372@N02,7238,1,1296282531,1296283889,3,2,1358
58345372@N02,7238,28,1296282873,1296282929,2,2,56
58345372@N02,7239,24,1296953711,1296953809,2,2,98
58345372@N02,7239,27,1296952982,1296953068,2,2,86
58345372@N02,7240,1,1297560283,1297560283,1,2,0
58345372@N02,7240,24,1297570829,1297570829,1,2,0
58345372@N02,7241,24,1298263363,1298263363,1,1,0
58345372@N02,7242,29,1298694547,1298695582,29,1,1035
58345372@N02,7243,29,1298768885,1298769378,16,1,493
58345372@N02,7244,16,1299378265,1299378473,3,4,208
58345372@N02,7244,24,1299386093,1299386907,4,4,814
58345372@N02,7244,29,1299368790,1299376789,14,4,7999
58345372@N02,7244,21,1299384708,1299384930,3,4,222
58345372@N02,7245,26,1299903423,1299903866,7,2,443
58345372@N02,7245,28,1299904189,1299904189,1,2,0
58345372@N02,7246,28,1301787220,1301787220,1,2,0
58345372@N02,7246,22,1301786033,1301786033,1,2,0
58345372@N02,7247,26,1305413195,1305413195,1,1,0
58345372@N02,7248,28,1306388143,1306389343,18,1,1200
58345372@N02,7249,28,1306472513,1306476377,7,1,3864
58345372@N02,7250,28,1306713095,1306713095,1,1,0
58345372@N02,7251,28,1310876963,1310877179,24,1,216
58345372@N02,7252,28,1315031239,1315031244,2,1,5
58345372@N02,7253,28,1315212293,1315212293,2,1,0
58345372@N02,7254,26,1315722159,1315722159,1,1,0
58345372@N02,7255,25,1316778466,1316779045,3,2,579
58345372@N02,7255,24,1316772721,1316774951,3,2,2230
58345372@N02,7256,26,1322349902,1322349902,1,1,0
58345372@N02,7257,26,1323124308,1323124308,1,1,0
58366987@N00,7258,17,1268204645,1268204645,1,8,0
58366987@N00,7258,26,1268216801,1268227009,4,8,10208
58366987@N00,7258,4,1268225602,1268225602,1,8,0
58366987@N00,7258,6,1268226443,1268226976,2,8,533
58366987@N00,7258,3,1268223026,1268223026,1,8,0
58366987@N00,7258,5,1268224947,1268224947,1,8,0
58366987@N00,7258,21,1268224240,1268224801,2,8,561
58366987@N00,7258,7,1268226090,1268226090,1,8,0
58383324@N00,7259,18,1431564788,1431604846,6,2,40058
58383324@N00,7259,13,1431566256,1431566256,1,2,0
58423006@N02,7260,26,1313136977,1313136977,1,1,0
58426797@N08,7261,26,1362802323,1362808420,25,1,6097
58426797@N08,7262,29,1370125729,1370130993,20,3,5264
58426797@N08,7262,28,1370137494,1370137494,1,3,0
58426797@N08,7262,13,1370149408,1370149932,5,3,524
58436993@N00,7263,1,1459760025,1459760025,1,19,0
58436993@N00,7263,14,1459731592,1459731592,1,19,0
58436993@N00,7263,27,1459749614,1459750679,6,19,1065
58436993@N00,7263,3,1459739227,1459739227,1,19,0
58436993@N00,7263,15,1459738601,1459738601,1,19,0
58436993@N00,7263,26,1459724795,1459737287,3,19,12492
58436993@N00,7263,28,1459720658,1459720699,2,19,41
58436993@N00,7263,24,1459738619,1459747286,3,19,8667
58436993@N00,7263,6,1459737343,1459740054,2,19,2711
58436993@N00,7263,21,1459739178,1459739178,1,19,0
58436993@N00,7263,29,1459726837,1459752530,5,19,25693
58436993@N00,7263,17,1459722848,1459723007,3,19,159
58436993@N00,7263,12,1459721576,1459747667,5,19,26091
58436993@N00,7263,13,1459742058,1459742080,2,19,22
58436993@N00,7263,16,1459721182,1459724653,14,19,3471
58436993@N00,7263,19,1459727172,1459727226,2,19,54
58436993@N00,7263,25,1459750188,1459750188,1,19,0
58436993@N00,7263,23,1459720859,1459734147,4,19,13288
58436993@N00,7263,30,1459733509,1459755111,6,19,21602
58493771@N00,7264,26,1304045755,1304078758,10,1,33003
58512585@N00,7265,15,1300001550,1300001550,1,7,0
58512585@N00,7265,30,1299966703,1299976075,2,7,9372
58512585@N00,7265,19,1299965420,1299965847,2,7,427
58512585@N00,7265,14,1299969650,1299969650,1,7,0
58512585@N00,7265,12,1299961324,1299961324,1,7,0
58512585@N00,7265,1,1299975361,1299975361,1,7,0
58512585@N00,7265,20,1299969067,1299969067,1,7,0
58512585@N00,7266,26,1300099805,1300099805,1,3,0
58512585@N00,7266,1,1300102231,1300102231,1,3,0
58512585@N00,7266,20,1300095937,1300095937,1,3,0
58513125@N05,7267,1,1404551795,1404551795,1,3,0
58513125@N05,7267,28,1404531210,1404552765,4,3,21555
58513125@N05,7267,16,1404549701,1404550532,13,3,831
58519896@N00,7268,26,1232784701,1232784757,2,5,56
58519896@N00,7268,28,1232754899,1232802545,3,5,47646
58519896@N00,7268,3,1232764674,1232768618,3,5,3944
58519896@N00,7268,21,1232763058,1232763058,1,5,0
58519896@N00,7268,24,1232761357,1232762324,3,5,967
58519896@N00,7269,24,1232876848,1232876848,1,1,0
58522598@N00,7270,16,1406470473,1406471236,8,8,763
58522598@N00,7270,30,1406459193,1406459193,1,8,0
58522598@N00,7270,22,1406458835,1406458835,1,8,0
58522598@N00,7270,13,1406452298,1406452348,2,8,50
58522598@N00,7270,26,1406461135,1406463489,5,8,2354
58522598@N00,7270,21,1406452215,1406452215,1,8,0
58522598@N00,7270,15,1406453614,1406453709,4,8,95
58522598@N00,7270,29,1406457999,1406457999,1,8,0
58588822@N00,7271,29,1437887584,1437887584,1,1,0
58667572@N00,7272,28,1288768104,1288768104,1,6,0
58667572@N00,7272,30,1288756753,1288756924,2,6,171
58667572@N00,7272,3,1288758609,1288758609,1,6,0
58667572@N00,7272,14,1288746353,1288746353,1,6,0
58667572@N00,7272,8,1288748108,1288748819,4,6,711
58667572@N00,7272,18,1288762786,1288766269,5,6,3483
58668786@N00,7273,13,1258847538,1258852154,14,5,4616
58668786@N00,7273,17,1258859598,1258859598,1,5,0
58668786@N00,7273,26,1258846727,1258869037,4,5,22310
58668786@N00,7273,30,1258861766,1258866277,10,5,4511
58668786@N00,7273,1,1258846237,1258846237,1,5,0
58668786@N00,7274,21,1445043946,1445043946,1,3,0
58668786@N00,7274,26,1445043624,1445043624,1,3,0
58668786@N00,7274,23,1445052395,1445052395,1,3,0
58694515@N08,7275,28,1353652611,1353652611,1,1,0
58694515@N08,7276,16,1364636686,1364636686,1,1,0
58694515@N08,7277,11,1373710940,1373710940,1,3,0
58694515@N08,7277,15,1373695668,1373695864,2,3,196
58694515@N08,7277,27,1373695342,1373695342,1,3,0
58694515@N08,7278,28,1391219325,1391219325,1,1,0
58720664@N08,7279,24,1353239756,1353239756,1,1,0
58720664@N08,7280,16,1353413071,1353413071,1,1,0
58720664@N08,7281,25,1353832258,1353832258,1,1,0
58720664@N08,7282,27,1354834401,1354834401,1,1,0
58720664@N08,7283,29,1367484453,1367484453,1,1,0
58720664@N08,7284,29,1384646318,1384646318,1,1,0
58753937@N00,7285,26,1251109648,1251109648,1,3,0
58753937@N00,7285,7,1251096224,1251096224,1,3,0
58753937@N00,7285,30,1251093078,1251093078,1,3,0
58785673@N08,7286,28,1341630868,1341642965,2,3,12097
58785673@N08,7286,18,1341634899,1341634899,1,3,0
58785673@N08,7286,1,1341642976,1341642976,1,3,0
58826624@N00,7287,13,1254627168,1254627168,1,1,0
58837464@N02,7288,12,1313824496,1313824496,1,1,0
58886894@N00,7289,28,1288996133,1288996133,1,1,0
58938024@N03,7290,20,1274572229,1274572229,1,2,0
58938024@N03,7290,28,1274590324,1274590324,1,2,0
58938245@N00,7291,1,1393288604,1393289086,4,4,482
58938245@N00,7291,20,1393294603,1393294618,2,4,15
58938245@N00,7291,29,1393294581,1393294583,2,4,2
58938245@N00,7291,28,1393289066,1393289066,1,4,0
58964713@N05,7292,12,1256314048,1256314048,1,1,0
58964713@N05,7293,1,1256344243,1256344243,1,1,0
58982814@N07,7294,16,1376138170,1376138170,1,2,0
58982814@N07,7294,17,1376127451,1376127451,1,2,0
58991728@N00,7295,28,1365147995,1365147995,1,1,0
59004662@N00,7296,19,1412467788,1412467788,1,1,0
59028125@N00,7297,13,1321559773,1321559773,1,1,0
59106234@N00,7298,20,1316860316,1316860316,1,1,0
59134168@N07,7299,26,1340254684,1340257989,5,1,3305
59184099@N06,7300,10,1274744172,1274744172,1,1,0
59184099@N06,7301,26,1275888081,1275888081,1,3,0
59184099@N06,7301,8,1275887693,1275887693,1,3,0
59184099@N06,7301,30,1275898885,1275898885,1,3,0
59184099@N06,7302,15,1277118505,1277118505,1,1,0
59184099@N06,7303,26,1311065222,1311065828,9,2,606
59184099@N06,7303,1,1311087389,1311087389,1,2,0
59184099@N06,7304,18,1311511019,1311511019,1,1,0
59184099@N06,7305,3,1311834637,1311834637,1,1,0
59184099@N06,7306,28,1312265765,1312266124,6,3,359
59184099@N06,7306,26,1312259672,1312260469,2,3,797
59184099@N06,7306,1,1312266657,1312266657,1,3,0
59184099@N06,7307,26,1312782225,1312782225,1,1,0
59184099@N06,7308,24,1313075862,1313075862,1,1,0
59184099@N06,7309,28,1313562172,1313562172,1,4,0
59184099@N06,7309,24,1313556139,1313556139,1,4,0
59184099@N06,7309,16,1313556821,1313556821,1,4,0
59184099@N06,7309,1,1313562227,1313562227,1,4,0
59184099@N06,7310,16,1314545857,1314545857,1,1,0
59184099@N06,7311,16,1314862460,1314867214,3,2,4754
59184099@N06,7311,1,1314858203,1314858357,2,2,154
59184099@N06,7312,26,1315330440,1315330440,1,1,0
59184099@N06,7313,30,1316765442,1316765547,2,3,105
59184099@N06,7313,27,1316749010,1316749589,2,3,579
59184099@N06,7313,26,1316758579,1316759832,4,3,1253
59184099@N06,7314,28,1316845248,1316845248,1,2,0
59184099@N06,7314,26,1316849209,1316849209,1,2,0
59184099@N06,7315,28,1317451145,1317478727,2,1,27582
59184099@N06,7316,20,1317798068,1317798068,1,1,0
59184099@N06,7317,28,1318420757,1318420757,1,1,0
59184099@N06,7318,28,1318607106,1318607106,1,1,0
59184099@N06,7319,26,1318934207,1318934207,1,1,0
59184099@N06,7320,1,1319348001,1319348001,1,3,0
59184099@N06,7320,26,1319363643,1319363643,1,3,0
59184099@N06,7320,28,1319352760,1319352760,1,3,0
59184099@N06,7321,29,1319785907,1319785907,1,2,0
59184099@N06,7321,30,1319788385,1319788385,1,2,0
59184099@N06,7322,28,1320409780,1320409780,1,1,0
59184099@N06,7323,12,1320494814,1320494814,1,1,0
59184099@N06,7324,29,1320976002,1320976002,1,3,0
59184099@N06,7324,15,1321003752,1321003752,1,3,0
59184099@N06,7324,24,1321008525,1321008525,1,3,0
59184099@N06,7325,28,1321628580,1321628580,1,2,0
59184099@N06,7325,29,1321626052,1321626052,1,2,0
59184099@N06,7326,30,1321937822,1321937822,1,2,0
59184099@N06,7326,11,1321931252,1321931252,1,2,0
59184099@N06,7327,31,1322231820,1322231820,1,1,0
59184099@N06,7328,1,1322813819,1322813819,1,1,0
59184099@N06,7329,26,1323441898,1323441898,1,2,0
59184099@N06,7329,25,1323440258,1323440258,1,2,0
59184099@N06,7330,20,1324034549,1324034549,1,1,0
59184099@N06,7331,26,1324647234,1324647234,1,1,0
59184099@N06,7332,29,1325571510,1325572070,2,1,560
59184099@N06,7333,19,1326547219,1326547219,1,1,0
59184099@N06,7334,28,1326908206,1326908206,1,1,0
59184099@N06,7335,15,1328261535,1328261535,1,2,0
59184099@N06,7335,24,1328261793,1328261793,1,2,0
59184099@N06,7336,17,1328793297,1328793297,1,1,0
59184099@N06,7337,26,1329371522,1329371522,1,1,0
59184099@N06,7338,26,1329404851,1329407796,2,1,2945
59184099@N06,7339,26,1329493287,1329493287,1,1,0
59184099@N06,7340,16,1330880922,1330880922,1,1,0
59184099@N06,7341,26,1331398392,1331398392,1,1,0
59184099@N06,7342,16,1331569389,1331569389,1,1,0
59184099@N06,7343,26,1331846312,1331846312,1,1,0
59184099@N06,7344,13,1335015747,1335015747,1,1,0
59184099@N06,7345,16,1335102361,1335102361,1,1,0
59184099@N06,7346,15,1336127876,1336128109,2,1,233
59184099@N06,7347,29,1337789282,1337789282,1,1,0
59184099@N06,7348,26,1338028591,1338028983,2,1,392
59184099@N06,7349,21,1338358685,1338358685,1,1,0
59184099@N06,7350,30,1346158051,1346158051,1,3,0
59184099@N06,7350,15,1346140440,1346140440,1,3,0
59184099@N06,7350,26,1346141880,1346141880,1,3,0
59184099@N06,7351,20,1352002375,1352002375,1,1,0
59184099@N06,7352,29,1355806210,1355806210,1,3,0
59184099@N06,7352,16,1355802786,1355802786,1,3,0
59184099@N06,7352,6,1355811528,1355811528,1,3,0
59184099@N06,7353,28,1371191370,1371191370,1,1,0
59184099@N06,7354,20,1376053408,1376053408,1,1,0
59184099@N06,7355,26,1376544972,1376544972,1,1,0
59184099@N06,7356,29,1376748657,1376748657,1,1,0
59184099@N06,7357,29,1378041715,1378041715,1,1,0
59184099@N06,7358,29,1378189489,1378189489,1,1,0
59184099@N06,7359,29,1378893917,1378893917,1,1,0
59184099@N06,7360,26,1380282342,1380282342,1,1,0
59184099@N06,7361,28,1388415775,1388415775,1,1,0
59184099@N06,7362,16,1388472898,1388472898,1,1,0
59184099@N06,7363,26,1395570660,1395570660,1,1,0
59184099@N06,7364,26,1396297760,1396297760,1,1,0
59184099@N06,7365,26,1398166854,1398166854,1,1,0
59184099@N06,7366,26,1399570003,1399570003,1,1,0
59184099@N06,7367,29,1402860261,1402860261,1,1,0
59184099@N06,7368,20,1403270844,1403270844,1,2,0
59184099@N06,7368,26,1403274392,1403274392,1,2,0
59184099@N06,7369,16,1403533032,1403533032,1,1,0
59184099@N06,7370,20,1403931078,1403931078,1,1,0
59184099@N06,7371,6,1403965021,1403965021,1,1,0
59184099@N06,7372,30,1412064246,1412077029,3,1,12783
59184099@N06,7373,16,1414477615,1414477615,1,1,0
59184099@N06,7374,20,1418103233,1418103233,1,1,0
59184099@N06,7375,6,1421588496,1421588496,1,1,0
59184099@N06,7376,26,1428201286,1428201286,1,1,0
59184099@N06,7377,26,1433510574,1433510574,1,1,0
59184099@N06,7378,7,1435672800,1435672800,1,1,0
59184099@N06,7379,16,1449758687,1449758687,1,2,0
59184099@N06,7379,27,1449754364,1449754364,1,2,0
59184099@N06,7380,26,1457333893,1457333893,1,1,0
59186794@N00,7381,3,1467235549,1467237764,3,1,2215
59203613@N04,7382,30,1339642033,1339642033,1,1,0
59217527@N05,7383,27,1318912515,1318912515,1,1,0
59243952@N04,7384,22,1276660696,1276660696,1,1,0
59263913@N00,7385,29,1329512643,1329512734,3,4,91
59263913@N00,7385,24,1329510199,1329510199,1,4,0
59263913@N00,7385,1,1329509461,1329509461,1,4,0
59263913@N00,7385,26,1329509787,1329509787,1,4,0
59263913@N00,7386,27,1329563141,1329563141,1,3,0
59263913@N00,7386,13,1329542151,1329542151,1,3,0
59263913@N00,7386,25,1329544060,1329544060,1,3,0
59263913@N00,7387,1,1329610836,1329610836,1,1,0
59263913@N00,7388,13,1329728790,1329728790,1,3,0
59263913@N00,7388,7,1329726925,1329726925,1,3,0
59263913@N00,7388,26,1329728747,1329728768,2,3,21
59270652@N04,7389,29,1346507436,1346507436,1,1,0
59323491@N00,7390,1,1380886761,1380892592,3,2,5831
59323491@N00,7390,26,1380891848,1380891848,1,2,0
59323491@N00,7391,1,1380946157,1380946157,1,1,0
59323491@N00,7392,14,1381017066,1381017066,1,1,0
59323491@N00,7393,17,1381364402,1381364402,1,3,0
59323491@N00,7393,7,1381363926,1381363926,1,3,0
59323491@N00,7393,1,1381364193,1381364193,1,3,0
59344479@N02,7394,26,1396914821,1396914821,1,1,0
59350481@N07,7395,23,1306757196,1306757196,1,2,0
59350481@N07,7395,28,1306736319,1306736372,3,2,53
59350481@N07,7396,3,1349323221,1349323221,1,1,0
59390981@N04,7397,1,1229736029,1229736029,1,1,0
59390981@N04,7398,31,1308126286,1308126286,1,4,0
59390981@N04,7398,27,1308117900,1308122635,3,4,4735
59390981@N04,7398,16,1308125825,1308125825,1,4,0
59390981@N04,7398,1,1308112540,1308112540,1,4,0
59390981@N04,7399,31,1325415504,1325415504,1,17,0
59390981@N04,7399,7,1325413652,1325413892,7,17,240
59390981@N04,7399,29,1325421333,1325421333,1,17,0
59390981@N04,7399,30,1325415144,1325416063,4,17,919
59390981@N04,7399,9,1325413953,1325413953,1,17,0
59390981@N04,7399,15,1325409665,1325409665,1,17,0
59390981@N04,7399,6,1325414329,1325414522,6,17,193
59390981@N04,7399,28,1325408769,1325422788,9,17,14019
59390981@N04,7399,17,1325409738,1325411628,2,17,1890
59390981@N04,7399,16,1325409453,1325409453,1,17,0
59390981@N04,7399,5,1325413811,1325413811,1,17,0
59390981@N04,7399,3,1325413179,1325413544,3,17,365
59390981@N04,7399,23,1325418532,1325418532,1,17,0
59390981@N04,7399,20,1325417474,1325418234,15,17,760
59390981@N04,7399,8,1325413967,1325413967,1,17,0
59390981@N04,7399,18,1325419413,1325419413,1,17,0
59390981@N04,7399,26,1325414510,1325415105,8,17,595
59390981@N04,7400,6,1325461506,1325461506,1,2,0
59390981@N04,7400,28,1325460053,1325465613,2,2,5560
59390981@N04,7401,31,1329047113,1329047113,1,4,0
59390981@N04,7401,23,1329044754,1329044754,1,4,0
59390981@N04,7401,18,1329045356,1329048764,2,4,3408
59390981@N04,7401,20,1329045625,1329047196,4,4,1571
59391018@N07,7402,18,1449530884,1449530884,1,1,0
59392555@N00,7403,8,1194748393,1194773357,21,1,24964
59392555@N00,7404,31,1243160772,1243160772,1,2,0
59392555@N00,7404,8,1243149850,1243174805,16,2,24955
59392555@N00,7405,31,1243213690,1243213855,4,1,165
59392555@N00,7406,31,1273576122,1273582301,9,1,6179
59392555@N00,7407,31,1273627305,1273661303,36,1,33998
59457417@N00,7408,26,1297571918,1297577417,5,2,5499
59457417@N00,7408,28,1297571710,1297571723,2,2,13
59457417@N00,7409,28,1297678199,1297678498,4,1,299
59457417@N00,7410,15,1387340064,1387340481,6,4,417
59457417@N00,7410,28,1387339332,1387365170,2,4,25838
59457417@N00,7410,26,1387365892,1387365892,1,4,0
59457417@N00,7410,27,1387339608,1387339608,1,4,0
59479001@N06,7411,28,1360408115,1360408115,1,1,0
59479001@N06,7412,7,1360565671,1360565671,1,1,0
59487718@N00,7413,27,1258872919,1258872919,1,3,0
59487718@N00,7413,16,1258872325,1258872325,1,3,0
59487718@N00,7413,26,1258871552,1258871552,1,3,0
59504839@N06,7414,26,1353504518,1353504518,1,1,0
59508646@N03,7415,26,1324842950,1324842950,1,1,0
59525461@N00,7416,28,1283680754,1283682166,7,1,1412
59538487@N00,7417,28,1207105059,1207111312,6,1,6253
59538487@N00,7418,30,1325381826,1325381826,1,1,0
59538487@N00,7419,14,1327721131,1327721409,3,2,278
59538487@N00,7419,20,1327729349,1327729349,1,2,0
59538487@N00,7420,16,1329694457,1329694600,4,2,143
59538487@N00,7420,15,1329698785,1329699257,4,2,472
59538487@N00,7421,20,1349563988,1349563988,1,6,0
59538487@N00,7421,29,1349564820,1349569318,24,6,4498
59538487@N00,7421,1,1349562181,1349562426,4,6,245
59538487@N00,7421,26,1349562860,1349562860,1,6,0
59538487@N00,7421,24,1349582494,1349582494,1,6,0
59538487@N00,7421,30,1349577819,1349577820,2,6,1
59538487@N00,7422,16,1353400506,1353400506,1,1,0
59538487@N00,7423,20,1355035701,1355035716,2,4,15
59538487@N00,7423,31,1355035518,1355035518,1,4,0
59538487@N00,7423,26,1355028291,1355028291,1,4,0
59538487@N00,7423,16,1355028340,1355028709,3,4,369
59538487@N00,7424,26,1355122058,1355122058,1,1,0
59538487@N00,7425,20,1355306704,1355306704,1,1,0
59538487@N00,7426,20,1365426514,1365426514,1,1,0
59538487@N00,7427,28,1365482690,1365482690,1,1,0
59538487@N00,7428,28,1368930915,1368930915,1,1,0
59538487@N00,7429,29,1369614091,1369614091,1,3,0
59538487@N00,7429,1,1369613548,1369613548,1,3,0
59538487@N00,7429,25,1369619795,1369619795,1,3,0
59538487@N00,7430,14,1373763436,1373763436,1,1,0
59538487@N00,7431,26,1373809197,1373809197,1,1,0
59538487@N00,7432,28,1374388019,1374388019,1,2,0
59538487@N00,7432,14,1374372897,1374372897,1,2,0
59538487@N00,7433,28,1374459586,1374459586,1,1,0
59538487@N00,7434,14,1374991046,1374991046,1,2,0
59538487@N00,7434,4,1374968834,1374968834,1,2,0
59538487@N00,7435,28,1376178653,1376178653,1,1,0
59538487@N00,7436,29,1381734246,1381734246,1,1,0
59538487@N00,7437,26,1385766800,1385766843,2,6,43
59538487@N00,7437,28,1385763953,1385766220,7,6,2267
59538487@N00,7437,15,1385774059,1385779515,8,6,5456
59538487@N00,7437,25,1385779266,1385809817,7,6,30551
59538487@N00,7437,29,1385788846,1385788872,4,6,26
59538487@N00,7437,1,1385764585,1385765704,23,6,1119
59538487@N00,7438,25,1385858071,1385858071,1,1,0
59538487@N00,7439,19,1386983283,1386983283,1,1,0
59538487@N00,7440,28,1389417937,1389417937,1,2,0
59538487@N00,7440,29,1389408514,1389408514,1,2,0
59538487@N00,7441,14,1394242174,1394242174,1,1,0
59538487@N00,7442,10,1396754523,1396754532,4,8,9
59538487@N00,7442,15,1396759016,1396760576,30,8,1560
59538487@N00,7442,22,1396751303,1396751316,2,8,13
59538487@N00,7442,14,1396750242,1396751757,25,8,1515
59538487@N00,7442,31,1396751521,1396751540,3,8,19
59538487@N00,7442,26,1396742927,1396742927,1,8,0
59538487@N00,7442,28,1396743060,1396743060,1,8,0
59538487@N00,7442,30,1396754599,1396755891,3,8,1292
59538487@N00,7443,31,1400375829,1400377603,8,6,1774
59538487@N00,7443,22,1400374957,1400379688,6,6,4731
59538487@N00,7443,30,1400376482,1400392542,5,6,16060
59538487@N00,7443,15,1400388741,1400388913,15,6,172
59538487@N00,7443,29,1400376073,1400378457,3,6,2384
59538487@N00,7443,1,1400372181,1400372214,3,6,33
59538487@N00,7444,22,1405846117,1405846205,9,8,88
59538487@N00,7444,14,1405846116,1405846739,2,8,623
59538487@N00,7444,27,1405853433,1405853435,3,8,2
59538487@N00,7444,28,1405831215,1405831749,16,8,534
59538487@N00,7444,16,1405849679,1405849681,3,8,2
59538487@N00,7444,19,1405840072,1405841215,11,8,1143
59538487@N00,7444,23,1405840924,1405840924,1,8,0
59538487@N00,7444,29,1405832869,1405832877,2,8,8
59538487@N00,7445,30,1412482458,1412482458,1,2,0
59538487@N00,7445,19,1412492793,1412492793,1,2,0
59538487@N00,7446,17,1417507082,1417513737,6,8,6655
59538487@N00,7446,28,1417500549,1417514478,5,8,13929
59538487@N00,7446,27,1417506915,1417507524,2,8,609
59538487@N00,7446,20,1417504055,1417504055,1,8,0
59538487@N00,7446,21,1417510120,1417510320,3,8,200
59538487@N00,7446,16,1417514377,1417514377,2,8,0
59538487@N00,7446,25,1417510390,1417511722,12,8,1332
59538487@N00,7446,26,1417506533,1417506727,7,8,194
59565042@N08,7447,26,1421485092,1421485092,1,1,0
59572566@N07,7448,1,1404396000,1404396000,1,1,0
59572566@N07,7449,1,1404477982,1404482400,4,1,4418
59572566@N07,7450,1,1404515914,1404559974,6,1,44060
59572566@N07,7451,1,1419989445,1420030551,16,1,41106
59572566@N07,7452,1,1420275270,1420275270,1,1,0
59609425@N08,7453,26,1293539584,1293539584,1,1,0
59642062@N00,7454,14,1355633534,1355634387,2,5,853
59642062@N00,7454,26,1355639878,1355639898,4,5,20
59642062@N00,7454,13,1355642066,1355642764,3,5,698
59642062@N00,7454,31,1355633259,1355633259,1,5,0
59642062@N00,7454,22,1355630219,1355632184,4,5,1965
59642062@N00,7455,14,1357433102,1357433102,1,2,0
59642062@N00,7455,3,1357446411,1357446411,1,2,0
59646076@N00,7456,17,1235353469,1235353469,1,1,0
59646076@N00,7457,22,1238346109,1238346109,1,2,0
59646076@N00,7457,28,1238336397,1238336423,2,2,26
59646076@N00,7458,26,1238994672,1239050940,26,1,56268
59646076@N00,7459,26,1239139859,1239145196,9,2,5337
59646076@N00,7459,29,1239146948,1239153589,4,2,6641
59646076@N00,7460,22,1244547399,1244549721,6,1,2322
59646076@N00,7461,28,1244757828,1244770093,4,1,12265
59646076@N00,7462,28,1244808782,1244809462,2,1,680
59646076@N00,7463,28,1244870823,1244901402,9,1,30579
59646076@N00,7464,6,1244942266,1244986435,16,3,44169
59646076@N00,7464,28,1244940749,1244940749,1,3,0
59646076@N00,7464,13,1244988676,1245015227,19,3,26551
59646076@N00,7465,6,1245059760,1245059760,1,2,0
59646076@N00,7465,22,1245058767,1245058767,1,2,0
59646076@N00,7466,29,1245097462,1245098667,2,1,1205
59646076@N00,7467,29,1245150072,1245152354,7,1,2282
59646076@N00,7468,17,1245202707,1245202707,1,1,0
59646076@N00,7469,17,1245271152,1245271395,2,1,243
59646076@N00,7470,17,1245358181,1245358181,1,1,0
59646076@N00,7471,17,1245415008,1245443699,3,1,28691
59646076@N00,7472,17,1245494403,1245496991,6,1,2588
59646076@N00,7473,13,1245526753,1245530341,8,1,3588
59646076@N00,7474,13,1245579749,1245579749,1,2,0
59646076@N00,7474,28,1245580975,1245580975,1,2,0
59698703@N05,7475,26,1466226621,1466226621,1,1,0
59710020@N03,7476,1,1425868461,1425868461,1,1,0
59735909@N00,7477,1,1350083254,1350092454,5,1,9200
59742495@N00,7478,28,1197722945,1197722945,1,2,0
59742495@N00,7478,26,1197723218,1197723218,1,2,0
59742495@N00,7479,28,1198738897,1198738897,1,1,0
59742495@N00,7480,28,1206331793,1206350792,2,1,18999
59742495@N00,7481,29,1212919409,1212919409,1,3,0
59742495@N00,7481,23,1212914479,1212914479,1,3,0
59742495@N00,7481,1,1212910213,1212910213,1,3,0
59742495@N00,7482,30,1213008910,1213008910,1,1,0
59753021@N00,7483,18,1226360417,1226360417,1,1,0
59753021@N00,7484,26,1228286086,1228286086,1,1,0
59753021@N00,7485,12,1245734199,1245735109,2,5,910
59753021@N00,7485,18,1245737943,1245737943,1,5,0
59753021@N00,7485,17,1245757350,1245757350,1,5,0
59753021@N00,7485,11,1245735973,1245736055,2,5,82
59753021@N00,7485,30,1245751983,1245753230,2,5,1247
59753021@N00,7486,18,1254205925,1254205925,1,1,0
59753021@N00,7487,18,1314502476,1314502476,1,4,0
59753021@N00,7487,25,1314502418,1314502418,1,4,0
59753021@N00,7487,11,1314502497,1314502518,2,4,21
59753021@N00,7487,30,1314502537,1314502591,4,4,54
59753021@N00,7488,26,1362067327,1362067327,1,1,0
59753021@N00,7489,26,1457416711,1457416711,1,4,0
59753021@N00,7489,16,1457413655,1457413655,1,4,0
59753021@N00,7489,27,1457414064,1457414064,1,4,0
59753021@N00,7489,30,1457410637,1457410637,1,4,0
59753021@N00,7490,23,1461368985,1461368985,1,1,0
59888866@N00,7491,29,1192178091,1192179725,2,1,1634
59888866@N00,7492,26,1235896384,1235900190,6,1,3806
59888866@N00,7493,29,1238361862,1238361862,1,1,0
59888866@N00,7494,3,1240306441,1240306441,1,4,0
59888866@N00,7494,21,1240304697,1240304764,2,4,67
59888866@N00,7494,28,1240306908,1240307064,2,4,156
59888866@N00,7494,29,1240298631,1240303152,4,4,4521
59888866@N00,7495,10,1274583007,1274589099,22,1,6092
59888866@N00,7496,20,1295064150,1295064150,1,1,0
59888866@N00,7497,10,1306550654,1306550654,1,6,0
59888866@N00,7497,15,1306561819,1306561819,1,6,0
59888866@N00,7497,30,1306551142,1306551142,1,6,0
59888866@N00,7497,7,1306572001,1306572001,1,6,0
59888866@N00,7497,28,1306547656,1306547656,1,6,0
59888866@N00,7497,29,1306554759,1306554847,2,6,88
59888866@N00,7498,26,1322827108,1322827108,1,1,0
59888866@N00,7499,27,1327150018,1327150018,1,1,0
59888866@N00,7500,5,1327382379,1327382379,1,1,0
59888866@N00,7501,28,1330537516,1330537516,1,2,0
59888866@N00,7501,3,1330533897,1330533897,1,2,0
59888866@N00,7502,31,1334210340,1334210340,1,1,0
59983818@N06,7503,28,1407340578,1407340578,1,1,0
60054626@N00,7504,26,1195549548,1195549548,1,1,0
60054626@N00,7505,26,1279933086,1279934089,6,1,1003
60143933@N02,7506,28,1353117888,1353117888,1,1,0
60312008@N00,7507,26,1204243869,1204278483,13,1,34614
60319488@N03,7508,28,1294052446,1294052446,1,4,0
60319488@N03,7508,26,1294052823,1294052823,1,4,0
60319488@N03,7508,23,1294055225,1294055336,2,4,111
60319488@N03,7508,13,1294053817,1294053817,1,4,0
60359963@N00,7509,15,1221641594,1221641594,1,1,0
60385541@N00,7510,28,1389687009,1389687009,1,8,0
60385541@N00,7510,26,1389678171,1389678387,2,8,216
60385541@N00,7510,17,1389672259,1389672259,1,8,0
60385541@N00,7510,27,1389673477,1389673477,1,8,0
60385541@N00,7510,16,1389674385,1389674385,1,8,0
60385541@N00,7510,3,1389679094,1389679125,2,8,31
60385541@N00,7510,1,1389676934,1389707640,3,8,30706
60385541@N00,7510,7,1389678598,1389678598,1,8,0
60385541@N00,7511,3,1389942656,1389942656,1,1,0
60385541@N00,7512,14,1409429194,1409432309,3,1,3115
60385541@N00,7513,29,1444008760,1444010296,3,9,1536
60385541@N00,7513,26,1443998850,1443998910,2,9,60
60385541@N00,7513,31,1444024916,1444024916,1,9,0
60385541@N00,7513,19,1444005670,1444005670,1,9,0
60385541@N00,7513,13,1443995301,1443995301,1,9,0
60385541@N00,7513,15,1444016976,1444016976,1,9,0
60385541@N00,7513,23,1444008132,1444028183,4,9,20051
60385541@N00,7513,1,1443993985,1443993985,1,9,0
60385541@N00,7513,20,1443999705,1444002293,5,9,2588
60448671@N07,7514,26,1307256592,1307274219,104,1,17627
60448671@N07,7515,31,1326852552,1326854863,8,2,2311
60448671@N07,7515,22,1326873112,1326874287,6,2,1175
60456299@N00,7516,12,1196754053,1196754053,1,1,0
60456299@N00,7517,28,1300001057,1300001057,1,1,0
60456299@N00,7518,16,1316766659,1316766659,1,2,0
60456299@N00,7518,13,1316766657,1316766657,1,2,0
60626506@N00,7519,8,1193719454,1193726973,3,1,7519
60657104@N00,7520,24,1458085007,1458085007,1,2,0
60657104@N00,7520,28,1458081546,1458087903,3,2,6357
60687534@N05,7521,28,1314194571,1314194571,1,1,0
60687534@N05,7522,28,1318508533,1318508533,1,1,0
60703488@N00,7523,5,1416797818,1416797831,2,10,13
60703488@N00,7523,6,1416797829,1416797829,1,10,0
60703488@N00,7523,20,1416789229,1416789237,5,10,8
60703488@N00,7523,26,1416794309,1416794708,21,10,399
60703488@N00,7523,9,1416796798,1416796799,2,10,1
60703488@N00,7523,31,1416793336,1416793801,7,10,465
60703488@N00,7523,1,1416784236,1416810600,39,10,26364
60703488@N00,7523,8,1416797705,1416797935,3,10,230
60703488@N00,7523,4,1416797711,1416808625,13,10,10914
60703488@N00,7523,7,1416797840,1416797840,1,10,0
60703488@N00,7524,6,1416917505,1416917505,1,8,0
60703488@N00,7524,26,1416906599,1416925511,42,8,18912
60703488@N00,7524,31,1416912399,1416912401,2,8,2
60703488@N00,7524,1,1416906110,1416922966,8,8,16856
60703488@N00,7524,28,1416906154,1416918005,7,8,11851
60703488@N00,7524,4,1416922950,1416922950,1,8,0
60703488@N00,7524,7,1416917483,1416917483,1,8,0
60703488@N00,7524,14,1416909231,1416911828,2,8,2597
60703488@N00,7525,15,1416976133,1416976141,5,3,8
60703488@N00,7525,1,1416967130,1416967130,1,3,0
60703488@N00,7525,16,1416967133,1416976157,18,3,9024
60703488@N00,7526,16,1417008528,1417009641,2,1,1113
60703488@N00,7527,30,1417265170,1417265170,1,4,0
60703488@N00,7527,25,1417261857,1417276799,10,4,14942
60703488@N00,7527,12,1417263857,1417263857,1,4,0
60703488@N00,7527,16,1417265780,1417269501,13,4,3721
60703488@N00,7528,16,1417312580,1417312580,1,1,0
60703488@N00,7529,25,1417644436,1417644436,1,1,0
60703488@N00,7530,1,1418257079,1418257079,1,1,0
60705682@N04,7531,26,1342073104,1342073104,1,1,0
60744963@N02,7532,28,1293442476,1293442476,1,1,0
60744963@N02,7533,15,1293575101,1293575101,1,1,0
60744963@N02,7534,28,1295247712,1295247722,2,5,10
60744963@N02,7534,24,1295253452,1295253452,1,5,0
60744963@N02,7534,15,1295253463,1295253463,1,5,0
60744963@N02,7534,1,1295257026,1295257026,1,5,0
60744963@N02,7534,26,1295253716,1295253716,1,5,0
60744963@N02,7535,25,1296116571,1296116571,1,1,0
60744963@N02,7536,29,1298725766,1298725766,1,8,0
60744963@N02,7536,18,1298726470,1298726470,1,8,0
60744963@N02,7536,30,1298725824,1298725824,1,8,0
60744963@N02,7536,31,1298716104,1298716149,2,8,45
60744963@N02,7536,16,1298726196,1298726196,1,8,0
60744963@N02,7536,1,1298727567,1298727643,3,8,76
60744963@N02,7536,28,1298726338,1298727703,30,8,1365
60744963@N02,7536,26,1298726025,1298726037,2,8,12
60744963@N02,7537,25,1299840881,1299841739,49,1,858
60744963@N02,7538,31,1300009810,1300009810,1,1,0
60744963@N02,7539,29,1300450544,1300450570,3,4,26
60744963@N02,7539,31,1300450822,1300451162,3,4,340
60744963@N02,7539,16,1300447031,1300447437,6,4,406
60744963@N02,7539,26,1300446952,1300449635,4,4,2683
60744963@N02,7540,28,1302359438,1302359438,1,2,0
60744963@N02,7540,1,1302360370,1302360370,1,2,0
60744963@N02,7541,28,1302965103,1302965103,1,1,0
60781728@N00,7542,17,1439636110,1439636110,1,2,0
60781728@N00,7542,22,1439610046,1439610046,1,2,0
60792472@N00,7543,11,1357163453,1357163453,1,6,0
60792472@N00,7543,13,1357174300,1357174300,1,6,0
60792472@N00,7543,4,1357163461,1357163461,1,6,0
60792472@N00,7543,26,1357162899,1357162904,2,6,5
60792472@N00,7543,3,1357167037,1357167037,1,6,0
60792472@N00,7543,21,1357170294,1357170518,3,6,224
60805142@N00,7544,18,1454041258,1454041354,2,1,96
60861613@N00,7545,25,1443766996,1443768180,26,11,1184
60861613@N00,7545,3,1443766875,1443770503,3,11,3628
60861613@N00,7545,24,1443759850,1443759968,4,11,118
60861613@N00,7545,27,1443755930,1443765078,2,11,9148
60861613@N00,7545,12,1443766726,1443766726,1,11,0
60861613@N00,7545,21,1443766836,1443766836,1,11,0
60861613@N00,7545,5,1443766786,1443770585,2,11,3799
60861613@N00,7545,1,1443753340,1443754217,4,11,877
60861613@N00,7545,30,1443771273,1443771317,3,11,44
60861613@N00,7545,28,1443772596,1443772596,1,11,0
60861613@N00,7545,15,1443755462,1443761767,5,11,6305
60861613@N00,7546,29,1443858520,1443858520,1,9,0
60861613@N00,7546,10,1443859504,1443859504,1,9,0
60861613@N00,7546,26,1443848575,1443848771,2,9,196
60861613@N00,7546,16,1443847386,1443847607,2,9,221
60861613@N00,7546,30,1443859332,1443859332,1,9,0
60861613@N00,7546,31,1443854727,1443859022,4,9,4295
60861613@N00,7546,22,1443858783,1443858783,1,9,0
60861613@N00,7546,1,1443842896,1443844224,7,9,1328
60861613@N00,7546,20,1443854798,1443854991,4,9,193
60867422@N07,7547,22,1330178007,1330178007,1,1,0
60867422@N07,7548,30,1367330400,1367330400,2,1,0
60867422@N07,7549,29,1388124972,1388124972,1,1,0
61023397@N08,7550,1,1371346671,1371346671,1,1,0
61024390@N00,7551,26,1470956235,1470957824,6,1,1589
61026350@N06,7552,26,1390805157,1390805157,1,1,0
61027211@N00,7553,26,1305779178,1305779178,1,1,0
61055387@N00,7554,26,1223090657,1223106296,2,1,15639
61081616@N04,7555,26,1284806600,1284806600,1,1,0
61102903@N02,7556,28,1376234268,1376234268,1,5,0
61102903@N02,7556,7,1376234257,1376234257,1,5,0
61102903@N02,7556,26,1376234153,1376234189,2,5,36
61102903@N02,7556,16,1376234178,1376234178,1,5,0
61102903@N02,7556,1,1376234134,1376234134,1,5,0
61102903@N02,7557,23,1454629219,1454629219,1,1,0
61102903@N02,7558,26,1454712997,1454712997,1,1,0
61153157@N00,7559,29,1364377465,1364377465,1,1,0
61198674@N00,7560,17,1262904035,1262904035,1,1,0
61207928@N04,7561,1,1307861804,1307861804,1,1,0
61207928@N04,7562,10,1309225704,1309225704,1,1,0
61207928@N04,7563,17,1309268354,1309268354,1,1,0
61207928@N04,7564,12,1309507700,1309507700,1,1,0
61207928@N04,7565,25,1309696262,1309696262,1,2,0
61207928@N04,7565,4,1309695924,1309695924,1,2,0
61207928@N04,7566,18,1309949377,1309949377,1,1,0
61207928@N04,7567,10,1312020217,1312020217,1,1,0
61207928@N04,7568,26,1354192796,1354192796,1,1,0
61207928@N04,7569,4,1354241884,1354241884,1,2,0
61207928@N04,7569,21,1354248478,1354248478,1,2,0
61207928@N04,7570,10,1404454293,1404454293,1,1,0
61207928@N04,7571,10,1404572640,1404573653,2,1,1013
61228464@N03,7572,1,1381108507,1381108847,2,1,340
61228464@N03,7573,1,1381181285,1381181377,2,1,92
61228464@N03,7574,1,1395337662,1395337662,1,1,0
61228464@N03,7575,1,1395428517,1395453470,3,1,24953
61237118@N00,7576,23,1317379143,1317379143,1,1,0
61242806@N00,7577,14,1320738016,1320738016,1,1,0
61258745@N03,7578,30,1273285356,1273285356,1,2,0
61258745@N03,7578,22,1273287102,1273287102,1,2,0
61258745@N03,7579,25,1273989490,1273989490,1,1,0
61258745@N03,7580,23,1274330901,1274330901,1,1,0
61258745@N03,7581,18,1274489937,1274489937,1,1,0
61258745@N03,7582,26,1275194692,1275194692,1,1,0
61258745@N03,7583,11,1275223902,1275223902,1,1,0
61258745@N03,7584,26,1276321819,1276322276,2,3,457
61258745@N03,7584,3,1276325661,1276325661,1,3,0
61258745@N03,7584,28,1276319531,1276319531,1,3,0
61258745@N03,7585,18,1276958558,1276958558,1,1,0
61258745@N03,7586,20,1277427353,1277427353,1,1,0
61258745@N03,7587,26,1277475840,1277475840,1,1,0
61258745@N03,7588,17,1277981920,1277981920,1,1,0
61258745@N03,7589,28,1279334667,1279334667,1,1,0
61258745@N03,7590,20,1279439553,1279439553,1,5,0
61258745@N03,7590,29,1279438563,1279438563,1,5,0
61258745@N03,7590,19,1279425336,1279430198,3,5,4862
61258745@N03,7590,28,1279422657,1279422657,1,5,0
61258745@N03,7590,18,1279437663,1279437663,1,5,0
61258745@N03,7591,22,1280123832,1280123832,1,2,0
61258745@N03,7591,31,1280123151,1280123151,1,2,0
61258745@N03,7592,29,1281751819,1281751819,1,1,0
61258745@N03,7593,12,1282438239,1282438239,1,1,0
61258745@N03,7594,12,1284195439,1284195439,1,2,0
61258745@N03,7594,18,1284193416,1284193416,1,2,0
61258745@N03,7595,28,1284762967,1284762967,1,2,0
61258745@N03,7595,14,1284766599,1284766599,1,2,0
61258745@N03,7596,1,1284797212,1284797212,1,1,0
61258745@N03,7597,29,1285723302,1285723302,1,2,0
61258745@N03,7597,17,1285726287,1285726287,1,2,0
61258745@N03,7598,30,1286630128,1286630128,1,4,0
61258745@N03,7598,29,1286629647,1286629647,1,4,0
61258745@N03,7598,31,1286628723,1286628723,1,4,0
61258745@N03,7598,1,1286605782,1286605782,1,4,0
61258745@N03,7599,26,1289044237,1289044237,1,2,0
61258745@N03,7599,3,1289044085,1289044085,1,2,0
61258745@N03,7600,29,1289652145,1289652548,2,4,403
61258745@N03,7600,28,1289613877,1289614283,2,4,406
61258745@N03,7600,20,1289619743,1289619743,1,4,0
61258745@N03,7600,1,1289637403,1289637403,1,4,0
61258745@N03,7601,25,1289980744,1289980744,1,3,0
61258745@N03,7601,29,1289986338,1289987866,2,3,1528
61258745@N03,7601,20,1289988191,1289988210,2,3,19
61258745@N03,7602,26,1291555177,1291555177,1,4,0
61258745@N03,7602,13,1291531433,1291531433,1,4,0
61258745@N03,7602,29,1291551232,1291551232,1,4,0
61258745@N03,7602,28,1291556260,1291556260,1,4,0
61258745@N03,7603,26,1291796672,1291796672,1,1,0
61258745@N03,7604,26,1295675399,1295675399,1,4,0
61258745@N03,7604,29,1295673684,1295673684,1,4,0
61258745@N03,7604,28,1295657287,1295657287,1,4,0
61258745@N03,7604,8,1295661546,1295661546,1,4,0
61258745@N03,7605,26,1296273064,1296273064,1,3,0
61258745@N03,7605,20,1296299438,1296302503,3,3,3065
61258745@N03,7605,18,1296274318,1296274318,1,3,0
61258745@N03,7606,4,1298251467,1298251467,1,6,0
61258745@N03,7606,28,1298240825,1298273768,2,6,32943
61258745@N03,7606,24,1298244895,1298248656,3,6,3761
61258745@N03,7606,27,1298247347,1298247347,1,6,0
61258745@N03,7606,1,1298243642,1298243642,1,6,0
61258745@N03,7606,12,1298245403,1298250229,2,6,4826
61258745@N03,7607,26,1298706236,1298706332,2,4,96
61258745@N03,7607,30,1298716527,1298716527,1,4,0
61258745@N03,7607,28,1298702045,1298731849,3,4,29804
61258745@N03,7607,18,1298710545,1298710545,1,4,0
61258745@N03,7608,29,1300144307,1300151215,6,2,6908
61258745@N03,7608,23,1300173482,1300173482,1,2,0
61258745@N03,7609,7,1301118450,1301118450,1,3,0
61258745@N03,7609,19,1301117506,1301117638,2,3,132
61258745@N03,7609,10,1301121475,1301121475,1,3,0
61258745@N03,7610,26,1302331446,1302341047,3,3,9601
61258745@N03,7610,18,1302337538,1302337538,1,3,0
61258745@N03,7610,15,1302336146,1302336146,1,3,0
61258745@N03,7611,22,1303032866,1303034907,2,4,2041
61258745@N03,7611,18,1303038017,1303038017,1,4,0
61258745@N03,7611,20,1303018831,1303038479,3,4,19648
61258745@N03,7611,23,1303039162,1303042556,2,4,3394
61258745@N03,7612,27,1305359615,1305359615,1,1,0
61258745@N03,7613,1,1305987107,1305987107,1,2,0
61258745@N03,7613,27,1305984229,1305986912,2,2,2683
61258745@N03,7614,26,1306742136,1306742136,1,1,0
61258745@N03,7615,28,1306987207,1306987207,1,10,0
61258745@N03,7615,26,1306987216,1306987243,2,10,27
61258745@N03,7615,16,1306987297,1306987297,1,10,0
61258745@N03,7615,22,1306987302,1306987302,1,10,0
61258745@N03,7615,1,1306987246,1306987246,1,10,0
61258745@N03,7615,5,1306987276,1306987276,1,10,0
61258745@N03,7615,13,1306987235,1306987235,1,10,0
61258745@N03,7615,25,1306987191,1306987191,1,10,0
61258745@N03,7615,30,1306987222,1306987229,2,10,7
61258745@N03,7615,29,1306987119,1306987263,2,10,144
61258745@N03,7616,12,1311487821,1311487821,1,1,0
61258745@N03,7617,26,1316241239,1316241239,1,1,0
61258745@N03,7618,21,1316848308,1316848308,1,1,0
61261095@N02,7619,20,1330843672,1330845157,2,6,1485
61261095@N02,7619,26,1330842956,1330852719,3,6,9763
61261095@N02,7619,18,1330850976,1330851684,4,6,708
61261095@N02,7619,25,1330857683,1330858715,2,6,1032
61261095@N02,7619,30,1330874433,1330875091,2,6,658
61261095@N02,7619,29,1330843398,1330843398,1,6,0
61261095@N02,7620,13,1330928542,1330928542,1,9,0
61261095@N02,7620,29,1330928070,1330928070,1,9,0
61261095@N02,7620,20,1330927313,1330927313,1,9,0
61261095@N02,7620,23,1330926820,1330926820,1,9,0
61261095@N02,7620,30,1330924964,1330924964,1,9,0
61261095@N02,7620,10,1330922881,1330923851,2,9,970
61261095@N02,7620,21,1330932793,1330932793,1,9,0
61261095@N02,7620,26,1330933486,1330933995,2,9,509
61261095@N02,7620,11,1330932883,1330932883,1,9,0
61261095@N02,7621,8,1331005254,1331005254,1,6,0
61261095@N02,7621,22,1331012080,1331018328,3,6,6248
61261095@N02,7621,30,1331017560,1331017560,1,6,0
61261095@N02,7621,11,1331008073,1331008073,1,6,0
61261095@N02,7621,31,1331012046,1331017745,3,6,5699
61261095@N02,7621,26,1331009481,1331009796,3,6,315
61261095@N02,7622,30,1331112431,1331112431,1,4,0
61261095@N02,7622,26,1331105553,1331105553,1,4,0
61261095@N02,7622,19,1331117369,1331117429,2,4,60
61261095@N02,7622,14,1331115205,1331115205,1,4,0
61282509@N08,7623,20,1277344803,1277344803,1,1,0
61357107@N05,7624,26,1337699471,1337699471,1,1,0
61363312@N00,7625,20,1387105305,1387105721,3,3,416
61363312@N00,7625,1,1387106439,1387106439,1,3,0
61363312@N00,7625,28,1387100802,1387101530,2,3,728
61363312@N00,7626,26,1387182380,1387193717,2,1,11337
61363312@N00,7627,18,1431817484,1431817484,1,1,0
61368956@N00,7628,17,1316062556,1316062574,2,2,18
61368956@N00,7628,1,1316062685,1316062685,1,2,0
61403949@N00,7629,26,1239792857,1239792857,1,2,0
61403949@N00,7629,29,1239794006,1239794006,1,2,0
61404390@N00,7630,29,1313623035,1313623035,1,2,0
61404390@N00,7630,25,1313629497,1313629497,1,2,0
61451953@N02,7631,28,1338284111,1338284111,1,1,0
61451953@N02,7632,28,1339666413,1339666413,1,1,0
61459002@N04,7633,1,1365857075,1365857075,1,1,0
61485851@N06,7634,28,1332166677,1332166677,1,2,0
61485851@N06,7634,26,1332156195,1332160735,3,2,4540
61510830@N02,7635,28,1333247017,1333247017,1,1,0
61511684@N00,7636,26,1258842324,1258842865,65,1,541
61517165@N00,7637,1,1354173420,1354173420,1,1,0
61601523@N00,7638,4,1450741248,1450743256,2,2,2008
61601523@N00,7638,26,1450739384,1450739384,1,2,0
61601523@N00,7639,28,1450787073,1450787073,1,2,0
61601523@N00,7639,26,1450784334,1450784334,1,2,0
61614489@N00,7640,17,1351503072,1351503072,1,1,0
61614489@N00,7641,20,1351656425,1351656425,1,1,0
61644290@N00,7642,26,1283763992,1283763992,1,1,0
61644290@N00,7643,20,1301195161,1301195161,1,1,0
61644290@N00,7644,28,1376264644,1376264665,2,1,21
61644290@N00,7645,1,1390362047,1390362047,1,1,0
61644290@N00,7646,1,1396790515,1396790515,1,2,0
61644290@N00,7646,25,1396790690,1396790690,1,2,0
61644290@N00,7647,19,1409551801,1409563246,2,1,11445
61702169@N02,7648,28,1357986142,1357986142,1,1,0
61716210@N07,7649,3,1287051534,1287051534,1,2,0
61716210@N07,7649,26,1287051843,1287051843,1,2,0
61761579@N00,7650,18,1428570634,1428580971,3,3,10337
61761579@N00,7650,23,1428565244,1428565244,1,3,0
61761579@N00,7650,19,1428541284,1428541284,1,3,0
61763311@N00,7651,19,1416904135,1416921225,12,3,17090
61763311@N00,7651,25,1416918700,1416920830,7,3,2130
61763311@N00,7651,29,1416916178,1416916178,1,3,0
61763311@N00,7652,19,1416950521,1416951299,4,1,778
61827589@N06,7653,29,1349769425,1349776639,5,2,7214
61827589@N06,7653,28,1349763743,1349764730,2,2,987
61827589@N06,7654,28,1353150329,1353150329,1,1,0
61827589@N06,7655,28,1356700499,1356700499,1,2,0
61827589@N06,7655,14,1356684280,1356684280,1,2,0
61827589@N06,7656,6,1377422623,1377422623,1,2,0
61827589@N06,7656,28,1377420399,1377420685,2,2,286
61827589@N06,7657,28,1378686360,1378686360,1,2,0
61827589@N06,7657,18,1378687516,1378687516,1,2,0
61838453@N08,7658,18,1449989630,1449989630,1,1,0
61905010@N03,7659,26,1409731849,1409731857,2,1,8
61906163@N00,7660,28,1293850183,1293864355,11,4,14172
61906163@N00,7660,30,1293847298,1293848697,9,4,1399
61906163@N00,7660,25,1293838850,1293839611,9,4,761
61906163@N00,7660,26,1293847140,1293848875,4,4,1735
61938758@N08,7661,1,1420364764,1420372542,6,1,7778
61938758@N08,7662,1,1420438868,1420438868,1,1,0
61938758@N08,7663,23,1420506891,1420506891,1,3,0
61938758@N08,7663,30,1420499068,1420499068,1,3,0
61938758@N08,7663,1,1420493217,1420538130,10,3,44913
61938758@N08,7664,1,1420588964,1420614652,5,1,25688
61938758@N08,7665,27,1420673068,1420673068,1,2,0
61938758@N08,7665,26,1420681702,1420681702,1,2,0
61943091@N00,7666,1,1405141105,1405141105,1,1,0
61967208@N07,7667,16,1307746758,1307746758,1,1,0
61971626@N00,7668,11,1291183492,1291183492,1,1,0
62001041@N08,7669,28,1342786700,1342787659,2,5,959
62001041@N08,7669,27,1342788876,1342788876,1,5,0
62001041@N08,7669,12,1342786933,1342786933,1,5,0
62001041@N08,7669,19,1342788897,1342788897,1,5,0
62001041@N08,7669,24,1342786668,1342786684,2,5,16
62086509@N00,7670,30,1375422385,1375422395,3,1,10
62102776@N02,7671,3,1299874900,1299874900,1,1,0
62102776@N02,7672,28,1331707731,1331707731,1,1,0
62102776@N02,7673,11,1331769437,1331769437,1,3,0
62102776@N02,7673,5,1331768971,1331768971,1,3,0
62102776@N02,7673,25,1331772366,1331772366,1,3,0
62102776@N02,7674,29,1344333603,1344333603,1,2,0
62102776@N02,7674,28,1344317117,1344321051,2,2,3934
62102776@N02,7675,20,1344403185,1344403185,1,2,0
62102776@N02,7675,25,1344421938,1344421938,1,2,0
62102776@N02,7676,17,1344471278,1344471278,1,4,0
62102776@N02,7676,26,1344505607,1344505607,1,4,0
62102776@N02,7676,20,1344473489,1344473489,1,4,0
62102776@N02,7676,14,1344479572,1344479572,1,4,0
62102776@N02,7677,29,1344581767,1344581767,1,2,0
62102776@N02,7677,18,1344599278,1344599278,1,2,0
62102776@N02,7678,8,1344662292,1344662292,1,1,0
62102776@N02,7679,29,1344741393,1344741393,1,1,0
62102776@N02,7680,28,1344824247,1344842203,2,1,17956
62102776@N02,7681,30,1345080917,1345080917,1,1,0
62102776@N02,7682,28,1345259368,1345259368,1,1,0
62102776@N02,7683,29,1345357490,1345357490,1,1,0
62102776@N02,7684,5,1345607016,1345607016,1,1,0
62102776@N02,7685,7,1345774162,1345774162,1,1,0
62102776@N02,7686,12,1346056561,1346056561,1,1,0
62102776@N02,7687,29,1346384747,1346384747,1,1,0
62102776@N02,7688,18,1346475354,1346475354,1,1,0
62102776@N02,7689,29,1346821865,1346821865,1,1,0
62102776@N02,7690,30,1347101072,1347101072,1,1,0
62102776@N02,7691,22,1362216377,1362216377,1,3,0
62102776@N02,7691,29,1362191208,1362191208,1,3,0
62102776@N02,7691,26,1362177896,1362177896,1,3,0
62102776@N02,7692,17,1362277690,1362277690,1,1,0
62102776@N02,7693,10,1362309624,1362309624,1,1,0
62102776@N02,7694,24,1362383090,1362383090,1,1,0
62102776@N02,7695,17,1362483485,1362483485,1,3,0
62102776@N02,7695,28,1362467988,1362467988,1,3,0
62102776@N02,7695,7,1362448353,1362448353,1,3,0
62111428@N06,7696,26,1280584800,1280584800,1,1,0
62121361@N03,7697,24,1313512071,1313512087,2,3,16
62121361@N03,7697,12,1313501875,1313501875,1,3,0
62121361@N03,7697,21,1313502136,1313502136,1,3,0
62121361@N03,7698,16,1316296820,1316296820,1,2,0
62121361@N03,7698,21,1316296060,1316296060,1,2,0
62121361@N03,7699,26,1321570599,1321570599,1,2,0
62121361@N03,7699,25,1321569057,1321569057,1,2,0
62121361@N03,7700,28,1323409156,1323428534,2,3,19378
62121361@N03,7700,24,1323424949,1323424949,1,3,0
62121361@N03,7700,26,1323408957,1323408957,1,3,0
62121361@N03,7701,6,1324012916,1324012916,1,5,0
62121361@N03,7701,28,1324021901,1324021901,1,5,0
62121361@N03,7701,24,1324010680,1324010680,1,5,0
62121361@N03,7701,26,1324008308,1324022781,2,5,14473
62121361@N03,7701,12,1324012275,1324012275,1,5,0
62121361@N03,7702,24,1325462172,1325492210,2,3,30038
62121361@N03,7702,30,1325464759,1325464759,1,3,0
62121361@N03,7702,12,1325462441,1325462441,1,3,0
62121361@N03,7703,21,1326184717,1326184717,1,7,0
62121361@N03,7703,24,1326172662,1326174008,4,7,1346
62121361@N03,7703,1,1326174728,1326174728,1,7,0
62121361@N03,7703,30,1326186765,1326186765,1,7,0
62121361@N03,7703,26,1326188109,1326188109,1,7,0
62121361@N03,7703,15,1326173379,1326173379,1,7,0
62121361@N03,7703,16,1326183186,1326183186,1,7,0
62121361@N03,7704,1,1326770461,1326770461,1,4,0
62121361@N03,7704,30,1326782657,1326782657,1,4,0
62121361@N03,7704,26,1326766446,1326779027,2,4,12581
62121361@N03,7704,15,1326771230,1326771230,1,4,0
62121361@N03,7705,30,1328335939,1328335939,1,1,0
62121361@N03,7706,29,1329644879,1329647108,4,1,2229
62121361@N03,7707,12,1329961984,1329962170,2,1,186
62121361@N03,7708,31,1330538424,1330538424,1,2,0
62121361@N03,7708,26,1330541437,1330542135,2,2,698
62121361@N03,7709,24,1332233667,1332234275,2,1,608
62121361@N03,7710,26,1332309135,1332312415,3,2,3280
62121361@N03,7710,21,1332310036,1332310954,3,2,918
62121361@N03,7711,24,1332396010,1332396010,1,1,0
62121361@N03,7712,26,1332752660,1332752660,4,3,0
62121361@N03,7712,29,1332756163,1332757252,2,3,1089
62121361@N03,7712,16,1332752660,1332752660,1,3,0
62121361@N03,7713,15,1333005341,1333007265,3,5,1924
62121361@N03,7713,13,1332993903,1332993903,1,5,0
62121361@N03,7713,30,1333010773,1333011587,4,5,814
62121361@N03,7713,12,1332985746,1332985746,1,5,0
62121361@N03,7713,21,1332986533,1332986533,1,5,0
62121361@N03,7714,26,1335350015,1335350015,1,1,0
62121361@N03,7715,26,1336634570,1336635261,3,4,691
62121361@N03,7715,1,1336633136,1336633136,1,4,0
62121361@N03,7715,12,1336634054,1336634054,1,4,0
62121361@N03,7715,24,1336633211,1336633211,1,4,0
62121361@N03,7716,20,1337608695,1337609388,2,2,693
62121361@N03,7716,29,1337609770,1337609770,1,2,0
62121361@N03,7717,26,1338963359,1338963359,1,3,0
62121361@N03,7717,12,1338961565,1338961565,1,3,0
62121361@N03,7717,21,1338961885,1338961885,1,3,0
62121361@N03,7718,24,1339128598,1339129901,2,1,1303
62121361@N03,7719,12,1339730292,1339730292,1,1,0
62121361@N03,7720,24,1340082096,1340083872,5,1,1776
62121361@N03,7721,21,1342002694,1342002694,1,1,0
62121361@N03,7722,24,1344250271,1344250271,1,1,0
62121361@N03,7723,24,1345004280,1345004619,3,2,339
62121361@N03,7723,1,1345003447,1345003447,1,2,0
62121361@N03,7724,21,1345809607,1345809607,1,1,0
62121361@N03,7725,26,1346422142,1346424372,2,1,2230
62121361@N03,7726,30,1349253910,1349253910,1,1,0
62121361@N03,7727,24,1350170701,1350170832,2,1,131
62121361@N03,7728,21,1354011963,1354011963,1,2,0
62121361@N03,7728,26,1354013146,1354013146,1,2,0
62121361@N03,7729,26,1358160104,1358160104,1,1,0
62121361@N03,7730,26,1386646666,1386646666,1,1,0
62208823@N00,7731,18,1366545122,1366545122,1,1,0
62208823@N00,7732,25,1366606111,1366606111,1,1,0
62213890@N00,7733,16,1229511309,1229511309,1,1,0
62222647@N00,7734,1,1403779954,1403779954,1,1,0
62236593@N04,7735,26,1364098202,1364098202,1,1,0
62236593@N04,7736,26,1393124383,1393124383,1,3,0
62236593@N04,7736,19,1393133108,1393133178,2,3,70
62236593@N04,7736,27,1393125650,1393125650,1,3,0
62236593@N04,7737,18,1440300885,1440300885,1,1,0
62236593@N04,7738,28,1440345318,1440345318,1,2,0
62236593@N04,7738,18,1440332026,1440332026,1,2,0
62236593@N04,7739,23,1440587111,1440587111,1,1,0
62245821@N04,7740,1,1354176685,1354176685,1,1,0
62297532@N00,7741,25,1355898681,1355898681,1,1,0
62297532@N00,7742,25,1356078818,1356078818,1,1,0
62323301@N08,7743,24,1304558876,1304558876,1,3,0
62323301@N08,7743,26,1304558996,1304558996,1,3,0
62323301@N08,7743,4,1304564331,1304564331,1,3,0
62323630@N06,7744,16,1304225718,1304225718,1,1,0
62372928@N03,7745,6,1399341583,1399341583,1,1,0
62392176@N00,7746,4,1227487542,1227487860,7,5,318
62392176@N00,7746,11,1227496366,1227498462,7,5,2096
62392176@N00,7746,7,1227485451,1227485522,2,5,71
62392176@N00,7746,26,1227484713,1227488333,5,5,3620
62392176@N00,7746,16,1227485164,1227485164,1,5,0
62392176@N00,7747,4,1227585164,1227585197,3,7,33
62392176@N00,7747,11,1227574950,1227574950,1,7,0
62392176@N00,7747,7,1227585593,1227585593,1,7,0
62392176@N00,7747,6,1227586155,1227586259,3,7,104
62392176@N00,7747,5,1227585849,1227585869,3,7,20
62392176@N00,7747,26,1227586466,1227603123,6,7,16657
62392176@N00,7747,28,1227569300,1227597864,2,7,28564
62392176@N00,7748,4,1227663049,1227663049,1,3,0
62392176@N00,7748,24,1227656660,1227657551,4,3,891
62392176@N00,7748,7,1227662542,1227662967,7,3,425
62392176@N00,7749,20,1227707716,1227708129,3,1,413
62392176@N00,7750,16,1227788688,1227789136,3,4,448
62392176@N00,7750,21,1227784935,1227786174,5,4,1239
62392176@N00,7750,1,1227790269,1227790269,1,4,0
62392176@N00,7750,25,1227784625,1227784702,2,4,77
62392176@N00,7751,13,1281051535,1281052116,4,10,581
62392176@N00,7751,16,1281064001,1281064608,2,10,607
62392176@N00,7751,21,1281054335,1281054335,1,10,0
62392176@N00,7751,31,1281070266,1281075547,4,10,5281
62392176@N00,7751,26,1281046684,1281046684,1,10,0
62392176@N00,7751,23,1281066131,1281066131,1,10,0
62392176@N00,7751,19,1281066788,1281066788,1,10,0
62392176@N00,7751,4,1281048170,1281048409,2,10,239
62392176@N00,7751,11,1281051035,1281054365,8,10,3330
62392176@N00,7751,29,1281072347,1281072595,3,10,248
62392176@N00,7752,16,1281137031,1281137147,3,1,116
62392176@N00,7753,28,1308970006,1308986775,4,1,16769
62392176@N00,7754,28,1309044509,1309084180,8,1,39671
62392176@N00,7755,28,1309129569,1309156591,22,1,27022
62392176@N00,7756,28,1309218197,1309253995,20,1,35798
62392176@N00,7757,1,1407831538,1407831539,4,2,1
62392176@N00,7757,12,1407832871,1407832871,3,2,0
62392176@N00,7758,25,1407923843,1407923847,4,3,4
62392176@N00,7758,30,1407916095,1407916096,3,3,1
62392176@N00,7758,8,1407925117,1407925117,2,3,0
62392176@N00,7759,22,1407981599,1407981666,4,5,67
62392176@N00,7759,27,1407977591,1407977591,1,5,0
62392176@N00,7759,31,1407981502,1407981502,1,5,0
62392176@N00,7759,17,1407975942,1407975942,1,5,0
62392176@N00,7759,7,1407969350,1407969350,1,5,0
62392176@N00,7760,5,1408101831,1408102035,3,2,204
62392176@N00,7760,3,1408101952,1408101955,2,2,3
62416932@N02,7761,28,1304923245,1304923245,1,1,0
62433076@N00,7762,20,1191280863,1191280877,2,12,14
62433076@N00,7762,26,1191263732,1191289576,3,12,25844
62433076@N00,7762,13,1191281665,1191281665,1,12,0
62433076@N00,7762,29,1191268250,1191275800,18,12,7550
62433076@N00,7762,30,1191282665,1191288267,16,12,5602
62433076@N00,7762,22,1191271897,1191281016,8,12,9119
62433076@N00,7762,18,1191264534,1191266502,28,12,1968
62433076@N00,7762,23,1191266645,1191266668,4,12,23
62433076@N00,7762,19,1191267139,1191268066,5,12,927
62433076@N00,7762,10,1191285414,1191285659,3,12,245
62433076@N00,7762,28,1191259623,1191259754,5,12,131
62433076@N00,7762,1,1191259464,1191259472,3,12,8
62433076@N00,7763,16,1191344021,1191344021,1,3,0
62433076@N00,7763,15,1191343403,1191347615,58,3,4212
62433076@N00,7763,27,1191345245,1191345277,3,3,32
62443344@N00,7764,28,1240580377,1240591291,2,1,10914
62443344@N00,7765,23,1256811377,1256811377,1,1,0
62443344@N00,7766,26,1259834249,1259834249,1,1,0
62443344@N00,7767,31,1265676670,1265683773,12,2,7103
62443344@N00,7767,26,1265676252,1265676386,2,2,134
62443344@N00,7768,10,1288148231,1288148832,3,6,601
62443344@N00,7768,17,1288153656,1288153656,1,6,0
62443344@N00,7768,23,1288159543,1288160041,6,6,498
62443344@N00,7768,20,1288149285,1288150292,10,6,1007
62443344@N00,7768,1,1288146829,1288146829,1,6,0
62443344@N00,7768,29,1288150699,1288150721,2,6,22
62443344@N00,7769,10,1298604163,1298604163,1,4,0
62443344@N00,7769,17,1298629273,1298629273,1,4,0
62443344@N00,7769,1,1298624479,1298625941,2,4,1462
62443344@N00,7769,30,1298604615,1298604615,1,4,0
62443344@N00,7770,30,1316765183,1316766652,2,7,1469
62443344@N00,7770,31,1316783131,1316783377,2,7,246
62443344@N00,7770,13,1316779905,1316779905,1,7,0
62443344@N00,7770,24,1316749262,1316784858,2,7,35596
62443344@N00,7770,27,1316748451,1316754757,2,7,6306
62443344@N00,7770,17,1316750436,1316750436,1,7,0
62443344@N00,7770,1,1316759421,1316764360,21,7,4939
62443344@N00,7771,29,1324347711,1324347711,1,5,0
62443344@N00,7771,28,1324340471,1324340471,1,5,0
62443344@N00,7771,26,1324340122,1324353777,9,5,13655
62443344@N00,7771,25,1324355803,1324356609,11,5,806
62443344@N00,7771,23,1324342561,1324346903,12,5,4342
62443344@N00,7772,29,1328675817,1328675817,1,4,0
62443344@N00,7772,30,1328675154,1328675171,2,4,17
62443344@N00,7772,27,1328667804,1328667804,1,4,0
62443344@N00,7772,22,1328673789,1328674048,2,4,259
62443344@N00,7773,28,1330487476,1330497134,5,11,9658
62443344@N00,7773,30,1330494254,1330494254,1,11,0
62443344@N00,7773,18,1330498645,1330498645,1,11,0
62443344@N00,7773,7,1330531390,1330531621,2,11,231
62443344@N00,7773,26,1330495467,1330540087,15,11,44620
62443344@N00,7773,25,1330537777,1330540002,12,11,2225
62443344@N00,7773,23,1330506750,1330535261,6,11,28511
62443344@N00,7773,27,1330518060,1330518060,1,11,0
62443344@N00,7773,17,1330536839,1330536853,2,11,14
62443344@N00,7773,22,1330514103,1330514103,1,11,0
62443344@N00,7773,20,1330489078,1330510487,3,11,21409
62443344@N00,7774,26,1331620930,1331639119,16,1,18189
62443344@N00,7775,23,1336954193,1336962649,15,1,8456
62443344@N00,7776,26,1350859899,1350898324,17,1,38425
62443344@N00,7777,23,1350931605,1350931605,1,2,0
62443344@N00,7777,20,1350928501,1350940931,45,2,12430
62443344@N00,7778,28,1350985218,1350988826,13,1,3608
62443344@N00,7779,6,1351153182,1351153182,1,2,0
62443344@N00,7779,16,1351151810,1351152095,2,2,285
62443344@N00,7780,28,1378775238,1378806414,20,1,31176
62443344@N00,7781,21,1444899585,1444899585,1,1,0
62460908@N07,7782,16,1305840108,1305840108,1,1,0
62460908@N07,7783,28,1329611692,1329611769,2,1,77
62460908@N07,7784,26,1342498530,1342498530,1,1,0
62460908@N07,7785,26,1357417339,1357417339,1,1,0
62460908@N07,7786,28,1357704860,1357704860,1,1,0
62460908@N07,7787,28,1358557637,1358557637,1,1,0
62460908@N07,7788,28,1358648902,1358648902,1,1,0
62460908@N07,7789,16,1360398054,1360398054,1,1,0
62460908@N07,7790,28,1361074458,1361074458,1,1,0
62460908@N07,7791,24,1361254354,1361254354,1,1,0
62460908@N07,7792,26,1361508286,1361508286,1,1,0
62460908@N07,7793,12,1361602052,1361602052,1,1,0
62460908@N07,7794,26,1361690568,1361690568,1,1,0
62460908@N07,7795,15,1362271950,1362271950,1,1,0
62460908@N07,7796,7,1362873634,1362873634,1,1,0
62460908@N07,7797,1,1364015120,1364015120,1,1,0
62460908@N07,7798,1,1364183486,1364183769,2,1,283
62460908@N07,7799,16,1364621425,1364621425,1,1,0
62460908@N07,7800,1,1364697163,1364697163,1,1,0
62460908@N07,7801,1,1365137386,1365137386,1,1,0
62460908@N07,7802,1,1366618645,1366618645,1,1,0
62460908@N07,7803,1,1366698862,1366698862,1,1,0
62460908@N07,7804,1,1366957881,1366957881,1,1,0
62460908@N07,7805,1,1367044121,1367044121,1,1,0
62460908@N07,7806,1,1367128499,1367128499,1,1,0
62460908@N07,7807,1,1367632033,1367649930,3,1,17897
62460908@N07,7808,5,1369545149,1369545149,1,1,0
62460908@N07,7809,1,1370578085,1370578085,1,1,0
62460908@N07,7810,26,1371861055,1371861055,1,2,0
62460908@N07,7810,1,1371880244,1371880244,1,2,0
62460908@N07,7811,1,1372900825,1372900825,1,1,0
62460908@N07,7812,12,1375081435,1375081435,1,1,0
62460908@N07,7813,1,1377390223,1377390223,1,1,0
62460908@N07,7814,30,1377830627,1377830627,1,1,0
62460908@N07,7815,1,1378263060,1378263060,1,1,0
62460908@N07,7816,1,1379818578,1379818578,1,1,0
62460908@N07,7817,25,1380259599,1380259599,1,1,0
62460908@N07,7818,1,1382234129,1382234129,1,1,0
62460908@N07,7819,20,1382414716,1382414716,1,1,0
62460908@N07,7820,1,1382768170,1382768170,1,1,0
62460908@N07,7821,1,1382830765,1382851325,2,1,20560
62460908@N07,7822,1,1382944604,1382944604,1,1,0
62460908@N07,7823,1,1383096453,1383096453,1,1,0
62460908@N07,7824,1,1383208286,1383208286,1,1,0
62460908@N07,7825,12,1383528909,1383528909,1,1,0
62460908@N07,7826,1,1384562248,1384562248,1,1,0
62460908@N07,7827,26,1384672282,1384672282,1,1,0
62460908@N07,7828,26,1385239437,1385239437,1,1,0
62460908@N07,7829,4,1386464190,1386464190,1,1,0
62460908@N07,7830,1,1388200534,1388200534,1,1,0
62460908@N07,7831,1,1388281233,1388281233,1,1,0
62460908@N07,7832,26,1389489807,1389489807,1,1,0
62460908@N07,7833,1,1394934608,1394934608,1,1,0
62460908@N07,7834,1,1395988853,1395988853,1,1,0
62460908@N07,7835,1,1400719229,1400719229,1,1,0
62460908@N07,7836,26,1401497851,1401497851,1,1,0
62460908@N07,7837,19,1403260573,1403260573,1,1,0
62460908@N07,7838,20,1407549721,1407549721,1,1,0
62460908@N07,7839,26,1410066724,1410066724,1,1,0
62460908@N07,7840,19,1411208863,1411208863,1,1,0
62460908@N07,7841,26,1413598906,1413598906,1,1,0
62460908@N07,7842,19,1413771078,1413771078,1,1,0
62460908@N07,7843,19,1415339691,1415339691,1,1,0
62460908@N07,7844,19,1419653714,1419653714,1,1,0
62552018@N06,7845,8,1371772381,1371772381,1,1,0
62552018@N06,7846,20,1379056043,1379056043,1,1,0
62552018@N06,7847,26,1381227909,1381227909,1,1,0
62552018@N06,7848,1,1395880443,1395880443,1,1,0
62552018@N06,7849,13,1395913689,1395913689,1,1,0
62566148@N00,7850,30,1344244227,1344245283,2,1,1056
62566148@N00,7851,30,1344330991,1344371914,7,1,40923
62566148@N00,7852,30,1344450078,1344450078,1,1,0
62566148@N00,7853,30,1344507015,1344517403,3,1,10388
62566937@N00,7854,15,1392520258,1392520258,1,9,0
62566937@N00,7854,30,1392509250,1392509250,1,9,0
62566937@N00,7854,24,1392518648,1392518648,1,9,0
62566937@N00,7854,21,1392515795,1392516225,2,9,430
62566937@N00,7854,26,1392502817,1392502817,2,9,0
62566937@N00,7854,16,1392529906,1392529906,1,9,0
62566937@N00,7854,5,1392515993,1392516029,2,9,36
62566937@N00,7854,4,1392515476,1392515476,1,9,0
62566937@N00,7854,28,1392529908,1392529908,1,9,0
62583568@N00,7855,13,1317457439,1317457439,1,1,0
62632667@N04,7856,18,1349417776,1349417776,1,1,0
62632667@N04,7857,29,1383450676,1383460238,2,1,9562
62647068@N00,7858,23,1212310635,1212310742,6,2,107
62647068@N00,7858,26,1212310364,1212310364,1,2,0
62783804@N05,7859,29,1286332165,1286342722,3,3,10557
62783804@N05,7859,30,1286338375,1286338538,2,3,163
62783804@N05,7859,28,1286328952,1286328952,1,3,0
62783804@N05,7860,21,1305651667,1305651667,1,1,0
62783804@N05,7861,29,1308025163,1308025163,1,1,0
62783804@N05,7862,29,1308300095,1308300095,1,1,0
62783804@N05,7863,1,1309248887,1309248887,1,1,0
62783804@N05,7864,10,1311650844,1311650844,1,1,0
62783804@N05,7865,26,1311833282,1311833282,1,1,0
62783804@N05,7866,20,1312891933,1312891933,1,1,0
62783804@N05,7867,16,1313722223,1313723542,2,1,1319
62783804@N05,7868,20,1316669680,1316669680,1,1,0
62783804@N05,7869,30,1317446270,1317446270,1,1,0
62783804@N05,7870,1,1317789851,1317789851,1,1,0
62783804@N05,7871,6,1322810659,1322810659,1,1,0
62783804@N05,7872,8,1324173926,1324173926,1,1,0
62783804@N05,7873,11,1326632395,1326632395,1,1,0
62783804@N05,7874,16,1339642290,1339642290,1,1,0
62831368@N08,7875,26,1315121099,1315135394,28,1,14295
62841817@N05,7876,30,1389011566,1389011566,1,2,0
62841817@N05,7876,23,1389011574,1389011574,1,2,0
62844184@N00,7877,28,1356406185,1356406846,2,1,661
62844184@N00,7878,18,1356500705,1356500705,1,4,0
62844184@N00,7878,20,1356505088,1356505088,1,4,0
62844184@N00,7878,28,1356500441,1356500441,1,4,0
62844184@N00,7878,30,1356500050,1356504849,2,4,4799
62844184@N00,7879,28,1360229457,1360229457,1,1,0
62901115@N00,7880,25,1351077205,1351077205,1,2,0
62901115@N00,7880,3,1351077191,1351077191,1,2,0
62937639@N00,7881,26,1329016388,1329016388,1,4,0
62937639@N00,7881,11,1329014215,1329041558,17,4,27343
62937639@N00,7881,4,1329009487,1329009487,1,4,0
62937639@N00,7881,28,1329016519,1329016519,1,4,0
62947310@N02,7882,28,1311580535,1311580535,1,3,0
62947310@N02,7882,18,1311584639,1311584639,1,3,0
62947310@N02,7882,10,1311588846,1311588846,1,3,0
62947310@N02,7883,10,1311652247,1311652247,1,1,0
62947310@N02,7884,18,1311732061,1311732061,1,2,0
62947310@N02,7884,10,1311737402,1311737402,1,2,0
62947310@N02,7885,28,1311769377,1311769377,1,2,0
62947310@N02,7885,18,1311769418,1311769418,1,2,0
62947310@N02,7886,19,1324183054,1324183054,1,1,0
62983673@N07,7887,21,1283257179,1283257179,1,2,0
62983673@N07,7887,24,1283256931,1283256931,1,2,0
62986558@N05,7888,14,1331295275,1331295275,1,1,0
62986558@N05,7889,21,1332489684,1332489684,1,1,0
62986558@N05,7890,17,1333100092,1333100092,1,2,0
62986558@N05,7890,15,1333093710,1333093710,1,2,0
62986558@N05,7891,14,1333938847,1333938847,1,2,0
62986558@N05,7891,28,1333942080,1333942080,1,2,0
62986558@N05,7892,28,1334729742,1334729742,1,1,0
62986558@N05,7893,26,1335608325,1335608325,1,1,0
62986558@N05,7894,27,1336129881,1336129881,1,2,0
62986558@N05,7894,7,1336137298,1336137298,1,2,0
62986558@N05,7895,28,1336227132,1336227132,1,2,0
62986558@N05,7895,5,1336225110,1336225110,1,2,0
62986558@N05,7896,17,1336992257,1336992257,1,3,0
62986558@N05,7896,30,1336996753,1336996753,1,3,0
62986558@N05,7896,23,1336994900,1336994900,1,3,0
62986558@N05,7897,28,1337511272,1337511272,1,1,0
62986558@N05,7898,17,1339590262,1339590593,2,1,331
62994159@N06,7899,1,1433575810,1433575810,1,1,0
63014850@N00,7900,23,1403146209,1403146209,1,6,0
63014850@N00,7900,13,1403147572,1403149098,2,6,1526
63014850@N00,7900,30,1403177173,1403177275,2,6,102
63014850@N00,7900,3,1403196497,1403196497,1,6,0
63014850@N00,7900,26,1403196606,1403196606,1,6,0
63014850@N00,7900,5,1403143734,1403143734,1,6,0
63076241@N00,7901,30,1370323936,1370323936,1,1,0
63096042@N07,7902,28,1319016869,1319016961,2,1,92
63104689@N03,7903,31,1397176170,1397176170,1,2,0
63104689@N03,7903,30,1397175961,1397175963,2,2,2
63104689@N03,7904,16,1411290592,1411290669,8,2,77
63104689@N03,7904,26,1411290812,1411290842,2,2,30
63104689@N03,7905,16,1414713207,1414713360,9,4,153
63104689@N03,7905,20,1414723412,1414723443,15,4,31
63104689@N03,7905,1,1414718157,1414719079,3,4,922
63104689@N03,7905,29,1414710756,1414710756,3,4,0
63104689@N03,7906,28,1415620177,1415620185,2,3,8
63104689@N03,7906,20,1415619196,1415619196,1,3,0
63104689@N03,7906,31,1415618385,1415618385,1,3,0
63104689@N03,7907,1,1417303104,1417303104,1,2,0
63104689@N03,7907,16,1417303480,1417304542,5,2,1062
63104916@N00,7908,26,1339127933,1339127933,1,1,0
63106298@N02,7909,26,1298289545,1298289545,1,1,0
63106298@N02,7910,26,1316763013,1316763038,2,1,25
63106298@N02,7911,16,1316952127,1316952127,1,2,0
63106298@N02,7911,21,1316942744,1316942744,1,2,0
63106298@N02,7912,18,1318583754,1318583754,1,9,0
63106298@N02,7912,30,1318583766,1318583766,1,9,0
63106298@N02,7912,20,1318583754,1318590051,2,9,6297
63106298@N02,7912,26,1318583766,1318583766,1,9,0
63106298@N02,7912,1,1318590051,1318590051,1,9,0
63106298@N02,7912,12,1318583766,1318583766,1,9,0
63106298@N02,7912,4,1318583754,1318583754,1,9,0
63106298@N02,7912,28,1318583754,1318583754,1,9,0
63106298@N02,7912,13,1318583574,1318583775,2,9,201
63106298@N02,7913,18,1319173235,1319173235,1,1,0
63106298@N02,7914,18,1320314278,1320314278,1,7,0
63106298@N02,7914,13,1320327952,1320329241,5,7,1289
63106298@N02,7914,24,1320333774,1320334644,3,7,870
63106298@N02,7914,20,1320326493,1320333412,3,7,6919
63106298@N02,7914,26,1320329623,1320334306,8,7,4683
63106298@N02,7914,4,1320314383,1320334857,4,7,20474
63106298@N02,7914,27,1320334090,1320334090,1,7,0
63106298@N02,7915,13,1321886246,1321889313,7,2,3067
63106298@N02,7915,15,1321883444,1321883444,1,2,0
63106298@N02,7916,20,1321964739,1321965128,3,5,389
63106298@N02,7916,16,1321970451,1321970653,2,5,202
63106298@N02,7916,30,1321925562,1321969524,4,5,43962
63106298@N02,7916,26,1321971257,1321971257,1,5,0
63106298@N02,7916,29,1321943226,1321967841,5,5,24615
63106298@N02,7917,28,1322010852,1322011836,2,2,984
63106298@N02,7917,27,1322010120,1322010120,1,2,0
63106298@N02,7918,6,1322111607,1322111761,3,3,154
63106298@N02,7918,30,1322109885,1322109885,1,3,0
63106298@N02,7918,26,1322112030,1322112030,1,3,0
63106298@N02,7919,13,1322545090,1322545090,1,7,0
63106298@N02,7919,6,1322538817,1322538817,1,7,0
63106298@N02,7919,24,1322545983,1322545983,1,7,0
63106298@N02,7919,1,1322531344,1322531344,1,7,0
63106298@N02,7919,4,1322541295,1322542250,3,7,955
63106298@N02,7919,29,1322543963,1322543963,1,7,0
63106298@N02,7919,28,1322526365,1322526365,1,7,0
63106298@N02,7920,28,1322789631,1322789631,1,1,0
63106298@N02,7921,27,1322916664,1322916664,1,3,0
63106298@N02,7921,6,1322907341,1322907341,1,3,0
63106298@N02,7921,3,1322903513,1322903513,1,3,0
63106298@N02,7922,13,1323567401,1323569984,2,1,2583
63106298@N02,7923,24,1323601579,1323604101,3,1,2522
63106298@N02,7924,23,1323751294,1323751294,1,6,0
63106298@N02,7924,24,1323748740,1323749906,6,6,1166
63106298@N02,7924,20,1323751676,1323751869,2,6,193
63106298@N02,7924,6,1323753758,1323754521,2,6,763
63106298@N02,7924,28,1323753560,1323753560,1,6,0
63106298@N02,7924,31,1323750517,1323750517,1,6,0
63106298@N02,7925,20,1325165636,1325165835,2,2,199
63106298@N02,7925,15,1325164749,1325166376,3,2,1627
63106298@N02,7926,15,1325202464,1325208853,9,1,6389
63106298@N02,7927,26,1325345067,1325345067,1,1,0
63106298@N02,7928,13,1327024853,1327024853,1,2,0
63106298@N02,7928,15,1327024814,1327024814,1,2,0
63106298@N02,7929,15,1327991864,1327992670,6,1,806
63106298@N02,7930,3,1328100887,1328100887,1,5,0
63106298@N02,7930,14,1328093973,1328093973,1,5,0
63106298@N02,7930,22,1328094751,1328094751,1,5,0
63106298@N02,7930,24,1328089566,1328089566,1,5,0
63106298@N02,7930,20,1328092772,1328092772,1,5,0
63106298@N02,7931,3,1328235592,1328235592,1,1,0
63106298@N02,7932,3,1328275093,1328284732,7,1,9639
63106298@N02,7933,15,1329648346,1329648478,2,4,132
63106298@N02,7933,8,1329648610,1329648610,1,4,0
63106298@N02,7933,13,1329648081,1329648081,1,4,0
63106298@N02,7933,1,1329643227,1329643227,1,4,0
63106298@N02,7934,28,1331262469,1331262469,1,3,0
63106298@N02,7934,15,1331268304,1331268602,2,3,298
63106298@N02,7934,18,1331263212,1331263212,1,3,0
63106298@N02,7935,15,1331597950,1331600832,2,1,2882
63106298@N02,7936,29,1332979369,1332979369,1,1,0
63106298@N02,7937,28,1333968633,1333968633,1,5,0
63106298@N02,7937,15,1333968512,1333968734,2,5,222
63106298@N02,7937,26,1333965986,1333972862,4,5,6876
63106298@N02,7937,24,1333965903,1333965903,1,5,0
63106298@N02,7937,25,1333966074,1333966509,4,5,435
63106298@N02,7938,16,1334020124,1334020124,1,1,0
63106298@N02,7939,19,1334134398,1334134398,1,2,0
63106298@N02,7939,13,1334133884,1334133884,1,2,0
63106298@N02,7940,26,1334193830,1334215765,2,1,21935
63106298@N02,7941,12,1334328653,1334328653,1,2,0
63106298@N02,7941,26,1334330716,1334330820,2,2,104
63106298@N02,7942,26,1334535549,1334535549,1,1,0
63106298@N02,7943,21,1335096823,1335096823,1,2,0
63106298@N02,7943,26,1335093051,1335093051,1,2,0
63106298@N02,7944,15,1335278151,1335278151,1,3,0
63106298@N02,7944,16,1335278478,1335278478,1,3,0
63106298@N02,7944,26,1335278770,1335280107,3,3,1337
63106298@N02,7945,15,1335373994,1335373994,1,4,0
63106298@N02,7945,30,1335374513,1335374513,1,4,0
63106298@N02,7945,26,1335374288,1335374288,1,4,0
63106298@N02,7945,28,1335371856,1335371856,1,4,0
63106298@N02,7946,16,1335417667,1335417667,1,3,0
63106298@N02,7946,20,1335409027,1335409027,1,3,0
63106298@N02,7946,23,1335408985,1335408985,1,3,0
63106298@N02,7947,15,1335708525,1335708525,1,8,0
63106298@N02,7947,3,1335708350,1335708350,1,8,0
63106298@N02,7947,19,1335708484,1335708484,1,8,0
63106298@N02,7947,24,1335708566,1335708566,1,8,0
63106298@N02,7947,26,1335708361,1335708361,1,8,0
63106298@N02,7947,6,1335708608,1335708796,2,8,188
63106298@N02,7947,28,1335708405,1335708405,1,8,0
63106298@N02,7947,13,1335708579,1335708839,2,8,260
63106298@N02,7948,15,1335890392,1335890392,1,5,0
63106298@N02,7948,16,1335890332,1335890332,1,5,0
63106298@N02,7948,6,1335891311,1335891311,1,5,0
63106298@N02,7948,26,1335890262,1335890262,1,5,0
63106298@N02,7948,28,1335890363,1335890363,1,5,0
63106298@N02,7949,15,1335979898,1335979944,2,4,46
63106298@N02,7949,19,1335979952,1335979952,1,4,0
63106298@N02,7949,27,1335980072,1335980072,1,4,0
63106298@N02,7949,23,1335980022,1335980022,1,4,0
63106298@N02,7950,20,1336095436,1336095436,1,2,0
63106298@N02,7950,19,1336095408,1336095417,2,2,9
63106298@N02,7951,31,1340205143,1340205143,1,4,0
63106298@N02,7951,26,1340205271,1340205271,1,4,0
63106298@N02,7951,16,1340205846,1340205846,1,4,0
63106298@N02,7951,24,1340205646,1340205646,1,4,0
63202442@N00,7952,20,1286411264,1286411264,1,1,0
63202442@N00,7953,30,1286450211,1286450211,1,1,0
63202442@N00,7954,25,1350284714,1350284714,1,1,0
63326305@N04,7955,10,1305960031,1305960031,1,2,0
63326305@N04,7955,18,1305932622,1305932622,1,2,0
63365181@N00,7956,17,1349102401,1349102401,1,1,0
63383881@N07,7957,25,1379847495,1379847700,2,4,205
63383881@N07,7957,1,1379817678,1379842362,3,4,24684
63383881@N07,7957,4,1379849500,1379849500,1,4,0
63383881@N07,7957,29,1379829127,1379829127,1,4,0
63383881@N07,7958,8,1379978389,1379978389,1,9,0
63383881@N07,7958,5,1379978686,1379979327,2,9,641
63383881@N07,7958,1,1379975757,1379975757,1,9,0
63383881@N07,7958,20,1379991732,1379991732,1,9,0
63383881@N07,7958,26,1379982926,1379984091,2,9,1165
63383881@N07,7958,30,1379988135,1379988135,1,9,0
63383881@N07,7958,11,1379988267,1379988267,1,9,0
63383881@N07,7958,3,1379979456,1379979664,2,9,208
63383881@N07,7958,7,1379988366,1379988424,2,9,58
63383881@N07,7959,25,1380074688,1380074688,1,3,0
63383881@N07,7959,15,1380070748,1380077129,2,3,6381
63383881@N07,7959,13,1380077508,1380078664,4,3,1156
63383881@N07,7960,13,1414192722,1414192722,1,2,0
63383881@N07,7960,20,1414197817,1414197817,1,2,0
63383881@N07,7961,14,1414228113,1414228113,1,2,0
63383881@N07,7961,20,1414227989,1414227989,1,2,0
63437796@N00,7962,25,1291460213,1291460213,1,1,0
63437796@N00,7963,27,1316854906,1316854906,1,1,0
63437796@N00,7964,25,1357974983,1357974983,1,1,0
63437796@N00,7965,1,1391856762,1391856762,1,1,0
63443853@N00,7966,30,1225449629,1225449629,1,1,0
63443853@N00,7967,26,1299386849,1299386849,1,1,0
63447360@N02,7968,18,1387957979,1387957979,1,1,0
63484364@N05,7969,27,1452267134,1452267134,1,4,0
63484364@N05,7969,15,1452266164,1452266826,2,4,662
63484364@N05,7969,18,1452227676,1452267549,8,4,39873
63484364@N05,7969,25,1452244258,1452244371,2,4,113
63484364@N05,7970,27,1452305238,1452305238,1,1,0
63488513@N00,7971,17,1378275715,1378275715,1,1,0
63511295@N07,7972,27,1309652645,1309652645,1,2,0
63511295@N07,7972,13,1309668570,1309668635,2,2,65
63520495@N08,7973,1,1356472799,1356472799,1,2,0
63520495@N08,7973,28,1356481230,1356481230,1,2,0
63520495@N08,7974,30,1356774373,1356774373,1,1,0
63520495@N08,7975,28,1358073749,1358073749,1,1,0
63520495@N08,7976,7,1359179697,1359179697,1,1,0
63520495@N08,7977,26,1364963982,1364963982,1,2,0
63520495@N08,7977,6,1364963874,1364963874,1,2,0
63520495@N08,7978,28,1372847799,1372847799,1,1,0
63520495@N08,7979,1,1373803573,1373803607,2,2,34
63520495@N08,7979,26,1373785990,1373785990,1,2,0
63520495@N08,7980,20,1374306952,1374306952,1,2,0
63520495@N08,7980,17,1374302829,1374302829,1,2,0
63520495@N08,7981,1,1376826334,1376826334,1,1,0
63520495@N08,7982,26,1376979113,1376979113,1,1,0
63520495@N08,7983,1,1385166828,1385166828,1,3,0
63520495@N08,7983,28,1385166784,1385166784,1,3,0
63520495@N08,7983,21,1385163546,1385163546,1,3,0
63520495@N08,7984,3,1385200101,1385200101,1,1,0
63520495@N08,7985,1,1385374852,1385374852,1,1,0
63520495@N08,7986,14,1385790803,1385790803,1,1,0
63520495@N08,7987,1,1386068249,1386068249,1,1,0
63520495@N08,7988,3,1405901588,1405901588,1,1,0
63520495@N08,7989,17,1409734052,1409734052,1,1,0
63520495@N08,7990,28,1425711651,1425711651,1,2,0
63520495@N08,7990,16,1425708170,1425708170,1,2,0
63520495@N08,7991,18,1427532846,1427532846,1,1,0
63520495@N08,7992,18,1448704020,1448704020,1,1,0
63520495@N08,7993,15,1459653008,1459653008,1,1,0
63520495@N08,7994,18,1460186781,1460186781,1,1,0
63542807@N00,7995,28,1357987850,1357987850,1,1,0
63542807@N00,7996,29,1412756747,1412756747,1,1,0
63579498@N08,7997,26,1214855891,1214855891,1,1,0
63579498@N08,7998,26,1214912735,1214912735,1,2,0
63579498@N08,7998,31,1214923550,1214923550,1,2,0
63579498@N08,7999,27,1243402759,1243402996,2,1,237
63631877@N00,8000,17,1219811470,1219811470,1,1,0
63631877@N00,8001,17,1219914929,1219914929,3,1,0
63631877@N00,8002,12,1222847479,1222847482,3,1,3
63631877@N00,8003,14,1223685278,1223685284,2,1,6
63631877@N00,8004,29,1230787446,1230787449,2,1,3
63631877@N00,8005,20,1234743344,1234743344,1,1,0
63631877@N00,8006,27,1237624002,1237624002,1,2,0
63631877@N00,8006,25,1237623998,1237623998,1,2,0
63631877@N00,8007,28,1243159126,1243159139,2,1,13
63631877@N00,8008,17,1243682700,1243682700,1,1,0
63631877@N00,8009,28,1258761907,1258761911,2,1,4
63631877@N00,8010,1,1272259494,1272259494,1,3,0
63631877@N00,8010,10,1272259486,1272259486,1,3,0
63631877@N00,8010,20,1272259489,1272259491,2,3,2
63631877@N00,8011,23,1273230295,1273230295,1,2,0
63631877@N00,8011,17,1273230302,1273230302,1,2,0
63631877@N00,8012,8,1274321366,1274321366,1,1,0
63631877@N00,8013,29,1276404974,1276404974,1,1,0
63631877@N00,8014,13,1290435570,1290435570,1,4,0
63631877@N00,8014,5,1290435578,1290435578,1,4,0
63631877@N00,8014,12,1290435574,1290435574,1,4,0
63631877@N00,8014,3,1290435581,1290435584,2,4,3
63631877@N00,8015,16,1291178092,1291178092,1,1,0
63631877@N00,8016,10,1405825440,1405825440,1,1,0
63631877@N00,8017,26,1443524403,1443524403,1,1,0
63666148@N00,8018,28,1362388787,1362388787,1,2,0
63666148@N00,8018,26,1362392912,1362392912,1,2,0
63683562@N07,8019,1,1370069491,1370069491,1,1,0
63689406@N00,8020,29,1268967565,1268967565,1,2,0
63689406@N00,8020,26,1268953859,1268953859,1,2,0
63689406@N00,8021,17,1269061910,1269061910,1,3,0
63689406@N00,8021,28,1269040268,1269040268,1,3,0
63689406@N00,8021,20,1269043864,1269067693,2,3,23829
63689406@N00,8022,21,1269118762,1269127998,2,6,9236
63689406@N00,8022,26,1269117378,1269127796,2,6,10418
63689406@N00,8022,24,1269129461,1269135640,3,6,6179
63689406@N00,8022,29,1269126039,1269126039,1,6,0
63689406@N00,8022,16,1269134584,1269135772,2,6,1188
63689406@N00,8022,12,1269118282,1269118333,2,6,51
63689406@N00,8023,28,1269171458,1269171458,1,2,0
63689406@N00,8023,16,1269174450,1269174450,1,2,0
63765288@N05,8024,18,1345627246,1345640565,2,9,13319
63765288@N05,8024,28,1345624227,1345663532,4,9,39305
63765288@N05,8024,11,1345625881,1345625988,4,9,107
63765288@N05,8024,23,1345640451,1345640451,1,9,0
63765288@N05,8024,27,1345624351,1345624351,1,9,0
63765288@N05,8024,4,1345622420,1345625998,3,9,3578
63765288@N05,8024,1,1345624014,1345663751,3,9,39737
63765288@N05,8024,5,1345622307,1345622357,2,9,50
63765288@N05,8024,26,1345624391,1345663240,8,9,38849
63772658@N07,8025,27,1460454561,1460454561,1,1,0
63773896@N03,8026,1,1432237065,1432237065,1,4,0
63773896@N03,8026,29,1432239689,1432239689,1,4,0
63773896@N03,8026,23,1432258385,1432258385,1,4,0
63773896@N03,8026,18,1432239475,1432239475,1,4,0
63773896@N03,8027,26,1432441874,1432441943,3,1,69
63862568@N00,8028,18,1447883628,1447883628,1,1,0
63903138@N00,8029,30,1253272552,1253272552,1,1,0
63903138@N00,8030,26,1259134134,1259134134,1,1,0
63903226@N06,8031,16,1346118898,1346118898,1,1,0
63903226@N06,8032,20,1398139429,1398139429,1,1,0
63903226@N06,8033,29,1401064065,1401064065,1,1,0
63903226@N06,8034,28,1416866339,1416866339,1,1,0
63948289@N03,8035,28,1388097810,1388107627,2,1,9817
63955107@N08,8036,18,1426491899,1426491899,1,1,0
63963077@N03,8037,20,1387423741,1387423741,1,1,0
63968574@N03,8038,30,1345516459,1345516592,2,1,133
63968574@N03,8039,11,1349151825,1349151825,1,8,0
63968574@N03,8039,30,1349148484,1349148484,1,8,0
63968574@N03,8039,1,1349147881,1349147881,1,8,0
63968574@N03,8039,28,1349148222,1349148222,1,8,0
63968574@N03,8039,13,1349153060,1349155007,2,8,1947
63968574@N03,8039,14,1349150931,1349150931,1,8,0
63968574@N03,8039,22,1349151942,1349151942,1,8,0
63968574@N03,8039,3,1349156193,1349156193,2,8,0
63968574@N03,8040,26,1350940865,1350990359,83,2,49494
63968574@N03,8040,30,1350969460,1350985559,4,2,16099
63968574@N03,8041,21,1353206427,1353206427,1,1,0
63968574@N03,8042,22,1353374179,1353374179,1,1,0
63968574@N03,8043,26,1354000139,1354000139,1,2,0
63968574@N03,8043,30,1354000139,1354000139,1,2,0
63968574@N03,8044,19,1362031444,1362031566,2,2,122
63968574@N03,8044,30,1362029719,1362029719,1,2,0
63968574@N03,8045,30,1362441868,1362461256,38,1,19388
63968574@N03,8046,30,1362624158,1362636229,24,1,12071
63968574@N03,8047,26,1365464696,1365468510,6,2,3814
63968574@N03,8047,30,1365463441,1365481245,11,2,17804
63968574@N03,8048,30,1365656081,1365663781,10,1,7700
63968574@N03,8049,30,1367465763,1367478279,8,1,12516
63968574@N03,8050,26,1369706089,1369716785,7,1,10696
63968574@N03,8051,30,1382229485,1382243911,50,1,14426
63968574@N03,8052,26,1416305070,1416318562,24,1,13492
63971589@N00,8053,25,1349503415,1349503415,1,2,0
63971589@N00,8053,17,1349486560,1349486560,1,2,0
63971589@N00,8054,7,1349570044,1349570044,1,1,0
63971589@N00,8055,1,1349599176,1349599176,1,1,0
63971589@N00,8056,23,1380866762,1380866762,1,1,0
63971589@N00,8057,20,1380943562,1380943562,1,1,0
63971589@N00,8058,12,1381038959,1381038959,1,1,0
63971589@N00,8059,18,1433428907,1433428907,1,2,0
63971589@N00,8059,4,1433405245,1433405245,1,2,0
63971589@N00,8060,22,1444027225,1444027225,1,1,0
64041142@N00,8061,28,1242793220,1242798466,2,1,5246
64047898@N07,8062,1,1389052380,1389078546,15,1,26166
64098965@N00,8063,26,1197546418,1197546418,1,1,0
64098965@N00,8064,26,1203681885,1203681885,1,1,0
64098965@N00,8065,24,1205495059,1205495059,1,4,0
64098965@N00,8065,11,1205491942,1205492164,2,4,222
64098965@N00,8065,29,1205492099,1205492160,2,4,61
64098965@N00,8065,26,1205491936,1205491936,1,4,0
64098965@N00,8066,26,1206788406,1206788406,1,1,0
64111181@N00,8067,26,1278243373,1278245348,2,2,1975
64111181@N00,8067,17,1278236619,1278236619,1,2,0
64123610@N00,8068,13,1356420123,1356420123,1,5,0
64123610@N00,8068,20,1356431135,1356431135,1,5,0
64123610@N00,8068,17,1356408103,1356411740,2,5,3637
64123610@N00,8068,28,1356438756,1356438756,1,5,0
64123610@N00,8068,21,1356416903,1356418796,2,5,1893
64128174@N00,8069,27,1404456599,1404456787,2,1,188
64149590@N00,8070,28,1294250519,1294261312,20,1,10793
64202793@N00,8071,3,1393908432,1393908432,1,12,0
64202793@N00,8071,13,1393909928,1393909933,9,12,5
64202793@N00,8071,21,1393908436,1393908436,1,12,0
64202793@N00,8071,11,1393888380,1393888381,2,12,1
64202793@N00,8071,29,1393893781,1393893796,7,12,15
64202793@N00,8071,1,1393886725,1393903369,3,12,16644
64202793@N00,8071,28,1393886985,1393886995,9,12,10
64202793@N00,8071,26,1393887660,1393887922,4,12,262
64202793@N00,8071,27,1393903240,1393919276,6,12,16036
64202793@N00,8071,15,1393911936,1393916349,25,12,4413
64202793@N00,8071,17,1393917923,1393920260,9,12,2337
64202793@N00,8071,16,1393919585,1393919624,5,12,39
64202793@N00,8072,1,1393974721,1393974731,10,1,10
64202793@N00,8073,10,1394084503,1394084503,1,12,0
64202793@N00,8073,11,1394084055,1394084058,4,12,3
64202793@N00,8073,30,1394086096,1394086130,2,12,34
64202793@N00,8073,23,1394073050,1394073052,2,12,2
64202793@N00,8073,31,1394074163,1394074164,2,12,1
64202793@N00,8073,22,1394074103,1394074103,1,12,0
64202793@N00,8073,28,1394069772,1394072090,16,12,2318
64202793@N00,8073,19,1394072528,1394073138,14,12,610
64202793@N00,8073,26,1394081929,1394082083,4,12,154
64202793@N00,8073,27,1394076991,1394077448,2,12,457
64202793@N00,8073,15,1394087355,1394087549,3,12,194
64202793@N00,8073,16,1394080797,1394081533,3,12,736
64236163@N00,8074,28,1363821311,1363821311,1,1,0
64286456@N00,8075,29,1345376672,1345376672,1,1,0
64286456@N00,8076,12,1369228847,1369228847,1,1,0
64286456@N00,8077,1,1373037749,1373037749,1,1,0
64286456@N00,8078,1,1380356066,1380356066,1,1,0
64286456@N00,8079,1,1380423998,1380425581,2,3,1583
64286456@N00,8079,29,1380426232,1380426232,1,3,0
64286456@N00,8079,14,1380424848,1380424848,1,3,0
64286456@N00,8080,26,1381323563,1381323563,1,1,0
64286456@N00,8081,28,1387020929,1387020929,1,1,0
64286456@N00,8082,29,1388441909,1388441909,1,2,0
64286456@N00,8082,27,1388448274,1388448274,1,2,0
64338179@N00,8083,18,1455608626,1455608626,1,1,0
64405577@N00,8084,30,1256377089,1256377102,3,2,13
64405577@N00,8084,16,1256373641,1256373641,1,2,0
64405577@N00,8085,29,1317519159,1317519159,1,1,0
64405577@N00,8086,28,1317559316,1317559316,1,3,0
64405577@N00,8086,3,1317558556,1317558556,1,3,0
64405577@N00,8086,11,1317558823,1317558823,1,3,0
64405577@N00,8087,29,1318142873,1318142873,1,3,0
64405577@N00,8087,30,1318142813,1318143463,2,3,650
64405577@N00,8087,31,1318142921,1318142921,1,3,0
64405577@N00,8088,4,1318766098,1318766098,1,3,0
64405577@N00,8088,15,1318769174,1318769174,1,3,0
64405577@N00,8088,24,1318769255,1318769255,1,3,0
64432343@N07,8089,6,1343042152,1343042152,1,3,0
64432343@N07,8089,27,1343047072,1343047980,2,3,908
64432343@N07,8089,26,1343048520,1343048520,1,3,0
64432343@N07,8090,26,1391428221,1391428221,1,1,0
64432343@N07,8091,27,1392252505,1392252505,1,1,0
64472855@N06,8092,8,1330480922,1330480922,1,1,0
64472855@N06,8093,13,1332222902,1332222902,1,1,0
64508904@N07,8094,28,1343811997,1343812017,2,2,20
64508904@N07,8094,3,1343815398,1343815398,1,2,0
64517504@N07,8095,30,1311727141,1311742160,13,1,15019
64553590@N07,8096,17,1309087070,1309091473,5,1,4403
64560041@N04,8097,27,1346560193,1346560193,1,2,0
64560041@N04,8097,13,1346560400,1346560400,1,2,0
64560041@N04,8098,30,1356915137,1356916579,2,1,1442
64560041@N04,8099,26,1357076005,1357076005,1,1,0
64569741@N00,8100,25,1308579041,1308579041,1,1,0
64569741@N00,8101,30,1308656305,1308656305,1,1,0
64569741@N00,8102,27,1309697370,1309697370,1,1,0
64569741@N00,8103,1,1309786567,1309786855,3,2,288
64569741@N00,8103,30,1309782894,1309782894,1,2,0
64569741@N00,8104,30,1315905832,1315905832,1,1,0
64569741@N00,8105,26,1324900475,1324900475,1,1,0
64569741@N00,8106,26,1331549336,1331549336,1,6,0
64569741@N00,8106,16,1331549690,1331550063,5,6,373
64569741@N00,8106,3,1331549656,1331549656,1,6,0
64569741@N00,8106,28,1331549297,1331549297,1,6,0
64569741@N00,8106,29,1331550091,1331550091,1,6,0
64569741@N00,8106,7,1331549561,1331549620,2,6,59
64569741@N00,8107,1,1337932554,1337932554,1,1,0
64569741@N00,8108,28,1341929789,1341929789,1,1,0
64569741@N00,8109,29,1344600169,1344617082,6,1,16913
64569741@N00,8110,8,1344780081,1344780081,1,1,0
64569741@N00,8111,26,1346506335,1346506335,1,1,0
64569741@N00,8112,28,1347606157,1347611067,2,1,4910
64569741@N00,8113,18,1348910738,1348910738,1,1,0
64569741@N00,8114,28,1349419261,1349419261,1,1,0
64569741@N00,8115,26,1353765016,1353765016,1,2,0
64569741@N00,8115,1,1353761883,1353761883,1,2,0
64569741@N00,8116,29,1354704509,1354708386,4,1,3877
64569741@N00,8117,29,1355745613,1355745613,1,1,0
64569741@N00,8118,29,1363330904,1363330904,1,1,0
64576282@N00,8119,28,1261190382,1261190382,1,1,0
64576282@N00,8120,1,1278057041,1278057041,1,2,0
64576282@N00,8120,21,1278061564,1278061686,2,2,122
64576282@N00,8121,7,1280638885,1280638885,1,3,0
64576282@N00,8121,21,1280652673,1280652765,2,3,92
64576282@N00,8121,24,1280644479,1280644479,1,3,0
64576282@N00,8122,16,1280754527,1280754527,1,1,0
64576282@N00,8123,24,1283747394,1283747394,1,2,0
64576282@N00,8123,27,1283743249,1283743249,1,2,0
64576282@N00,8124,28,1286173788,1286173788,1,3,0
64576282@N00,8124,15,1286162402,1286168648,3,3,6246
64576282@N00,8124,26,1286171361,1286171367,2,3,6
64576282@N00,8125,22,1288070652,1288070652,1,8,0
64576282@N00,8125,11,1288081013,1288081209,2,8,196
64576282@N00,8125,29,1288068819,1288083438,2,8,14619
64576282@N00,8125,31,1288069984,1288070647,3,8,663
64576282@N00,8125,14,1288084832,1288084832,1,8,0
64576282@N00,8125,21,1288074969,1288075605,6,8,636
64576282@N00,8125,3,1288075156,1288075156,1,8,0
64576282@N00,8125,30,1288082418,1288083554,4,8,1136
64576282@N00,8126,11,1288609907,1288609907,1,1,0
64576282@N00,8127,28,1304702956,1304702956,1,1,0
64576282@N00,8128,28,1304752903,1304755673,2,1,2770
64576282@N00,8129,19,1319525603,1319525603,1,2,0
64576282@N00,8129,12,1319533133,1319533141,2,2,8
64579523@N02,8130,26,1290847378,1290847378,1,1,0
64579523@N02,8131,26,1294034558,1294034558,1,1,0
64579523@N02,8132,26,1295008102,1295008494,2,1,392
64579523@N02,8133,26,1297393570,1297393570,1,1,0
64591327@N00,8134,18,1424946650,1424959003,2,1,12353
64591327@N00,8135,18,1427802983,1427802983,1,1,0
64591327@N00,8136,18,1434161389,1434161389,1,1,0
64591327@N00,8137,18,1435059812,1435063929,2,1,4117
64604717@N03,8138,16,1218273566,1218273566,1,6,0
64604717@N03,8138,23,1218267387,1218267387,1,6,0
64604717@N03,8138,30,1218268577,1218274508,2,6,5931
64604717@N03,8138,31,1218270557,1218270557,1,6,0
64604717@N03,8138,29,1218275383,1218275383,1,6,0
64604717@N03,8138,18,1218268434,1218268434,1,6,0
64634436@N00,8139,24,1297467967,1297467967,1,1,0
64651023@N00,8140,15,1329211925,1329211925,1,1,0
64658966@N06,8141,26,1329263853,1329263853,1,1,0
64724295@N08,8142,26,1325421477,1325421477,1,1,0
64724295@N08,8143,26,1325464123,1325464123,1,1,0
64724295@N08,8144,26,1326114079,1326144939,4,1,30860
64724295@N08,8145,10,1332756861,1332756861,1,1,0
64724295@N08,8146,26,1337612780,1337612780,1,1,0
64724295@N08,8147,30,1338794739,1338794739,1,1,0
64734640@N06,8148,1,1340412069,1340412069,1,1,0
64748777@N08,8149,25,1309443469,1309443469,1,1,0
64772907@N05,8150,20,1279754704,1279754704,1,1,0
64819638@N03,8151,18,1450051805,1450051805,1,1,0
64822977@N00,8152,26,1333521363,1333521628,4,7,265
64822977@N00,8152,22,1333532279,1333533782,11,7,1503
64822977@N00,8152,20,1333522527,1333524665,3,7,2138
64822977@N00,8152,28,1333521641,1333536018,3,7,14377
64822977@N00,8152,18,1333526488,1333528039,9,7,1551
64822977@N00,8152,4,1333528217,1333531926,13,7,3709
64822977@N00,8152,31,1333521897,1333522436,3,7,539
64822977@N00,8153,26,1333598612,1333603201,23,2,4589
64822977@N00,8153,1,1333603207,1333603268,3,2,61
64822977@N00,8154,26,1333686261,1333690510,11,5,4249
64822977@N00,8154,20,1333697018,1333697053,2,5,35
64822977@N00,8154,12,1333698965,1333703870,3,5,4905
64822977@N00,8154,1,1333685544,1333685544,1,5,0
64822977@N00,8154,9,1333690547,1333695829,54,5,5282
64822977@N00,8155,27,1333794215,1333798143,16,1,3928
64823004@N05,8156,1,1330683863,1330683863,1,1,0
64823004@N05,8157,18,1330730114,1330730114,1,2,0
64823004@N05,8157,31,1330732336,1330732336,1,2,0
64879525@N08,8158,10,1344249734,1344249734,1,1,0
64890329@N08,8159,29,1323227025,1323227025,1,1,0
64890329@N08,8160,27,1324951604,1324951604,1,1,0
64890329@N08,8161,1,1372421813,1372421813,1,1,0
64956248@N06,8162,17,1377051009,1377051009,1,1,0
64985588@N06,8163,27,1311138820,1311138820,1,3,0
64985588@N06,8163,28,1311120038,1311139336,7,3,19298
64985588@N06,8163,1,1311119526,1311119526,1,3,0
64985588@N06,8164,29,1325511095,1325511095,1,2,0
64985588@N06,8164,30,1325511847,1325511847,1,2,0
64985588@N06,8165,6,1326691298,1326691298,1,2,0
64985588@N06,8165,15,1326692717,1326692717,1,2,0
64985588@N06,8166,6,1329039942,1329039942,1,1,0
64985588@N06,8167,29,1330838132,1330838132,1,3,0
64985588@N06,8167,25,1330844364,1330844485,2,3,121
64985588@N06,8167,20,1330849327,1330849402,2,3,75
64985588@N06,8168,24,1335181860,1335181860,1,2,0
64985588@N06,8168,29,1335179123,1335179123,1,2,0
64985588@N06,8169,18,1347950607,1347952009,2,1,1402
65009074@N07,8170,28,1454145748,1454145748,1,1,0
65009812@N02,8171,8,1429492546,1429492546,1,8,0
65009812@N02,8171,18,1429500405,1429500416,2,8,11
65009812@N02,8171,25,1429510359,1429510366,2,8,7
65009812@N02,8171,1,1429486844,1429486844,1,8,0
65009812@N02,8171,19,1429500449,1429500449,1,8,0
65009812@N02,8171,14,1429497363,1429506468,2,8,9105
65009812@N02,8171,27,1429489768,1429527448,4,8,37680
65009812@N02,8171,28,1429493267,1429493267,1,8,0
65034792@N04,8172,28,1363055339,1363055339,1,1,0
65034792@N04,8173,28,1363224136,1363224136,1,2,0
65034792@N04,8173,17,1363248369,1363248369,1,2,0
65067917@N00,8174,25,1292149406,1292149406,1,1,0
65067917@N00,8175,25,1292233971,1292233981,2,1,10
65067917@N00,8176,28,1325336308,1325336308,1,1,0
65067917@N00,8177,28,1350638876,1350639552,6,1,676
65067917@N00,8178,28,1350690082,1350690082,1,1,0
65067917@N00,8179,25,1368919796,1368919796,1,1,0
65105672@N00,8180,20,1284596517,1284610330,10,1,13813
65105672@N00,8181,20,1284681992,1284718551,6,1,36559
65105672@N00,8182,20,1284854202,1284860556,12,1,6354
65105672@N00,8183,20,1284894684,1284896470,11,1,1786
65105672@N00,8184,20,1284945923,1284965803,9,1,19880
65106121@N00,8185,26,1313805639,1313805639,1,3,0
65106121@N00,8185,14,1313798842,1313798842,1,3,0
65106121@N00,8185,15,1313811676,1313812735,4,3,1059
65121058@N00,8186,26,1307517286,1307517286,1,1,0
65147136@N00,8187,15,1311654615,1311654615,1,4,0
65147136@N00,8187,12,1311663666,1311663666,1,4,0
65147136@N00,8187,20,1311652970,1311652970,1,4,0
65147136@N00,8187,29,1311670453,1311670453,1,4,0
65148532@N06,8188,15,1391235990,1391236526,2,5,536
65148532@N06,8188,31,1391220238,1391220238,1,5,0
65148532@N06,8188,8,1391212787,1391212787,1,5,0
65148532@N06,8188,28,1391231342,1391233932,7,5,2590
65148532@N06,8188,26,1391213213,1391215456,3,5,2243
65196834@N00,8189,26,1328643477,1328654441,35,1,10964
65198673@N07,8190,1,1460418870,1460457518,12,1,38648
65202446@N05,8191,1,1355893548,1355893548,1,1,0
65219585@N00,8192,11,1397481277,1397481277,1,1,0
65226079@N00,8193,10,1262232968,1262260798,11,2,27830
65226079@N00,8193,19,1262254037,1262254037,1,2,0
65228518@N04,8194,29,1400004908,1400004908,1,1,0
65298649@N00,8195,26,1327191017,1327191017,1,1,0
65321004@N02,8196,26,1325131196,1325131196,1,5,0
65321004@N02,8196,13,1325129201,1325129574,5,5,373
65321004@N02,8196,29,1325137594,1325137594,1,5,0
65321004@N02,8196,23,1325127539,1325127539,1,5,0
65321004@N02,8196,14,1325137283,1325137357,2,5,74
65367662@N00,8197,1,1291817698,1291817698,1,1,0
65367662@N00,8198,1,1313208181,1313208193,4,1,12
65374071@N00,8199,22,1341802308,1341802308,1,11,0
65374071@N00,8199,19,1341855032,1341855032,1,11,0
65374071@N00,8199,8,1341815784,1341876783,2,11,60999
65374071@N00,8199,29,1341793832,1341793832,1,11,0
65374071@N00,8199,16,1341808697,1341895256,5,11,86559
65374071@N00,8199,25,1341830079,1341891793,4,11,61714
65374071@N00,8199,27,1341834055,1341834055,1,11,0
65374071@N00,8199,18,1341866138,1341866138,1,11,0
65374071@N00,8199,24,1341869898,1341869898,1,11,0
65374071@N00,8199,11,1341836106,1341836106,1,11,0
65374071@N00,8199,26,1341833625,1341833625,1,11,0
65374071@N00,8200,7,1371908202,1371908202,1,2,0
65374071@N00,8200,28,1371907939,1371907939,1,2,0
65404669@N02,8201,18,1347431809,1347439672,5,8,7863
65404669@N02,8201,28,1347431410,1347446348,12,8,14938
65404669@N02,8201,30,1347434725,1347435661,2,8,936
65404669@N02,8201,23,1347431729,1347438447,7,8,6718
65404669@N02,8201,1,1347446232,1347446232,1,8,0
65404669@N02,8201,27,1347449732,1347449732,1,8,0
65404669@N02,8201,29,1347436294,1347438225,3,8,1931
65404669@N02,8201,20,1347431333,1347431333,1,8,0
65404669@N02,8202,23,1347487193,1347487193,1,1,0
65404669@N02,8203,15,1347597481,1347600890,5,6,3409
65404669@N02,8203,28,1347625716,1347625716,1,6,0
65404669@N02,8203,14,1347629183,1347629183,1,6,0
65404669@N02,8203,30,1347590172,1347590172,1,6,0
65404669@N02,8203,29,1347592746,1347592746,1,6,0
65404669@N02,8203,20,1347626868,1347629241,4,6,2373
65404669@N02,8204,3,1347670940,1347670940,1,3,0
65404669@N02,8204,28,1347693606,1347693607,2,3,1
65404669@N02,8204,20,1347705123,1347705123,1,3,0
65404669@N02,8205,18,1347758609,1347758609,1,3,0
65404669@N02,8205,23,1347758607,1347758607,1,3,0
65404669@N02,8205,30,1347763680,1347763963,2,3,283
65404669@N02,8206,28,1355894491,1355894491,1,1,0
65404669@N02,8207,1,1355993218,1355993218,1,2,0
65404669@N02,8207,29,1355992375,1355992375,1,2,0
65404669@N02,8208,3,1356065499,1356065499,1,2,0
65404669@N02,8208,4,1356049844,1356049844,1,2,0
65429311@N03,8209,28,1357171132,1357171132,1,1,0
65437859@N00,8210,26,1282383112,1282425322,12,1,42210
65515841@N05,8211,26,1299299560,1299299560,1,1,0
65515841@N05,8212,26,1351067721,1351067721,1,1,0
65515841@N05,8213,18,1372315982,1372316009,2,1,27
65515841@N05,8214,3,1374480566,1374481243,2,5,677
65515841@N05,8214,1,1374461212,1374473614,10,5,12402
65515841@N05,8214,17,1374476236,1374476236,1,5,0
65515841@N05,8214,12,1374480752,1374480752,1,5,0
65515841@N05,8214,26,1374480694,1374480694,1,5,0
65515841@N05,8215,17,1376557371,1376557371,1,1,0
65515841@N05,8216,17,1379313967,1379313967,1,3,0
65515841@N05,8216,28,1379307969,1379307969,1,3,0
65515841@N05,8216,14,1379311579,1379311579,1,3,0
65515841@N05,8217,30,1380095247,1380095247,1,3,0
65515841@N05,8217,26,1380095534,1380095534,1,3,0
65515841@N05,8217,3,1380096426,1380096426,1,3,0
65515841@N05,8218,17,1380948515,1380948526,2,1,11
65515841@N05,8219,16,1382576935,1382576935,1,2,0
65515841@N05,8219,23,1382581823,1382581823,1,2,0
65543500@N00,8220,12,1445988336,1445988349,2,12,13
65543500@N00,8220,26,1445999581,1445999650,2,12,69
65543500@N00,8220,13,1445993978,1445994173,4,12,195
65543500@N00,8220,5,1446007295,1446007295,1,12,0
65543500@N00,8220,20,1446004598,1446012803,2,12,8205
65543500@N00,8220,1,1445982404,1445997450,3,12,15046
65543500@N00,8220,16,1445985891,1445985891,1,12,0
65543500@N00,8220,30,1445989970,1445989970,1,12,0
65543500@N00,8220,31,1446009574,1446009574,1,12,0
65543500@N00,8220,29,1445990452,1445990452,1,12,0
65543500@N00,8220,28,1445985258,1445985275,2,12,17
65543500@N00,8220,25,1445988708,1445988721,2,12,13
65616340@N03,8221,3,1366174542,1366174542,1,2,0
65616340@N03,8221,7,1366176021,1366194622,2,2,18601
65627981@N06,8222,14,1412069035,1412069035,1,2,0
65627981@N06,8222,19,1412063734,1412095004,2,2,31270
65645597@N00,8223,16,1442049514,1442049514,2,6,0
65645597@N00,8223,1,1442017519,1442017612,2,6,93
65645597@N00,8223,26,1442049634,1442059771,6,6,10137
65645597@N00,8223,27,1442019015,1442032598,2,6,13583
65645597@N00,8223,20,1442043023,1442044300,3,6,1277
65645597@N00,8223,25,1442022051,1442023906,3,6,1855
65651806@N00,8224,26,1293539907,1293539907,1,5,0
65651806@N00,8224,16,1293530910,1293530910,1,5,0
65651806@N00,8224,29,1293527354,1293527354,1,5,0
65651806@N00,8224,17,1293528447,1293528903,2,5,456
65651806@N00,8224,20,1293537357,1293537357,1,5,0
65679275@N02,8225,27,1311674050,1311674050,1,1,0
65679275@N02,8226,1,1369295341,1369295341,1,3,0
65679275@N02,8226,13,1369296649,1369298916,3,3,2267
65679275@N02,8226,7,1369304234,1369304234,1,3,0
65679275@N02,8227,1,1369334398,1369340176,2,3,5778
65679275@N02,8227,28,1369341962,1369341962,1,3,0
65679275@N02,8227,26,1369337421,1369337421,1,3,0
65679275@N02,8228,26,1369401498,1369401498,1,2,0
65679275@N02,8228,13,1369406261,1369406261,1,2,0
65679275@N02,8229,1,1369439647,1369439647,1,1,0
65679275@N02,8230,1,1369638974,1369638974,1,1,0
65679275@N02,8231,1,1377996104,1377996104,1,1,0
65679275@N02,8232,28,1380077846,1380077846,1,1,0
65717496@N00,8233,18,1443699132,1443699132,1,1,0
65717496@N00,8234,18,1448695130,1448695130,1,1,0
65717496@N00,8235,23,1463702601,1463702601,1,1,0
65784570@N00,8236,5,1336806107,1336806107,1,1,0
65784570@N00,8237,1,1404703107,1404703107,1,1,0
65806304@N05,8238,25,1421117264,1421117264,1,1,0
65806304@N05,8239,18,1421208184,1421208184,1,1,0
65873732@N05,8240,1,1364343666,1364343666,1,1,0
65883612@N08,8241,16,1362267368,1362268145,4,4,777
65883612@N08,8241,19,1362270887,1362270887,1,4,0
65883612@N08,8241,23,1362275400,1362275421,2,4,21
65883612@N08,8241,8,1362279812,1362279812,1,4,0
65883612@N08,8242,12,1362472444,1362472444,1,1,0
65883612@N08,8243,18,1362551847,1362551847,1,1,0
65883612@N08,8244,13,1362618951,1362618951,1,5,0
65883612@N08,8244,19,1362632922,1362632971,3,5,49
65883612@N08,8244,16,1362629191,1362629195,2,5,4
65883612@N08,8244,22,1362623281,1362623334,2,5,53
65883612@N08,8244,25,1362638602,1362638602,1,5,0
65886790@N05,8245,26,1415246901,1415246901,1,1,0
65925308@N02,8246,1,1373406617,1373406617,1,1,0
65925308@N02,8247,13,1374101403,1374101403,1,2,0
65925308@N02,8247,27,1374101528,1374101528,1,2,0
65925308@N02,8248,1,1374439327,1374439327,1,1,0
65925308@N02,8249,1,1374482296,1374482296,1,1,0
65925308@N02,8250,29,1374960034,1374960034,1,1,0
65925308@N02,8251,1,1375955948,1375956783,2,1,835
65925308@N02,8252,13,1376174896,1376174896,1,1,0
65925308@N02,8253,1,1376260193,1376260193,1,1,0
65925308@N02,8254,1,1377985643,1377985643,1,1,0
65925308@N02,8255,14,1378065992,1378065992,1,1,0
65925647@N08,8256,17,1380478144,1380478144,1,1,0
65927504@N05,8257,26,1313981429,1313981429,1,1,0
65932457@N03,8258,30,1314685907,1314685907,1,1,0
65932457@N03,8259,30,1319433460,1319433460,1,1,0
65943028@N03,8260,26,1290684663,1290684663,1,1,0
65945527@N00,8261,29,1205134371,1205134371,1,4,0
65945527@N00,8261,28,1205134361,1205134361,1,4,0
65945527@N00,8261,31,1205134390,1205134390,1,4,0
65945527@N00,8261,26,1205134367,1205134367,1,4,0
65945527@N00,8262,20,1205191155,1205191155,1,3,0
65945527@N00,8262,28,1205191170,1205191170,1,3,0
65945527@N00,8262,26,1205191165,1205191180,2,3,15
65945527@N00,8263,20,1205288312,1205288312,1,3,0
65945527@N00,8263,31,1205288291,1205288543,2,3,252
65945527@N00,8263,26,1205312290,1205312290,1,3,0
65959869@N08,8264,21,1343004301,1343004685,2,4,384
65959869@N08,8264,13,1343005227,1343005227,1,4,0
65959869@N08,8264,18,1343024381,1343024381,1,4,0
65959869@N08,8264,1,1343003125,1343003125,1,4,0
65959869@N08,8265,12,1343266641,1343266641,1,3,0
65959869@N08,8265,11,1343268817,1343268817,1,3,0
65959869@N08,8265,20,1343276119,1343276119,2,3,0
65975121@N07,8266,17,1431250999,1431250999,1,1,0
65977111@N03,8267,31,1351762964,1351762999,2,1,35
65977111@N03,8268,22,1380001302,1380001302,1,3,0
65977111@N03,8268,27,1380008729,1380008830,4,3,101
65977111@N03,8268,16,1380008689,1380008778,2,3,89
65997263@N08,8269,28,1352934230,1352934230,1,2,0
65997263@N08,8269,22,1352935150,1352935150,1,2,0
66008314@N00,8270,28,1216525426,1216525426,1,1,0
66008314@N00,8271,17,1223078105,1223078105,1,3,0
66008314@N00,8271,22,1223093127,1223093164,4,3,37
66008314@N00,8271,28,1223096789,1223104440,3,3,7651
66008314@N00,8272,28,1230860982,1230860982,1,1,0
66008314@N00,8273,26,1233453663,1233453783,2,3,120
66008314@N00,8273,23,1233463235,1233463235,1,3,0
66008314@N00,8273,28,1233453467,1233453467,1,3,0
66008314@N00,8274,26,1258179777,1258179777,1,1,0
66008314@N00,8275,26,1275085476,1275085476,1,3,0
66008314@N00,8275,30,1275080624,1275111481,4,3,30857
66008314@N00,8275,28,1275094119,1275094119,1,3,0
66008314@N00,8276,30,1275141058,1275141058,1,1,0
66008314@N00,8277,30,1275179153,1275179200,2,1,47
66008314@N00,8278,1,1292662953,1292663604,3,6,651
66008314@N00,8278,26,1292659978,1292659978,1,6,0
66008314@N00,8278,25,1292628001,1292630527,5,6,2526
66008314@N00,8278,13,1292629154,1292631699,3,6,2545
66008314@N00,8278,30,1292635763,1292636168,3,6,405
66008314@N00,8278,28,1292666191,1292666199,2,6,8
66008314@N00,8279,17,1314409904,1314409904,1,3,0
66008314@N00,8279,14,1314416221,1314416221,1,3,0
66008314@N00,8279,28,1314404856,1314404856,1,3,0
66008314@N00,8280,1,1319260479,1319260479,1,3,0
66008314@N00,8280,26,1319248744,1319248744,1,3,0
66008314@N00,8280,24,1319261405,1319261405,1,3,0
66008314@N00,8281,17,1321062512,1321062512,1,1,0
66008314@N00,8282,30,1322951844,1322952134,2,1,290
66008314@N00,8283,14,1342319664,1342319664,1,2,0
66008314@N00,8283,29,1342320139,1342320139,1,2,0
66008314@N00,8284,3,1349475096,1349475096,2,4,0
66008314@N00,8284,12,1349476124,1349476124,2,4,0
66008314@N00,8284,30,1349484918,1349486255,4,4,1337
66008314@N00,8284,17,1349472607,1349472607,2,4,0
66026223@N08,8285,26,1377425422,1377425687,2,1,265
66026223@N08,8286,1,1377959352,1377959352,1,1,0
66026223@N08,8287,26,1378011021,1378011212,2,4,191
66026223@N08,8287,13,1378034342,1378034342,1,4,0
66026223@N08,8287,16,1378010803,1378012152,2,4,1349
66026223@N08,8287,3,1378010600,1378010600,1,4,0
66026223@N08,8288,13,1378087987,1378087987,1,2,0
66026223@N08,8288,28,1378087689,1378087689,1,2,0
66026223@N08,8289,29,1378121730,1378121730,1,3,0
66026223@N08,8289,14,1378120265,1378121859,2,3,1594
66026223@N08,8289,20,1378121548,1378121548,1,3,0
66026223@N08,8290,24,1378394177,1378394344,2,2,167
66026223@N08,8290,13,1378393819,1378393819,1,2,0
66026223@N08,8291,20,1382745213,1382745213,1,1,0
66026223@N08,8292,20,1383051977,1383051977,1,2,0
66026223@N08,8292,26,1383051777,1383051777,1,2,0
66026985@N02,8293,26,1367374638,1367374638,1,4,0
66026985@N02,8293,17,1367380089,1367380089,1,4,0
66026985@N02,8293,27,1367380012,1367380134,3,4,122
66026985@N02,8293,28,1367372999,1367379998,6,4,6999
66051919@N00,8294,30,1223695980,1223695980,1,1,0
66056796@N04,8295,1,1418642239,1418642239,1,1,0
66064257@N08,8296,19,1409373141,1409383948,3,1,10807
66064257@N08,8297,18,1428914958,1428914958,1,1,0
66087520@N05,8298,23,1375664407,1375664407,1,1,0
66087520@N05,8299,5,1375695003,1375695003,1,1,0
66103198@N07,8300,1,1386830517,1386830517,1,1,0
66234998@N00,8301,28,1292555344,1292555344,1,1,0
66234998@N00,8302,28,1297047072,1297047072,1,1,0
66234998@N00,8303,20,1298350693,1298350693,1,1,0
66234998@N00,8304,29,1305431640,1305431640,1,1,0
66234998@N00,8305,27,1307843974,1307851240,2,1,7266
66292766@N05,8306,24,1451614627,1451614627,1,1,0
66304943@N00,8307,17,1196769211,1196769211,1,1,0
66304943@N00,8308,28,1319959089,1319959089,1,1,0
66309654@N00,8309,18,1421499600,1421499600,1,1,0
66313469@N06,8310,18,1310749836,1310749836,1,2,0
66313469@N06,8310,27,1310738378,1310738378,1,2,0
66313469@N06,8311,1,1310816913,1310816913,1,3,0
66313469@N06,8311,26,1310821463,1310821463,1,3,0
66313469@N06,8311,28,1310817254,1310817382,2,3,128
66313469@N06,8312,1,1313123876,1313123876,1,1,0
66313469@N06,8313,15,1314080189,1314080189,1,1,0
66313469@N06,8314,21,1316242310,1316242310,1,2,0
66313469@N06,8314,26,1316241682,1316241682,2,2,0
66313469@N06,8315,26,1317516096,1317516096,1,1,0
66313469@N06,8316,26,1329904390,1329925978,6,2,21588
66313469@N06,8316,10,1329908784,1329909117,3,2,333
66313469@N06,8317,26,1329997521,1329998973,11,1,1452
66316766@N06,8318,25,1350104873,1350105127,2,1,254
66316766@N06,8319,1,1350627459,1350627459,1,2,0
66316766@N06,8319,28,1350627319,1350627409,3,2,90
66316766@N06,8320,29,1350800337,1350800337,1,1,0
66316766@N06,8321,1,1351491063,1351491063,1,2,0
66316766@N06,8321,14,1351472175,1351472175,1,2,0
66316766@N06,8322,28,1351909368,1351909370,2,3,2
66316766@N06,8322,1,1351901659,1351904396,9,3,2737
66316766@N06,8322,16,1351899712,1351899903,4,3,191
66316766@N06,8323,1,1352533092,1352533142,2,1,50
66316766@N06,8324,25,1352610486,1352610616,2,1,130
66316766@N06,8325,1,1353209058,1353209058,1,1,0
66316766@N06,8326,29,1353812528,1353812528,1,1,0
66316766@N06,8327,29,1354002554,1354002554,1,1,0
66316766@N06,8328,16,1354330046,1354330046,1,1,0
66316766@N06,8329,28,1354404282,1354404282,1,1,0
66316766@N06,8330,1,1354672987,1354674618,5,2,1631
66316766@N06,8330,28,1354672994,1354680284,4,2,7290
66316766@N06,8331,22,1356752200,1356752200,1,3,0
66316766@N06,8331,14,1356745019,1356745969,4,3,950
66316766@N06,8331,1,1356759479,1356759479,1,3,0
66316766@N06,8332,13,1357356771,1357367376,5,1,10605
66316766@N06,8333,21,1357868029,1357868029,1,2,0
66316766@N06,8333,31,1357869929,1357869929,1,2,0
66316766@N06,8334,25,1358150686,1358150686,1,1,0
66316766@N06,8335,29,1358480782,1358480782,1,1,0
66316766@N06,8336,18,1358829989,1358829989,1,3,0
66316766@N06,8336,31,1358829981,1358829981,1,3,0
66316766@N06,8336,28,1358829987,1358829987,1,3,0
66316766@N06,8337,26,1359866405,1359866405,1,1,0
66316766@N06,8338,25,1360052094,1360052094,1,2,0
66316766@N06,8338,28,1360053003,1360053016,5,2,13
66316766@N06,8339,26,1360480590,1360480590,1,1,0
66316766@N06,8340,21,1360644917,1360644917,1,1,0
66316766@N06,8341,20,1360805531,1360805531,1,3,0
66316766@N06,8341,28,1360805664,1360805676,3,3,12
66316766@N06,8341,29,1360823366,1360823366,1,3,0
66316766@N06,8342,11,1364102445,1364102445,1,2,0
66316766@N06,8342,25,1364102452,1364102452,1,2,0
66316766@N06,8343,28,1365060850,1365060850,1,1,0
66316766@N06,8344,31,1365124276,1365124276,1,1,0
66316766@N06,8345,11,1366358450,1366358450,1,2,0
66316766@N06,8345,12,1366347437,1366347437,1,2,0
66316766@N06,8346,13,1367301750,1367301757,2,1,7
66316766@N06,8347,20,1368345981,1368345981,1,6,0
66316766@N06,8347,30,1368321679,1368321679,1,6,0
66316766@N06,8347,11,1368332447,1368332447,1,6,0
66316766@N06,8347,16,1368320640,1368320640,1,6,0
66316766@N06,8347,29,1368315551,1368315551,1,6,0
66316766@N06,8347,26,1368335320,1368335320,3,6,0
66316766@N06,8348,11,1369615079,1369618233,3,3,3154
66316766@N06,8348,21,1369616983,1369616983,1,3,0
66316766@N06,8348,25,1369616508,1369616508,1,3,0
66316766@N06,8349,30,1369809074,1369809074,1,2,0
66316766@N06,8349,11,1369800545,1369800545,1,2,0
66316766@N06,8350,31,1370327594,1370327594,1,2,0
66316766@N06,8350,10,1370327834,1370327834,1,2,0
66316766@N06,8351,11,1370395058,1370395058,1,1,0
66352349@N00,8352,28,1339496012,1339496012,1,1,0
66382450@N08,8353,1,1369419648,1369419648,1,1,0
66390033@N02,8354,1,1283984180,1283984180,1,1,0
66390033@N02,8355,1,1284122749,1284122749,1,1,0
66390033@N02,8356,1,1402221600,1402221604,2,1,4
66406888@N08,8357,29,1257229568,1257229568,1,1,0
66406888@N08,8358,31,1285659716,1285659716,1,2,0
66406888@N08,8358,30,1285656129,1285656129,1,2,0
66406888@N08,8359,30,1321670789,1321670789,1,1,0
66406888@N08,8360,24,1338249862,1338249862,1,1,0
66406888@N08,8361,29,1342767490,1342767490,1,1,0
66406888@N08,8362,1,1344673034,1344673034,1,1,0
66406888@N08,8363,1,1347574157,1347574157,1,1,0
66406888@N08,8364,1,1352969091,1352969091,1,1,0
66406888@N08,8365,1,1369239847,1369239847,1,1,0
66565233@N00,8366,11,1227322832,1227322832,1,1,0
66565233@N00,8367,5,1258793330,1258793330,1,1,0
66626762@N06,8368,1,1418479010,1418479010,1,1,0
66626894@N06,8369,22,1345440216,1345440216,1,2,0
66626894@N06,8369,28,1345462406,1345462967,2,2,561
66729316@N00,8370,28,1253920361,1253925826,2,1,5465
66729316@N00,8371,13,1253971027,1253971114,3,1,87
66729316@N00,8372,28,1254179328,1254179719,2,1,391
66729316@N00,8373,13,1254242484,1254265524,7,1,23040
66729316@N00,8374,13,1306122221,1306122779,4,3,558
66729316@N00,8374,12,1306110357,1306112095,4,3,1738
66729316@N00,8374,26,1306114824,1306120069,12,3,5245
66729316@N00,8375,13,1306283914,1306284023,5,3,109
66729316@N00,8375,15,1306301842,1306301842,1,3,0
66729316@N00,8375,26,1306281186,1306299761,4,3,18575
66729316@N00,8376,13,1306379218,1306379318,7,6,100
66729316@N00,8376,28,1306364192,1306364192,1,6,0
66729316@N00,8376,15,1306372134,1306378795,11,6,6661
66729316@N00,8376,12,1306379865,1306380508,2,6,643
66729316@N00,8376,24,1306370777,1306370777,1,6,0
66729316@N00,8376,26,1306366011,1306397938,3,6,31927
66729316@N00,8377,16,1306456438,1306456438,1,3,0
66729316@N00,8377,22,1306472066,1306474979,7,3,2913
66729316@N00,8377,26,1306454828,1306503383,11,3,48555
66729316@N00,8378,13,1306538002,1306542040,28,5,4038
66729316@N00,8378,22,1306549337,1306549337,1,5,0
66729316@N00,8378,12,1306536008,1306536008,1,5,0
66729316@N00,8378,26,1306544451,1306549326,3,5,4875
66729316@N00,8378,3,1306535995,1306535995,1,5,0
66729316@N00,8379,13,1306594856,1306612558,21,2,17702
66729316@N00,8379,26,1306592206,1306612607,5,2,20401
66729316@N00,8380,27,1343980070,1343980070,1,2,0
66729316@N00,8380,1,1343976860,1343976860,1,2,0
66729316@N00,8381,15,1344040673,1344043095,12,5,2422
66729316@N00,8381,24,1344040577,1344043124,3,5,2547
66729316@N00,8381,11,1344071972,1344077723,2,5,5751
66729316@N00,8381,1,1344037453,1344037471,3,5,18
66729316@N00,8381,17,1344052083,1344052083,1,5,0
66729316@N00,8382,14,1344143019,1344143019,1,1,0
66736603@N00,8383,15,1390611244,1390611244,1,1,0
66787548@N00,8384,26,1298167248,1298167248,1,2,0
66787548@N00,8384,20,1298162601,1298162601,1,2,0
66787548@N00,8385,12,1299045390,1299045390,1,9,0
66787548@N00,8385,17,1299044042,1299044042,1,9,0
66787548@N00,8385,13,1299047559,1299047689,2,9,130
66787548@N00,8385,25,1299049518,1299049791,2,9,273
66787548@N00,8385,15,1299050521,1299050521,1,9,0
66787548@N00,8385,18,1299027141,1299027141,1,9,0
66787548@N00,8385,23,1299031048,1299031048,1,9,0
66787548@N00,8385,3,1299039681,1299040282,2,9,601
66787548@N00,8385,20,1299032233,1299032233,1,9,0
66787548@N00,8386,12,1306026038,1306026038,1,1,0
66787548@N00,8387,28,1355547943,1355553542,2,2,5599
66787548@N00,8387,18,1355549536,1355549536,1,2,0
66787548@N00,8388,28,1356662459,1356662459,1,3,0
66787548@N00,8388,25,1356680521,1356680521,1,3,0
66787548@N00,8388,7,1356673082,1356673082,1,3,0
66787548@N00,8389,15,1358152806,1358152806,1,6,0
66787548@N00,8389,18,1358127934,1358127934,1,6,0
66787548@N00,8389,30,1358141056,1358141056,1,6,0
66787548@N00,8389,26,1358125495,1358132151,2,6,6656
66787548@N00,8389,1,1358123456,1358123456,1,6,0
66787548@N00,8389,7,1358148419,1358148419,1,6,0
66787548@N00,8390,28,1361424342,1361424342,1,3,0
66787548@N00,8390,20,1361428720,1361428720,1,3,0
66787548@N00,8390,29,1361431134,1361431134,1,3,0
66787548@N00,8391,1,1368178817,1368178817,1,3,0
66787548@N00,8391,28,1368185368,1368185368,1,3,0
66787548@N00,8391,10,1368186945,1368186945,1,3,0
66801522@N00,8392,28,1248169703,1248169703,1,1,0
66854904@N06,8393,19,1346417620,1346417620,1,1,0
66905940@N00,8394,15,1359074046,1359074046,1,3,0
66905940@N00,8394,29,1359075463,1359075463,1,3,0
66905940@N00,8394,23,1359100063,1359100063,1,3,0
66905940@N00,8395,29,1359160105,1359160105,1,3,0
66905940@N00,8395,15,1359171526,1359171919,2,3,393
66905940@N00,8395,26,1359189589,1359193701,2,3,4112
66905940@N00,8396,13,1359247564,1359247564,1,1,0
66915962@N00,8397,3,1345747483,1345747483,1,1,0
66926478@N00,8398,28,1237331641,1237369388,8,1,37747
66926478@N00,8399,28,1252280822,1252291065,3,1,10243
66926478@N00,8400,28,1256167579,1256170504,4,1,2925
66976172@N00,8401,30,1376435181,1376435181,1,2,0
66976172@N00,8401,13,1376458312,1376458312,1,2,0
66994870@N00,8402,7,1236831579,1236832076,2,4,497
66994870@N00,8402,26,1236824535,1236849101,12,4,24566
66994870@N00,8402,1,1236823969,1236838148,6,4,14179
66994870@N00,8402,28,1236838356,1236838376,2,4,20
66994870@N00,8403,29,1256688533,1256688533,1,8,0
66994870@N00,8403,1,1256686228,1256712430,10,8,26202
66994870@N00,8403,3,1256698356,1256698517,2,8,161
66994870@N00,8403,20,1256693026,1256693061,2,8,35
66994870@N00,8403,11,1256696925,1256696972,2,8,47
66994870@N00,8403,8,1256698127,1256702450,2,8,4323
66994870@N00,8403,28,1256702837,1256711828,4,8,8991
66994870@N00,8403,23,1256687292,1256688379,2,8,1087
67011795@N00,8404,13,1364176502,1364176502,1,2,0
67011795@N00,8404,4,1364200424,1364200424,1,2,0
67011795@N00,8405,17,1364298342,1364298342,1,1,0
67011795@N00,8406,26,1364387870,1364387870,1,2,0
67011795@N00,8406,3,1364366795,1364366795,1,2,0
67066894@N00,8407,18,1450306680,1450306680,1,1,0
67093054@N00,8408,26,1367119068,1367129810,6,15,10742
67093054@N00,8408,6,1367121264,1367121354,2,15,90
67093054@N00,8408,16,1367116646,1367130604,4,15,13958
67093054@N00,8408,23,1367116713,1367118415,6,15,1702
67093054@N00,8408,29,1367123917,1367128077,7,15,4160
67093054@N00,8408,21,1367130215,1367130215,1,15,0
67093054@N00,8408,1,1367115883,1367135892,5,15,20009
67093054@N00,8408,28,1367116078,1367116092,2,15,14
67093054@N00,8408,31,1367122342,1367122342,1,15,0
67093054@N00,8408,17,1367132319,1367132369,3,15,50
67093054@N00,8408,11,1367122013,1367122013,1,15,0
67093054@N00,8408,12,1367130391,1367130408,3,15,17
67093054@N00,8408,30,1367122451,1367122525,2,15,74
67093054@N00,8408,5,1367130187,1367130187,1,15,0
67093054@N00,8408,20,1367128081,1367128670,3,15,589
67093054@N00,8409,1,1367209935,1367209935,1,1,0
67093054@N00,8410,19,1394367096,1394367326,3,14,230
67093054@N00,8410,14,1394366353,1394366353,1,14,0
67093054@N00,8410,18,1394340066,1394340604,2,14,538
67093054@N00,8410,30,1394350444,1394350487,3,14,43
67093054@N00,8410,31,1394349383,1394366881,6,14,17498
67093054@N00,8410,17,1394353104,1394353142,3,14,38
67093054@N00,8410,27,1394350840,1394352298,8,14,1458
67093054@N00,8410,28,1394336660,1394356311,13,14,19651
67093054@N00,8410,16,1394336902,1394355966,11,14,19064
67093054@N00,8410,20,1394347374,1394349189,10,14,1815
67093054@N00,8410,23,1394339279,1394353430,7,14,14151
67093054@N00,8410,3,1394337861,1394337861,1,14,0
67093054@N00,8410,26,1394338120,1394367574,13,14,29454
67093054@N00,8410,29,1394341362,1394366051,25,14,24689
67123974@N05,8411,30,1350029036,1350029036,1,1,0
67156975@N00,8412,28,1292301175,1292301175,1,2,0
67156975@N00,8412,22,1292301342,1292301342,1,2,0
67232196@N07,8413,22,1361581927,1361581927,1,2,0
67232196@N07,8413,12,1361572386,1361572386,1,2,0
67232196@N07,8414,25,1387528760,1387528760,1,1,0
67234205@N05,8415,18,1311507250,1311507250,1,1,0
67246822@N00,8416,29,1211419711,1211419711,1,7,0
67246822@N00,8416,12,1211411330,1211411330,1,7,0
67246822@N00,8416,10,1211415208,1211415208,1,7,0
67246822@N00,8416,3,1211412293,1211412293,1,7,0
67246822@N00,8416,26,1211424891,1211425314,2,7,423
67246822@N00,8416,20,1211416448,1211416621,2,7,173
67246822@N00,8416,16,1211411316,1211411316,1,7,0
67246822@N00,8417,29,1211522100,1211522100,1,4,0
67246822@N00,8417,28,1211521270,1211521270,1,4,0
67246822@N00,8417,26,1211518917,1211519064,2,4,147
67246822@N00,8417,19,1211521932,1211521932,1,4,0
67246822@N00,8418,29,1237850668,1237859913,4,10,9245
67246822@N00,8418,10,1237875824,1237875824,1,10,0
67246822@N00,8418,3,1237878743,1237878743,1,10,0
67246822@N00,8418,30,1237865122,1237886726,3,10,21604
67246822@N00,8418,1,1237846959,1237874260,2,10,27301
67246822@N00,8418,26,1237874561,1237882827,8,10,8266
67246822@N00,8418,20,1237863007,1237863915,5,10,908
67246822@N00,8418,23,1237848423,1237848423,1,10,0
67246822@N00,8418,7,1237879739,1237880217,2,10,478
67246822@N00,8418,25,1237876920,1237877136,3,10,216
67246822@N00,8419,12,1237958660,1237960022,3,6,1362
67246822@N00,8419,24,1237958972,1237958972,1,6,0
67246822@N00,8419,5,1237960303,1237960605,2,6,302
67246822@N00,8419,28,1237961500,1237961500,1,6,0
67246822@N00,8419,26,1237961399,1237961399,1,6,0
67246822@N00,8419,17,1237954432,1237954432,1,6,0
67246822@N00,8420,3,1238059433,1238059433,1,3,0
67246822@N00,8420,28,1238063494,1238063494,1,3,0
67246822@N00,8420,20,1238062197,1238062197,1,3,0
67246822@N00,8421,10,1238115967,1238115967,1,5,0
67246822@N00,8421,5,1238121445,1238121445,1,5,0
67246822@N00,8421,22,1238117502,1238117825,2,5,323
67246822@N00,8421,8,1238120778,1238120799,2,5,21
67246822@N00,8421,20,1238113498,1238114647,5,5,1149
67246822@N00,8422,23,1238372912,1238372912,1,1,0
67246822@N00,8423,28,1355109025,1355109025,1,1,0
67246822@N00,8424,29,1355190841,1355190841,1,2,0
67246822@N00,8424,26,1355183190,1355183190,1,2,0
67246822@N00,8425,26,1355292664,1355293107,2,3,443
67246822@N00,8425,20,1355291318,1355291318,1,3,0
67246822@N00,8425,29,1355291645,1355291849,2,3,204
67246822@N00,8426,17,1355373823,1355373823,1,2,0
67246822@N00,8426,28,1355374949,1355374949,1,2,0
67252708@N03,8427,1,1277170199,1277170199,1,1,0
67260043@N04,8428,1,1324724606,1324725519,2,2,913
67260043@N04,8428,28,1324724684,1324725256,6,2,572
67260043@N04,8429,29,1324777263,1324777549,2,10,286
67260043@N04,8429,8,1324785245,1324785245,1,10,0
67260043@N04,8429,10,1324784298,1324784298,1,10,0
67260043@N04,8429,6,1324785171,1324785171,1,10,0
67260043@N04,8429,26,1324785471,1324785596,3,10,125
67260043@N04,8429,23,1324786206,1324788869,6,10,2663
67260043@N04,8429,1,1324772861,1324773750,5,10,889
67260043@N04,8429,20,1324776593,1324780323,4,10,3730
67260043@N04,8429,18,1324775448,1324786237,2,10,10789
67260043@N04,8429,30,1324786427,1324789176,3,10,2749
67260043@N04,8430,27,1324902412,1324902810,4,8,398
67260043@N04,8430,26,1324865468,1324903144,9,8,37676
67260043@N04,8430,5,1324891926,1324891926,1,8,0
67260043@N04,8430,28,1324903856,1324903922,3,8,66
67260043@N04,8430,24,1324867669,1324871369,2,8,3700
67260043@N04,8430,25,1324895263,1324895309,2,8,46
67260043@N04,8430,8,1324892073,1324893400,2,8,1327
67260043@N04,8430,16,1324902249,1324902372,2,8,123
67341227@N00,8431,26,1198302375,1198310216,10,6,7841
67341227@N00,8431,4,1198311831,1198311831,1,6,0
67341227@N00,8431,16,1198301890,1198301890,1,6,0
67341227@N00,8431,25,1198311209,1198311613,2,6,404
67341227@N00,8431,23,1198301050,1198301154,2,6,104
67341227@N00,8431,24,1198287277,1198290336,7,6,3059
67406704@N00,8432,16,1291183824,1291183824,1,4,0
67406704@N00,8432,26,1291160432,1291160432,1,4,0
67406704@N00,8432,28,1291183544,1291183638,3,4,94
67406704@N00,8432,7,1291165219,1291165219,1,4,0
67414260@N04,8433,15,1359866354,1359866354,1,3,0
67414260@N04,8433,17,1359893878,1359894222,3,3,344
67414260@N04,8433,26,1359893853,1359893853,1,3,0
67429254@N08,8434,1,1451019555,1451019555,1,1,0
67457152@N03,8435,22,1324725489,1324726853,2,1,1364
67485853@N00,8436,26,1305510996,1305536367,20,1,25371
67506747@N00,8437,13,1239089219,1239089509,4,2,290
67506747@N00,8437,17,1239093642,1239093642,1,2,0
67506747@N00,8438,24,1262259027,1262259027,1,1,0
67507070@N00,8439,28,1311681754,1311681880,2,1,126
67511235@N04,8440,11,1341013865,1341013865,1,1,0
67527114@N03,8441,22,1350667950,1350667950,1,1,0
67582642@N00,8442,26,1251801704,1251801704,1,1,0
67601202@N00,8443,10,1189824686,1189824686,1,2,0
67601202@N00,8443,31,1189825234,1189828376,3,2,3142
67621043@N00,8444,28,1314151205,1314151205,1,4,0
67621043@N00,8444,20,1314160834,1314160834,1,4,0
67621043@N00,8444,29,1314157048,1314159659,2,4,2611
67621043@N00,8444,26,1314151760,1314151760,1,4,0
67621043@N00,8445,28,1438260042,1438260042,1,1,0
67621043@N00,8446,18,1438404317,1438404317,1,1,0
67671102@N00,8447,29,1351904019,1351904019,1,1,0
67694478@N02,8448,26,1356508190,1356508648,2,1,458
67694478@N02,8449,26,1356639956,1356639956,1,1,0
67694478@N02,8450,26,1356772021,1356777729,2,1,5708
67764891@N00,8451,25,1259547315,1259549524,3,1,2209
67839741@N06,8452,1,1401851091,1401851091,1,1,0
67839741@N06,8453,27,1403142997,1403142997,1,1,0
67839741@N06,8454,18,1415576928,1415576928,1,2,0
67839741@N06,8454,19,1415576458,1415576458,1,2,0
67839741@N06,8455,13,1418866529,1418866529,1,1,0
67839741@N06,8456,18,1420236996,1420236996,1,1,0
67839741@N06,8457,31,1423110851,1423110851,1,1,0
67839741@N06,8458,29,1425363045,1425363045,1,1,0
67839741@N06,8459,13,1430210729,1430210729,1,1,0
67892147@N00,8460,16,1324534371,1324534371,1,1,0
67892147@N00,8461,16,1324594064,1324594064,1,3,0
67892147@N00,8461,29,1324594088,1324594088,1,3,0
67892147@N00,8461,24,1324594123,1324594123,1,3,0
67892147@N00,8462,16,1325463763,1325463776,2,4,13
67892147@N00,8462,15,1325463694,1325463694,1,4,0
67892147@N00,8462,23,1325463718,1325463718,1,4,0
67892147@N00,8462,1,1325463755,1325463755,1,4,0
67954857@N00,8463,1,1306303820,1306303820,1,1,0
67979847@N04,8464,1,1399697671,1399730609,6,1,32938
67994320@N00,8465,26,1270950949,1270950949,1,1,0
68002062@N06,8466,26,1337767517,1337767517,1,1,0
68016701@N04,8467,26,1357377880,1357377880,1,1,0
68092559@N06,8468,1,1381607370,1381607370,1,1,0
68092559@N06,8469,1,1381675601,1381676314,2,1,713
68092559@N06,8470,31,1381974698,1381974698,1,4,0
68092559@N06,8470,1,1381987520,1381987520,1,4,0
68092559@N06,8470,28,1381977020,1381977020,1,4,0
68092559@N06,8470,20,1381974426,1381974426,1,4,0
68092559@N06,8471,1,1382949591,1382949591,1,1,0
68092559@N06,8472,30,1395094614,1395094614,1,1,0
68092559@N06,8473,26,1399881844,1399887548,3,1,5704
68092559@N06,8474,19,1406089770,1406089770,1,1,0
68092559@N06,8475,18,1432298266,1432298366,2,1,100
68111040@N00,8476,18,1214273538,1214273538,1,4,0
68111040@N00,8476,16,1214300647,1214305598,3,4,4951
68111040@N00,8476,27,1214304763,1214304763,1,4,0
68111040@N00,8476,17,1214304745,1214304745,1,4,0
68111040@N00,8477,15,1216202604,1216203141,2,2,537
68111040@N00,8477,27,1216214770,1216214770,1,2,0
68111040@N00,8478,15,1247046971,1247046971,1,1,0
68126271@N03,8479,3,1388124892,1388124892,1,1,0
68126271@N03,8480,14,1388449846,1388449846,1,5,0
68126271@N03,8480,20,1388465959,1388465959,1,5,0
68126271@N03,8480,25,1388473999,1388474957,4,5,958
68126271@N03,8480,21,1388472899,1388472899,1,5,0
68126271@N03,8480,29,1388469478,1388469478,1,5,0
68126271@N03,8481,28,1419994834,1420031090,2,8,36256
68126271@N03,8481,25,1420027164,1420028206,2,8,1042
68126271@N03,8481,16,1420015866,1420015866,1,8,0
68126271@N03,8481,31,1420018982,1420018982,1,8,0
68126271@N03,8481,26,1419979813,1419979813,1,8,0
68126271@N03,8481,29,1419997287,1420016800,2,8,19513
68126271@N03,8481,18,1420030354,1420030354,1,8,0
68126271@N03,8481,3,1419982940,1419988298,2,8,5358
68126271@N03,8482,28,1431734609,1431734609,1,1,0
68154176@N00,8483,27,1337509470,1337509470,1,1,0
68154176@N00,8484,17,1367745729,1367745729,1,1,0
68154176@N00,8485,17,1379292998,1379292998,1,1,0
68181852@N07,8486,30,1317391200,1317391200,1,1,0
68181852@N07,8487,30,1318917291,1318918056,2,1,765
68181852@N07,8488,30,1320546712,1320546712,1,1,0
68208220@N08,8489,28,1322061104,1322061155,4,1,51
68217111@N00,8490,16,1322009040,1322010669,2,14,1629
68217111@N00,8490,21,1322019934,1322023740,9,14,3806
68217111@N00,8490,15,1322013377,1322020356,5,14,6979
68217111@N00,8490,30,1322008680,1322008680,1,14,0
68217111@N00,8490,6,1322025651,1322025651,1,14,0
68217111@N00,8490,3,1322023580,1322023726,5,14,146
68217111@N00,8490,27,1322010299,1322010299,1,14,0
68217111@N00,8490,1,1322007276,1322008693,11,14,1417
68217111@N00,8490,11,1322014262,1322014262,1,14,0
68217111@N00,8490,26,1322031645,1322031645,1,14,0
68217111@N00,8490,13,1322014144,1322022025,17,14,7881
68217111@N00,8490,24,1322013370,1322020283,8,14,6913
68217111@N00,8490,7,1322025401,1322025401,1,14,0
68217111@N00,8490,4,1322014150,1322014413,9,14,263
68217111@N00,8491,16,1326511943,1326520622,13,6,8679
68217111@N00,8491,15,1326506021,1326506021,1,6,0
68217111@N00,8491,27,1326505927,1326508931,2,6,3004
68217111@N00,8491,17,1326505950,1326508276,3,6,2326
68217111@N00,8491,26,1326501204,1326501204,1,6,0
68217111@N00,8491,28,1326509968,1326509973,3,6,5
68217111@N00,8492,11,1330217923,1330217935,3,5,12
68217111@N00,8492,1,1330209598,1330209598,1,5,0
68217111@N00,8492,13,1330214646,1330217150,16,5,2504
68217111@N00,8492,18,1330211715,1330211715,1,5,0
68217111@N00,8492,4,1330217823,1330218597,15,5,774
68217111@N00,8493,14,1333237899,1333237899,1,1,0
68255606@N00,8494,28,1358747424,1358747424,1,1,0
68276252@N06,8495,4,1337512321,1337512321,1,6,0
68276252@N06,8495,26,1337472781,1337517168,2,6,44387
68276252@N06,8495,16,1337472222,1337472222,1,6,0
68276252@N06,8495,28,1337471737,1337517080,24,6,45343
68276252@N06,8495,27,1337479635,1337479635,1,6,0
68276252@N06,8495,1,1337477805,1337517089,5,6,39284
68276252@N06,8496,28,1337569949,1337569949,1,1,0
68276252@N06,8497,28,1337601410,1337603597,3,2,2187
68276252@N06,8497,17,1337603912,1337603912,1,2,0
68276252@N06,8498,4,1337672384,1337672384,1,3,0
68276252@N06,8498,28,1337647795,1337679803,7,3,32008
68276252@N06,8498,21,1337649036,1337649036,1,3,0
68276252@N06,8499,13,1337743337,1337745520,2,1,2183
68276252@N06,8500,28,1345707363,1345708013,4,3,650
68276252@N06,8500,17,1345707859,1345707859,1,3,0
68276252@N06,8500,16,1345707227,1345707227,1,3,0
68276252@N06,8501,28,1349818623,1349818623,1,1,0
68313075@N02,8502,26,1342914583,1342914583,1,1,0
68324071@N07,8503,29,1328675209,1328675209,1,3,0
68324071@N07,8503,27,1328667405,1328667405,1,3,0
68324071@N07,8503,26,1328673902,1328673902,1,3,0
68356861@N03,8504,30,1324183375,1324183375,1,1,0
68398783@N00,8505,30,1261714360,1261714360,1,1,0
68431505@N00,8506,28,1281939281,1281939281,1,1,0
68431505@N00,8507,26,1283694487,1283694487,1,1,0
68619290@N02,8508,6,1318489164,1318489164,1,1,0
68753746@N00,8509,15,1451288754,1451288754,1,2,0
68753746@N00,8509,28,1451279445,1451279445,1,2,0
68769844@N07,8510,1,1429060396,1429077345,3,8,16949
68769844@N07,8510,26,1429072744,1429072744,1,8,0
68769844@N07,8510,30,1429069188,1429069188,1,8,0
68769844@N07,8510,29,1429064789,1429080638,2,8,15849
68769844@N07,8510,25,1429075881,1429075881,1,8,0
68769844@N07,8510,23,1429064586,1429064586,1,8,0
68769844@N07,8510,27,1429061403,1429076961,3,8,15558
68769844@N07,8510,16,1429082246,1429082246,1,8,0
68826320@N00,8511,26,1251435600,1251435602,3,1,2
68839278@N07,8512,16,1337134440,1337134440,1,1,0
68839278@N07,8513,14,1351650995,1351650995,1,1,0
68847360@N04,8514,18,1343856178,1343856178,1,1,0
68851654@N08,8515,26,1309694414,1309694414,1,2,0
68851654@N08,8515,16,1309688359,1309688359,1,2,0
68896886@N05,8516,13,1356604919,1356604919,1,2,0
68896886@N05,8516,10,1356610466,1356610466,1,2,0
68896886@N05,8517,29,1360294487,1360294487,1,2,0
68896886@N05,8517,10,1360299463,1360300119,2,2,656
68926559@N00,8518,17,1254029582,1254029582,1,1,0
68926559@N00,8519,3,1327806986,1327806986,1,2,0
68926559@N00,8519,28,1327803623,1327803623,1,2,0
68931954@N00,8520,31,1344316160,1344316171,2,16,11
68931954@N00,8520,15,1344306345,1344306519,4,16,174
68931954@N00,8520,20,1344299156,1344300852,7,16,1696
68931954@N00,8520,24,1344310650,1344312510,3,16,1860
68931954@N00,8520,29,1344298291,1344298912,3,16,621
68931954@N00,8520,21,1344303132,1344303258,2,16,126
68931954@N00,8520,28,1344291080,1344316537,2,16,25457
68931954@N00,8520,13,1344301330,1344301413,3,16,83
68931954@N00,8520,30,1344313989,1344314441,4,16,452
68931954@N00,8520,22,1344314582,1344314641,4,16,59
68931954@N00,8520,1,1344301935,1344302558,3,16,623
68931954@N00,8520,18,1344297694,1344309357,5,16,11663
68931954@N00,8520,12,1344306617,1344312604,4,16,5987
68931954@N00,8520,17,1344294928,1344295067,2,16,139
68931954@N00,8520,26,1344313633,1344313659,2,16,26
68931954@N00,8520,25,1344303709,1344303808,4,16,99
68946319@N00,8521,29,1297657416,1297657416,1,1,0
68947259@N00,8522,18,1299889992,1299889992,1,1,0
68947259@N00,8523,28,1366190595,1366201373,9,2,10778
68947259@N00,8523,27,1366187902,1366187902,1,2,0
68957137@N00,8524,16,1457243066,1457243066,1,1,0
68989113@N00,8525,31,1229044460,1229059536,12,1,15076
68989113@N00,8526,1,1252811232,1252811232,1,1,0
68989113@N00,8527,31,1272326143,1272326161,3,1,18
68989113@N00,8528,28,1291324852,1291324963,2,1,111
68989113@N00,8529,29,1303609847,1303609847,1,1,0
68989113@N00,8530,20,1320998147,1320998147,1,1,0
68989113@N00,8531,28,1323772380,1323772380,1,2,0
68989113@N00,8531,25,1323772247,1323772247,1,2,0
68989113@N00,8532,28,1325627123,1325627123,1,2,0
68989113@N00,8532,25,1325630093,1325631437,2,2,1344
68989113@N00,8533,28,1362468220,1362469005,2,1,785
68989113@N00,8534,29,1380159798,1380159798,1,1,0
68989113@N00,8535,28,1383255149,1383255149,1,1,0
69014672@N00,8536,17,1287643352,1287643352,1,5,0
69014672@N00,8536,30,1287640025,1287640025,1,5,0
69014672@N00,8536,1,1287642916,1287642916,1,5,0
69014672@N00,8536,29,1287640059,1287640059,1,5,0
69014672@N00,8536,28,1287646291,1287646291,1,5,0
69024677@N00,8537,26,1202104919,1202104919,1,2,0
69024677@N00,8537,13,1202096889,1202097384,4,2,495
69024677@N00,8538,19,1202204314,1202204543,2,4,229
69024677@N00,8538,1,1202203157,1202203157,1,4,0
69024677@N00,8538,29,1202185450,1202185815,3,4,365
69024677@N00,8538,28,1202186139,1202220018,4,4,33879
69026149@N00,8539,30,1298094009,1298094009,1,1,0
69026149@N00,8540,30,1298162320,1298182479,18,1,20159
69026149@N00,8541,30,1298247448,1298288443,29,1,40995
69031754@N06,8542,23,1446260686,1446260686,1,1,0
69031754@N06,8543,17,1446296863,1446296863,1,1,0
69036873@N00,8544,10,1303710360,1303730341,7,1,19981
69036873@N00,8545,10,1310487214,1310487658,2,1,444
69074591@N00,8546,26,1444309584,1444309584,1,1,0
69111988@N07,8547,27,1366798299,1366798299,1,1,0
69114926@N00,8548,21,1321588516,1321590193,5,7,1677
69114926@N00,8548,5,1321592110,1321595668,12,7,3558
69114926@N00,8548,20,1321581360,1321581360,1,7,0
69114926@N00,8548,25,1321590100,1321590148,2,7,48
69114926@N00,8548,3,1321563354,1321595952,29,7,32598
69114926@N00,8548,7,1321585660,1321586878,10,7,1218
69114926@N00,8548,16,1321574308,1321602659,12,7,28351
69114926@N00,8549,1,1321678930,1321678930,1,8,0
69114926@N00,8549,21,1321658525,1321658525,1,8,0
69114926@N00,8549,23,1321661587,1321661594,2,8,7
69114926@N00,8549,5,1321657978,1321658109,4,8,131
69114926@N00,8549,28,1321695312,1321695312,1,8,0
69114926@N00,8549,3,1321658320,1321682698,9,8,24378
69114926@N00,8549,16,1321656182,1321656182,1,8,0
69114926@N00,8549,8,1321657734,1321657890,7,8,156
69138343@N00,8550,26,1329118823,1329118823,1,1,0
69181973@N05,8551,1,1397027490,1397040509,13,1,13019
69271250@N00,8552,17,1333102835,1333102835,1,1,0
69271250@N00,8553,25,1364608328,1364608328,1,2,0
69271250@N00,8553,1,1364603400,1364603400,1,2,0
69271250@N00,8554,26,1364965139,1364965139,1,1,0
69271250@N00,8555,28,1395885255,1395902284,2,3,17029
69271250@N00,8555,15,1395906549,1395907387,3,3,838
69271250@N00,8555,20,1395892051,1395892051,1,3,0
69271250@N00,8556,17,1396355722,1396355722,1,1,0
69271250@N00,8557,30,1396513550,1396513550,1,3,0
69271250@N00,8557,14,1396521669,1396521669,1,3,0
69271250@N00,8557,28,1396530098,1396530102,2,3,4
69272110@N05,8558,19,1402790730,1402790730,1,1,0
69301930@N03,8559,16,1381961564,1381961564,1,5,0
69301930@N03,8559,29,1381985526,1381985526,1,5,0
69301930@N03,8559,13,1381969697,1381969697,1,5,0
69301930@N03,8559,31,1381983987,1381983987,1,5,0
69301930@N03,8559,30,1381982837,1381982837,1,5,0
69302803@N06,8560,16,1361524938,1361524938,1,1,0
69487366@N02,8561,18,1425333060,1425333060,1,1,0
69487366@N02,8562,18,1425365506,1425365506,1,1,0
69487366@N02,8563,18,1425539950,1425539950,1,1,0
69574134@N00,8564,16,1270015984,1270016454,4,6,470
69574134@N00,8564,17,1270016498,1270017529,2,6,1031
69574134@N00,8564,12,1270015894,1270015936,2,6,42
69574134@N00,8564,27,1270017692,1270018068,5,6,376
69574134@N00,8564,28,1270019306,1270019410,3,6,104
69574134@N00,8564,4,1270015978,1270015978,1,6,0
69574134@N00,8565,24,1270234524,1270237034,10,10,2510
69574134@N00,8565,26,1270201629,1270201654,2,10,25
69574134@N00,8565,22,1270203239,1270225735,7,10,22496
69574134@N00,8565,23,1270219548,1270219548,1,10,0
69574134@N00,8565,20,1270222266,1270223269,4,10,1003
69574134@N00,8565,30,1270210535,1270214431,2,10,3896
69574134@N00,8565,10,1270220206,1270220488,2,10,282
69574134@N00,8565,27,1270199058,1270199058,1,10,0
69574134@N00,8565,29,1270214126,1270227739,6,10,13613
69574134@N00,8565,4,1270201884,1270201895,2,10,11
69739859@N06,8566,26,1350534274,1350534274,1,1,0
69872582@N00,8567,14,1338678777,1338678777,1,2,0
69872582@N00,8567,31,1338680230,1338680240,2,2,10
69872582@N00,8568,6,1338714027,1338714027,1,1,0
69872582@N00,8569,23,1338788177,1338788177,1,7,0
69872582@N00,8569,14,1338770309,1338789885,2,7,19576
69872582@N00,8569,26,1338787817,1338787817,1,7,0
69872582@N00,8569,20,1338782407,1338782407,1,7,0
69872582@N00,8569,31,1338784544,1338784548,2,7,4
69872582@N00,8569,22,1338773834,1338789346,2,7,15512
69872582@N00,8569,30,1338784292,1338784340,2,7,48
69883003@N00,8570,10,1300423341,1300423341,1,1,0
69883003@N00,8571,26,1301657475,1301663744,3,1,6269
69883003@N00,8572,23,1304154283,1304154283,1,2,0
69883003@N00,8572,30,1304167885,1304167885,1,2,0
69883003@N00,8573,23,1316847067,1316847067,1,3,0
69883003@N00,8573,17,1316839813,1316839813,1,3,0
69883003@N00,8573,18,1316846670,1316846670,1,3,0
69883003@N00,8574,27,1318415730,1318423226,2,2,7496
69883003@N00,8574,4,1318421917,1318421917,1,2,0
69883003@N00,8575,25,1323688203,1323688203,1,1,0
69883003@N00,8576,28,1325376231,1325376231,1,1,0
69883003@N00,8577,28,1325410677,1325421109,2,1,10432
69883003@N00,8578,12,1326005738,1326005738,1,1,0
69883003@N00,8579,26,1354438153,1354438450,2,2,297
69883003@N00,8579,18,1354426701,1354426701,1,2,0
69883003@N00,8580,29,1357444838,1357444838,1,3,0
69883003@N00,8580,28,1357438257,1357438257,1,3,0
69883003@N00,8580,18,1357444648,1357444648,1,3,0
69899432@N00,8581,22,1219631499,1219631920,9,1,421
69962528@N08,8582,30,1359591274,1359591274,1,3,0
69962528@N08,8582,28,1359590874,1359591048,2,3,174
69962528@N08,8582,18,1359591092,1359591092,1,3,0
70025073@N00,8583,28,1242427401,1242427401,1,1,0
70059755@N00,8584,7,1224196376,1224196376,1,3,0
70059755@N00,8584,4,1224199841,1224199841,1,3,0
70059755@N00,8584,24,1224192391,1224192508,2,3,117
70059755@N00,8585,1,1224243732,1224248631,3,14,4899
70059755@N00,8585,29,1224247600,1224247638,2,14,38
70059755@N00,8585,10,1224246954,1224246954,1,14,0
70059755@N00,8585,27,1224245078,1224245078,1,14,0
70059755@N00,8585,30,1224247136,1224247136,1,14,0
70059755@N00,8585,26,1224244126,1224244677,4,14,551
70059755@N00,8585,16,1224245005,1224245025,2,14,20
70059755@N00,8585,20,1224247317,1224247404,3,14,87
70059755@N00,8585,4,1224246620,1224246620,1,14,0
70059755@N00,8585,3,1224246422,1224246422,1,14,0
70059755@N00,8585,6,1224244304,1224244304,1,14,0
70059755@N00,8585,28,1224243862,1224248315,7,14,4453
70059755@N00,8585,12,1224245831,1224246034,3,14,203
70059755@N00,8585,17,1224245459,1224245543,2,14,84
70059755@N00,8586,8,1224279186,1224279186,1,1,0
70059755@N00,8587,20,1224320974,1224320974,1,1,0
70059755@N00,8588,27,1380515615,1380515615,1,3,0
70059755@N00,8588,24,1380514931,1380514931,1,3,0
70059755@N00,8588,12,1380514949,1380514949,1,3,0
70059755@N00,8589,1,1413001319,1413001319,1,1,0
70084804@N00,8590,1,1393423724,1393423724,1,1,0
70084804@N00,8591,26,1465775756,1465796716,2,1,20960
70126701@N06,8592,1,1322994829,1322994829,1,1,0
70142236@N04,8593,23,1321848661,1321848661,1,1,0
70142236@N04,8594,28,1339863195,1339870693,2,1,7498
70154861@N00,8595,26,1257219832,1257219832,1,1,0
70229871@N06,8596,18,1431844020,1431844020,1,1,0
70229871@N06,8597,18,1433653186,1433653186,1,1,0
70314287@N07,8598,30,1288689249,1288689249,1,1,0
70319699@N05,8599,26,1328418214,1328424007,5,4,5793
70319699@N05,8599,23,1328416204,1328426366,3,4,10162
70319699@N05,8599,29,1328413779,1328429764,2,4,15985
70319699@N05,8599,19,1328416107,1328416107,1,4,0
70319699@N05,8600,26,1328794868,1328794868,1,2,0
70319699@N05,8600,29,1328794852,1328794852,1,2,0
70319699@N05,8601,26,1328940172,1328940172,1,4,0
70319699@N05,8601,28,1328940959,1328940959,1,4,0
70319699@N05,8601,6,1328940064,1328940064,3,4,0
70319699@N05,8601,31,1328937873,1328937873,1,4,0
70319699@N05,8602,29,1329629494,1329629494,1,2,0
70319699@N05,8602,31,1329629789,1329629789,1,2,0
70319699@N05,8603,1,1330695082,1330695082,1,1,0
70319699@N05,8604,22,1334041341,1334041586,2,1,245
70319699@N05,8605,21,1334296874,1334296874,1,4,0
70319699@N05,8605,26,1334295448,1334298979,4,4,3531
70319699@N05,8605,28,1334294621,1334294621,1,4,0
70319699@N05,8605,6,1334296471,1334296471,2,4,0
70319699@N05,8606,29,1335012131,1335012623,2,1,492
70319699@N05,8607,19,1337413269,1337413269,1,1,0
70319699@N05,8608,11,1337928243,1337928243,1,1,0
70319699@N05,8609,29,1341059972,1341060099,3,1,127
70341093@N00,8610,17,1292057637,1292057637,1,1,0
70382627@N00,8611,28,1243648979,1243689895,32,1,40916
70382627@N00,8612,28,1243731210,1243755120,19,1,23910
70382627@N00,8613,28,1244008626,1244009014,10,1,388
70382627@N00,8614,26,1357167994,1357172434,2,7,4440
70382627@N00,8614,28,1357212636,1357213977,2,7,1341
70382627@N00,8614,15,1357177272,1357177272,1,7,0
70382627@N00,8614,1,1357166674,1357166674,1,7,0
70382627@N00,8614,25,1357197951,1357200656,7,7,2705
70382627@N00,8614,20,1357196546,1357196570,2,7,24
70382627@N00,8614,8,1357172427,1357172427,1,7,0
70584662@N00,8615,29,1379998118,1379998118,1,2,0
70584662@N00,8615,21,1379991868,1379991868,1,2,0
70584662@N00,8616,5,1380157225,1380157225,1,1,0
70618035@N00,8617,18,1440320480,1440320732,2,1,252
70698203@N00,8618,26,1447718988,1447745210,2,10,26222
70698203@N00,8618,4,1447721538,1447733999,2,10,12461
70698203@N00,8618,14,1447723794,1447723794,1,10,0
70698203@N00,8618,16,1447717822,1447717822,1,10,0
70698203@N00,8618,6,1447719228,1447719228,1,10,0
70698203@N00,8618,30,1447729866,1447729866,1,10,0
70698203@N00,8618,9,1447719300,1447719300,1,10,0
70698203@N00,8618,17,1447733315,1447733315,1,10,0
70698203@N00,8618,28,1447722464,1447743602,8,10,21138
70698203@N00,8618,12,1447715592,1447715592,1,10,0
70698203@N00,8619,26,1447808016,1447828324,2,2,20308
70698203@N00,8619,16,1447832401,1447832401,1,2,0
70698203@N00,8620,26,1447913307,1447913307,1,7,0
70698203@N00,8620,30,1447913234,1447913234,1,7,0
70698203@N00,8620,20,1447896789,1447896789,1,7,0
70698203@N00,8620,1,1447910967,1447910967,1,7,0
70698203@N00,8620,14,1447917654,1447917818,3,7,164
70698203@N00,8620,27,1447922037,1447922037,1,7,0
70698203@N00,8620,31,1447912672,1447912672,1,7,0
70731501@N00,8621,24,1340874388,1340874400,2,1,12
70731501@N00,8622,24,1351140309,1351140454,4,1,145
70767289@N00,8623,26,1470563073,1470563073,1,1,0
70779799@N00,8624,22,1385864240,1385880044,2,2,15804
70779799@N00,8624,31,1385880017,1385880017,1,2,0
70786875@N00,8625,26,1335498733,1335498733,1,1,0
70827934@N08,8626,14,1306666817,1306666817,1,1,0
70862502@N00,8627,20,1322152367,1322152367,1,1,0
70862502@N00,8628,18,1322219012,1322219012,1,2,0
70862502@N00,8628,28,1322199540,1322199540,1,2,0
70862502@N00,8629,26,1322255226,1322255226,1,1,0
70862502@N00,8630,15,1322286765,1322286765,1,1,0
70862502@N00,8631,20,1327680451,1327680451,1,2,0
70862502@N00,8631,28,1327680064,1327680064,1,2,0
70862502@N00,8632,28,1351951805,1351963982,2,1,12177
70862502@N00,8633,16,1352055324,1352055324,1,1,0
70862502@N00,8634,14,1352104819,1352104819,1,1,0
70862502@N00,8635,20,1353099289,1353099289,1,2,0
70862502@N00,8635,26,1353100295,1353100295,1,2,0
70862502@N00,8636,26,1353152140,1353152140,1,2,0
70862502@N00,8636,27,1353137810,1353137810,1,2,0
70862502@N00,8637,20,1358528172,1358528172,1,2,0
70862502@N00,8637,28,1358527344,1358530350,2,2,3006
70862502@N00,8638,27,1358693898,1358693898,1,1,0
70862502@N00,8639,20,1367585052,1367585052,1,1,0
70862502@N00,8640,27,1367632654,1367639961,4,1,7307
70862502@N00,8641,1,1367731589,1367731589,1,1,0
70862502@N00,8642,15,1367812876,1367812876,1,1,0
70862502@N00,8643,19,1415932590,1415932590,1,1,0
70862502@N00,8644,27,1416004126,1416004126,1,1,0
70862502@N00,8645,14,1416076034,1416088495,2,1,12461
70862502@N00,8646,23,1416194636,1416194636,1,1,0
70862502@N00,8647,27,1421443632,1421443632,1,2,0
70862502@N00,8647,21,1421441005,1421441005,1,2,0
70862502@N00,8648,14,1431218427,1431218427,1,1,0
70862502@N00,8649,18,1446856351,1446856351,1,1,0
70862502@N00,8650,27,1446930288,1446930288,1,1,0
70862502@N00,8651,20,1462527693,1462527693,1,1,0
70891215@N05,8652,26,1238495455,1238495455,1,1,0
70891215@N05,8653,26,1238531422,1238531422,1,1,0
70891215@N05,8654,26,1238613450,1238613450,1,1,0
70966699@N02,8655,26,1322441273,1322442849,72,1,1576
70969739@N00,8656,26,1309220727,1309220727,1,1,0
70969739@N00,8657,25,1309333479,1309333479,1,2,0
70969739@N00,8657,1,1309326761,1309326761,1,2,0
71048666@N00,8658,1,1220478093,1220478093,1,1,0
71048666@N00,8659,8,1227125192,1227125192,1,1,0
71048666@N00,8660,26,1253846861,1253846861,1,2,0
71048666@N00,8660,28,1253846438,1253846438,1,2,0
71048666@N00,8661,30,1255993307,1255993307,1,1,0
71048666@N00,8662,1,1265031105,1265031604,2,2,499
71048666@N00,8662,20,1265024256,1265024256,1,2,0
71079304@N04,8663,10,1262149363,1262149363,1,5,0
71079304@N04,8663,18,1262153024,1262153024,1,5,0
71079304@N04,8663,26,1262152832,1262152986,2,5,154
71079304@N04,8663,16,1262152702,1262152702,1,5,0
71079304@N04,8663,1,1262154596,1262154596,1,5,0
71079304@N04,8664,23,1373918071,1373918504,3,8,433
71079304@N04,8664,29,1373919881,1373919881,1,8,0
71079304@N04,8664,9,1373917572,1373917572,1,8,0
71079304@N04,8664,15,1373898591,1373898591,1,8,0
71079304@N04,8664,12,1373911120,1373914540,3,8,3420
71079304@N04,8664,6,1373917348,1373917348,1,8,0
71079304@N04,8664,24,1373897693,1373914415,2,8,16722
71079304@N04,8664,16,1373897869,1373914596,3,8,16727
71103764@N00,8665,16,1394316042,1394316042,1,1,0
71103764@N00,8666,16,1394490619,1394490619,1,2,0
71103764@N00,8666,14,1394492266,1394494296,2,2,2030
71103764@N00,8667,15,1394604620,1394604620,1,2,0
71103764@N00,8667,24,1394604660,1394604660,1,2,0
71103764@N00,8668,26,1394688129,1394688129,1,5,0
71103764@N00,8668,28,1394661072,1394669452,2,5,8380
71103764@N00,8668,4,1394692373,1394692373,1,5,0
71103764@N00,8668,14,1394666403,1394666403,1,5,0
71103764@N00,8668,7,1394695401,1394695401,1,5,0
71121295@N00,8669,17,1205007692,1205007692,1,1,0
71121295@N00,8670,12,1233386310,1233386310,1,4,0
71121295@N00,8670,24,1233364228,1233364228,1,4,0
71121295@N00,8670,4,1233355550,1233355550,1,4,0
71121295@N00,8670,6,1233356417,1233356417,1,4,0
71121295@N00,8671,10,1259991725,1259992472,2,1,747
71121295@N00,8672,10,1260051542,1260051542,1,1,0
71121295@N00,8673,18,1272759673,1272759673,1,3,0
71121295@N00,8673,26,1272749720,1272761499,7,3,11779
71121295@N00,8673,3,1272749280,1272749280,1,3,0
71121295@N00,8674,28,1339276164,1339278332,6,2,2168
71121295@N00,8674,1,1339276056,1339277621,5,2,1565
71185155@N02,8675,17,1332458263,1332458263,1,2,0
71185155@N02,8675,28,1332486981,1332486981,1,2,0
71214537@N00,8676,26,1441935983,1441935983,1,5,0
71214537@N00,8676,22,1441944276,1441944511,2,5,235
71214537@N00,8676,23,1441936093,1441936093,1,5,0
71214537@N00,8676,6,1441924884,1441925021,2,5,137
71214537@N00,8676,4,1441926657,1441926836,2,5,179
71300344@N04,8677,29,1349769060,1349769060,1,1,0
71300344@N04,8678,29,1350021536,1350021536,1,1,0
71344135@N00,8679,16,1260611969,1260611976,2,2,7
71344135@N00,8679,21,1260616345,1260616345,1,2,0
71356371@N00,8680,27,1315128261,1315128261,1,1,0
71356371@N00,8681,23,1337577340,1337577410,3,2,70
71356371@N00,8681,8,1337563696,1337563696,1,2,0
71356371@N00,8682,13,1363749804,1363749804,1,1,0
71416221@N02,8683,12,1435192001,1435192001,1,1,0
71455873@N00,8684,24,1382163288,1382163303,2,8,15
71455873@N00,8684,29,1382135714,1382135714,1,8,0
71455873@N00,8684,25,1382148071,1382149455,3,8,1384
71455873@N00,8684,26,1382152787,1382152787,1,8,0
71455873@N00,8684,17,1382162433,1382162433,1,8,0
71455873@N00,8684,13,1382147526,1382147857,7,8,331
71455873@N00,8684,14,1382139585,1382139585,1,8,0
71455873@N00,8684,1,1382132581,1382132670,2,8,89
71486434@N00,8685,28,1215568878,1215586337,6,7,17459
71486434@N00,8685,1,1215568708,1215585583,8,7,16875
71486434@N00,8685,20,1215569740,1215570218,2,7,478
71486434@N00,8685,29,1215569539,1215569539,1,7,0
71486434@N00,8685,30,1215579088,1215579116,2,7,28
71486434@N00,8685,10,1215578183,1215578906,6,7,723
71486434@N00,8685,26,1215569171,1215569342,4,7,171
71486434@N00,8686,1,1215670555,1215670603,5,11,48
71486434@N00,8686,3,1215684909,1215685441,11,11,532
71486434@N00,8686,19,1215696160,1215697047,4,11,887
71486434@N00,8686,28,1215698558,1215699157,2,11,599
71486434@N00,8686,24,1215673033,1215681827,14,11,8794
71486434@N00,8686,29,1215695003,1215695312,3,11,309
71486434@N00,8686,31,1215693602,1215694393,13,11,791
71486434@N00,8686,17,1215689452,1215690296,7,11,844
71486434@N00,8686,27,1215682259,1215682259,1,11,0
71486434@N00,8686,13,1215688929,1215688929,1,11,0
71486434@N00,8686,26,1215670674,1215698406,4,11,27732
71486434@N00,8687,28,1223018717,1223018809,3,3,92
71486434@N00,8687,20,1223019644,1223020475,8,3,831
71486434@N00,8687,29,1223015445,1223015445,1,3,0
71486434@N00,8688,28,1223086418,1223107488,4,5,21070
71486434@N00,8688,22,1223091620,1223091651,2,5,31
71486434@N00,8688,23,1223096733,1223097252,6,5,519
71486434@N00,8688,24,1223088575,1223088934,7,5,359
71486434@N00,8688,26,1223086735,1223086947,4,5,212
71486434@N00,8689,22,1223173334,1223173334,1,1,0
71486434@N00,8690,31,1236749756,1236752308,30,15,2552
71486434@N00,8690,17,1236744242,1236744373,4,15,131
71486434@N00,8690,23,1236748026,1236748087,3,15,61
71486434@N00,8690,26,1236743653,1236765937,9,15,22284
71486434@N00,8690,29,1236741320,1236763967,8,15,22647
71486434@N00,8690,28,1236736766,1236753667,20,15,16901
71486434@N00,8690,10,1236757227,1236757272,2,15,45
71486434@N00,8690,22,1236751138,1236751598,4,15,460
71486434@N00,8690,19,1236748218,1236748218,1,15,0
71486434@N00,8690,16,1236737881,1236755852,2,15,17971
71486434@N00,8690,20,1236748393,1236749427,8,15,1034
71486434@N00,8690,1,1236736741,1236736741,1,15,0
71486434@N00,8690,3,1236753823,1236754197,3,15,374
71486434@N00,8690,25,1236754579,1236755520,12,15,941
71486434@N00,8690,15,1236739989,1236739989,1,15,0
71486434@N00,8691,24,1236814611,1236815969,11,5,1358
71486434@N00,8691,23,1236816762,1236816762,1,5,0
71486434@N00,8691,29,1236819984,1236821352,4,5,1368
71486434@N00,8691,22,1236819154,1236819309,11,5,155
71486434@N00,8691,1,1236823487,1236825559,8,5,2072
71486434@N00,8692,17,1237194780,1237194780,1,2,0
71486434@N00,8692,22,1237195034,1237195679,2,2,645
71486434@N00,8693,17,1254458290,1254458290,1,11,0
71486434@N00,8693,23,1254467708,1254468465,5,11,757
71486434@N00,8693,29,1254465134,1254465134,1,11,0
71486434@N00,8693,14,1254463000,1254463000,1,11,0
71486434@N00,8693,28,1254455630,1254464476,5,11,8846
71486434@N00,8693,18,1254466872,1254467263,7,11,391
71486434@N00,8693,22,1254472755,1254472755,1,11,0
71486434@N00,8693,19,1254465900,1254466442,7,11,542
71486434@N00,8693,24,1254459794,1254459794,1,11,0
71486434@N00,8693,16,1254471728,1254471728,1,11,0
71486434@N00,8693,1,1254455454,1254462209,12,11,6755
71486434@N00,8694,4,1254556165,1254557084,9,5,919
71486434@N00,8694,26,1254551525,1254551768,5,5,243
71486434@N00,8694,25,1254553241,1254555029,5,5,1788
71486434@N00,8694,20,1254558992,1254559142,4,5,150
71486434@N00,8694,3,1254552562,1254553062,4,5,500
71486434@N00,8695,29,1254633950,1254650352,3,6,16402
71486434@N00,8695,30,1254623534,1254637988,26,6,14454
71486434@N00,8695,28,1254622393,1254651618,8,6,29225
71486434@N00,8695,27,1254644544,1254644544,1,6,0
71486434@N00,8695,24,1254625495,1254625532,2,6,37
71486434@N00,8695,1,1254622169,1254623128,7,6,959
71486434@N00,8696,17,1255762564,1255762564,1,2,0
71486434@N00,8696,22,1255762179,1255762268,2,2,89
71486434@N00,8697,11,1286093201,1286098567,6,1,5366
71502979@N00,8698,17,1231347085,1231347085,1,1,0
71502979@N00,8699,17,1232037228,1232037595,11,1,367
71502979@N00,8700,18,1247027191,1247027264,2,1,73
71502979@N00,8701,27,1264134308,1264134354,2,2,46
71502979@N00,8701,16,1264134146,1264134146,1,2,0
71502979@N00,8702,17,1264404306,1264404474,2,1,168
71502979@N00,8703,13,1266818355,1266818520,2,2,165
71502979@N00,8703,31,1266817683,1266817960,2,2,277
71502979@N00,8704,6,1268029496,1268029637,3,4,141
71502979@N00,8704,11,1268031385,1268032035,5,4,650
71502979@N00,8704,3,1268033347,1268033347,1,4,0
71502979@N00,8704,16,1268025999,1268026754,3,4,755
71502979@N00,8705,12,1274344041,1274346988,2,1,2947
71502979@N00,8706,9,1292317786,1292317786,1,1,0
71502979@N00,8707,20,1299898121,1299898398,2,2,277
71502979@N00,8707,30,1299911836,1299912438,4,2,602
71502979@N00,8708,29,1300147125,1300147125,1,2,0
71502979@N00,8708,17,1300167955,1300169166,7,2,1211
7154330@N03,8709,26,1255309327,1255309327,1,1,0
71574801@N00,8710,24,1296955610,1296956842,4,1,1232
71597211@N00,8711,26,1200681342,1200681342,1,1,0
71597211@N00,8712,22,1239750719,1239750719,1,4,0
71597211@N00,8712,25,1239768781,1239768781,1,4,0
71597211@N00,8712,31,1239750180,1239750180,1,4,0
71597211@N00,8712,11,1239760225,1239760225,1,4,0
71597211@N00,8713,13,1287366720,1287366720,1,4,0
71597211@N00,8713,28,1287390734,1287390734,1,4,0
71597211@N00,8713,1,1287359783,1287359783,1,4,0
71597211@N00,8713,27,1287370628,1287370628,1,4,0
71597211@N00,8714,27,1377405394,1377405394,1,2,0
71597211@N00,8714,31,1377418559,1377418559,1,2,0
71769353@N00,8715,8,1194564535,1194584988,3,1,20453
71781509@N00,8716,4,1418600531,1418600531,1,7,0
71781509@N00,8716,21,1418595545,1418596915,2,7,1370
71781509@N00,8716,12,1418597612,1418597612,1,7,0
71781509@N00,8716,16,1418600534,1418600534,1,7,0
71781509@N00,8716,3,1418595492,1418595492,1,7,0
71781509@N00,8716,25,1418596925,1418596928,2,7,3
71781509@N00,8716,15,1418593318,1418593688,2,7,370
71781509@N00,8717,26,1418643185,1418643185,1,1,0
71781509@N00,8718,4,1418708054,1418708057,3,5,3
71781509@N00,8718,13,1418704301,1418704410,3,5,109
71781509@N00,8718,26,1418702009,1418702009,1,5,0
71781509@N00,8718,7,1418703304,1418703304,1,5,0
71781509@N00,8718,6,1418703311,1418703311,1,5,0
71821256@N00,8719,26,1192523785,1192523785,1,4,0
71821256@N00,8719,7,1192510186,1192510226,6,4,40
71821256@N00,8719,5,1192511208,1192511239,2,4,31
71821256@N00,8719,17,1192512014,1192512014,1,4,0
71821256@N00,8720,26,1198491303,1198491303,1,1,0
71821256@N00,8721,3,1198552630,1198552630,1,3,0
71821256@N00,8721,8,1198562091,1198562434,2,3,343
71821256@N00,8721,7,1198538200,1198538247,5,3,47
71821256@N00,8722,24,1204858364,1204861934,3,3,3570
71821256@N00,8722,3,1204875533,1204875533,1,3,0
71821256@N00,8722,13,1204864552,1204874350,6,3,9798
71821256@N00,8723,7,1210485777,1210485820,7,2,43
71821256@N00,8723,13,1210483090,1210484657,12,2,1567
71875258@N00,8724,4,1369273797,1369273797,1,1,0
71915105@N07,8725,26,1383370945,1383370945,1,1,0
71957979@N00,8726,31,1277790546,1277790631,2,1,85
71957979@N00,8727,24,1300600997,1300600997,1,1,0
71969256@N00,8728,23,1351917316,1351917426,4,4,110
71969256@N00,8728,18,1351911569,1351917472,8,4,5903
71969256@N00,8728,26,1351911061,1351917508,5,4,6447
71969256@N00,8728,30,1351911427,1351911543,5,4,116
71982069@N07,8729,28,1341881479,1341881752,3,1,273
71988189@N00,8730,28,1439247868,1439247868,1,1,0
7202153@N03,8731,13,1281073244,1281073244,1,2,0
7202153@N03,8731,12,1281074787,1281074857,3,2,70
72043907@N00,8732,24,1373970301,1373970301,1,4,0
72043907@N00,8732,29,1373954568,1373954568,1,4,0
72043907@N00,8732,15,1373943606,1373943606,1,4,0
72043907@N00,8732,28,1373966641,1373966641,1,4,0
72171460@N00,8733,31,1386215476,1386215476,1,5,0
72171460@N00,8733,13,1386211044,1386211044,1,5,0
72171460@N00,8733,22,1386215482,1386215482,1,5,0
72171460@N00,8733,7,1386207928,1386207928,1,5,0
72171460@N00,8733,28,1386204167,1386204167,1,5,0
72171460@N00,8734,14,1392957803,1392957803,1,1,0
72171460@N00,8735,14,1393376909,1393376909,1,1,0
72171460@N00,8736,16,1412322467,1412322467,1,1,0
72204768@N08,8737,3,1325524647,1325524647,1,1,0
72269863@N00,8738,29,1460879107,1460879107,1,3,0
72269863@N00,8738,17,1460868430,1460868430,1,3,0
72269863@N00,8738,27,1460885166,1460885166,1,3,0
7231700@N07,8739,7,1295259593,1295260084,2,2,491
7231700@N07,8739,16,1295275627,1295275627,1,2,0
72333664@N00,8740,24,1188373126,1188373126,1,2,0
72333664@N00,8740,10,1188373121,1188373121,1,2,0
7235065@N08,8741,1,1369962016,1369985257,4,1,23241
7235065@N08,8742,1,1370164322,1370164322,1,1,0
72381155@N00,8743,26,1195205939,1195217130,14,1,11191
72409673@N00,8744,28,1294956156,1294956156,1,1,0
72409673@N00,8745,27,1304076955,1304076955,1,1,0
72409673@N00,8746,29,1310987746,1310987803,2,1,57
72409673@N00,8747,28,1319073546,1319075082,2,1,1536
72409673@N00,8748,28,1330517254,1330517254,1,1,0
72409673@N00,8749,26,1355740693,1355740693,1,1,0
72432542@N00,8750,22,1276022671,1276022671,1,1,0
72439928@N00,8751,26,1259490283,1259490283,1,1,0
7246234@N07,8752,16,1280919057,1280919057,1,1,0
72507824@N00,8753,12,1217089204,1217089204,1,1,0
72547598@N00,8754,27,1385543537,1385543537,1,15,0
72547598@N00,8754,18,1385536111,1385537346,3,15,1235
72547598@N00,8754,21,1385523504,1385523504,1,15,0
72547598@N00,8754,14,1385539524,1385539524,1,15,0
72547598@N00,8754,16,1385542831,1385542831,1,15,0
72547598@N00,8754,20,1385518099,1385518099,1,15,0
72547598@N00,8754,31,1385531922,1385531922,1,15,0
72547598@N00,8754,12,1385528485,1385529352,2,15,867
72547598@N00,8754,23,1385536801,1385537209,2,15,408
72547598@N00,8754,17,1385547451,1385547451,1,15,0
72547598@N00,8754,26,1385522283,1385542758,6,15,20475
72547598@N00,8754,29,1385516838,1385516838,1,15,0
72547598@N00,8754,28,1385548746,1385548758,2,15,12
72547598@N00,8754,30,1385531764,1385532453,2,15,689
72547598@N00,8754,3,1385522611,1385522962,2,15,351
7256454@N05,8755,3,1263370067,1263370067,1,3,0
7256454@N05,8755,25,1263369247,1263369635,11,3,388
7256454@N05,8755,21,1263368202,1263368892,19,3,690
7256454@N05,8756,25,1263464462,1263465903,44,2,1441
7256454@N05,8756,26,1263466273,1263466273,1,2,0
7256454@N05,8757,26,1263600756,1263600756,1,2,0
7256454@N05,8757,21,1263603036,1263604417,10,2,1381
7256454@N05,8758,29,1303257546,1303284909,59,3,27363
7256454@N05,8758,26,1303255708,1303256154,9,3,446
7256454@N05,8758,1,1303280051,1303280065,5,3,14
7256454@N05,8759,3,1303446533,1303446563,5,1,30
7256454@N05,8760,14,1303477813,1303477939,7,2,126
7256454@N05,8760,1,1303475774,1303475797,2,2,23
72589879@N00,8761,18,1320805939,1320805939,1,7,0
72589879@N00,8761,16,1320797444,1320797444,1,7,0
72589879@N00,8761,26,1320808510,1320808665,2,7,155
72589879@N00,8761,12,1320798857,1320798857,1,7,0
72589879@N00,8761,25,1320798684,1320798684,1,7,0
72589879@N00,8761,20,1320807069,1320807069,1,7,0
72589879@N00,8761,22,1320807358,1320807358,1,7,0
72589879@N00,8762,18,1444781439,1444781763,2,4,324
72589879@N00,8762,26,1444767532,1444785160,28,4,17628
72589879@N00,8762,20,1444778132,1444778132,1,4,0
72589879@N00,8762,29,1444779545,1444781833,3,4,2288
72658777@N07,8763,26,1357064807,1357066004,3,1,1197
72658777@N07,8764,28,1364059921,1364059921,1,1,0
72720461@N02,8765,28,1316257856,1316257856,1,1,0
72755761@N00,8766,8,1333150466,1333150466,1,2,0
72755761@N00,8766,26,1333150906,1333150906,1,2,0
72774400@N00,8767,26,1352980954,1352980954,1,1,0
72774400@N00,8768,20,1353036606,1353036606,1,3,0
72774400@N00,8768,27,1353030907,1353030907,1,3,0
72774400@N00,8768,13,1353019402,1353030082,3,3,10680
72792293@N00,8769,19,1189352883,1189365731,8,1,12848
72792293@N00,8770,19,1203675697,1203677116,4,1,1419
72792293@N00,8771,19,1204051002,1204065523,15,1,14521
72792293@N00,8772,19,1204209443,1204214363,5,1,4920
72792293@N00,8773,19,1210770800,1210770947,2,1,147
72792293@N00,8774,19,1211023870,1211040780,6,1,16910
72792293@N00,8775,19,1219146568,1219162932,11,1,16364
72792293@N00,8776,19,1220446959,1220453155,6,1,6196
72792293@N00,8777,19,1221002367,1221004352,7,1,1985
72792293@N00,8778,19,1221070471,1221090218,17,1,19747
72792293@N00,8779,19,1222199167,1222201060,3,1,1893
72792293@N00,8780,19,1225568929,1225568972,3,1,43
72792293@N00,8781,19,1225652267,1225667468,23,1,15201
72792293@N00,8782,19,1227110393,1227117970,8,1,7577
72792293@N00,8783,19,1228586498,1228595510,5,1,9012
72792293@N00,8784,19,1229355445,1229377554,6,1,22109
72792293@N00,8785,19,1229445609,1229469726,11,1,24117
72792293@N00,8786,19,1230894599,1230898302,5,1,3703
72792293@N00,8787,19,1234479144,1234481518,5,1,2374
72792293@N00,8788,19,1235110913,1235112745,4,1,1832
72792293@N00,8789,19,1237143014,1237147786,5,1,4772
72792293@N00,8790,19,1238563113,1238563113,1,1,0
72792293@N00,8791,19,1238591979,1238591998,2,1,19
72792293@N00,8792,19,1240383054,1240387755,8,1,4701
72792293@N00,8793,19,1240827883,1240828539,5,1,656
72792293@N00,8794,19,1241655948,1241657140,3,1,1192
72792293@N00,8795,19,1244495627,1244514678,15,1,19051
72792293@N00,8796,19,1245583403,1245583403,1,1,0
72792293@N00,8797,19,1249019659,1249033017,5,1,13358
72792293@N00,8798,19,1250549007,1250550671,6,1,1664
72792293@N00,8799,19,1253626722,1253627447,5,1,725
72792293@N00,8800,19,1255048782,1255055611,13,1,6829
72792293@N00,8801,19,1257512700,1257512700,1,1,0
72792293@N00,8802,19,1257927485,1257939556,7,1,12071
72792293@N00,8803,19,1261097797,1261124058,3,1,26261
72792293@N00,8804,19,1261204996,1261235906,8,1,30910
72792293@N00,8805,19,1261817390,1261827197,12,1,9807
72792293@N00,8806,19,1262773224,1262783835,4,1,10611
72792293@N00,8807,19,1262868152,1262868152,1,1,0
72792293@N00,8808,18,1265966075,1265966082,2,2,7
72792293@N00,8808,19,1265967336,1265967977,3,2,641
72792293@N00,8809,19,1271205341,1271241794,11,1,36453
72792293@N00,8810,19,1272607116,1272607116,1,1,0
72792293@N00,8811,19,1272650878,1272666120,8,1,15242
72792293@N00,8812,19,1281158324,1281158324,1,1,0
72792293@N00,8813,19,1283661491,1283668970,3,1,7479
72792293@N00,8814,19,1296008838,1296008973,2,1,135
72792293@N00,8815,19,1304314228,1304324214,3,1,9986
72792293@N00,8816,19,1314879439,1314879940,2,1,501
72792293@N00,8817,19,1317467124,1317483794,4,1,16670
72792293@N00,8818,19,1317585382,1317585382,1,1,0
72792293@N00,8819,19,1318643140,1318643160,7,1,20
72792293@N00,8820,19,1318879500,1318879896,4,1,396
72792293@N00,8821,19,1319020986,1319020986,1,1,0
72792293@N00,8822,19,1319167529,1319174589,11,1,7060
72792293@N00,8823,19,1319254515,1319259583,3,1,5068
72792293@N00,8824,19,1319333847,1319345970,2,1,12123
72792293@N00,8825,19,1319477825,1319492477,20,1,14652
72792293@N00,8826,19,1320039626,1320046891,5,1,7265
72792293@N00,8827,19,1320453188,1320471748,12,1,18560
72792293@N00,8828,19,1320548053,1320553585,5,1,5532
72792293@N00,8829,19,1321601970,1321604460,14,1,2490
72792293@N00,8830,19,1328837472,1328846281,5,1,8809
72792293@N00,8831,19,1337304720,1337317694,11,1,12974
72792293@N00,8832,19,1339889677,1339905632,12,1,15955
72792293@N00,8833,19,1345792343,1345801375,8,1,9032
72792293@N00,8834,19,1346219661,1346220009,2,1,348
72792293@N00,8835,19,1347151592,1347173293,20,1,21701
72792293@N00,8836,19,1378998360,1379029871,17,1,31511
72792293@N00,8837,19,1410561852,1410607167,35,1,45315
72792293@N00,8838,1,1431419229,1431419229,1,1,0
72792293@N00,8839,19,1438302919,1438341941,19,1,39022
72792293@N00,8840,19,1440322094,1440322094,1,1,0
7282277@N07,8841,29,1404219113,1404219113,1,7,0
7282277@N07,8841,23,1404218970,1404218972,3,7,2
7282277@N07,8841,16,1404198733,1404198733,1,7,0
7282277@N07,8841,12,1404198634,1404198634,1,7,0
7282277@N07,8841,28,1404212551,1404214506,14,7,1955
7282277@N07,8841,1,1404209865,1404220088,2,7,10223
7282277@N07,8841,26,1404189512,1404194887,9,7,5375
7282277@N07,8842,6,1404268803,1404268880,3,13,77
7282277@N07,8842,21,1404277340,1404277340,1,13,0
7282277@N07,8842,7,1404267588,1404270997,7,13,3409
7282277@N07,8842,13,1404277079,1404277344,3,13,265
7282277@N07,8842,25,1404277355,1404277358,2,13,3
7282277@N07,8842,5,1404267390,1404267676,4,13,286
7282277@N07,8842,20,1404276433,1404276889,5,13,456
7282277@N07,8842,15,1404265636,1404277680,11,13,12044
7282277@N07,8842,4,1404266628,1404266628,1,13,0
7282277@N07,8842,28,1404274290,1404275848,9,13,1558
7282277@N07,8842,17,1404272748,1404277760,8,13,5012
7282277@N07,8842,1,1404263743,1404277781,9,13,14038
7282277@N07,8842,11,1404269130,1404269906,3,13,776
72844756@N00,8843,29,1259307283,1259307356,2,1,73
72844756@N00,8844,18,1268388475,1268388475,1,3,0
72844756@N00,8844,3,1268375096,1268375096,1,3,0
72844756@N00,8844,20,1268381780,1268387039,2,3,5259
72844756@N00,8845,28,1269207163,1269207163,1,6,0
72844756@N00,8845,29,1269217295,1269217295,1,6,0
72844756@N00,8845,26,1269207807,1269208992,2,6,1185
72844756@N00,8845,6,1269208104,1269208104,1,6,0
72844756@N00,8845,20,1269211834,1269211834,1,6,0
72844756@N00,8845,17,1269215978,1269215978,1,6,0
72844756@N00,8846,1,1272406822,1272414798,3,2,7976
72844756@N00,8846,28,1272414083,1272414083,1,2,0
72844756@N00,8847,25,1274441361,1274441361,1,2,0
72844756@N00,8847,15,1274438393,1274438393,1,2,0
72844756@N00,8848,29,1274533861,1274533861,1,1,0
72844756@N00,8849,23,1285401900,1285401900,1,1,0
72872155@N00,8850,26,1194554590,1194554675,5,1,85
72872155@N00,8851,26,1196514368,1196539420,17,1,25052
72872155@N00,8852,20,1289528847,1289529109,2,1,262
72872155@N00,8853,26,1291979949,1291979949,1,1,0
72872155@N00,8854,28,1325724606,1325724606,1,1,0
72872155@N00,8855,20,1325755206,1325755206,1,1,0
72872155@N00,8856,28,1327203571,1327204571,2,1,1000
72872155@N00,8857,19,1332591547,1332591547,1,1,0
72872155@N00,8858,5,1344130581,1344130581,1,1,0
72872155@N00,8859,18,1356686084,1356686084,1,1,0
72915363@N00,8860,5,1298100700,1298100700,1,1,0
72915363@N00,8861,18,1355195581,1355195581,1,2,0
72915363@N00,8861,27,1355190177,1355190177,1,2,0
72915363@N00,8862,28,1355311335,1355311335,1,1,0
72926310@N00,8863,10,1221218668,1221218668,1,2,0
72926310@N00,8863,24,1221218663,1221218663,1,2,0
72926310@N00,8864,19,1366072759,1366072759,1,9,0
72926310@N00,8864,28,1366066358,1366066528,2,9,170
72926310@N00,8864,24,1366076208,1366076486,10,9,278
72926310@N00,8864,21,1366069614,1366069687,2,9,73
72926310@N00,8864,27,1366067976,1366068057,2,9,81
72926310@N00,8864,12,1366067410,1366076032,11,9,8622
72926310@N00,8864,3,1366070493,1366070519,2,9,26
72926310@N00,8864,31,1366090385,1366090558,2,9,173
72926310@N00,8864,29,1366072187,1366072187,1,9,0
7296328@N07,8865,29,1310799483,1310799483,1,6,0
7296328@N07,8865,1,1310804516,1310822273,3,6,17757
7296328@N07,8865,26,1310805026,1310805026,1,6,0
7296328@N07,8865,7,1310785470,1310785470,1,6,0
7296328@N07,8865,28,1310815743,1310815743,1,6,0
7296328@N07,8865,31,1310797865,1310797865,1,6,0
73043483@N06,8866,24,1325153813,1325153813,1,1,0
73051591@N00,8867,19,1403760114,1403760114,1,1,0
73105116@N00,8868,29,1212760394,1212760394,1,1,0
73105116@N00,8869,26,1213019201,1213019201,1,1,0
73105116@N00,8870,20,1244212774,1244212774,1,6,0
73105116@N00,8870,31,1244188579,1244188579,1,6,0
73105116@N00,8870,28,1244220551,1244220551,1,6,0
73105116@N00,8870,24,1244175299,1244175299,1,6,0
73105116@N00,8870,18,1244220326,1244220326,1,6,0
73105116@N00,8870,25,1244186263,1244186263,1,6,0
73105116@N00,8871,8,1244439459,1244439459,1,1,0
73105116@N00,8872,6,1253433719,1253433719,1,2,0
73105116@N00,8872,26,1253433805,1253433805,1,2,0
73105116@N00,8873,30,1254202734,1254202734,1,3,0
73105116@N00,8873,28,1254215954,1254216008,2,3,54
73105116@N00,8873,29,1254192705,1254192705,1,3,0
73105116@N00,8874,28,1353573267,1353573267,1,1,0
73105116@N00,8875,28,1353882202,1353882202,1,1,0
73164011@N00,8876,26,1243894253,1243934751,24,1,40498
73164011@N00,8877,16,1308283105,1308283105,1,1,0
73279190@N00,8878,17,1365142507,1365142507,1,1,0
73293249@N00,8879,3,1221064369,1221064933,5,21,564
73293249@N00,8879,12,1221064074,1221064157,2,21,83
73293249@N00,8879,19,1221050833,1221052198,7,21,1365
73293249@N00,8879,25,1221039408,1221039423,2,21,15
73293249@N00,8879,15,1221057305,1221060752,16,21,3447
73293249@N00,8879,26,1221053598,1221073957,12,21,20359
73293249@N00,8879,21,1221055821,1221063895,4,21,8074
73293249@N00,8879,16,1221053858,1221053858,1,21,0
73293249@N00,8879,23,1221043121,1221067057,2,21,23936
73293249@N00,8879,7,1221063422,1221063587,3,21,165
73293249@N00,8879,24,1221054777,1221054777,1,21,0
73293249@N00,8879,29,1221044448,1221070246,10,21,25798
73293249@N00,8879,13,1221071727,1221072845,11,21,1118
73293249@N00,8879,30,1221042364,1221043100,7,21,736
73293249@N00,8879,17,1221061629,1221061629,1,21,0
73293249@N00,8879,18,1221041815,1221068101,3,21,26286
73293249@N00,8879,28,1221040032,1221074254,10,21,34222
73293249@N00,8879,14,1221045881,1221046549,4,21,668
73293249@N00,8879,22,1221044906,1221044906,1,21,0
73293249@N00,8879,6,1221063269,1221063388,3,21,119
73293249@N00,8879,1,1221037459,1221074590,11,21,37131
7330503@N04,8880,18,1454378758,1454408296,4,1,29538
7330503@N04,8881,18,1454478933,1454479346,2,1,413
73310709@N05,8882,30,1356659085,1356659085,1,2,0
73310709@N05,8882,26,1356677642,1356677642,1,2,0
7337318@N05,8883,28,1316235637,1316238963,2,1,3326
7337318@N05,8884,27,1353892125,1353892125,1,2,0
7337318@N05,8884,28,1353917763,1353918108,2,2,345
73392257@N00,8885,24,1354251835,1354251835,1,2,0
73392257@N00,8885,25,1354252047,1354252047,1,2,0
73392257@N00,8886,17,1407650633,1407650633,1,3,0
73392257@N00,8886,26,1407644241,1407644241,1,3,0
73392257@N00,8886,19,1407632643,1407632643,1,3,0
7340027@N06,8887,28,1344290393,1344290393,1,3,0
7340027@N06,8887,16,1344294403,1344294403,1,3,0
7340027@N06,8887,26,1344295645,1344295645,1,3,0
7340027@N06,8888,28,1344328725,1344328725,1,1,0
7340027@N06,8889,28,1352017931,1352017931,1,3,0
7340027@N06,8889,20,1352021430,1352021430,1,3,0
7340027@N06,8889,15,1352018603,1352018603,1,3,0
7340027@N06,8890,27,1352964440,1352964440,1,1,0
7340027@N06,8891,28,1353753223,1353753223,1,1,0
7340027@N06,8892,28,1355386228,1355388870,4,1,2642
7340027@N06,8893,1,1365150216,1365150216,1,1,0
7340027@N06,8894,12,1365977729,1365977729,1,3,0
7340027@N06,8894,29,1365977965,1365977965,1,3,0
7340027@N06,8894,27,1365978361,1365978361,1,3,0
7340027@N06,8895,26,1370346361,1370346361,1,1,0
7340027@N06,8896,1,1372069069,1372069069,1,3,0
7340027@N06,8896,17,1372077027,1372077027,1,3,0
7340027@N06,8896,20,1372070500,1372070500,1,3,0
7340027@N06,8897,26,1372240714,1372240714,1,1,0
7340027@N06,8898,1,1384714722,1384714722,1,1,0
7340027@N06,8899,1,1384755829,1384775339,2,1,19510
73436623@N05,8900,18,1398852355,1398852355,1,3,0
73436623@N05,8900,22,1398852066,1398852066,1,3,0
73436623@N05,8900,14,1398849467,1398849467,1,3,0
73436623@N05,8901,22,1408329261,1408329261,1,1,0
73436623@N05,8902,24,1420203230,1420203230,1,3,0
73436623@N05,8902,26,1420180933,1420180933,1,3,0
73436623@N05,8902,28,1420165200,1420165200,1,3,0
73451901@N00,8903,18,1260427839,1260427839,1,1,0
7346406@N06,8904,26,1286533883,1286533883,1,1,0
7346406@N06,8905,29,1295761153,1295761326,2,1,173
73565146@N00,8906,11,1296757604,1296762790,3,2,5186
73565146@N00,8906,1,1296749349,1296749349,1,2,0
73565702@N00,8907,23,1351222409,1351222409,1,6,0
73565702@N00,8907,29,1351235374,1351235374,1,6,0
73565702@N00,8907,1,1351214800,1351214800,1,6,0
73565702@N00,8907,3,1351217672,1351217672,1,6,0
73565702@N00,8907,26,1351235807,1351235807,1,6,0
73565702@N00,8907,21,1351219808,1351219808,1,6,0
73565702@N00,8908,29,1364277337,1364277337,1,5,0
73565702@N00,8908,3,1364263299,1364263594,2,5,295
73565702@N00,8908,26,1364259730,1364259730,1,5,0
73565702@N00,8908,25,1364269124,1364269710,2,5,586
73565702@N00,8908,21,1364263024,1364263024,1,5,0
73565702@N00,8909,29,1374467572,1374467572,1,3,0
73565702@N00,8909,27,1374462400,1374462400,1,3,0
73565702@N00,8909,17,1374463650,1374465370,2,3,1720
73565702@N00,8910,20,1374796898,1374796898,1,1,0
73613627@N06,8911,11,1403251559,1403251559,1,1,0
73614576@N08,8912,23,1280152801,1280152801,1,1,0
73621375@N00,8913,20,1214038780,1214038788,2,6,8
73621375@N00,8913,31,1214051716,1214052754,6,6,1038
73621375@N00,8913,22,1214039930,1214039930,1,6,0
73621375@N00,8913,23,1214033165,1214034577,11,6,1412
73621375@N00,8913,1,1214032694,1214032716,2,6,22
73621375@N00,8913,29,1214035167,1214035190,2,6,23
73621375@N00,8914,24,1214093103,1214093103,1,5,0
73621375@N00,8914,26,1214092998,1214102174,5,5,9176
73621375@N00,8914,16,1214093149,1214093180,2,5,31
73621375@N00,8914,6,1214102259,1214102278,2,5,19
73621375@N00,8914,17,1214097203,1214097203,1,5,0
73621375@N00,8915,28,1214190973,1214192563,5,1,1590
73621375@N00,8916,26,1228451033,1228462042,12,6,11009
73621375@N00,8916,23,1228451121,1228452816,9,6,1695
73621375@N00,8916,18,1228452909,1228452909,1,6,0
73621375@N00,8916,28,1228450640,1228450738,3,6,98
73621375@N00,8916,29,1228459380,1228460647,6,6,1267
73621375@N00,8916,19,1228454074,1228455551,3,6,1477
73621375@N00,8917,24,1228543706,1228549998,5,6,6292
73621375@N00,8917,26,1228561422,1228565291,3,6,3869
73621375@N00,8917,16,1228557454,1228561870,4,6,4416
73621375@N00,8917,3,1228561589,1228561806,3,6,217
73621375@N00,8917,28,1228555418,1228556901,5,6,1483
73621375@N00,8917,25,1228561973,1228563175,10,6,1202
73621375@N00,8918,26,1228600968,1228607983,27,8,7015
73621375@N00,8918,15,1228618330,1228618342,2,8,12
73621375@N00,8918,30,1228608844,1228608844,1,8,0
73621375@N00,8918,13,1228613849,1228614160,2,8,311
73621375@N00,8918,28,1228603163,1228607035,6,8,3872
73621375@N00,8918,25,1228612498,1228617594,77,8,5096
73621375@N00,8918,29,1228609163,1228610863,16,8,1700
73621375@N00,8918,1,1228619903,1228619912,2,8,9
73621375@N00,8919,26,1292046635,1292046828,8,7,193
73621375@N00,8919,30,1292026880,1292027007,3,7,127
73621375@N00,8919,6,1292046931,1292047147,8,7,216
73621375@N00,8919,25,1292032738,1292034547,6,7,1809
73621375@N00,8919,17,1292029560,1292050674,5,7,21114
73621375@N00,8919,29,1292023880,1292026178,5,7,2298
73621375@N00,8919,23,1292027861,1292028684,12,7,823
73621375@N00,8920,28,1292148401,1292148494,2,3,93
73621375@N00,8920,30,1292133718,1292135368,3,3,1650
73621375@N00,8920,23,1292136126,1292138415,22,3,2289
73621375@N00,8921,30,1292203239,1292203239,1,4,0
73621375@N00,8921,23,1292207657,1292207716,2,4,59
73621375@N00,8921,29,1292203466,1292207290,22,4,3824
73621375@N00,8921,26,1292202682,1292202991,5,4,309
7363441@N07,8922,26,1354587921,1354605715,2,4,17794
7363441@N07,8922,21,1354605079,1354605381,2,4,302
7363441@N07,8922,1,1354600940,1354606765,13,4,5825
7363441@N07,8922,9,1354605515,1354605515,1,4,0
73666782@N00,8923,28,1361585261,1361614518,3,1,29257
73666782@N00,8924,1,1393070244,1393070244,1,1,0
73666782@N00,8925,1,1393123096,1393123096,1,1,0
73666782@N00,8926,7,1393307749,1393307749,1,1,0
73694110@N00,8927,28,1349515633,1349515633,1,1,0
73746571@N00,8928,21,1380280927,1380280927,1,1,0
7377220@N07,8929,26,1239680488,1239680488,1,1,0
73779712@N00,8930,28,1237869249,1237869249,1,1,0
7378372@N02,8931,30,1357368299,1357368304,2,1,5
73802184@N00,8932,20,1355529460,1355529460,1,5,0
73802184@N00,8932,16,1355527596,1355527596,1,5,0
73802184@N00,8932,26,1355571976,1355571976,1,5,0
73802184@N00,8932,21,1355561073,1355561109,2,5,36
73802184@N00,8932,1,1355550735,1355550800,5,5,65
73802184@N00,8933,28,1361605908,1361605908,2,4,0
73802184@N00,8933,15,1361606155,1361606285,4,4,130
73802184@N00,8933,17,1361604983,1361604983,2,4,0
73802184@N00,8933,27,1361612120,1361612120,2,4,0
73802184@N00,8934,15,1394695768,1394695812,4,5,44
73802184@N00,8934,16,1394693028,1394693028,1,5,0
73802184@N00,8934,30,1394697672,1394697672,1,5,0
73802184@N00,8934,18,1394707249,1394707249,1,5,0
73802184@N00,8934,23,1394704325,1394704339,3,5,14
73802184@N00,8935,30,1394777692,1394777692,1,1,0
73802184@N00,8936,13,1394930451,1394930451,1,3,0
73802184@N00,8936,9,1394924497,1394924497,1,3,0
73802184@N00,8936,23,1394922172,1394922260,2,3,88
73802184@N00,8937,28,1395009652,1395013387,22,1,3735
73802184@N00,8938,28,1395147299,1395147299,1,1,0
73843632@N04,8939,28,1335610891,1335610891,1,2,0
73843632@N04,8939,18,1335610939,1335610939,1,2,0
7387461@N02,8940,3,1282009927,1282009927,1,1,0
73883362@N00,8941,16,1385325239,1385325239,1,3,0
73883362@N00,8941,1,1385316264,1385358772,2,3,42508
73883362@N00,8941,29,1385345394,1385345394,1,3,0
73883362@N00,8942,28,1385443790,1385443790,1,1,0
73883362@N00,8943,19,1418921964,1418921964,1,1,0
73883362@N00,8944,14,1419047042,1419047042,1,1,0
73889777@N00,8945,18,1432278931,1432299648,2,1,20717
73889777@N00,8946,18,1432430992,1432430992,1,1,0
7396528@N02,8947,28,1293768775,1293805444,3,6,36669
7396528@N02,8947,1,1293762042,1293762079,2,6,37
7396528@N02,8947,26,1293792449,1293793197,3,6,748
7396528@N02,8947,20,1293778153,1293778153,1,6,0
7396528@N02,8947,27,1293756041,1293756041,1,6,0
7396528@N02,8947,16,1293755289,1293793820,4,6,38531
7396528@N02,8948,13,1293853264,1293853378,3,2,114
7396528@N02,8948,1,1293861396,1293861396,1,2,0
7397017@N04,8949,16,1206842373,1206842373,1,1,0
7397017@N04,8950,16,1206879179,1206879179,1,1,0
7398381@N04,8951,20,1291322784,1291322784,1,1,0
7401887@N02,8952,18,1450136494,1450136494,1,1,0
7401887@N02,8953,18,1450185715,1450185715,1,1,0
7401887@N02,8954,18,1459806601,1459814041,2,1,7440
7406966@N05,8955,16,1253876718,1253876718,1,2,0
7406966@N05,8955,27,1253866340,1253866340,1,2,0
7408156@N05,8956,26,1288836528,1288866856,161,1,30328
74122389@N07,8957,17,1399440509,1399440510,2,6,1
74122389@N07,8957,26,1399440465,1399440465,1,6,0
74122389@N07,8957,1,1399440462,1399440462,1,6,0
74122389@N07,8957,30,1399440468,1399440471,2,6,3
74122389@N07,8957,21,1399440515,1399440579,8,6,64
74122389@N07,8957,13,1399440591,1399440591,1,6,0
74164239@N00,8958,30,1245753034,1245753034,1,1,0
74193050@N00,8959,28,1329794706,1329806084,2,1,11378
74215305@N00,8960,27,1199250698,1199250698,1,4,0
74215305@N00,8960,16,1199251040,1199251040,1,4,0
74215305@N00,8960,18,1199243951,1199243951,1,4,0
74215305@N00,8960,20,1199241594,1199241594,1,4,0
74236522@N00,8961,29,1233175103,1233175103,1,1,0
74236522@N00,8962,28,1233261225,1233261225,1,1,0
74236522@N00,8963,29,1233347277,1233347277,1,1,0
74236522@N00,8964,25,1234571094,1234571094,1,1,0
74236522@N00,8965,13,1236289649,1236289649,1,1,0
74236522@N00,8966,16,1251902165,1251902165,1,1,0
74236522@N00,8967,26,1260762439,1260762439,1,1,0
74269575@N03,8968,4,1326080017,1326080017,1,1,0
74269575@N03,8969,30,1326168150,1326168150,1,2,0
74269575@N03,8969,16,1326159502,1326159502,1,2,0
74285955@N00,8970,29,1335086735,1335086735,1,4,0
74285955@N00,8970,13,1335092018,1335092018,1,4,0
74285955@N00,8970,19,1335085193,1335085193,1,4,0
74285955@N00,8970,23,1335112696,1335112696,1,4,0
74285955@N00,8971,18,1345948867,1345974061,2,1,25194
74285955@N00,8972,15,1347780750,1347805877,2,1,25127
74285955@N00,8973,31,1364867709,1364867709,1,1,0
74285955@N00,8974,7,1365321003,1365321003,1,1,0
74285955@N00,8975,30,1366518861,1366518861,1,1,0
74285955@N00,8976,26,1368320217,1368320217,1,1,0
74285955@N00,8977,15,1377391523,1377391523,1,1,0
74285955@N00,8978,28,1381635246,1381635246,1,2,0
74285955@N00,8978,1,1381633027,1381633027,1,2,0
7434666@N07,8979,28,1188186697,1188198870,28,1,12173
74354559@N05,8980,26,1426140966,1426149185,3,3,8219
74354559@N05,8980,15,1426128482,1426135537,4,3,7055
74354559@N05,8980,16,1426133251,1426133251,1,3,0
74382902@N00,8981,31,1360992455,1360992455,1,4,0
74382902@N00,8981,23,1360994760,1360994760,1,4,0
74382902@N00,8981,12,1361010763,1361011404,2,4,641
74382902@N00,8981,24,1360998156,1360998156,1,4,0
74403697@N02,8982,30,1418345151,1418345151,2,5,0
74403697@N02,8982,26,1418366473,1418366473,1,5,0
74403697@N02,8982,20,1418345171,1418345646,7,5,475
74403697@N02,8982,17,1418334771,1418340024,5,5,5253
74403697@N02,8982,1,1418338422,1418338441,7,5,19
74403697@N02,8983,30,1418418644,1418418644,2,10,0
74403697@N02,8983,17,1418418644,1418418644,5,10,0
74403697@N02,8983,12,1418446820,1418488420,2,10,41600
74403697@N02,8983,21,1418467712,1418475331,2,10,7619
74403697@N02,8983,26,1418418644,1418465446,2,10,46802
74403697@N02,8983,25,1418469202,1418469204,2,10,2
74403697@N02,8983,20,1418418644,1418418644,7,10,0
74403697@N02,8983,24,1418449451,1418488420,19,10,38969
74403697@N02,8983,1,1418418644,1418418644,7,10,0
74403697@N02,8983,13,1418470073,1418470073,1,10,0
7442675@N08,8984,15,1344349700,1344349700,1,1,0
7442719@N04,8985,18,1439142379,1439142379,1,1,0
74471986@N00,8986,1,1402118954,1402118954,1,1,0
74478949@N02,8987,28,1345158261,1345158261,1,1,0
7449712@N02,8988,26,1377865213,1377865213,1,1,0
74501739@N05,8989,30,1463448678,1463448678,1,1,0
74501739@N05,8990,4,1463483640,1463483640,1,1,0
74501739@N05,8991,31,1463618943,1463618943,1,1,0
74501739@N05,8992,1,1463660508,1463660508,1,3,0
74501739@N05,8992,30,1463656361,1463656361,1,3,0
74501739@N05,8992,26,1463659312,1463659312,1,3,0
7451795@N03,8993,23,1397554307,1397554307,1,1,0
7451795@N03,8994,11,1397637463,1397637463,1,1,0
7459168@N04,8995,16,1256523904,1256524785,4,6,881
7459168@N04,8995,12,1256522981,1256522981,1,6,0
7459168@N04,8995,30,1256531022,1256531057,2,6,35
7459168@N04,8995,26,1256525293,1256525369,2,6,76
7459168@N04,8995,17,1256520402,1256520402,1,6,0
7459168@N04,8995,10,1256530134,1256530417,2,6,283
7459168@N04,8996,1,1379256134,1379256134,1,1,0
74594655@N00,8997,28,1199616224,1199616300,4,9,76
74594655@N00,8997,1,1199596243,1199616609,2,9,20366
74594655@N00,8997,20,1199593813,1199594537,3,9,724
74594655@N00,8997,18,1199611790,1199615843,3,9,4053
74594655@N00,8997,17,1199595904,1199595904,1,9,0
74594655@N00,8997,16,1199605916,1199606274,2,9,358
74594655@N00,8997,15,1199599559,1199603875,6,9,4316
74594655@N00,8997,27,1199606100,1199606100,1,9,0
74594655@N00,8997,24,1199602852,1199602852,1,9,0
74594655@N00,8998,26,1199668874,1199668874,1,1,0
74594655@N00,8999,18,1245986108,1245986617,2,4,509
74594655@N00,8999,31,1245984694,1245984694,1,4,0
74594655@N00,8999,5,1246006874,1246006874,1,4,0
74594655@N00,8999,23,1246017391,1246021875,2,4,4484
74594655@N00,9000,24,1258159744,1258159744,1,3,0
74594655@N00,9000,15,1258161842,1258161842,1,3,0
74594655@N00,9000,12,1258165298,1258165298,1,3,0
74616830@N00,9001,19,1199420495,1199421223,3,2,728
74616830@N00,9001,18,1199418697,1199418697,1,2,0
74616830@N00,9002,24,1327022330,1327022330,1,3,0
74616830@N00,9002,26,1327017705,1327018049,2,3,344
74616830@N00,9002,8,1327018716,1327018754,2,3,38
74616830@N00,9003,23,1327143632,1327143632,1,3,0
74616830@N00,9003,29,1327124839,1327125755,3,3,916
74616830@N00,9003,21,1327146535,1327147364,2,3,829
74616830@N00,9004,23,1327196908,1327196908,1,1,0
74644696@N00,9005,10,1193644867,1193650472,6,1,5605
74644696@N00,9006,10,1193693505,1193711626,28,1,18121
74712199@N00,9007,27,1259623526,1259623526,1,1,0
74712199@N00,9008,23,1302410939,1302410939,1,2,0
74712199@N00,9008,17,1302394004,1302396058,2,2,2054
74712199@N00,9009,1,1317356526,1317356526,1,1,0
74712199@N00,9010,27,1317431561,1317431561,1,1,0
74712199@N00,9011,12,1317511988,1317511988,1,1,0
74712199@N00,9012,27,1319855718,1319855718,1,2,0
74712199@N00,9012,16,1319856023,1319856023,1,2,0
74712199@N00,9013,24,1319946005,1319946005,1,1,0
74712199@N00,9014,16,1322885402,1322885402,1,1,0
74712199@N00,9015,25,1322963424,1322963424,1,1,0
74712199@N00,9016,18,1336864369,1336864369,1,1,0
74712199@N00,9017,28,1345860630,1345860630,1,2,0
74712199@N00,9017,12,1345862362,1345862362,1,2,0
74712199@N00,9018,30,1349600980,1349600980,1,1,0
74712199@N00,9019,17,1349654382,1349654382,1,1,0
74712199@N00,9020,17,1354333987,1354335245,2,1,1258
74712199@N00,9021,1,1370670130,1370670130,1,1,0
74712199@N00,9022,30,1370741758,1370741758,1,1,0
74712199@N00,9023,26,1370776459,1370776459,1,1,0
74712199@N00,9024,18,1373601150,1373601150,1,2,0
74712199@N00,9024,17,1373585666,1373585666,1,2,0
74712199@N00,9025,20,1380865518,1380865518,1,1,0
74712199@N00,9026,1,1386407522,1386407522,1,1,0
74712199@N00,9027,1,1395611365,1395611365,1,1,0
74712199@N00,9028,17,1405295277,1405295277,1,2,0
74712199@N00,9028,19,1405290539,1405290539,1,2,0
74712199@N00,9029,20,1412324134,1412324134,1,1,0
74712199@N00,9030,25,1417944586,1417944586,1,2,0
74712199@N00,9030,26,1417946789,1417946789,1,2,0
74712199@N00,9031,17,1424479060,1424479060,1,1,0
7474477@N08,9032,17,1203339634,1203339634,1,6,0
7474477@N08,9032,4,1203339611,1203339612,2,6,1
7474477@N08,9032,28,1203339607,1203339632,3,6,25
7474477@N08,9032,12,1203339610,1203339610,1,6,0
7474477@N08,9032,26,1203339633,1203339633,1,6,0
7474477@N08,9032,30,1203339600,1203339637,3,6,37
74754977@N03,9033,19,1403936336,1403957556,4,1,21220
74813143@N05,9034,17,1328404553,1328404701,3,4,148
74813143@N05,9034,24,1328406880,1328406880,1,4,0
74813143@N05,9034,25,1328414307,1328416896,7,4,2589
74813143@N05,9034,28,1328402265,1328402265,1,4,0
74836867@N00,9035,26,1468547054,1468595173,5,1,48119
74836867@N00,9036,26,1468854188,1468858792,5,1,4604
74839311@N00,9037,1,1276235217,1276235217,1,1,0
7485909@N03,9038,19,1416964850,1416964850,1,1,0
7490457@N07,9039,29,1337388774,1337388774,1,3,0
7490457@N07,9039,28,1337416557,1337416557,1,3,0
7490457@N07,9039,15,1337394204,1337394204,1,3,0
7490457@N07,9040,28,1362190914,1362190914,1,2,0
7490457@N07,9040,15,1362184397,1362184397,1,2,0
75014282@N08,9041,28,1394965631,1394965631,1,1,0
75113182@N08,9042,17,1272027763,1272027763,1,1,0
75229645@N00,9043,31,1317430179,1317430179,1,2,0
75229645@N00,9043,29,1317430131,1317431530,5,2,1399
75229645@N00,9044,21,1443854035,1443854069,3,6,34
75229645@N00,9044,26,1443860143,1443860143,1,6,0
75229645@N00,9044,14,1443834786,1443834786,1,6,0
75229645@N00,9044,22,1443834686,1443835414,2,6,728
75229645@N00,9044,27,1443859630,1443872027,2,6,12397
75229645@N00,9044,20,1443827310,1443827507,3,6,197
75255210@N00,9045,26,1303043056,1303043056,1,1,0
75268070@N00,9046,23,1272100213,1272100213,1,1,0
75274024@N00,9047,20,1373268603,1373268603,1,2,0
75274024@N00,9047,17,1373244868,1373244868,1,2,0
75345140@N00,9048,22,1317271995,1317271995,1,1,0
75367347@N07,9049,16,1313526204,1313526204,1,1,0
7537305@N05,9050,29,1341377559,1341377559,1,1,0
75427019@N00,9051,13,1344221876,1344221876,1,1,0
75427019@N00,9052,17,1405168571,1405168571,1,1,0
75433066@N00,9053,17,1238803576,1238810742,3,1,7166
75447720@N02,9054,17,1340679751,1340679986,2,1,235
75494748@N08,9055,26,1435221973,1435233066,2,1,11093
75494748@N08,9056,14,1435361340,1435361340,1,1,0
75494748@N08,9057,26,1435397570,1435397570,1,1,0
75509382@N07,9058,19,1406377604,1406377604,1,1,0
75558245@N00,9059,20,1243579417,1243579417,1,9,0
75558245@N00,9059,26,1243567406,1243592033,3,9,24627
75558245@N00,9059,29,1243571247,1243573800,4,9,2553
75558245@N00,9059,28,1243566300,1243593589,7,9,27289
75558245@N00,9059,10,1243586733,1243586733,1,9,0
75558245@N00,9059,1,1243566106,1243566106,1,9,0
75558245@N00,9059,3,1243591413,1243591413,1,9,0
75558245@N00,9059,4,1243591094,1243591094,1,9,0
75558245@N00,9059,31,1243570947,1243570947,1,9,0
75558245@N00,9060,12,1243786760,1243786760,1,2,0
75558245@N00,9060,20,1243784030,1243784030,1,2,0
75605227@N04,9061,7,1466932963,1466932963,1,1,0
75617537@N03,9062,1,1368785764,1368785764,1,1,0
75649425@N07,9063,28,1336132659,1336132659,1,1,0
75666721@N08,9064,22,1388460502,1388460502,1,2,0
75666721@N08,9064,20,1388463752,1388463752,1,2,0
75666721@N08,9065,28,1388492749,1388506005,2,1,13256
75666721@N08,9066,17,1399203103,1399203103,1,2,0
75666721@N08,9066,16,1399186653,1399186653,1,2,0
75666721@N08,9067,28,1399282151,1399282151,1,1,0
75666721@N08,9068,1,1402283773,1402283773,1,1,0
75666721@N08,9069,19,1413700407,1413700407,1,1,0
75666721@N08,9070,18,1423987017,1423987017,1,1,0
75667634@N00,9071,5,1420853957,1420854002,2,1,45
75674173@N00,9072,31,1316083598,1316083598,1,1,0
75674173@N00,9073,29,1316172382,1316172382,1,4,0
75674173@N00,9073,20,1316172781,1316172788,2,4,7
75674173@N00,9073,23,1316177505,1316177505,1,4,0
75674173@N00,9073,24,1316181185,1316181185,1,4,0
75683070@N00,9074,26,1326728779,1326755350,22,22,26571
75683070@N00,9074,1,1326723796,1326725810,5,22,2014
75683070@N00,9074,19,1326744376,1326744396,2,22,20
75683070@N00,9074,10,1326736944,1326755894,25,22,18950
75683070@N00,9074,4,1326736867,1326741936,22,22,5069
75683070@N00,9074,13,1326731522,1326731522,1,22,0
75683070@N00,9074,24,1326735851,1326750739,17,22,14888
75683070@N00,9074,27,1326727469,1326752253,6,22,24784
75683070@N00,9074,12,1326736483,1326736543,5,22,60
75683070@N00,9074,21,1326729359,1326732826,4,22,3467
75683070@N00,9074,30,1326737295,1326747141,10,22,9846
75683070@N00,9074,20,1326746912,1326746912,1,22,0
75683070@N00,9074,6,1326729267,1326755384,12,22,26117
75683070@N00,9074,25,1326748467,1326761384,47,22,12917
75683070@N00,9074,22,1326746159,1326746793,6,22,634
75683070@N00,9074,15,1326728091,1326751546,2,22,23455
75683070@N00,9074,8,1326734269,1326734681,2,22,412
75683070@N00,9074,29,1326744445,1326747089,15,22,2644
75683070@N00,9074,3,1326731695,1326756873,13,22,25178
75683070@N00,9074,7,1326732938,1326733214,6,22,276
75683070@N00,9074,16,1326726730,1326760283,33,22,33553
75683070@N00,9074,28,1326725828,1326755025,26,22,29197
75683070@N00,9075,26,1430698296,1430733016,21,27,34720
75683070@N00,9075,9,1430723360,1430723705,3,27,345
75683070@N00,9075,1,1430691527,1430734024,4,27,42497
75683070@N00,9075,19,1430702775,1430725923,15,27,23148
75683070@N00,9075,10,1430706979,1430706979,1,27,0
75683070@N00,9075,13,1430712286,1430731069,24,27,18783
75683070@N00,9075,24,1430697502,1430717381,29,27,19879
75683070@N00,9075,31,1430707069,1430707563,2,27,494
75683070@N00,9075,27,1430694313,1430728281,18,27,33968
75683070@N00,9075,23,1430700669,1430724462,14,27,23793
75683070@N00,9075,21,1430717844,1430720817,3,27,2973
75683070@N00,9075,30,1430705938,1430725309,4,27,19371
75683070@N00,9075,18,1430699515,1430726309,24,27,26794
75683070@N00,9075,20,1430705919,1430711548,4,27,5629
75683070@N00,9075,6,1430698173,1430723722,6,27,25549
75683070@N00,9075,25,1430712435,1430719588,26,27,7153
75683070@N00,9075,22,1430707665,1430711823,9,27,4158
75683070@N00,9075,5,1430698103,1430698103,1,27,0
75683070@N00,9075,12,1430697630,1430717606,14,27,19976
75683070@N00,9075,14,1430708145,1430710514,9,27,2369
75683070@N00,9075,17,1430697079,1430697388,6,27,309
75683070@N00,9075,15,1430712719,1430728138,6,27,15419
75683070@N00,9075,29,1430703302,1430725971,41,27,22669
75683070@N00,9075,3,1430697988,1430721015,5,27,23027
75683070@N00,9075,7,1430698086,1430722591,5,27,24505
75683070@N00,9075,16,1430693568,1430698585,8,27,5017
75683070@N00,9075,28,1430693376,1430693424,5,27,48
75722661@N00,9076,16,1220743611,1220743611,1,1,0
75722661@N00,9077,15,1281089995,1281089995,1,1,0
75722661@N00,9078,23,1298858187,1298858187,1,2,0
75722661@N00,9078,26,1298857674,1298857674,1,2,0
75722661@N00,9079,30,1317430774,1317430774,1,1,0
75755096@N02,9080,1,1414742395,1414742395,1,1,0
75755096@N02,9081,25,1414841840,1414841840,1,1,0
75755096@N02,9082,29,1415164251,1415164251,1,1,0
75755096@N02,9083,20,1415701328,1415701328,1,1,0
7575958@N02,9084,26,1221962157,1221962157,1,1,0
75797390@N00,9085,28,1404813796,1404813796,1,2,0
75797390@N00,9085,14,1404811445,1404811445,1,2,0
75806696@N00,9086,12,1290924001,1290924001,1,2,0
75806696@N00,9086,19,1290922006,1290922006,1,2,0
7585404@N05,9087,26,1458777898,1458777898,1,1,0
7593170@N07,9088,16,1217512800,1217512800,1,4,0
7593170@N07,9088,30,1217512800,1217512800,1,4,0
7593170@N07,9088,4,1217512800,1217512800,1,4,0
7593170@N07,9088,12,1217512800,1217512800,1,4,0
75941851@N00,9089,19,1226360752,1226360975,2,9,223
75941851@N00,9089,1,1226380655,1226380655,1,9,0
75941851@N00,9089,29,1226364530,1226364530,1,9,0
75941851@N00,9089,20,1226364597,1226364680,3,9,83
75941851@N00,9089,13,1226377054,1226379129,18,9,2075
75941851@N00,9089,16,1226373743,1226373743,1,9,0
75941851@N00,9089,22,1226366082,1226369763,4,9,3681
75941851@N00,9089,3,1226375556,1226375556,1,9,0
75941851@N00,9089,21,1226375813,1226375874,2,9,61
75941851@N00,9090,22,1254445705,1254445705,1,12,0
75941851@N00,9090,23,1254448849,1254450297,2,12,1448
75941851@N00,9090,19,1254447009,1254447052,3,12,43
75941851@N00,9090,15,1254459121,1254459430,2,12,309
75941851@N00,9090,21,1254454255,1254454255,1,12,0
75941851@N00,9090,20,1254441948,1254441948,1,12,0
75941851@N00,9090,18,1254448609,1254448609,1,12,0
75941851@N00,9090,13,1254454769,1254454782,2,12,13
75941851@N00,9090,14,1254445679,1254445733,2,12,54
75941851@N00,9090,30,1254448441,1254448441,1,12,0
75941851@N00,9090,26,1254462013,1254462474,5,12,461
75941851@N00,9090,12,1254455012,1254455012,1,12,0
75941851@N00,9091,22,1268377347,1268377347,1,1,0
75987989@N03,9092,5,1339305177,1339305177,1,1,0
75992475@N02,9093,26,1434803610,1434803610,1,4,0
75992475@N02,9093,15,1434793933,1434809583,2,4,15650
75992475@N02,9093,27,1434765880,1434765880,1,4,0
75992475@N02,9093,28,1434762955,1434762955,1,4,0
75992475@N02,9094,26,1434863215,1434863215,1,2,0
75992475@N02,9094,30,1434872118,1434872118,1,2,0
75992475@N02,9095,1,1434930852,1434933301,4,4,2449
75992475@N02,9095,24,1434937767,1434937767,1,4,0
75992475@N02,9095,28,1434931921,1434933833,2,4,1912
75992475@N02,9095,13,1434944511,1434944511,1,4,0
76024515@N07,9096,27,1333805942,1333805942,1,1,0
76024515@N07,9097,29,1354938926,1354938926,1,2,0
76024515@N07,9097,26,1354957740,1354957740,1,2,0
76024515@N07,9098,24,1363856729,1363856729,1,2,0
76024515@N07,9098,12,1363857280,1363857280,1,2,0
76024515@N07,9099,12,1423711390,1423711390,1,1,0
76033853@N00,9100,12,1365304537,1365304537,1,1,0
7606077@N02,9101,15,1457773961,1457773961,1,1,0
76101503@N00,9102,18,1437730262,1437730262,1,1,0
76112547@N00,9103,27,1316050136,1316050136,1,2,0
76112547@N00,9103,14,1316062099,1316062099,1,2,0
7613980@N06,9104,23,1286847091,1286847091,1,1,0
76151808@N00,9105,6,1203041031,1203041031,1,14,0
76151808@N00,9105,12,1203037657,1203037657,1,14,0
76151808@N00,9105,19,1203052881,1203052881,1,14,0
76151808@N00,9105,15,1203036966,1203036966,1,14,0
76151808@N00,9105,5,1203040263,1203040263,1,14,0
76151808@N00,9105,11,1203039945,1203040037,2,14,92
76151808@N00,9105,3,1203062177,1203062177,1,14,0
76151808@N00,9105,16,1203050736,1203051331,5,14,595
76151808@N00,9105,24,1203036718,1203046664,2,14,9946
76151808@N00,9105,31,1203044978,1203044978,1,14,0
76151808@N00,9105,9,1203041013,1203041013,1,14,0
76151808@N00,9105,1,1203035498,1203035498,1,14,0
76151808@N00,9105,21,1203038802,1203059562,3,14,20760
76151808@N00,9105,17,1203038371,1203038371,1,14,0
76151808@N00,9106,28,1203371981,1203371981,1,2,0
76151808@N00,9106,17,1203372587,1203372587,1,2,0
76151808@N00,9107,27,1203497480,1203497480,1,4,0
76151808@N00,9107,24,1203463617,1203479081,3,4,15464
76151808@N00,9107,23,1203499937,1203499937,1,4,0
76151808@N00,9107,26,1203469666,1203469897,2,4,231
76151808@N00,9108,6,1203647446,1203647446,1,9,0
76151808@N00,9108,19,1203661011,1203661011,1,9,0
76151808@N00,9108,15,1203659284,1203659284,1,9,0
76151808@N00,9108,27,1203660247,1203660247,1,9,0
76151808@N00,9108,25,1203638199,1203638199,1,9,0
76151808@N00,9108,24,1203659518,1203659518,1,9,0
76151808@N00,9108,13,1203640568,1203642306,3,9,1738
76151808@N00,9108,30,1203647964,1203648491,2,9,527
76151808@N00,9108,29,1203635627,1203635627,1,9,0
76151808@N00,9109,28,1203741769,1203741769,1,5,0
76151808@N00,9109,31,1203725085,1203726450,3,5,1365
76151808@N00,9109,13,1203744890,1203744890,1,5,0
76151808@N00,9109,26,1203723305,1203723305,1,5,0
76151808@N00,9109,18,1203724570,1203724570,1,5,0
76151808@N00,9110,26,1276862154,1276862636,2,7,482
76151808@N00,9110,29,1276870174,1276881033,6,7,10859
76151808@N00,9110,28,1276883356,1276883356,1,7,0
76151808@N00,9110,3,1276879708,1276879708,1,7,0
76151808@N00,9110,16,1276878364,1276878364,1,7,0
76151808@N00,9110,23,1276863124,1276863242,2,7,118
76151808@N00,9110,15,1276879004,1276879004,1,7,0
76151808@N00,9111,13,1276930240,1276932691,3,6,2451
76151808@N00,9111,1,1276944604,1276944604,1,6,0
76151808@N00,9111,26,1276928031,1276928031,1,6,0
76151808@N00,9111,25,1276929494,1276929753,2,6,259
76151808@N00,9111,28,1276943339,1276943339,1,6,0
76151808@N00,9111,7,1276928163,1276928163,1,6,0
76151808@N00,9112,26,1376965828,1376965828,1,4,0
76151808@N00,9112,29,1376959551,1376959551,1,4,0
76151808@N00,9112,25,1376983816,1376983816,1,4,0
76151808@N00,9112,15,1377000408,1377000408,1,4,0
76151808@N00,9113,31,1377177737,1377177737,1,3,0
76151808@N00,9113,29,1377136366,1377136366,1,3,0
76151808@N00,9113,27,1377164063,1377164063,1,3,0
76151808@N00,9114,13,1436857599,1436859537,2,2,1938
76151808@N00,9114,4,1436862858,1436862858,1,2,0
76151808@N00,9115,26,1436918995,1436918995,1,2,0
76151808@N00,9115,28,1436915630,1436915630,1,2,0
76151808@N00,9116,28,1437052126,1437052548,2,1,422
76188625@N00,9117,6,1219752670,1219752968,2,1,298
76198248@N05,9118,28,1293691988,1293707283,2,1,15295
76198248@N05,9119,26,1331935892,1331935892,1,1,0
76213266@N00,9120,15,1224209724,1224229336,2,5,19612
76213266@N00,9120,26,1224240121,1224243285,2,5,3164
76213266@N00,9120,13,1224230589,1224230589,1,5,0
76213266@N00,9120,1,1224202010,1224202010,1,5,0
76213266@N00,9120,16,1224205677,1224205677,1,5,0
76225887@N00,9121,26,1275849056,1275849441,4,1,385
76225887@N00,9122,26,1275899555,1275899564,2,1,9
76225887@N00,9123,26,1276021806,1276022051,8,1,245
76237104@N05,9124,26,1312766171,1312784254,4,1,18083
76242871@N03,9125,4,1354938799,1354938799,1,1,0
76300083@N02,9126,15,1335580556,1335580556,1,1,0
7630487@N08,9127,17,1373600532,1373600532,1,3,0
7630487@N08,9127,15,1373602885,1373602885,1,3,0
7630487@N08,9127,7,1373598104,1373598104,1,3,0
7630487@N08,9128,28,1379743965,1379743965,1,3,0
7630487@N08,9128,30,1379739906,1379740055,2,3,149
7630487@N08,9128,18,1379743002,1379743002,1,3,0
7630487@N08,9129,30,1379830002,1379830173,2,2,171
7630487@N08,9129,29,1379830845,1379830845,1,2,0
7630487@N08,9130,30,1386742427,1386742427,1,6,0
7630487@N08,9130,20,1386731238,1386731734,2,6,496
7630487@N08,9130,18,1386742625,1386742625,1,6,0
7630487@N08,9130,29,1386742254,1386742254,1,6,0
7630487@N08,9130,21,1386737982,1386737982,1,6,0
7630487@N08,9130,26,1386725058,1386725058,1,6,0
7630487@N08,9131,20,1417075652,1417075801,2,5,149
7630487@N08,9131,25,1417074644,1417075003,2,5,359
7630487@N08,9131,30,1417073522,1417074238,2,5,716
7630487@N08,9131,17,1417075494,1417075494,1,5,0
7630487@N08,9131,19,1417073951,1417073951,1,5,0
7630487@N08,9132,3,1418641887,1418641887,1,1,0
7630487@N08,9133,28,1418746390,1418746390,1,1,0
7635377@N05,9134,22,1207318585,1207318585,1,1,0
76364672@N08,9135,28,1328765967,1328765967,1,1,0
76372974@N08,9136,7,1340022749,1340022749,1,3,0
76372974@N08,9136,30,1340019759,1340019759,1,3,0
76372974@N08,9136,13,1340019493,1340021364,2,3,1871
7642077@N04,9137,1,1370734389,1370734389,1,1,0
7642077@N04,9138,1,1370833541,1370863745,20,3,30204
7642077@N04,9138,22,1370835803,1370836099,6,3,296
7642077@N04,9138,14,1370834624,1370835069,12,3,445
7642077@N04,9139,1,1370909029,1370953593,22,1,44564
7642077@N04,9140,1,1370990384,1371040212,42,1,49828
7642077@N04,9141,1,1372364199,1372364199,1,1,0
76425102@N00,9142,1,1364876383,1364876383,1,1,0
7642964@N03,9143,26,1241830902,1241830902,1,1,0
76459280@N06,9144,20,1375096302,1375126671,11,1,30369
76500745@N03,9145,19,1340515685,1340515685,1,1,0
76508379@N07,9146,29,1342743486,1342743486,1,1,0
76508379@N07,9147,26,1342783968,1342783968,1,1,0
76619232@N00,9148,1,1362011260,1362011260,1,1,0
76619232@N00,9149,17,1362107128,1362110057,2,3,2929
76619232@N00,9149,27,1362110125,1362110125,1,3,0
76619232@N00,9149,1,1362095339,1362106650,3,3,11311
76665138@N00,9150,25,1240029560,1240030302,21,12,742
76665138@N00,9150,27,1240021431,1240021431,1,12,0
76665138@N00,9150,28,1240022582,1240060030,11,12,37448
76665138@N00,9150,17,1240021311,1240033060,10,12,11749
76665138@N00,9150,16,1240021427,1240051316,27,12,29889
76665138@N00,9150,26,1240018693,1240062298,13,12,43605
76665138@N00,9150,29,1240055232,1240058763,7,12,3531
76665138@N00,9150,3,1240009244,1240029169,18,12,19925
76665138@N00,9150,5,1240019308,1240019980,8,12,672
76665138@N00,9150,24,1240026146,1240028844,40,12,2698
76665138@N00,9150,13,1240030602,1240032333,18,12,1731
76665138@N00,9150,23,1240034340,1240034567,9,12,227
76665138@N00,9151,28,1240197023,1240214363,11,8,17340
76665138@N00,9151,17,1240203929,1240204536,3,8,607
76665138@N00,9151,16,1240205780,1240211256,2,8,5476
76665138@N00,9151,26,1240199975,1240214483,29,8,14508
76665138@N00,9151,29,1240206797,1240209352,9,8,2555
76665138@N00,9151,3,1240214533,1240219712,6,8,5179
76665138@N00,9151,10,1240206757,1240206757,1,8,0
76665138@N00,9151,24,1240216500,1240217923,26,8,1423
76665138@N00,9152,28,1240279578,1240280324,13,3,746
76665138@N00,9152,17,1240281036,1240281892,2,3,856
76665138@N00,9152,26,1240280546,1240285937,3,3,5391
76701708@N00,9153,14,1418084341,1418084344,3,1,3
76749155@N06,9154,29,1373029758,1373030519,4,1,761
76749155@N06,9155,26,1373093966,1373093993,2,1,27
7677428@N07,9156,1,1380198459,1380198459,1,1,0
7680756@N08,9157,18,1228297595,1228297595,1,5,0
7680756@N08,9157,1,1228297714,1228297733,2,5,19
7680756@N08,9157,26,1228296656,1228297460,5,5,804
7680756@N08,9157,21,1228294155,1228294160,2,5,5
7680756@N08,9157,28,1228297478,1228297478,1,5,0
76825970@N02,9158,17,1394204669,1394204669,1,1,0
7682712@N04,9159,1,1366545344,1366545344,1,1,0
76830337@N07,9160,5,1368103271,1368103271,1,2,0
76830337@N07,9160,16,1368103435,1368103435,1,2,0
76944731@N00,9161,26,1306111195,1306111195,1,2,0
76944731@N00,9161,8,1306133250,1306133250,1,2,0
76944731@N00,9162,15,1325985340,1325985340,1,2,0
76944731@N00,9162,28,1325983381,1325983381,1,2,0
76944731@N00,9163,29,1353294699,1353294746,2,1,47
76944731@N00,9164,20,1471662422,1471663252,2,2,830
76944731@N00,9164,26,1471645192,1471691490,2,2,46298
76959737@N00,9165,26,1325766809,1325766809,1,1,0
76959737@N00,9166,26,1329718047,1329718047,1,1,0
76959737@N00,9167,23,1340617825,1340617825,1,1,0
7702423@N04,9168,16,1342057517,1342097445,182,1,39928
77084926@N06,9169,27,1379363149,1379363149,1,1,0
77108445@N00,9170,26,1264845336,1264845336,1,1,0
77120147@N06,9171,30,1319834819,1319834819,1,1,0
77120147@N06,9172,28,1324895965,1324895965,1,1,0
77120147@N06,9173,28,1326433305,1326433305,1,3,0
77120147@N06,9173,23,1326440662,1326440662,1,3,0
77120147@N06,9173,6,1326442408,1326442408,1,3,0
77120147@N06,9174,30,1327151272,1327151272,1,1,0
77120147@N06,9175,19,1327893265,1327893265,1,3,0
77120147@N06,9175,13,1327889565,1327889678,2,3,113
77120147@N06,9175,20,1327892806,1327892839,2,3,33
77120147@N06,9176,28,1328856722,1328856722,1,2,0
77120147@N06,9176,10,1328858577,1328858577,1,2,0
77120147@N06,9177,18,1330171541,1330171541,1,6,0
77120147@N06,9177,5,1330146427,1330146427,1,6,0
77120147@N06,9177,15,1330149199,1330168004,2,6,18805
77120147@N06,9177,26,1330145851,1330146024,2,6,173
77120147@N06,9177,8,1330146214,1330146237,2,6,23
77120147@N06,9177,20,1330144366,1330144366,1,6,0
77120147@N06,9178,11,1331251784,1331251784,1,7,0
77120147@N06,9178,1,1331257438,1331257438,1,7,0
77120147@N06,9178,26,1331244182,1331255703,4,7,11521
77120147@N06,9178,3,1331252435,1331252435,1,7,0
77120147@N06,9178,29,1331246624,1331250103,2,7,3479
77120147@N06,9178,22,1331248957,1331248957,1,7,0
77120147@N06,9178,20,1331247094,1331247641,6,7,547
77120147@N06,9179,20,1331369692,1331370405,2,1,713
77120147@N06,9180,26,1332284507,1332284814,2,4,307
77120147@N06,9180,22,1332287572,1332287572,1,4,0
77120147@N06,9180,28,1332290766,1332291178,2,4,412
77120147@N06,9180,30,1332288376,1332288376,1,4,0
77120147@N06,9181,12,1332579400,1332579400,1,1,0
77120147@N06,9182,28,1333408317,1333408317,1,1,0
77120147@N06,9183,16,1333633170,1333633170,1,1,0
77120147@N06,9184,20,1334392277,1334392277,1,4,0
77120147@N06,9184,15,1334396013,1334396081,3,4,68
77120147@N06,9184,12,1334395413,1334395413,1,4,0
77120147@N06,9184,26,1334384493,1334384493,1,4,0
77120147@N06,9185,26,1336410363,1336410363,1,2,0
77120147@N06,9185,20,1336405884,1336405884,1,2,0
77120147@N06,9186,26,1336605659,1336609789,4,7,4130
77120147@N06,9186,1,1336612076,1336612076,1,7,0
77120147@N06,9186,16,1336609976,1336609976,1,7,0
77120147@N06,9186,23,1336609022,1336609164,3,7,142
77120147@N06,9186,12,1336610151,1336610275,2,7,124
77120147@N06,9186,15,1336611107,1336611107,1,7,0
77120147@N06,9186,22,1336607728,1336607728,1,7,0
77120147@N06,9187,26,1338041286,1338041286,1,3,0
77120147@N06,9187,18,1338024938,1338024938,1,3,0
77120147@N06,9187,5,1338039852,1338039852,1,3,0
77120147@N06,9188,10,1340431273,1340431273,1,1,0
77120147@N06,9189,26,1340917826,1340917826,1,6,0
77120147@N06,9189,1,1340924489,1340925055,2,6,566
77120147@N06,9189,5,1340918068,1340918068,1,6,0
77120147@N06,9189,12,1340919489,1340919489,1,6,0
77120147@N06,9189,22,1340921636,1340923324,4,6,1688
77120147@N06,9189,30,1340921107,1340921219,2,6,112
77120147@N06,9190,20,1341315117,1341315117,1,1,0
77120147@N06,9191,26,1343521504,1343521504,1,1,0
77154962@N00,9192,26,1274055237,1274055237,1,3,0
77154962@N00,9192,28,1274053497,1274053497,1,3,0
77154962@N00,9192,1,1274053071,1274064716,2,3,11645
77154962@N00,9193,17,1274096927,1274096927,1,4,0
77154962@N00,9193,12,1274099842,1274099842,1,4,0
77154962@N00,9193,26,1274100180,1274100180,1,4,0
77154962@N00,9193,1,1274094610,1274094610,1,4,0
77154962@N00,9194,5,1274239427,1274239427,1,5,0
77154962@N00,9194,20,1274225321,1274225321,1,5,0
77154962@N00,9194,26,1274232983,1274232983,1,5,0
77154962@N00,9194,25,1274231552,1274231552,1,5,0
77154962@N00,9194,7,1274247697,1274247784,2,5,87
77179348@N00,9195,15,1340260905,1340267004,12,18,6099
77179348@N00,9195,14,1340234474,1340248790,21,18,14316
77179348@N00,9195,20,1340243626,1340247971,11,18,4345
77179348@N00,9195,24,1340241331,1340266996,49,18,25665
77179348@N00,9195,31,1340243312,1340243365,3,18,53
77179348@N00,9195,18,1340253593,1340258584,21,18,4991
77179348@N00,9195,21,1340241638,1340241653,3,18,15
77179348@N00,9195,26,1340238613,1340258696,5,18,20083
77179348@N00,9195,30,1340245391,1340253265,10,18,7874
77179348@N00,9195,1,1340237640,1340237843,5,18,203
77179348@N00,9195,29,1340242998,1340258019,28,18,15021
77179348@N00,9195,12,1340241370,1340265335,12,18,23965
77179348@N00,9195,17,1340261671,1340262478,11,18,807
77179348@N00,9195,27,1340245735,1340245735,1,18,0
77179348@N00,9195,22,1340243537,1340250606,18,18,7069
77179348@N00,9195,28,1340237853,1340238502,4,18,649
77179348@N00,9195,16,1340258706,1340260764,16,18,2058
77179348@N00,9195,19,1340245196,1340258199,29,18,13003
77179348@N00,9196,14,1344659711,1344661500,8,15,1789
77179348@N00,9196,20,1344668128,1344669204,2,15,1076
77179348@N00,9196,24,1344677594,1344692683,12,15,15089
77179348@N00,9196,31,1344665166,1344665337,10,15,171
77179348@N00,9196,18,1344650002,1344655239,14,15,5237
77179348@N00,9196,30,1344655876,1344673005,16,15,17129
77179348@N00,9196,1,1344648943,1344648959,2,15,16
77179348@N00,9196,29,1344664774,1344689643,39,15,24869
77179348@N00,9196,12,1344682982,1344683056,2,15,74
77179348@N00,9196,17,1344693244,1344693244,1,15,0
77179348@N00,9196,22,1344658798,1344660829,17,15,2031
77179348@N00,9196,16,1344684337,1344686217,58,15,1880
77179348@N00,9196,23,1344649247,1344664306,7,15,15059
77179348@N00,9196,19,1344655034,1344655610,8,15,576
77179348@N00,9196,15,1344686618,1344692875,3,15,6257
77179348@N00,9197,4,1344739486,1344739693,9,10,207
77179348@N00,9197,11,1344739514,1344739635,7,10,121
77179348@N00,9197,20,1344738061,1344738061,1,10,0
77179348@N00,9197,13,1344738470,1344738482,3,10,12
77179348@N00,9197,21,1344739324,1344739762,7,10,438
77179348@N00,9197,15,1344740753,1344742538,30,10,1785
77179348@N00,9197,1,1344737772,1344743299,21,10,5527
77179348@N00,9197,22,1344738265,1344738275,3,10,10
77179348@N00,9197,17,1344741271,1344742572,5,10,1301
77179348@N00,9197,28,1344743376,1344743388,2,10,12
77179348@N00,9198,12,1405763194,1405763199,6,1,5
77179348@N00,9199,27,1405836904,1405837790,3,1,886
77187971@N00,9200,28,1350993929,1350993929,1,1,0
77194376@N05,9201,26,1376394236,1376394236,1,1,0
77197718@N06,9202,30,1374897827,1374897827,1,1,0
77217620@N08,9203,26,1329828775,1329828775,1,1,0
77217620@N08,9204,28,1330857516,1330857516,1,1,0
77217620@N08,9205,18,1332066461,1332066461,1,1,0
77217620@N08,9206,28,1332302354,1332302354,1,1,0
77217620@N08,9207,28,1333357697,1333357697,1,1,0
77217620@N08,9208,28,1333517279,1333529691,2,1,12412
77217620@N08,9209,18,1333614092,1333614092,1,1,0
77217620@N08,9210,26,1333774535,1333774535,1,1,0
77217620@N08,9211,28,1333852684,1333852684,1,1,0
77217620@N08,9212,28,1334203253,1334203253,1,1,0
77217620@N08,9213,28,1334820991,1334820991,1,1,0
77217620@N08,9214,18,1338380219,1338380219,1,2,0
77217620@N08,9214,28,1338367305,1338367305,1,2,0
77217620@N08,9215,26,1338956506,1338956506,1,3,0
77217620@N08,9215,12,1338956920,1338956920,1,3,0
77217620@N08,9215,29,1338955883,1338955883,1,3,0
77217620@N08,9216,28,1339581095,1339581095,1,1,0
77217620@N08,9217,28,1340776374,1340776374,1,1,0
77217620@N08,9218,22,1340850189,1340854831,3,2,4642
77217620@N08,9218,23,1340849692,1340849692,1,2,0
77217620@N08,9219,28,1342477663,1342477663,1,1,0
77237839@N07,9220,28,1393749226,1393749789,4,3,563
77237839@N07,9220,23,1393739310,1393739346,6,3,36
77237839@N07,9220,29,1393735817,1393749222,2,3,13405
77249045@N07,9221,28,1314953350,1314953500,3,2,150
77249045@N07,9221,27,1314945399,1314945399,1,2,0
77249045@N07,9222,16,1316134999,1316135140,6,4,141
77249045@N07,9222,21,1316130409,1316130928,2,4,519
77249045@N07,9222,1,1316125033,1316125061,2,4,28
77249045@N07,9222,28,1316135568,1316135568,1,4,0
77249045@N07,9223,26,1317961517,1317961517,1,4,0
77249045@N07,9223,23,1317958418,1317958418,1,4,0
77249045@N07,9223,21,1317955217,1317956263,6,4,1046
77249045@N07,9223,28,1317961314,1317962000,9,4,686
77249045@N07,9224,21,1318415680,1318416390,9,5,710
77249045@N07,9224,26,1318423493,1318423493,1,5,0
77249045@N07,9224,1,1318420200,1318422485,2,5,2285
77249045@N07,9224,3,1318417804,1318417918,2,5,114
77249045@N07,9224,28,1318419726,1318423938,5,5,4212
77249045@N07,9225,21,1319356314,1319356945,3,3,631
77249045@N07,9225,28,1319358072,1319358072,1,3,0
77249045@N07,9225,20,1319366318,1319366318,1,3,0
77249045@N07,9226,16,1320368112,1320368228,4,3,116
77249045@N07,9226,26,1320366678,1320366678,1,3,0
77249045@N07,9226,20,1320378439,1320379520,5,3,1081
77249045@N07,9227,26,1321776842,1321777912,6,2,1070
77249045@N07,9227,27,1321760144,1321760144,1,2,0
77249045@N07,9228,21,1323405661,1323406589,8,4,928
77249045@N07,9228,18,1323393026,1323393026,1,4,0
77249045@N07,9228,28,1323392773,1323393184,4,4,411
77249045@N07,9228,13,1323406782,1323406782,1,4,0
77249045@N07,9229,22,1324184321,1324184438,3,1,117
77249045@N07,9230,24,1325818312,1325818651,6,4,339
77249045@N07,9230,28,1325826554,1325826826,2,4,272
77249045@N07,9230,26,1325819151,1325819464,5,4,313
77249045@N07,9230,1,1325826360,1325826360,1,4,0
77249045@N07,9231,16,1325867948,1325867948,1,1,0
77249045@N07,9232,26,1325925821,1325925821,1,1,0
77249045@N07,9233,24,1326332822,1326333399,21,3,577
77249045@N07,9233,26,1326329956,1326329956,1,3,0
77249045@N07,9233,16,1326329454,1326336580,3,3,7126
77249045@N07,9234,24,1326433565,1326433911,16,1,346
77249045@N07,9235,5,1328422553,1328422584,3,3,31
77249045@N07,9235,26,1328420893,1328420893,1,3,0
77249045@N07,9235,1,1328424306,1328437125,7,3,12819
77249045@N07,9236,5,1328969106,1328969132,3,4,26
77249045@N07,9236,24,1328942238,1328943144,5,4,906
77249045@N07,9236,30,1328968141,1328968141,1,4,0
77249045@N07,9236,25,1328937869,1328941195,21,4,3326
77249045@N07,9237,28,1330469353,1330469384,2,8,31
77249045@N07,9237,6,1330465218,1330465218,1,8,0
77249045@N07,9237,24,1330483877,1330484334,18,8,457
77249045@N07,9237,13,1330466050,1330466050,1,8,0
77249045@N07,9237,23,1330507565,1330507565,1,8,0
77249045@N07,9237,26,1330465502,1330513946,11,8,48444
77249045@N07,9237,16,1330465305,1330465305,1,8,0
77249045@N07,9237,1,1330471577,1330491702,9,8,20125
77249045@N07,9238,29,1331354031,1331354445,12,6,414
77249045@N07,9238,28,1331381629,1331381810,2,6,181
77249045@N07,9238,20,1331377932,1331377932,1,6,0
77249045@N07,9238,23,1331352280,1331352280,1,6,0
77249045@N07,9238,21,1331348921,1331349154,5,6,233
77249045@N07,9238,25,1331359264,1331359941,16,6,677
77249045@N07,9239,26,1332484149,1332484149,1,2,0
77249045@N07,9239,31,1332501979,1332502616,21,2,637
77249045@N07,9240,1,1334907944,1334907944,1,3,0
77249045@N07,9240,28,1334902792,1334902792,1,3,0
77249045@N07,9240,31,1334925367,1334925454,2,3,87
77249045@N07,9241,28,1338538404,1338538404,1,1,0
77249045@N07,9242,28,1344315764,1344315820,3,1,56
77249045@N07,9243,3,1346293414,1346293414,1,4,0
77249045@N07,9243,26,1346310547,1346310547,1,4,0
77249045@N07,9243,24,1346287290,1346287712,4,4,422
77249045@N07,9243,28,1346297393,1346297393,1,4,0
77249045@N07,9244,20,1348809381,1348809847,2,4,466
77249045@N07,9244,21,1348818708,1348819248,7,4,540
77249045@N07,9244,9,1348817490,1348817657,2,4,167
77249045@N07,9244,16,1348813906,1348813946,2,4,40
77249045@N07,9245,21,1354597431,1354597608,3,5,177
77249045@N07,9245,1,1354606581,1354608496,7,5,1915
77249045@N07,9245,16,1354598134,1354598205,3,5,71
77249045@N07,9245,26,1354597575,1354597621,2,5,46
77249045@N07,9245,28,1354606367,1354606811,2,5,444
77249045@N07,9246,29,1355722540,1355722731,2,2,191
77249045@N07,9246,28,1355713676,1355715006,16,2,1330
77249045@N07,9247,16,1357867424,1357867424,1,7,0
77249045@N07,9247,3,1357866717,1357866717,1,7,0
77249045@N07,9247,21,1357866149,1357886169,4,7,20020
77249045@N07,9247,25,1357866279,1357884702,13,7,18423
77249045@N07,9247,1,1357864506,1357864517,2,7,11
77249045@N07,9247,26,1357867805,1357867932,6,7,127
77249045@N07,9247,24,1357868931,1357879178,4,7,10247
77249045@N07,9248,25,1358044637,1358044637,1,1,0
7730953@N08,9249,17,1399440128,1399442542,2,1,2414
7730953@N08,9250,28,1418119333,1418119333,1,1,0
7730953@N08,9251,18,1418158532,1418158532,2,7,0
7730953@N08,9251,31,1418158532,1418158532,1,7,0
7730953@N08,9251,20,1418158531,1418158531,1,7,0
7730953@N08,9251,28,1418158533,1418158533,1,7,0
7730953@N08,9251,13,1418158531,1418158531,1,7,0
7730953@N08,9251,29,1418158531,1418158533,2,7,2
7730953@N08,9251,26,1418158530,1418158530,1,7,0
7730953@N08,9252,7,1445910491,1445910491,1,4,0
7730953@N08,9252,12,1445915551,1445915551,1,4,0
7730953@N08,9252,24,1445915479,1445915541,2,4,62
7730953@N08,9252,15,1445919345,1445919345,1,4,0
7732814@N08,9253,26,1304156457,1304156457,1,1,0
7732814@N08,9254,28,1323783376,1323783376,1,1,0
77339363@N00,9255,26,1314861222,1314861222,1,1,0
77403773@N08,9256,21,1333159141,1333159838,2,1,697
77403773@N08,9257,16,1333661743,1333661743,1,1,0
77439734@N00,9258,27,1246769654,1246772364,2,7,2710
77439734@N00,9258,26,1246775370,1246776016,5,7,646
77439734@N00,9258,15,1246772078,1246772092,3,7,14
77439734@N00,9258,16,1246769346,1246769424,11,7,78
77439734@N00,9258,24,1246772220,1246775162,34,7,2942
77439734@N00,9258,28,1246769148,1246776126,15,7,6978
77439734@N00,9258,1,1246768794,1246769000,22,7,206
77466107@N00,9259,7,1353137942,1353137942,1,2,0
77466107@N00,9259,21,1353136411,1353136411,1,2,0
7751128@N02,9260,26,1219550755,1219587524,23,1,36769
7751128@N02,9261,26,1236296937,1236325851,37,1,28914
7751128@N02,9262,26,1258869406,1258898283,6,1,28877
77526212@N08,9263,1,1379746299,1379781866,12,1,35567
7756282@N04,9264,1,1192176892,1192218044,52,1,41152
7756282@N04,9265,1,1192701693,1192701693,1,1,0
7756282@N04,9266,1,1193557437,1193557437,1,1,0
77586464@N08,9267,28,1334659140,1334659140,1,1,0
77586464@N08,9268,8,1335005509,1335005509,1,1,0
7771611@N06,9269,28,1317830051,1317830525,2,3,474
7771611@N06,9269,29,1317827642,1317830257,2,3,2615
7771611@N06,9269,23,1317827945,1317830683,2,3,2738
7771611@N06,9270,1,1317919172,1317919172,1,3,0
7771611@N06,9270,29,1317903048,1317903048,1,3,0
7771611@N06,9270,28,1317919491,1317919491,1,3,0
7771611@N06,9271,1,1317982905,1317982905,1,1,0
7772341@N06,9272,16,1358684661,1358684661,1,1,0
77723504@N00,9273,5,1289017315,1289017315,1,4,0
77723504@N00,9273,28,1289002339,1289002339,1,4,0
77723504@N00,9273,13,1289019971,1289019971,1,4,0
77723504@N00,9273,30,1289005370,1289005370,1,4,0
77736600@N00,9274,6,1248171052,1248171052,1,1,0
77736600@N00,9275,26,1292387838,1292387838,1,1,0
77796709@N06,9276,28,1333798594,1333798594,1,1,0
77796709@N06,9277,1,1345123624,1345123624,1,1,0
7784816@N03,9278,27,1334456864,1334456864,1,2,0
7784816@N03,9278,22,1334456745,1334456745,1,2,0
7784816@N03,9279,27,1334640746,1334640746,1,1,0
7787707@N04,9280,19,1413255071,1413255071,1,1,0
77893517@N02,9281,18,1459388703,1459390908,2,1,2205
77893517@N02,9282,18,1459420520,1459420744,3,1,224
77906206@N00,9283,1,1206662720,1206664053,5,1,1333
77906206@N00,9284,30,1206742247,1206742255,2,2,8
77906206@N00,9284,26,1206741873,1206741873,1,2,0
77906206@N00,9285,30,1206841561,1206842403,5,4,842
77906206@N00,9285,1,1206832441,1206832441,1,4,0
77906206@N00,9285,29,1206833285,1206834918,8,4,1633
77906206@N00,9285,22,1206837011,1206840717,18,4,3706
77906206@N00,9286,26,1295922524,1295922524,1,1,0
7793758@N06,9287,26,1246235177,1246269469,8,1,34292
7793758@N06,9288,26,1246307736,1246307893,4,1,157
7793758@N06,9289,26,1246348251,1246358036,11,1,9785
7793758@N06,9290,26,1246400207,1246416674,4,1,16467
7793758@N06,9291,26,1246487197,1246489829,3,1,2632
7793758@N06,9292,26,1246573837,1246595492,9,1,21655
7794405@N05,9293,30,1329074544,1329074544,1,1,0
7794405@N05,9294,26,1331097151,1331097155,2,2,4
7794405@N05,9294,4,1331078541,1331078541,1,2,0
77945684@N00,9295,4,1190364125,1190364125,1,19,0
77945684@N00,9295,25,1190360339,1190360670,2,19,331
77945684@N00,9295,18,1190332219,1190357778,3,19,25559
77945684@N00,9295,17,1190347061,1190376887,4,19,29826
77945684@N00,9295,15,1190348391,1190348391,1,19,0
77945684@N00,9295,20,1190337701,1190337701,1,19,0
77945684@N00,9295,12,1190352158,1190365511,3,19,13353
77945684@N00,9295,7,1190363184,1190363184,1,19,0
77945684@N00,9295,24,1190348653,1190352475,2,19,3822
77945684@N00,9295,22,1190343184,1190343184,1,19,0
77945684@N00,9295,10,1190358710,1190358710,1,19,0
77945684@N00,9295,3,1190364617,1190365783,2,19,1166
77945684@N00,9295,1,1190331196,1190331340,2,19,144
77945684@N00,9295,5,1190367584,1190367584,1,19,0
77945684@N00,9295,21,1190353406,1190353635,2,19,229
77945684@N00,9295,16,1190345963,1190379445,3,19,33482
77945684@N00,9295,26,1190345935,1190374861,9,19,28926
77945684@N00,9295,30,1190340154,1190343010,2,19,2856
77945684@N00,9295,28,1190356316,1190365174,5,19,8858
77953371@N03,9296,18,1398227925,1398227925,1,1,0
77967578@N00,9297,26,1198769241,1198792723,2,5,23482
77967578@N00,9297,24,1198784822,1198784822,1,5,0
77967578@N00,9297,20,1198786545,1198797240,5,5,10695
77967578@N00,9297,1,1198777755,1198777755,1,5,0
77967578@N00,9297,18,1198780589,1198780593,2,5,4
77967578@N00,9298,28,1213608459,1213608459,1,1,0
77967578@N00,9299,16,1213652606,1213652862,4,5,256
77967578@N00,9299,26,1213650514,1213650514,1,5,0
77967578@N00,9299,28,1213653729,1213653902,2,5,173
77967578@N00,9299,20,1213649361,1213649383,2,5,22
77967578@N00,9299,17,1213651222,1213652242,4,5,1020
77967578@N00,9300,27,1214080456,1214080456,1,5,0
77967578@N00,9300,20,1214075160,1214075160,1,5,0
77967578@N00,9300,18,1214086498,1214086540,2,5,42
77967578@N00,9300,26,1214083613,1214083613,1,5,0
77967578@N00,9300,16,1214081365,1214081365,1,5,0
77967578@N00,9301,22,1215109827,1215109827,1,5,0
77967578@N00,9301,18,1215124065,1215124782,2,5,717
77967578@N00,9301,26,1215100380,1215100380,1,5,0
77967578@N00,9301,24,1215081567,1215081567,1,5,0
77967578@N00,9301,3,1215098556,1215098556,1,5,0
77967578@N00,9302,26,1230393411,1230393411,1,2,0
77967578@N00,9302,20,1230387187,1230412862,3,2,25675
77967578@N00,9303,26,1252634883,1252634883,1,2,0
77967578@N00,9303,3,1252623312,1252623312,1,2,0
77967578@N00,9304,26,1257883775,1257883775,1,1,0
78013771@N00,9305,30,1352315577,1352315844,2,1,267
78013771@N00,9306,30,1352604496,1352631541,4,2,27045
78013771@N00,9306,19,1352629875,1352629875,1,2,0
78013771@N00,9307,30,1352686438,1352686438,1,2,0
78013771@N00,9307,13,1352707601,1352708615,3,2,1014
78013771@N00,9308,30,1352766658,1352774066,2,4,7408
78013771@N00,9308,11,1352761102,1352761109,2,4,7
78013771@N00,9308,13,1352760469,1352762709,3,4,2240
78013771@N00,9308,29,1352768624,1352768624,1,4,0
78013771@N00,9309,7,1352935080,1352935140,2,8,60
78013771@N00,9309,14,1352938247,1352963725,17,8,25478
78013771@N00,9309,21,1352933988,1352933988,1,8,0
78013771@N00,9309,26,1352935690,1352935690,2,8,0
78013771@N00,9309,28,1352932143,1352933464,2,8,1321
78013771@N00,9309,6,1352935181,1352935181,1,8,0
78013771@N00,9309,16,1352935873,1352937403,2,8,1530
78013771@N00,9309,30,1352931941,1352931993,2,8,52
78013771@N00,9310,30,1353037954,1353037954,1,1,0
78025158@N00,9311,27,1238117433,1238117433,1,1,0
78025158@N00,9312,28,1238156928,1238157396,13,1,468
78025158@N00,9313,27,1238668200,1238668200,1,1,0
78025158@N00,9314,27,1238759100,1238759100,1,1,0
78025158@N00,9315,21,1240480506,1240480521,2,2,15
78025158@N00,9315,27,1240486200,1240486800,2,2,600
78025158@N00,9316,28,1240573539,1240573564,3,1,25
78025158@N00,9317,17,1242564309,1242564309,1,2,0
78025158@N00,9317,20,1242556745,1242558193,4,2,1448
78025158@N00,9318,27,1244464680,1244464680,1,1,0
78025158@N00,9319,24,1246859025,1246859025,1,3,0
78025158@N00,9319,13,1246865841,1246865841,1,3,0
78025158@N00,9319,4,1246861307,1246861307,1,3,0
78025158@N00,9320,27,1249910100,1249910100,1,2,0
78025158@N00,9320,28,1249912691,1249912691,1,2,0
78025158@N00,9321,16,1249990478,1249990478,1,2,0
78025158@N00,9321,27,1249995360,1249995360,1,2,0
78025158@N00,9322,27,1250171160,1250171160,1,1,0
78025158@N00,9323,20,1250908272,1250909412,6,1,1140
78025158@N00,9324,12,1255513200,1255513200,1,1,0
78025158@N00,9325,27,1255677195,1255677195,1,1,0
78025158@N00,9326,27,1257582660,1257582660,1,1,0
78025158@N00,9327,11,1260531698,1260531698,1,4,0
78025158@N00,9327,27,1260534360,1260534900,2,4,540
78025158@N00,9327,28,1260537137,1260539419,9,4,2282
78025158@N00,9327,17,1260536490,1260536490,1,4,0
78025158@N00,9328,3,1261396955,1261396955,1,2,0
78025158@N00,9328,27,1261398540,1261399440,2,2,900
78025158@N00,9329,12,1267961640,1267961640,1,1,0
78025158@N00,9330,12,1285327252,1285327252,1,1,0
78025158@N00,9331,12,1288959000,1288960200,2,1,1200
78025158@N00,9332,28,1296983696,1296983696,1,1,0
78025158@N00,9333,28,1325340877,1325340877,1,1,0
78025158@N00,9334,26,1357448400,1357448400,1,1,0
78027754@N00,9335,29,1437916497,1437918866,36,1,2369
78027754@N00,9336,28,1462719004,1462720785,130,1,1781
78091495@N02,9337,13,1279595718,1279596345,9,12,627
78091495@N02,9337,3,1279595257,1279630687,3,12,35430
78091495@N02,9337,1,1279632378,1279632734,5,12,356
78091495@N02,9337,26,1279625478,1279630355,5,12,4877
78091495@N02,9337,24,1279581035,1279584699,10,12,3664
78091495@N02,9337,30,1279603784,1279629732,4,12,25948
78091495@N02,9337,16,1279577844,1279625440,11,12,47596
78091495@N02,9337,14,1279578176,1279596964,5,12,18788
78091495@N02,9337,27,1279586053,1279586540,5,12,487
78091495@N02,9337,7,1279596694,1279596694,1,12,0
78091495@N02,9337,28,1279586047,1279625758,8,12,39711
78091495@N02,9337,19,1279601172,1279603704,4,12,2532
78097662@N00,9338,25,1243136564,1243136930,2,7,366
78097662@N00,9338,11,1243124172,1243124172,1,7,0
78097662@N00,9338,29,1243127091,1243127091,1,7,0
78097662@N00,9338,28,1243117863,1243118221,3,7,358
78097662@N00,9338,24,1243119975,1243120277,3,7,302
78097662@N00,9338,4,1243121973,1243131940,6,7,9967
78097662@N00,9338,13,1243132130,1243134907,3,7,2777
78137955@N00,9339,15,1324766008,1324766008,1,7,0
78137955@N00,9339,3,1324769935,1324769981,2,7,46
78137955@N00,9339,28,1324766536,1324766536,1,7,0
78137955@N00,9339,26,1324768583,1324768583,1,7,0
78137955@N00,9339,21,1324769557,1324769557,1,7,0
78137955@N00,9339,24,1324765861,1324765861,1,7,0
78137955@N00,9339,1,1324766806,1324767704,2,7,898
78137955@N00,9340,31,1324851920,1324851971,4,4,51
78137955@N00,9340,20,1324852852,1324852959,2,4,107
78137955@N00,9340,25,1324853391,1324854524,14,4,1133
78137955@N00,9340,13,1324855273,1324871452,8,4,16179
78175333@N00,9341,7,1238365968,1238366239,5,10,271
78175333@N00,9341,27,1238384845,1238384845,1,10,0
78175333@N00,9341,26,1238365084,1238365086,2,10,2
78175333@N00,9341,28,1238364561,1238364561,1,10,0
78175333@N00,9341,1,1238364009,1238364009,1,10,0
78175333@N00,9341,18,1238380085,1238380130,2,10,45
78175333@N00,9341,24,1238373506,1238373506,1,10,0
78175333@N00,9341,17,1238388077,1238388267,2,10,190
78175333@N00,9341,15,1238386722,1238386722,1,10,0
78175333@N00,9341,13,1238368438,1238368447,2,10,9
7827476@N06,9342,23,1375071960,1375071960,1,1,0
78309767@N00,9343,8,1195875830,1195875830,1,1,0
78611100@N00,9344,5,1340545297,1340545297,1,15,0
78611100@N00,9344,25,1340545070,1340545097,5,15,27
78611100@N00,9344,16,1340545302,1340545339,2,15,37
78611100@N00,9344,31,1340545226,1340545248,4,15,22
78611100@N00,9344,18,1340545283,1340545283,1,15,0
78611100@N00,9344,26,1340544958,1340545626,47,15,668
78611100@N00,9344,27,1340545632,1340545632,1,15,0
78611100@N00,9344,29,1340545189,1340545267,7,15,78
78611100@N00,9344,7,1340545614,1340545614,1,15,0
78611100@N00,9344,30,1340545254,1340545275,3,15,21
78611100@N00,9344,20,1340545161,1340545181,3,15,20
78611100@N00,9344,28,1340544936,1340545663,10,15,727
78611100@N00,9344,13,1340545102,1340545153,10,15,51
78611100@N00,9344,24,1340544994,1340545066,16,15,72
78611100@N00,9344,15,1340544952,1340544952,1,15,0
78647421@N00,9345,5,1305171495,1305171495,1,1,0
78647934@N06,9346,19,1409616834,1409616834,1,1,0
78647934@N06,9347,19,1409674358,1409674358,1,1,0
78672040@N00,9348,1,1210036031,1210036031,1,1,0
78672040@N00,9349,22,1272552229,1272552229,1,1,0
78672040@N00,9350,1,1272691587,1272699603,3,1,8016
78672040@N00,9351,26,1272758198,1272760159,19,2,1961
78672040@N00,9351,1,1272751448,1272785091,63,2,33643
78720487@N02,9352,1,1416188043,1416188179,5,15,136
78720487@N02,9352,15,1416192330,1416192344,2,15,14
78720487@N02,9352,27,1416191058,1416191058,1,15,0
78720487@N02,9352,21,1416190348,1416205684,6,15,15336
78720487@N02,9352,25,1416199734,1416205569,30,15,5835
78720487@N02,9352,22,1416204971,1416204971,1,15,0
78720487@N02,9352,20,1416214194,1416214194,1,15,0
78720487@N02,9352,26,1416209954,1416211371,5,15,1417
78720487@N02,9352,3,1416205737,1416205737,1,15,0
78720487@N02,9352,18,1416207608,1416207608,1,15,0
78720487@N02,9352,16,1416188469,1416188530,2,15,61
78720487@N02,9352,13,1416200456,1416205499,16,15,5043
78720487@N02,9352,29,1416188403,1416190835,2,15,2432
78720487@N02,9352,28,1416188291,1416214561,37,15,26270
78720487@N02,9352,24,1416193241,1416197850,4,15,4609
7874766@N02,9353,31,1356577057,1356577057,1,1,0
7874766@N02,9354,1,1357084641,1357132795,4,5,48154
7874766@N02,9354,26,1357085507,1357085668,3,5,161
7874766@N02,9354,28,1357085030,1357132677,17,5,47647
7874766@N02,9354,24,1357120143,1357120143,1,5,0
7874766@N02,9354,31,1357084602,1357132196,5,5,47594
78750974@N06,9355,29,1339498908,1339500175,35,1,1267
78750974@N06,9356,21,1339625246,1339625246,1,2,0
78750974@N06,9356,11,1339625151,1339625156,2,2,5
78750974@N06,9357,29,1339735270,1339749190,3,1,13920
78792726@N00,9358,13,1223710169,1223710190,2,1,21
78832226@N00,9359,26,1211108991,1211110637,3,1,1646
78832226@N00,9360,1,1211160986,1211160986,1,12,0
78832226@N00,9360,29,1211185404,1211185404,1,12,0
78832226@N00,9360,13,1211161720,1211161720,1,12,0
78832226@N00,9360,20,1211175182,1211175182,1,12,0
78832226@N00,9360,26,1211179534,1211179741,2,12,207
78832226@N00,9360,11,1211182071,1211182071,1,12,0
78832226@N00,9360,16,1211166227,1211179297,2,12,13070
78832226@N00,9360,27,1211156966,1211156966,1,12,0
78832226@N00,9360,30,1211166756,1211171661,4,12,4905
78832226@N00,9360,17,1211156214,1211163050,4,12,6836
78832226@N00,9360,24,1211158775,1211191144,5,12,32369
78832226@N00,9360,8,1211181341,1211181551,2,12,210
78832226@N00,9361,1,1211240459,1211241386,2,8,927
78832226@N00,9361,29,1211273283,1211273283,1,8,0
78832226@N00,9361,26,1211276670,1211276670,1,8,0
78832226@N00,9361,12,1211269373,1211269373,1,8,0
78832226@N00,9361,23,1211276453,1211276453,1,8,0
78832226@N00,9361,19,1211272710,1211272710,1,8,0
78832226@N00,9361,21,1211269762,1211269762,1,8,0
78832226@N00,9361,17,1211266625,1211267287,2,8,662
78832226@N00,9362,1,1211333755,1211333755,1,3,0
78832226@N00,9362,28,1211332552,1211333472,3,3,920
78832226@N00,9362,7,1211331820,1211331820,1,3,0
78832226@N00,9363,20,1224144818,1224144818,1,9,0
78832226@N00,9363,28,1224123614,1224123642,2,9,28
78832226@N00,9363,26,1224151587,1224151587,1,9,0
78832226@N00,9363,16,1224139001,1224139983,2,9,982
78832226@N00,9363,12,1224125678,1224136139,2,9,10461
78832226@N00,9363,27,1224136779,1224138876,3,9,2097
78832226@N00,9363,29,1224141800,1224143446,14,9,1646
78832226@N00,9363,30,1224145323,1224145323,1,9,0
78832226@N00,9363,17,1224131336,1224131494,2,9,158
78832226@N00,9364,1,1224213967,1224243516,2,10,29549
78832226@N00,9364,13,1224220110,1224220110,1,10,0
78832226@N00,9364,28,1224192751,1224243987,3,10,51236
78832226@N00,9364,26,1224221737,1224221737,1,10,0
78832226@N00,9364,24,1224230025,1224234890,3,10,4865
78832226@N00,9364,21,1224235400,1224235400,1,10,0
78832226@N00,9364,30,1224226939,1224226939,1,10,0
78832226@N00,9364,17,1224196736,1224196736,1,10,0
78832226@N00,9364,18,1224224300,1224224300,1,10,0
78832226@N00,9364,6,1224221498,1224221498,1,10,0
78832226@N00,9365,29,1235525432,1235529735,4,3,4303
78832226@N00,9365,28,1235520144,1235520186,2,3,42
78832226@N00,9365,17,1235539028,1235539806,2,3,778
78832226@N00,9366,15,1242029507,1242029650,2,10,143
78832226@N00,9366,13,1242031498,1242032386,4,10,888
78832226@N00,9366,28,1242018377,1242018377,1,10,0
78832226@N00,9366,5,1242036526,1242036758,2,10,232
78832226@N00,9366,16,1242027825,1242027825,1,10,0
78832226@N00,9366,12,1242020108,1242020108,1,10,0
78832226@N00,9366,25,1242035574,1242035712,2,10,138
78832226@N00,9366,27,1242025573,1242026122,2,10,549
78832226@N00,9366,30,1242020895,1242024311,3,10,3416
78832226@N00,9366,7,1242036635,1242036635,1,10,0
78832226@N00,9367,1,1242108983,1242108983,1,3,0
78832226@N00,9367,20,1242122880,1242122880,1,3,0
78832226@N00,9367,18,1242116823,1242116823,1,3,0
78832226@N00,9368,3,1242177931,1242177931,1,6,0
78832226@N00,9368,12,1242176369,1242176369,1,6,0
78832226@N00,9368,24,1242171669,1242171820,2,6,151
78832226@N00,9368,23,1242181598,1242181598,1,6,0
78832226@N00,9368,19,1242183230,1242183304,2,6,74
78832226@N00,9368,17,1242174663,1242174663,1,6,0
78832226@N00,9369,20,1322808686,1322808686,1,10,0
78832226@N00,9369,5,1322813816,1322813816,1,10,0
78832226@N00,9369,25,1322797951,1322797951,1,10,0
78832226@N00,9369,27,1322789249,1322789249,1,10,0
78832226@N00,9369,29,1322806227,1322806227,1,10,0
78832226@N00,9369,30,1322810046,1322810046,1,10,0
78832226@N00,9369,17,1322796404,1322796404,1,10,0
78832226@N00,9369,9,1322812639,1322812639,1,10,0
78832226@N00,9369,8,1322830041,1322830041,1,10,0
78832226@N00,9369,18,1322826409,1322826409,1,10,0
78832226@N00,9370,23,1322880602,1322880602,1,2,0
78832226@N00,9370,30,1322878504,1322878504,1,2,0
78927690@N02,9371,28,1361111855,1361112317,2,1,462
78957591@N00,9372,20,1348536898,1348536898,1,3,0
78957591@N00,9372,25,1348545336,1348545336,1,3,0
78957591@N00,9372,28,1348541903,1348550031,3,3,8128
78957591@N00,9373,28,1348648120,1348648120,1,1,0
78957591@N00,9374,25,1447052092,1447052092,1,2,0
78957591@N00,9374,28,1447024471,1447024471,1,2,0
78958621@N04,9375,28,1385816400,1385816400,2,1,0
79016114@N04,9376,28,1414206776,1414221185,2,1,14409
79016114@N04,9377,28,1414298524,1414298524,1,1,0
79016114@N04,9378,28,1414379440,1414385957,2,1,6517
79023626@N00,9379,18,1460036971,1460036971,1,1,0
79056206@N00,9380,24,1230967680,1230967680,1,1,0
7906627@N04,9381,16,1345855864,1345855864,1,6,0
7906627@N04,9381,12,1345865270,1345865270,1,6,0
7906627@N04,9381,27,1345857590,1345858244,3,6,654
7906627@N04,9381,23,1345871411,1345871521,2,6,110
7906627@N04,9381,13,1345868546,1345868546,1,6,0
7906627@N04,9381,28,1345855317,1345871635,2,6,16318
7906627@N04,9382,27,1365555285,1365555285,1,3,0
7906627@N04,9382,18,1365572629,1365572629,1,3,0
7906627@N04,9382,1,1365551895,1365551895,1,3,0
7906627@N04,9383,27,1375574379,1375574379,1,3,0
7906627@N04,9383,29,1375585516,1375585516,1,3,0
7906627@N04,9383,15,1375609764,1375609764,1,3,0
7906627@N04,9384,27,1378349158,1378349158,1,2,0
7906627@N04,9384,1,1378343586,1378343586,1,2,0
7906627@N04,9385,25,1390347291,1390347291,1,1,0
7906627@N04,9386,15,1396931218,1396931218,1,3,0
7906627@N04,9386,27,1396918051,1396923751,2,3,5700
7906627@N04,9386,1,1396954144,1396954144,1,3,0
7906627@N04,9387,19,1402788160,1402788160,1,3,0
7906627@N04,9387,20,1402806362,1402806362,1,3,0
7906627@N04,9387,13,1402796374,1402796374,1,3,0
7906627@N04,9388,19,1403758345,1403758345,1,1,0
7906627@N04,9389,18,1430651383,1430651383,1,1,0
7906627@N04,9390,18,1453613898,1453613898,1,1,0
7906939@N04,9391,26,1261529322,1261529322,1,2,0
7906939@N04,9391,28,1261528403,1261528403,1,2,0
7906939@N04,9392,26,1261561329,1261561329,1,1,0
7914705@N02,9393,17,1314255505,1314255505,1,1,0
79167230@N00,9394,16,1312357657,1312357657,1,2,0
79167230@N00,9394,26,1312356824,1312356824,1,2,0
79172203@N00,9395,28,1198836446,1198836446,1,1,0
79172203@N00,9396,22,1234663766,1234663788,2,4,22
79172203@N00,9396,31,1234658643,1234659514,4,4,871
79172203@N00,9396,26,1234666680,1234694349,18,4,27669
79172203@N00,9396,28,1234653662,1234668972,11,4,15310
79172203@N00,9397,1,1234757790,1234768597,2,5,10807
79172203@N00,9397,22,1234756216,1234756216,1,5,0
79172203@N00,9397,12,1234749646,1234749646,1,5,0
79172203@N00,9397,25,1234749256,1234749401,5,5,145
79172203@N00,9397,28,1234768737,1234769019,3,5,282
79172203@N00,9398,13,1250207823,1250207823,1,2,0
79172203@N00,9398,25,1250205631,1250205802,5,2,171
79172203@N00,9399,26,1250259020,1250259058,2,1,38
79172203@N00,9400,23,1250483207,1250483207,1,5,0
79172203@N00,9400,3,1250467600,1250468186,5,5,586
79172203@N00,9400,26,1250469537,1250484170,8,5,14633
79172203@N00,9400,7,1250466693,1250466693,1,5,0
79172203@N00,9400,5,1250469194,1250469194,1,5,0
79172203@N00,9401,30,1255252111,1255252111,1,8,0
79172203@N00,9401,3,1255264021,1255264221,2,8,200
79172203@N00,9401,20,1255218657,1255266653,6,8,47996
79172203@N00,9401,26,1255227123,1255261114,32,8,33991
79172203@N00,9401,1,1255267405,1255267443,2,8,38
79172203@N00,9401,25,1255264525,1255264540,2,8,15
79172203@N00,9401,16,1255261284,1255261333,2,8,49
79172203@N00,9401,28,1255246824,1255267299,9,8,20475
79172203@N00,9402,20,1255347475,1255347641,2,2,166
79172203@N00,9402,29,1255342725,1255342968,2,2,243
79172203@N00,9403,26,1261145094,1261145102,2,1,8
79172203@N00,9404,20,1261178559,1261179312,10,7,753
79172203@N00,9404,26,1261183290,1261222809,11,7,39519
79172203@N00,9404,29,1261193909,1261199360,32,7,5451
79172203@N00,9404,1,1261200221,1261200221,1,7,0
79172203@N00,9404,28,1261199882,1261214844,4,7,14962
79172203@N00,9404,25,1261184307,1261186465,15,7,2158
79172203@N00,9404,7,1261192293,1261192293,1,7,0
79172203@N00,9405,27,1261308689,1261308880,12,7,191
79172203@N00,9405,3,1261306032,1261306032,1,7,0
79172203@N00,9405,20,1261284343,1261286179,28,7,1836
79172203@N00,9405,29,1261300633,1261300827,2,7,194
79172203@N00,9405,25,1261303119,1261313073,29,7,9954
79172203@N00,9405,16,1261304533,1261304533,1,7,0
79172203@N00,9405,28,1261287687,1261315304,49,7,27617
79172203@N00,9406,3,1261351844,1261352314,2,4,470
79172203@N00,9406,13,1261354075,1261356646,4,4,2571
79172203@N00,9406,26,1261371785,1261371796,2,4,11
79172203@N00,9406,29,1261350467,1261358324,12,4,7857
79172203@N00,9407,23,1270873577,1270874658,7,7,1081
79172203@N00,9407,3,1270869826,1270869826,1,7,0
79172203@N00,9407,17,1270870083,1270870083,1,7,0
79172203@N00,9407,26,1270871981,1270871981,1,7,0
79172203@N00,9407,11,1270869669,1270869685,2,7,16
79172203@N00,9407,29,1270866825,1270866851,2,7,26
79172203@N00,9407,16,1270871929,1270871929,1,7,0
79172203@N00,9408,23,1271036289,1271041099,7,6,4810
79172203@N00,9408,3,1271046763,1271046763,1,6,0
79172203@N00,9408,13,1271049557,1271053356,17,6,3799
79172203@N00,9408,29,1271042320,1271042320,1,6,0
79172203@N00,9408,21,1271049408,1271049408,1,6,0
79172203@N00,9408,25,1271047362,1271049163,13,6,1801
79172203@N00,9409,25,1278673395,1278675687,4,1,2292
79172203@N00,9410,13,1278735485,1278735722,3,5,237
79172203@N00,9410,26,1278731509,1278736386,9,5,4877
79172203@N00,9410,6,1278735967,1278736150,6,5,183
79172203@N00,9410,25,1278732008,1278732190,2,5,182
79172203@N00,9410,29,1278722551,1278722682,4,5,131
79172203@N00,9411,26,1278906682,1278908073,26,5,1391
79172203@N00,9411,28,1278910305,1278910506,9,5,201
79172203@N00,9411,18,1278906564,1278909792,8,5,3228
79172203@N00,9411,20,1278906289,1278906289,1,5,0
79172203@N00,9411,29,1278899028,1278899028,1,5,0
79172203@N00,9412,25,1281745351,1281746169,5,3,818
79172203@N00,9412,5,1281744127,1281744498,7,3,371
79172203@N00,9412,8,1281746745,1281746745,1,3,0
79172203@N00,9413,17,1281829560,1281829950,5,5,390
79172203@N00,9413,28,1281840891,1281840904,2,5,13
79172203@N00,9413,23,1281831967,1281832186,5,5,219
79172203@N00,9413,20,1281835598,1281836032,7,5,434
79172203@N00,9413,29,1281833881,1281833881,1,5,0
79172203@N00,9414,26,1297473636,1297484454,7,10,10818
79172203@N00,9414,6,1297484238,1297484253,2,10,15
79172203@N00,9414,25,1297474227,1297475352,18,10,1125
79172203@N00,9414,11,1297484014,1297484014,1,10,0
79172203@N00,9414,23,1297476075,1297477873,13,10,1798
79172203@N00,9414,30,1297478969,1297478969,1,10,0
79172203@N00,9414,28,1297484901,1297487831,3,10,2930
79172203@N00,9414,18,1297473341,1297473341,1,10,0
79172203@N00,9414,20,1297470689,1297470961,3,10,272
79172203@N00,9414,29,1297469470,1297470059,3,10,589
79172203@N00,9415,30,1297602305,1297602305,1,4,0
79172203@N00,9415,28,1297606380,1297606380,1,4,0
79172203@N00,9415,20,1297601034,1297601447,4,4,413
79172203@N00,9415,29,1297598096,1297600725,18,4,2629
79172203@N00,9416,15,1302329233,1302330878,2,5,1645
79172203@N00,9416,16,1302326012,1302326232,2,5,220
79172203@N00,9416,30,1302322697,1302323761,9,5,1064
79172203@N00,9416,27,1302331677,1302331677,1,5,0
79172203@N00,9416,18,1302319678,1302319678,1,5,0
79172203@N00,9417,1,1302402826,1302402996,8,8,170
79172203@N00,9417,12,1302397204,1302398559,11,8,1355
79172203@N00,9417,17,1302416995,1302416995,1,8,0
79172203@N00,9417,26,1302415776,1302415776,1,8,0
79172203@N00,9417,30,1302398910,1302398910,1,8,0
79172203@N00,9417,28,1302399307,1302399307,1,8,0
79172203@N00,9417,8,1302398670,1302398702,3,8,32
79172203@N00,9417,22,1302420192,1302420192,1,8,0
79172203@N00,9418,26,1302485008,1302485008,1,8,0
79172203@N00,9418,16,1302484884,1302484897,2,8,13
79172203@N00,9418,30,1302485133,1302515997,29,8,30864
79172203@N00,9418,28,1302479317,1302479317,1,8,0
79172203@N00,9418,31,1302485467,1302500133,12,8,14666
79172203@N00,9418,22,1302500356,1302500697,9,8,341
79172203@N00,9418,20,1302508246,1302508246,1,8,0
79172203@N00,9418,29,1302485421,1302500078,3,8,14657
79172203@N00,9419,1,1305964850,1305964879,3,8,29
79172203@N00,9419,28,1305990907,1305990907,1,8,0
79172203@N00,9419,15,1305958056,1305958056,1,8,0
79172203@N00,9419,27,1305953877,1305956753,24,8,2876
79172203@N00,9419,18,1305970435,1305970435,1,8,0
79172203@N00,9419,22,1305960597,1305961579,4,8,982
79172203@N00,9419,20,1305983254,1305983254,1,8,0
79172203@N00,9419,29,1305982848,1305982848,1,8,0
79172203@N00,9420,25,1306057620,1306057620,1,9,0
79172203@N00,9420,8,1306048566,1306048652,3,9,86
79172203@N00,9420,26,1306048244,1306077561,25,9,29317
79172203@N00,9420,6,1306049164,1306049179,2,9,15
79172203@N00,9420,20,1306054067,1306054096,3,9,29
79172203@N00,9420,11,1306028311,1306028311,1,9,0
79172203@N00,9420,28,1306048042,1306048042,1,9,0
79172203@N00,9420,27,1306072461,1306072461,1,9,0
79172203@N00,9420,1,1306047910,1306047915,2,9,5
79172203@N00,9421,25,1313152264,1313154098,20,4,1834
79172203@N00,9421,26,1313154836,1313154850,2,4,14
79172203@N00,9421,20,1313148261,1313148261,1,4,0
79172203@N00,9421,29,1313146500,1313146500,1,4,0
79172203@N00,9422,28,1313220171,1313221075,58,2,904
79172203@N00,9422,27,1313197159,1313197175,2,2,16
79172203@N00,9423,28,1313378646,1313378646,1,6,0
79172203@N00,9423,26,1313371366,1313378325,5,6,6959
79172203@N00,9423,23,1313371749,1313372985,5,6,1236
79172203@N00,9423,30,1313375312,1313376312,7,6,1000
79172203@N00,9423,29,1313373334,1313374576,6,6,1242
79172203@N00,9423,1,1313370648,1313370648,1,6,0
79172203@N00,9424,25,1325240105,1325241541,35,5,1436
79172203@N00,9424,28,1325247609,1325247609,1,5,0
79172203@N00,9424,20,1325229665,1325233455,12,5,3790
79172203@N00,9424,29,1325231858,1325232111,2,5,253
79172203@N00,9424,27,1325245169,1325245524,3,5,355
79172203@N00,9425,22,1325317654,1325317669,3,17,15
79172203@N00,9425,25,1325292691,1325293959,27,17,1268
79172203@N00,9425,28,1325306443,1325309411,2,17,2968
79172203@N00,9425,13,1325294085,1325300411,18,17,6326
79172203@N00,9425,5,1325290803,1325291701,7,17,898
79172203@N00,9425,26,1325301117,1325347285,3,17,46168
79172203@N00,9425,12,1325346999,1325346999,1,17,0
79172203@N00,9425,10,1325291989,1325291989,1,17,0
79172203@N00,9425,16,1325289211,1325289211,1,17,0
79172203@N00,9425,18,1325303586,1325303592,2,17,6
79172203@N00,9425,7,1325290542,1325290743,2,17,201
79172203@N00,9425,3,1325300996,1325300996,1,17,0
79172203@N00,9425,23,1325302378,1325303307,5,17,929
79172203@N00,9425,15,1325313119,1325313285,3,17,166
79172203@N00,9425,29,1325339794,1325344050,2,17,4256
79172203@N00,9425,21,1325292397,1325292397,1,17,0
79172203@N00,9425,1,1325306495,1325309061,10,17,2566
79172203@N00,9426,22,1325470057,1325475492,19,20,5435
79172203@N00,9426,9,1325477490,1325477490,1,20,0
79172203@N00,9426,14,1325466615,1325466615,1,20,0
79172203@N00,9426,28,1325479267,1325511526,115,20,32259
79172203@N00,9426,13,1325466770,1325476922,11,20,10152
79172203@N00,9426,31,1325469998,1325469998,1,20,0
79172203@N00,9426,26,1325467626,1325508764,35,20,41138
79172203@N00,9426,6,1325476199,1325477605,8,20,1406
79172203@N00,9426,25,1325476380,1325509454,21,20,33074
79172203@N00,9426,10,1325477342,1325477342,1,20,0
79172203@N00,9426,20,1325466568,1325508142,8,20,41574
79172203@N00,9426,18,1325468041,1325479145,7,20,11104
79172203@N00,9426,23,1325468876,1325479108,11,20,10232
79172203@N00,9426,15,1325465654,1325467144,2,20,1490
79172203@N00,9426,30,1325469283,1325471317,16,20,2034
79172203@N00,9426,11,1325477408,1325477408,1,20,0
79172203@N00,9426,29,1325473957,1325508236,6,20,34279
79172203@N00,9426,27,1325502112,1325502213,2,20,101
79172203@N00,9426,21,1325477200,1325477200,1,20,0
79172203@N00,9426,1,1325464407,1325464443,2,20,36
79172203@N00,9427,20,1330475988,1330476496,2,4,508
79172203@N00,9427,18,1330478672,1330478672,1,4,0
79172203@N00,9427,23,1330479746,1330480528,2,4,782
79172203@N00,9427,1,1330483422,1330483422,1,4,0
79172203@N00,9428,22,1330669225,1330669225,1,9,0
79172203@N00,9428,25,1330651226,1330652358,16,9,1132
79172203@N00,9428,13,1330669423,1330669423,1,9,0
79172203@N00,9428,20,1330650594,1330657514,5,9,6920
79172203@N00,9428,18,1330656082,1330657085,12,9,1003
79172203@N00,9428,29,1330659745,1330696279,22,9,36534
79172203@N00,9428,28,1330670979,1330674793,24,9,3814
79172203@N00,9428,21,1330655439,1330655728,19,9,289
79172203@N00,9428,1,1330650373,1330650373,1,9,0
79172203@N00,9429,26,1330746387,1330746659,6,1,272
79172203@N00,9430,23,1334878194,1334878194,1,13,0
79172203@N00,9430,30,1334881541,1334881553,2,13,12
79172203@N00,9430,20,1334880186,1334881188,6,13,1002
79172203@N00,9430,29,1334878988,1334879126,2,13,138
79172203@N00,9430,27,1334890071,1334890071,1,13,0
79172203@N00,9430,3,1334885285,1334885544,6,13,259
79172203@N00,9430,15,1334888873,1334889840,3,13,967
79172203@N00,9430,25,1334887588,1334888854,25,13,1266
79172203@N00,9430,5,1334883286,1334883293,2,13,7
79172203@N00,9430,22,1334881075,1334881126,2,13,51
79172203@N00,9430,26,1334878022,1334878206,6,13,184
79172203@N00,9430,10,1334884184,1334884281,2,13,97
79172203@N00,9430,16,1334877920,1334877920,1,13,0
79172203@N00,9431,18,1334987828,1334987886,2,2,58
79172203@N00,9431,27,1334985760,1334986069,6,2,309
79172203@N00,9432,18,1335084478,1335084636,6,6,158
79172203@N00,9432,23,1335083593,1335084368,18,6,775
79172203@N00,9432,20,1335091329,1335091329,1,6,0
79172203@N00,9432,29,1335089004,1335090331,11,6,1327
79172203@N00,9432,26,1335088362,1335088544,2,6,182
79172203@N00,9432,22,1335091710,1335091710,1,6,0
79172203@N00,9433,23,1339236189,1339237436,9,9,1247
79172203@N00,9433,29,1339242237,1339246456,15,9,4219
79172203@N00,9433,25,1339228670,1339229964,27,9,1294
79172203@N00,9433,11,1339228288,1339228288,1,9,0
79172203@N00,9433,5,1339233898,1339233898,1,9,0
79172203@N00,9433,28,1339248446,1339248446,1,9,0
79172203@N00,9433,21,1339230031,1339232959,31,9,2928
79172203@N00,9433,26,1339234847,1339235006,6,9,159
79172203@N00,9433,19,1339235267,1339235734,6,9,467
79172203@N00,9434,18,1339403420,1339403547,2,21,127
79172203@N00,9434,7,1339401905,1339401948,6,21,43
79172203@N00,9434,23,1339403513,1339403521,2,21,8
79172203@N00,9434,30,1339405003,1339406603,12,21,1600
79172203@N00,9434,20,1339403978,1339406820,6,21,2842
79172203@N00,9434,29,1339403673,1339413540,25,21,9867
79172203@N00,9434,21,1339402791,1339402791,1,21,0
79172203@N00,9434,3,1339402552,1339402954,7,21,402
79172203@N00,9434,15,1339386131,1339386141,2,21,10
79172203@N00,9434,25,1339373137,1339373734,3,21,597
79172203@N00,9434,11,1339402245,1339402499,12,21,254
79172203@N00,9434,5,1339402063,1339402162,4,21,99
79172203@N00,9434,13,1339376393,1339377065,2,21,672
79172203@N00,9434,28,1339380545,1339380657,7,21,112
79172203@N00,9434,8,1339402942,1339402942,1,21,0
79172203@N00,9434,24,1339386335,1339386381,3,21,46
79172203@N00,9434,12,1339372513,1339372659,7,21,146
79172203@N00,9434,6,1339401578,1339402052,18,21,474
79172203@N00,9434,1,1339381206,1339399145,20,21,17939
79172203@N00,9434,19,1339403584,1339403584,1,21,0
79172203@N00,9434,26,1339380162,1339401547,27,21,21385
79172203@N00,9435,27,1345860115,1345860115,1,3,0
79172203@N00,9435,21,1345853842,1345859448,14,3,5606
79172203@N00,9435,25,1345854449,1345855273,6,3,824
79172203@N00,9436,23,1346046117,1346046409,3,9,292
79172203@N00,9436,29,1346040639,1346045761,6,9,5122
79172203@N00,9436,21,1346052486,1346052486,1,9,0
79172203@N00,9436,1,1346058706,1346058765,3,9,59
79172203@N00,9436,3,1346052497,1346052497,1,9,0
79172203@N00,9436,28,1346055687,1346058561,53,9,2874
79172203@N00,9436,13,1346050843,1346052142,4,9,1299
79172203@N00,9436,26,1346052810,1346053348,6,9,538
79172203@N00,9436,6,1346052640,1346052687,2,9,47
79172203@N00,9437,30,1348836874,1348836905,3,9,31
79172203@N00,9437,20,1348793192,1348837325,24,9,44133
79172203@N00,9437,29,1348837061,1348838082,15,9,1021
79172203@N00,9437,1,1348840003,1348840388,20,9,385
79172203@N00,9437,25,1348796906,1348797691,12,9,785
79172203@N00,9437,22,1348793144,1348793170,2,9,26
79172203@N00,9437,13,1348822404,1348822404,1,9,0
79172203@N00,9437,28,1348782645,1348839964,32,9,57319
79172203@N00,9437,26,1348782805,1348838466,19,9,55661
79172203@N00,9438,20,1355283497,1355284425,14,4,928
79172203@N00,9438,29,1355284844,1355284844,1,4,0
79172203@N00,9438,25,1355279306,1355280354,39,4,1048
79172203@N00,9438,13,1355280507,1355281441,25,4,934
79172203@N00,9439,1,1355402496,1355402665,5,8,169
79172203@N00,9439,3,1355400979,1355401038,2,8,59
79172203@N00,9439,25,1355398046,1355400738,39,8,2692
79172203@N00,9439,16,1355397268,1355397307,2,8,39
79172203@N00,9439,6,1355401747,1355401818,3,8,71
79172203@N00,9439,28,1355396655,1355402514,10,8,5859
79172203@N00,9439,12,1355397556,1355397586,2,8,30
79172203@N00,9439,26,1355401200,1355402162,16,8,962
79172203@N00,9440,27,1355438673,1355441877,5,6,3204
79172203@N00,9440,26,1355437719,1355437719,1,6,0
79172203@N00,9440,29,1355475369,1355478605,10,6,3236
79172203@N00,9440,25,1355454270,1355455809,110,6,1539
79172203@N00,9440,28,1355461380,1355461380,1,6,0
79172203@N00,9440,20,1355449011,1355471634,6,6,22623
79172203@N00,9441,26,1355549300,1355549896,22,8,596
79172203@N00,9441,29,1355550437,1355551352,31,8,915
79172203@N00,9441,1,1355548674,1355557314,9,8,8640
79172203@N00,9441,25,1355579285,1355579637,8,8,352
79172203@N00,9441,28,1355548902,1355548970,3,8,68
79172203@N00,9441,30,1355550218,1355550294,2,8,76
79172203@N00,9441,22,1355551755,1355552592,17,8,837
79172203@N00,9441,20,1355551450,1355574628,16,8,23178
79172203@N00,9442,20,1362099886,1362100083,3,1,197
79172203@N00,9443,26,1362202365,1362202913,22,5,548
79172203@N00,9443,16,1362202985,1362203023,3,5,38
79172203@N00,9443,25,1362186838,1362187074,7,5,236
79172203@N00,9443,29,1362201303,1362229159,48,5,27856
79172203@N00,9443,30,1362201530,1362201530,1,5,0
79172203@N00,9444,15,1367036381,1367036605,11,6,224
79172203@N00,9444,26,1367017457,1367063931,94,6,46474
79172203@N00,9444,6,1367018702,1367018858,3,6,156
79172203@N00,9444,29,1367066328,1367067613,40,6,1285
79172203@N00,9444,25,1367021139,1367021875,33,6,736
79172203@N00,9444,18,1367054829,1367056924,4,6,2095
79172203@N00,9445,26,1367197370,1367198211,24,9,841
79172203@N00,9445,29,1367201599,1367201599,1,9,0
79172203@N00,9445,23,1367198488,1367212424,20,9,13936
79172203@N00,9445,19,1367198689,1367199962,38,9,1273
79172203@N00,9445,30,1367200080,1367202510,41,9,2430
79172203@N00,9445,22,1367201903,1367202321,17,9,418
79172203@N00,9445,10,1367206964,1367208273,15,9,1309
79172203@N00,9445,18,1367198270,1367198534,5,9,264
79172203@N00,9445,31,1367201684,1367201820,8,9,136
79172203@N00,9446,8,1376451773,1376451778,2,1,5
79172203@N00,9447,1,1376532267,1376532350,3,3,83
79172203@N00,9447,28,1376531765,1376531823,3,3,58
79172203@N00,9447,20,1376526174,1376526526,3,3,352
79172203@N00,9448,26,1376572261,1376573089,20,3,828
79172203@N00,9448,1,1376577332,1376577364,2,3,32
79172203@N00,9448,28,1376577151,1376577255,5,3,104
79172203@N00,9449,26,1376624441,1376627938,64,3,3497
79172203@N00,9449,29,1376613238,1376613838,5,3,600
79172203@N00,9449,18,1376619654,1376620471,3,3,817
79172203@N00,9450,25,1376715855,1376716903,22,1,1048
79172203@N00,9451,24,1388372252,1388372581,9,4,329
79172203@N00,9451,18,1388369030,1388369076,2,4,46
79172203@N00,9451,23,1388367888,1388368817,10,4,929
79172203@N00,9451,28,1388357533,1388357640,2,4,107
79172203@N00,9452,21,1388575363,1388577106,17,10,1743
79172203@N00,9452,20,1388583500,1388584099,20,10,599
79172203@N00,9452,29,1388584213,1388584713,19,10,500
79172203@N00,9452,13,1388549633,1388551390,58,10,1757
79172203@N00,9452,1,1388586217,1388586217,1,10,0
79172203@N00,9452,15,1388554005,1388554156,4,10,151
79172203@N00,9452,26,1388547300,1388585579,27,10,38279
79172203@N00,9452,6,1388548973,1388549000,3,10,27
79172203@N00,9452,25,1388575038,1388579582,62,10,4544
79172203@N00,9452,28,1388554942,1388586096,16,10,31154
79172203@N00,9453,3,1388744526,1388744529,2,12,3
79172203@N00,9453,15,1388713700,1388713700,1,12,0
79172203@N00,9453,18,1388703322,1388723674,11,12,20352
79172203@N00,9453,20,1388705547,1388712410,10,12,6863
79172203@N00,9453,29,1388721139,1388751760,5,12,30621
79172203@N00,9453,13,1388712896,1388713153,2,12,257
79172203@N00,9453,1,1388712137,1388712140,2,12,3
79172203@N00,9453,17,1388747417,1388749883,16,12,2466
79172203@N00,9453,26,1388702766,1388744310,4,12,41544
79172203@N00,9453,6,1388718746,1388718768,3,12,22
79172203@N00,9453,25,1388757665,1388757737,8,12,72
79172203@N00,9453,28,1388724688,1388759336,15,12,34648
79172203@N00,9454,18,1392426191,1392426191,1,3,0
79172203@N00,9454,26,1392435961,1392436952,26,3,991
79172203@N00,9454,6,1392415340,1392415340,1,3,0
79172203@N00,9455,1,1392534696,1392535098,12,3,402
79172203@N00,9455,26,1392535851,1392536778,17,3,927
79172203@N00,9455,28,1392535523,1392542474,36,3,6951
79172203@N00,9456,6,1392605418,1392605431,3,1,13
79172203@N00,9457,24,1397360155,1397360155,1,7,0
79172203@N00,9457,20,1397354762,1397354762,1,7,0
79172203@N00,9457,1,1397355885,1397355892,2,7,7
79172203@N00,9457,12,1397361526,1397361526,1,7,0
79172203@N00,9457,15,1397358847,1397359037,2,7,190
79172203@N00,9457,16,1397356139,1397356139,1,7,0
79172203@N00,9457,28,1397356040,1397356094,7,7,54
79172203@N00,9458,1,1407817858,1407817858,1,1,0
79172203@N00,9459,3,1407913546,1407913555,2,5,9
79172203@N00,9459,18,1407911161,1407911170,2,5,9
79172203@N00,9459,29,1407932320,1407935376,25,5,3056
79172203@N00,9459,26,1407913687,1407915732,3,5,2045
79172203@N00,9459,16,1407927970,1407927970,1,5,0
79172203@N00,9460,3,1408018106,1408018106,1,2,0
79172203@N00,9460,26,1408017834,1408017834,1,2,0
79172203@N00,9461,20,1412895176,1412895176,1,1,0
79172203@N00,9462,18,1412938316,1412938734,5,7,418
79172203@N00,9462,30,1412929858,1412935733,6,7,5875
79172203@N00,9462,29,1412935904,1412936311,8,7,407
79172203@N00,9462,1,1412939311,1412947093,5,7,7782
79172203@N00,9462,28,1412941254,1412946756,25,7,5502
79172203@N00,9462,13,1412925922,1412928565,4,7,2643
79172203@N00,9462,26,1412945091,1412945141,3,7,50
79172203@N00,9463,20,1412993210,1412993365,8,5,155
79172203@N00,9463,30,1412990397,1412990752,38,5,355
79172203@N00,9463,1,1412987399,1412987820,25,5,421
79172203@N00,9463,28,1412987846,1412989389,100,5,1543
79172203@N00,9463,26,1412990019,1412994529,26,5,4510
79172203@N00,9464,15,1413059148,1413059312,3,5,164
79172203@N00,9464,30,1413057672,1413057672,1,5,0
79172203@N00,9464,1,1413059376,1413059376,1,5,0
79172203@N00,9464,26,1413056828,1413056833,2,5,5
79172203@N00,9464,6,1413058381,1413058381,1,5,0
79172203@N00,9465,20,1413162449,1413164229,60,7,1780
79172203@N00,9465,23,1413166259,1413167627,9,7,1368
79172203@N00,9465,30,1413173109,1413173109,1,7,0
79172203@N00,9465,1,1413179085,1413179205,2,7,120
79172203@N00,9465,22,1413164636,1413164985,7,7,349
79172203@N00,9465,25,1413170096,1413171089,21,7,993
79172203@N00,9465,28,1413158713,1413158737,3,7,24
79172203@N00,9466,25,1416443314,1416449935,28,1,6621
79172203@N00,9467,18,1416613564,1416622682,23,7,9118
79172203@N00,9467,30,1416621415,1416621415,1,7,0
79172203@N00,9467,29,1416621610,1416622539,45,7,929
79172203@N00,9467,1,1416623574,1416623591,4,7,17
79172203@N00,9467,25,1416655110,1416656390,6,7,1280
79172203@N00,9467,28,1416623217,1416645064,46,7,21847
79172203@N00,9467,26,1416612532,1416623108,18,7,10576
79172203@N00,9468,29,1423904783,1423911345,5,1,6562
79172203@N00,9469,18,1423966836,1423969534,7,4,2698
79172203@N00,9469,30,1423952428,1423952428,1,4,0
79172203@N00,9469,29,1423994113,1423994876,6,4,763
79172203@N00,9469,28,1424002277,1424002277,1,4,0
79172203@N00,9470,26,1424048726,1424049583,27,5,857
79172203@N00,9470,6,1424049706,1424049997,5,5,291
79172203@N00,9470,20,1424046351,1424047783,10,5,1432
79172203@N00,9470,29,1424048138,1424048229,3,5,91
79172203@N00,9470,3,1424050184,1424050197,2,5,13
79172203@N00,9471,28,1427587696,1427590663,21,13,2967
79172203@N00,9471,8,1427580545,1427591101,6,13,10556
79172203@N00,9471,17,1427587029,1427587063,2,13,34
79172203@N00,9471,16,1427587393,1427587648,14,13,255
79172203@N00,9471,26,1427580838,1427594458,66,13,13620
79172203@N00,9471,23,1427594589,1427601303,3,13,6714
79172203@N00,9471,20,1427595149,1427596557,5,13,1408
79172203@N00,9471,29,1427582174,1427597045,12,13,14871
79172203@N00,9471,27,1427587088,1427587403,2,13,315
79172203@N00,9471,21,1427580161,1427599723,12,13,19562
79172203@N00,9471,1,1427588181,1427588181,1,13,0
79172203@N00,9471,15,1427587001,1427587001,1,13,0
79172203@N00,9471,11,1427591468,1427591688,2,13,220
79172203@N00,9472,22,1427680434,1427681228,13,5,794
79172203@N00,9472,31,1427680745,1427680745,1,5,0
79172203@N00,9472,26,1427684577,1427684724,6,5,147
79172203@N00,9472,20,1427690011,1427690011,1,5,0
79172203@N00,9472,29,1427697615,1427707435,36,5,9820
79172203@N00,9473,22,1432314677,1432314716,2,4,39
79172203@N00,9473,26,1432313414,1432321266,35,4,7852
79172203@N00,9473,16,1432319245,1432319245,1,4,0
79172203@N00,9473,27,1432310136,1432310136,1,4,0
79172203@N00,9474,28,1432375646,1432378112,118,5,2466
79172203@N00,9474,23,1432368153,1432368888,13,5,735
79172203@N00,9474,29,1432383646,1432383980,4,5,334
79172203@N00,9474,3,1432360349,1432360349,1,5,0
79172203@N00,9474,25,1432362026,1432362727,27,5,701
79172203@N00,9475,28,1432436426,1432437499,18,4,1073
79172203@N00,9475,26,1432437653,1432449799,38,4,12146
79172203@N00,9475,1,1432435801,1432436300,13,4,499
79172203@N00,9475,31,1432444380,1432446548,16,4,2168
79172203@N00,9476,19,1439459409,1439459434,2,3,25
79172203@N00,9476,20,1439455097,1439455266,3,3,169
79172203@N00,9476,21,1439448891,1439449727,29,3,836
79172203@N00,9477,26,1439502652,1439502678,3,2,26
79172203@N00,9477,1,1439500932,1439500939,2,2,7
79172203@N00,9478,25,1439543618,1439543933,6,3,315
79172203@N00,9478,29,1439537208,1439551467,43,3,14259
79172203@N00,9478,21,1439542670,1439542782,6,3,112
79172203@N00,9479,26,1439648504,1439649111,8,5,607
79172203@N00,9479,28,1439649737,1439649816,4,5,79
79172203@N00,9479,23,1439629235,1439629235,1,5,0
79172203@N00,9479,20,1439643333,1439643349,4,5,16
79172203@N00,9479,29,1439644899,1439645624,8,5,725
79172203@N00,9480,28,1441851628,1441851628,1,1,0
79172203@N00,9481,30,1441924036,1441924232,16,9,196
79172203@N00,9481,19,1441924963,1441924983,3,9,20
79172203@N00,9481,20,1441924383,1441931568,44,9,7185
79172203@N00,9481,18,1441925025,1441925025,1,9,0
79172203@N00,9481,26,1441922821,1441923126,19,9,305
79172203@N00,9481,29,1441924634,1441933193,15,9,8559
79172203@N00,9481,1,1441922389,1441922405,4,9,16
79172203@N00,9481,28,1441922535,1441922786,5,9,251
79172203@N00,9481,23,1441924991,1441925003,2,9,12
79172203@N00,9482,26,1441979260,1441979470,9,2,210
79172203@N00,9482,21,1441976714,1441977573,52,2,859
79172203@N00,9483,30,1442064796,1442064815,2,10,19
79172203@N00,9483,27,1442047171,1442047274,3,10,103
79172203@N00,9483,20,1442062493,1442064251,2,10,1758
79172203@N00,9483,26,1442042328,1442042438,6,10,110
79172203@N00,9483,6,1442042244,1442042263,3,10,19
79172203@N00,9483,1,1442039069,1442039398,17,10,329
79172203@N00,9483,12,1442048464,1442048470,2,10,6
79172203@N00,9483,28,1442039670,1442066737,17,10,27067
79172203@N00,9483,25,1442048861,1442050334,9,10,1473
79172203@N00,9483,7,1442042142,1442042187,2,10,45
79172203@N00,9484,24,1442115605,1442115648,4,2,43
79172203@N00,9484,23,1442107316,1442108295,2,2,979
79172203@N00,9485,26,1444379679,1444396826,11,8,17147
79172203@N00,9485,30,1444390519,1444390519,1,8,0
79172203@N00,9485,22,1444389844,1444389844,1,8,0
79172203@N00,9485,11,1444379361,1444379387,2,8,26
79172203@N00,9485,1,1444382396,1444382432,3,8,36
79172203@N00,9485,28,1444379841,1444384214,6,8,4373
79172203@N00,9485,25,1444378743,1444378791,2,8,48
79172203@N00,9485,16,1444387108,1444387435,8,8,327
79172203@N00,9486,20,1444450760,1444451819,3,3,1059
79172203@N00,9486,1,1444446679,1444446679,1,3,0
79172203@N00,9486,28,1444447226,1444447670,5,3,444
79172203@N00,9487,26,1444505943,1444505943,1,3,0
79172203@N00,9487,21,1444506533,1444506533,1,3,0
79172203@N00,9487,28,1444503979,1444505658,2,3,1679
79172203@N00,9488,27,1444599954,1444609347,5,10,9393
79172203@N00,9488,13,1444612948,1444612952,2,10,4
79172203@N00,9488,17,1444600076,1444600150,4,10,74
79172203@N00,9488,26,1444599539,1444599751,8,10,212
79172203@N00,9488,29,1444606417,1444606450,2,10,33
79172203@N00,9488,1,1444597843,1444598635,5,10,792
79172203@N00,9488,28,1444598717,1444599000,12,10,283
79172203@N00,9488,25,1444612119,1444612696,10,10,577
79172203@N00,9488,16,1444599054,1444599909,7,10,855
79172203@N00,9488,23,1444607845,1444607857,6,10,12
79172203@N00,9489,30,1451708077,1451708080,2,14,3
79172203@N00,9489,27,1451728719,1451728719,1,14,0
79172203@N00,9489,20,1451613921,1451740507,28,14,126586
79172203@N00,9489,18,1451614446,1451653200,3,14,38754
79172203@N00,9489,13,1451652159,1451652395,10,14,236
79172203@N00,9489,15,1451694187,1451728697,15,14,34510
79172203@N00,9489,26,1451652534,1451744926,40,14,92392
79172203@N00,9489,29,1451636354,1451653658,38,14,17304
79172203@N00,9489,1,1451655999,1451683232,9,14,27233
79172203@N00,9489,28,1451654886,1451729432,43,14,74546
79172203@N00,9489,25,1451650814,1451744298,61,14,93484
79172203@N00,9489,16,1451728952,1451728971,3,14,19
79172203@N00,9489,17,1451728667,1451728667,1,14,0
79172203@N00,9489,23,1451653315,1451698413,37,14,45098
79172203@N00,9490,20,1455404170,1455431548,19,6,27378
79172203@N00,9490,15,1455442857,1455442917,3,6,60
79172203@N00,9490,25,1455413939,1455414800,7,6,861
79172203@N00,9490,30,1455428216,1455428899,7,6,683
79172203@N00,9490,3,1455440974,1455440974,1,6,0
79172203@N00,9490,29,1455433525,1455433531,2,6,6
79172203@N00,9491,21,1455530544,1455534022,46,4,3478
79172203@N00,9491,1,1455545789,1455545836,2,4,47
79172203@N00,9491,23,1455502616,1455502616,1,4,0
79172203@N00,9491,27,1455535951,1455535951,1,4,0
79172203@N00,9492,23,1455593079,1455593685,3,1,606
79172203@N00,9493,1,1459390985,1459390985,1,10,0
79172203@N00,9493,14,1459393736,1459393736,1,10,0
79172203@N00,9493,7,1459395454,1459395708,3,10,254
79172203@N00,9493,23,1459392928,1459393034,3,10,106
79172203@N00,9493,30,1459394982,1459395197,4,10,215
79172203@N00,9493,28,1459391437,1459402716,4,10,11279
79172203@N00,9493,27,1459396431,1459396431,1,10,0
79172203@N00,9493,24,1459396371,1459396371,1,10,0
79172203@N00,9493,18,1459392136,1459392136,1,10,0
79172203@N00,9493,29,1459393376,1459393376,1,10,0
79172203@N00,9494,17,1459474499,1459474889,2,4,390
79172203@N00,9494,15,1459474369,1459474904,6,4,535
79172203@N00,9494,27,1459473997,1459474219,12,4,222
79172203@N00,9494,24,1459474287,1459474332,2,4,45
79172203@N00,9495,20,1459506232,1459506316,3,1,84
79172203@N00,9496,1,1459554470,1459555268,16,4,798
79172203@N00,9496,28,1459554280,1459557576,35,4,3296
79172203@N00,9496,24,1459558589,1459558694,9,4,105
79172203@N00,9496,18,1459554229,1459554229,1,4,0
79172203@N00,9497,20,1459593851,1459593851,1,1,0
79172203@N00,9498,26,1465710448,1465710487,6,2,39
79172203@N00,9498,18,1465694223,1465694265,2,2,42
79172203@N00,9499,16,1465779328,1465779328,1,1,0
79172203@N00,9500,28,1465816407,1465817321,13,2,914
79172203@N00,9500,26,1465821427,1465821427,1,2,0
79172203@N00,9501,18,1468239879,1468239879,1,1,0
79172203@N00,9502,1,1470974168,1470974352,3,5,184
79172203@N00,9502,23,1470980894,1470981295,2,5,401
79172203@N00,9502,26,1471002089,1471007051,5,5,4962
79172203@N00,9502,27,1470996610,1470996610,1,5,0
79172203@N00,9502,25,1471004339,1471004795,8,5,456
79172203@N00,9503,21,1471085383,1471088618,33,4,3235
79172203@N00,9503,1,1471063513,1471063513,1,4,0
79172203@N00,9503,16,1471063059,1471063089,3,4,30
79172203@N00,9503,26,1471063137,1471063253,9,4,116
79172203@N00,9504,18,1471137117,1471137117,1,1,0
79209019@N00,9505,26,1356036589,1356036589,1,1,0
79209019@N00,9506,26,1394879732,1394879732,1,1,0
79209019@N00,9507,26,1438889878,1438889878,1,1,0
79209421@N00,9508,7,1274086506,1274086506,1,2,0
79209421@N00,9508,5,1274086124,1274086129,2,2,5
79254752@N08,9509,28,1368255225,1368255225,1,2,0
79254752@N08,9509,1,1368263343,1368263343,1,2,0
7927897@N02,9510,18,1449096457,1449096457,1,1,0
7927897@N02,9511,18,1457314159,1457314159,1,1,0
7933322@N08,9512,1,1381197697,1381197697,1,2,0
7933322@N08,9512,15,1381209915,1381209915,1,2,0
7933322@N08,9513,7,1381723302,1381736320,2,3,13018
7933322@N08,9513,16,1381732657,1381732872,2,3,215
7933322@N08,9513,27,1381732764,1381732764,1,3,0
7933322@N08,9514,30,1450783050,1450783050,1,6,0
7933322@N08,9514,26,1450782802,1450782802,1,6,0
7933322@N08,9514,14,1450783266,1450783266,1,6,0
7933322@N08,9514,24,1450782356,1450782356,1,6,0
7933322@N08,9514,18,1450783634,1450783634,1,6,0
7933322@N08,9514,15,1450783429,1450783429,1,6,0
79349162@N00,9515,28,1253366428,1253366428,1,4,0
79349162@N00,9515,24,1253366417,1253366417,1,4,0
79349162@N00,9515,22,1253366425,1253366425,1,4,0
79349162@N00,9515,30,1253366411,1253366411,1,4,0
79382601@N05,9516,17,1332567416,1332567416,1,1,0
79387229@N00,9517,26,1225908909,1225921881,20,1,12972
79405715@N00,9518,14,1362833921,1362833921,1,1,0
79405715@N00,9519,22,1364725061,1364725061,1,1,0
79416801@N03,9520,29,1384065054,1384065054,1,3,0
79416801@N03,9520,27,1384055300,1384055300,1,3,0
79416801@N03,9520,20,1384069986,1384069986,1,3,0
79416801@N03,9521,7,1384217200,1384217200,1,1,0
79416801@N03,9522,28,1411289838,1411289838,1,1,0
79426194@N06,9523,22,1341740909,1341740909,1,1,0
79426194@N06,9524,28,1341894792,1341894792,1,1,0
79439374@N04,9525,11,1413541318,1413541318,1,1,0
7945637@N07,9526,28,1192692264,1192692264,1,3,0
7945637@N07,9526,12,1192693093,1192694432,2,3,1339
7945637@N07,9526,27,1192695231,1192695374,2,3,143
7945637@N07,9527,13,1192770172,1192770648,2,4,476
7945637@N07,9527,31,1192757237,1192757237,1,4,0
7945637@N07,9527,23,1192752896,1192753005,2,4,109
7945637@N07,9527,26,1192762644,1192762644,1,4,0
7945637@N07,9528,11,1242449094,1242449094,1,3,0
7945637@N07,9528,31,1242447233,1242458645,2,3,11412
7945637@N07,9528,26,1242444438,1242444454,2,3,16
7945637@N07,9529,12,1242551974,1242556582,3,3,4608
7945637@N07,9529,31,1242574366,1242574366,1,3,0
7945637@N07,9529,27,1242547226,1242547226,1,3,0
7945637@N07,9530,26,1252490502,1252490502,1,2,0
7945637@N07,9530,27,1252487705,1252487705,1,2,0
7945637@N07,9531,12,1252651248,1252651248,1,1,0
7945637@N07,9532,26,1314848379,1314848379,1,1,0
7945637@N07,9533,31,1315042410,1315042410,1,1,0
7945637@N07,9534,21,1315230964,1315230964,1,1,0
7945637@N07,9535,31,1385972638,1385972638,1,1,0
7945637@N07,9536,16,1441592585,1441592585,1,1,0
79486179@N00,9537,30,1295231706,1295231706,1,1,0
79524349@N00,9538,29,1363161335,1363161357,2,1,22
79529489@N00,9539,28,1350298006,1350298006,1,1,0
79551604@N00,9540,27,1275295961,1275295961,1,1,0
79551604@N00,9541,22,1369457832,1369457832,1,5,0
79551604@N00,9541,15,1369459894,1369459894,2,5,0
79551604@N00,9541,27,1369457857,1369457857,1,5,0
79551604@N00,9541,1,1369455396,1369455408,3,5,12
79551604@N00,9541,17,1369461019,1369461019,1,5,0
79551604@N00,9542,28,1369547080,1369547080,1,4,0
79551604@N00,9542,23,1369548826,1369548847,2,4,21
79551604@N00,9542,18,1369561978,1369561978,1,4,0
79551604@N00,9542,30,1369553564,1369553629,3,4,65
7956802@N02,9543,1,1342563354,1342563354,1,1,0
7956802@N02,9544,28,1345594667,1345594667,1,1,0
79624377@N06,9545,13,1374287721,1374287721,1,1,0
79761301@N00,9546,15,1188123925,1188123925,1,1,0
79761301@N00,9547,29,1191512089,1191512273,6,6,184
79761301@N00,9547,20,1191515290,1191515290,1,6,0
79761301@N00,9547,28,1191518647,1191518702,4,6,55
79761301@N00,9547,23,1191511763,1191511763,1,6,0
79761301@N00,9547,30,1191516317,1191516317,1,6,0
79761301@N00,9547,31,1191512911,1191512944,3,6,33
79761301@N00,9548,20,1191600308,1191600308,1,2,0
79761301@N00,9548,25,1191597631,1191599111,14,2,1480
79761301@N00,9549,6,1192725625,1192725636,2,7,11
79761301@N00,9549,11,1192725879,1192725908,2,7,29
79761301@N00,9549,29,1192721604,1192721926,4,7,322
79761301@N00,9549,28,1192711318,1192711331,2,7,13
79761301@N00,9549,25,1192726423,1192727559,6,7,1136
79761301@N00,9549,23,1192722110,1192722897,2,7,787
79761301@N00,9549,30,1192728684,1192728684,1,7,0
79761301@N00,9550,25,1197069448,1197069448,1,2,0
79761301@N00,9550,20,1197054555,1197054555,1,2,0
79761301@N00,9551,29,1200086170,1200086170,1,1,0
79761301@N00,9552,5,1201970154,1201970159,2,4,5
79761301@N00,9552,29,1201998761,1202000266,5,4,1505
79761301@N00,9552,20,1201999988,1201999988,1,4,0
79761301@N00,9552,23,1201969833,1202000795,4,4,30962
79761301@N00,9553,30,1204388553,1204388553,1,4,0
79761301@N00,9553,26,1204388417,1204388417,1,4,0
79761301@N00,9553,13,1204387888,1204387888,1,4,0
79761301@N00,9553,28,1204386339,1204390429,5,4,4090
79761301@N00,9554,30,1207088065,1207088065,1,3,0
79761301@N00,9554,28,1207082242,1207082242,1,3,0
79761301@N00,9554,23,1207088354,1207088354,1,3,0
79761301@N00,9555,28,1219265844,1219265844,1,1,0
79761301@N00,9556,20,1219695274,1219695282,2,2,8
79761301@N00,9556,23,1219694617,1219694706,3,2,89
79761301@N00,9557,30,1224617480,1224617480,1,5,0
79761301@N00,9557,31,1224612122,1224612122,1,5,0
79761301@N00,9557,29,1224611237,1224611237,1,5,0
79761301@N00,9557,20,1224612149,1224620524,11,5,8375
79761301@N00,9557,28,1224603169,1224603169,1,5,0
79761301@N00,9558,13,1236384011,1236384011,1,1,0
79761301@N00,9559,30,1293986338,1293986338,1,3,0
79761301@N00,9559,5,1293986582,1293986582,1,3,0
79761301@N00,9559,28,1293987958,1293987997,3,3,39
7977582@N06,9560,28,1397512121,1397512121,1,1,0
7977582@N06,9561,3,1397560319,1397560319,1,1,0
79781814@N00,9562,26,1352521551,1352521551,1,2,0
79781814@N00,9562,28,1352517078,1352517078,1,2,0
79842767@N00,9563,17,1259480702,1259481844,2,1,1142
7988769@N08,9564,29,1425693272,1425693978,2,4,706
7988769@N08,9564,3,1425693298,1425693298,1,4,0
7988769@N08,9564,12,1425693359,1425693359,1,4,0
7988769@N08,9564,26,1425693685,1425693869,2,4,184
7988769@N08,9565,30,1426048211,1426048211,1,1,0
7988769@N08,9566,16,1426246009,1426246009,1,1,0
7988769@N08,9567,27,1426337215,1426337215,1,1,0
7988769@N08,9568,11,1426420500,1426420500,1,1,0
7988769@N08,9569,12,1426462550,1426462550,1,1,0
7988769@N08,9570,18,1426634636,1426634636,1,1,0
7988769@N08,9571,19,1427064557,1427064557,1,1,0
7988769@N08,9572,5,1427334375,1427334375,1,1,0
7988769@N08,9573,13,1427673252,1427673252,1,1,0
7988769@N08,9574,30,1427847944,1427847944,1,1,0
7988769@N08,9575,30,1427963039,1427963039,1,1,0
7988769@N08,9576,1,1428983538,1428983538,1,1,0
7988769@N08,9577,1,1429156339,1429156339,1,1,0
7988769@N08,9578,13,1429276852,1429276852,1,1,0
7988769@N08,9579,18,1429487623,1429487623,1,1,0
7988769@N08,9580,13,1429572142,1429572142,1,1,0
7988769@N08,9581,12,1432451875,1432451875,1,2,0
7988769@N08,9581,28,1432455988,1432455988,1,2,0
7988769@N08,9582,20,1432715698,1432715698,1,1,0
7988769@N08,9583,29,1433135411,1433135411,1,2,0
7988769@N08,9583,12,1433125488,1433125488,1,2,0
7988769@N08,9584,30,1434069467,1434069467,1,1,0
7988769@N08,9585,16,1438751367,1438751367,1,1,0
79894532@N03,9586,20,1308013376,1308023080,2,1,9704
79894532@N03,9587,20,1326947882,1326948077,3,1,195
79941846@N08,9588,19,1329698346,1329698346,1,1,0
79941846@N08,9589,17,1346635631,1346635631,1,1,0
79978100@N04,9590,25,1427508430,1427508430,1,4,0
79978100@N04,9590,26,1427495531,1427495531,1,4,0
79978100@N04,9590,13,1427508384,1427508384,1,4,0
79978100@N04,9590,16,1427489713,1427493361,7,4,3648
79978100@N04,9591,20,1427579797,1427579797,1,1,0
79978100@N04,9592,28,1427700115,1427700136,8,2,21
79978100@N04,9592,19,1427692597,1427692683,7,2,86
80028591@N00,9593,26,1209519239,1209519239,1,1,0
80028591@N00,9594,25,1212140080,1212140080,1,1,0
80028591@N00,9595,26,1237207462,1237207462,1,2,0
80028591@N00,9595,3,1237207424,1237207424,1,2,0
80028591@N00,9596,28,1356044438,1356044438,1,1,0
80028591@N00,9597,20,1426041786,1426041786,1,1,0
80028591@N00,9598,18,1439298061,1439298061,1,1,0
80030448@N02,9599,28,1336439494,1336439494,1,1,0
8021465@N08,9600,25,1246107626,1246107626,1,1,0
8021465@N08,9601,20,1274337235,1274337235,1,1,0
8021465@N08,9602,1,1274412994,1274412994,1,1,0
8021465@N08,9603,7,1274457370,1274458092,2,4,722
8021465@N08,9603,13,1274452256,1274452256,1,4,0
8021465@N08,9603,28,1274444257,1274444257,1,4,0
8021465@N08,9603,26,1274456597,1274456597,1,4,0
8021465@N08,9604,1,1274524082,1274524082,1,2,0
8021465@N08,9604,26,1274496944,1274544666,4,2,47722
8021465@N08,9605,26,1274584812,1274593623,5,1,8811
8022297@N02,9606,1,1297911756,1297911818,2,3,62
8022297@N02,9606,26,1297912014,1297920860,2,3,8846
8022297@N02,9606,8,1297912752,1297912752,1,3,0
8022297@N02,9607,1,1302756188,1302756188,1,4,0
8022297@N02,9607,28,1302755912,1302755912,1,4,0
8022297@N02,9607,30,1302748722,1302748722,1,4,0
8022297@N02,9607,19,1302753501,1302753501,1,4,0
80237899@N00,9608,17,1264579453,1264579453,1,5,0
80237899@N00,9608,30,1264561114,1264561114,1,5,0
80237899@N00,9608,29,1264572226,1264572226,1,5,0
80237899@N00,9608,13,1264559502,1264559502,1,5,0
80237899@N00,9608,26,1264570261,1264584726,2,5,14465
8026214@N07,9609,21,1322817607,1322817607,1,1,0
80286151@N07,9610,14,1395539161,1395539161,1,1,0
80292103@N00,9611,15,1322088251,1322088301,2,3,50
80292103@N00,9611,26,1322093010,1322093010,1,3,0
80292103@N00,9611,16,1322092462,1322092501,2,3,39
80292103@N00,9612,30,1323685010,1323685010,1,1,0
80292103@N00,9613,8,1323743117,1323743126,3,1,9
80292103@N00,9614,17,1324858896,1324858896,1,1,0
80292103@N00,9615,11,1332046394,1332046394,1,4,0
80292103@N00,9615,25,1332045633,1332045690,6,4,57
80292103@N00,9615,1,1332042261,1332042261,1,4,0
80292103@N00,9615,26,1332053034,1332053034,2,4,0
80292103@N00,9616,21,1332112201,1332112202,2,2,1
80292103@N00,9616,4,1332110243,1332110243,1,2,0
80292103@N00,9617,28,1333004694,1333004703,3,1,9
80292103@N00,9618,3,1338686318,1338686318,1,1,0
80292103@N00,9619,27,1353640791,1353642355,7,1,1564
80312567@N06,9620,1,1335746704,1335746890,2,1,186
8034015@N04,9621,1,1207323638,1207323638,1,1,0
8034015@N04,9622,1,1207362655,1207371053,2,1,8398
8034015@N04,9623,1,1207506876,1207543648,59,1,36772
8034015@N04,9624,25,1324331321,1324331321,1,2,0
8034015@N04,9624,27,1324325807,1324326655,2,2,848
8034015@N04,9625,28,1383999211,1383999211,1,2,0
8034015@N04,9625,27,1383973352,1383973352,1,2,0
80371340@N00,9626,29,1308181816,1308181816,1,1,0
80371340@N00,9627,17,1349659631,1349659631,1,1,0
80371340@N00,9628,28,1349771913,1349771915,2,2,2
80371340@N00,9628,30,1349761190,1349761190,1,2,0
80371340@N00,9629,30,1350016356,1350016356,1,1,0
80371340@N00,9630,18,1350208459,1350208459,1,1,0
8039966@N05,9631,28,1353843950,1353843950,1,1,0
8039966@N05,9632,13,1360890685,1360890685,1,1,0
8039966@N05,9633,16,1367665202,1367665202,1,2,0
8039966@N05,9633,28,1367655008,1367655008,1,2,0
8039966@N05,9634,14,1385185248,1385185248,1,5,0
8039966@N05,9634,17,1385196178,1385196178,1,5,0
8039966@N05,9634,15,1385176597,1385177321,3,5,724
8039966@N05,9634,16,1385196613,1385196613,1,5,0
8039966@N05,9634,23,1385192049,1385192049,1,5,0
8039966@N05,9635,17,1388362416,1388362416,1,1,0
8039966@N05,9636,14,1390102706,1390102706,1,1,0
8039966@N05,9637,23,1445729861,1445729861,1,1,0
80402035@N00,9638,1,1387014042,1387014042,1,1,0
80412496@N07,9639,1,1377962883,1377962883,1,1,0
80412496@N07,9640,1,1400836792,1400836792,1,1,0
8046157@N06,9641,15,1424137573,1424137573,1,1,0
80468618@N00,9642,24,1421457406,1421457406,1,1,0
80499359@N04,9643,28,1376982250,1376982250,1,2,0
80499359@N04,9643,29,1376987906,1376988292,2,2,386
80499359@N04,9644,26,1408524535,1408524535,1,1,0
80499359@N04,9645,1,1408569904,1408569904,1,3,0
80499359@N04,9645,30,1408567506,1408567506,1,3,0
80499359@N04,9645,29,1408553993,1408553993,1,3,0
80499359@N04,9646,1,1414383547,1414383547,1,1,0
80505420@N00,9647,17,1241320763,1241343491,7,1,22728
8054996@N07,9648,20,1259985623,1259986430,9,7,807
8054996@N07,9648,26,1259984257,1259984267,2,7,10
8054996@N07,9648,30,1259985491,1259985491,1,7,0
8054996@N07,9648,1,1259999611,1259999713,4,7,102
8054996@N07,9648,25,1259987574,1259993554,23,7,5980
8054996@N07,9648,28,1259981559,1259983166,5,7,1607
8054996@N07,9648,29,1259985359,1259985469,2,7,110
80639660@N00,9649,26,1384868275,1384905051,27,1,36776
80639660@N00,9650,26,1385073657,1385073657,1,1,0
80639660@N00,9651,26,1385115468,1385153369,9,1,37901
80646560@N00,9652,18,1423292757,1423292757,1,1,0
80658772@N00,9653,1,1428625871,1428625871,1,12,0
80658772@N00,9653,21,1428636948,1428637454,2,12,506
80658772@N00,9653,10,1428630178,1428654654,4,12,24476
80658772@N00,9653,20,1428626017,1428626017,1,12,0
80658772@N00,9653,4,1428637016,1428637040,3,12,24
80658772@N00,9653,25,1428626699,1428626699,1,12,0
80658772@N00,9653,11,1428637052,1428637059,2,12,7
80658772@N00,9653,7,1428631370,1428631370,1,12,0
80658772@N00,9653,26,1428627322,1428661575,41,12,34253
80658772@N00,9653,22,1428647794,1428647949,2,12,155
80658772@N00,9653,28,1428638681,1428638681,1,12,0
80658772@N00,9653,16,1428638482,1428638482,1,12,0
8068421@N07,9654,20,1237717735,1237717735,1,1,0
80685608@N00,9655,30,1293234492,1293234503,2,4,11
80685608@N00,9655,29,1293256940,1293256940,1,4,0
80685608@N00,9655,26,1293263877,1293264171,3,4,294
80685608@N00,9655,28,1293236870,1293254421,2,4,17551
80687988@N00,9656,12,1217027913,1217027913,1,3,0
80687988@N00,9656,26,1217029785,1217029785,1,3,0
80687988@N00,9656,28,1217029497,1217029497,1,3,0
80687988@N00,9657,18,1217263442,1217263442,1,3,0
80687988@N00,9657,17,1217277841,1217281309,3,3,3468
80687988@N00,9657,4,1217257115,1217257222,3,3,107
80775532@N06,9658,22,1399974448,1399974484,3,16,36
80775532@N06,9658,17,1399961992,1399961992,1,16,0
80775532@N06,9658,1,1399939157,1399975666,2,16,36509
80775532@N06,9658,28,1399939296,1399975420,7,16,36124
80775532@N06,9658,14,1399973679,1399973679,1,16,0
80775532@N06,9658,21,1399951100,1399956419,3,16,5319
80775532@N06,9658,26,1399944304,1399944498,2,16,194
80775532@N06,9658,30,1399974900,1399974900,1,16,0
80775532@N06,9658,13,1399951448,1399952255,2,16,807
80775532@N06,9658,4,1399957400,1399957400,1,16,0
80775532@N06,9658,23,1399974859,1399974859,1,16,0
80775532@N06,9658,18,1399959263,1399959263,1,16,0
80775532@N06,9658,20,1399945962,1399976623,3,16,30661
80775532@N06,9658,29,1399974542,1399974789,5,16,247
80775532@N06,9658,31,1399946343,1399974548,3,16,28205
80775532@N06,9658,15,1399964237,1399964250,2,16,13
8088503@N03,9659,28,1345613971,1345614511,2,1,540
8088503@N03,9660,26,1355120714,1355120714,1,1,0
8088503@N03,9661,9,1387415848,1387415848,1,1,0
8090409@N08,9662,22,1364459351,1364459355,2,9,4
8090409@N08,9662,15,1364456180,1364456418,3,9,238
8090409@N08,9662,19,1364447310,1364447310,1,9,0
8090409@N08,9662,26,1364430454,1364430471,2,9,17
8090409@N08,9662,28,1364418784,1364437381,4,9,18597
8090409@N08,9662,1,1364417796,1364446468,4,9,28672
8090409@N08,9662,18,1364452225,1364452225,1,9,0
8090409@N08,9662,29,1364426195,1364432932,6,9,6737
8090409@N08,9662,17,1364421899,1364462899,7,9,41000
8090769@N06,9663,29,1360285981,1360286425,2,1,444
8090769@N06,9664,20,1360384794,1360384794,1,2,0
8090769@N06,9664,28,1360400807,1360400807,1,2,0
80907784@N00,9665,27,1224329573,1224329987,2,2,414
80907784@N00,9665,16,1224327140,1224327140,1,2,0
80907784@N00,9666,3,1230371493,1230371493,1,1,0
80973446@N02,9667,26,1385971854,1385971854,1,2,0
80973446@N02,9667,1,1385968529,1385968529,1,2,0
80975886@N00,9668,10,1246177123,1246203315,138,1,26192
80975886@N00,9669,26,1295255175,1295255175,1,2,0
80975886@N00,9669,28,1295264305,1295264305,1,2,0
80975886@N00,9670,28,1305470523,1305470985,3,1,462
80977395@N00,9671,26,1230974003,1230980896,3,2,6893
80977395@N00,9671,28,1230972618,1230973373,2,2,755
8100317@N02,9672,16,1371845748,1371845748,1,2,0
8100317@N02,9672,27,1371844102,1371844102,1,2,0
8100317@N02,9673,17,1377182806,1377182806,1,1,0
8100317@N02,9674,1,1386846193,1386846193,1,1,0
8100317@N02,9675,12,1398857453,1398857453,1,1,0
8100317@N02,9676,31,1415267960,1415267960,1,1,0
8101809@N08,9677,21,1329606188,1329606188,1,4,0
8101809@N08,9677,1,1329608365,1329608365,1,4,0
8101809@N08,9677,10,1329604148,1329604148,1,4,0
8101809@N08,9677,13,1329605278,1329605450,2,4,172
8101809@N08,9678,8,1329697127,1329697127,1,3,0
8101809@N08,9678,30,1329704121,1329704121,1,3,0
8101809@N08,9678,1,1329692886,1329693617,5,3,731
8101809@N08,9679,1,1356928208,1356929276,28,2,1068
8101809@N08,9679,28,1356927951,1356929314,13,2,1363
8101809@N08,9680,27,1357009168,1357009282,3,2,114
8101809@N08,9680,21,1356991854,1356991861,2,2,7
81039954@N05,9681,12,1373965375,1373965375,1,4,0
81039954@N05,9681,27,1373967631,1373967631,1,4,0
81039954@N05,9681,29,1373958774,1373960600,2,4,1826
81039954@N05,9681,28,1373971864,1373971864,1,4,0
81039954@N05,9682,1,1374039649,1374039649,1,6,0
81039954@N05,9682,12,1374037593,1374037593,1,6,0
81039954@N05,9682,23,1374036664,1374036664,1,6,0
81039954@N05,9682,27,1374038248,1374038248,1,6,0
81039954@N05,9682,15,1374043942,1374043942,1,6,0
81039954@N05,9682,17,1374038933,1374038933,1,6,0
81068258@N02,9683,21,1330495457,1330495457,1,1,0
81068258@N02,9684,23,1335943331,1335943331,1,1,0
8109836@N08,9685,25,1310701286,1310701286,1,2,0
8109836@N08,9685,21,1310691884,1310691884,1,2,0
8117728@N07,9686,19,1328916340,1328916478,4,3,138
8117728@N07,9686,29,1328916130,1328916198,2,3,68
8117728@N07,9686,23,1328915368,1328917046,28,3,1678
81183458@N00,9687,3,1348277133,1348277133,1,3,0
81183458@N00,9687,1,1348269701,1348269701,1,3,0
81183458@N00,9687,26,1348270209,1348270209,1,3,0
81197180@N00,9688,20,1353660838,1353660838,1,1,0
81197180@N00,9689,26,1353770940,1353770940,1,1,0
81197180@N00,9690,28,1354007864,1354007864,1,1,0
81197180@N00,9691,9,1422772212,1422772212,1,8,0
81197180@N00,9691,7,1422771786,1422771786,1,8,0
81197180@N00,9691,1,1422761318,1422761318,1,8,0
81197180@N00,9691,31,1422753466,1422753466,1,8,0
81197180@N00,9691,16,1422764173,1422764173,1,8,0
81197180@N00,9691,19,1422775079,1422775079,1,8,0
81197180@N00,9691,17,1422766069,1422766165,2,8,96
81197180@N00,9691,30,1422772802,1422772802,1,8,0
81232363@N00,9692,26,1251541705,1251542416,3,1,711
81232363@N00,9693,13,1251589217,1251589217,1,6,0
81232363@N00,9693,25,1251588164,1251588164,1,6,0
81232363@N00,9693,29,1251580895,1251580895,1,6,0
81232363@N00,9693,28,1251578759,1251594545,3,6,15786
81232363@N00,9693,1,1251578664,1251578664,1,6,0
81232363@N00,9693,26,1251578957,1251618666,3,6,39709
81232363@N00,9694,12,1299382884,1299382884,1,4,0
81232363@N00,9694,29,1299376580,1299376580,1,4,0
81232363@N00,9694,28,1299358889,1299380385,2,4,21496
81232363@N00,9694,26,1299388765,1299388944,3,4,179
81281582@N07,9695,26,1278903426,1278923734,9,1,20308
81281582@N07,9696,26,1291122000,1291122000,14,1,0
81281582@N07,9697,26,1307882225,1307883312,2,1,1087
81281582@N07,9698,26,1314405513,1314405513,1,1,0
81281582@N07,9699,26,1320417841,1320439910,20,1,22069
81281582@N07,9700,26,1321539063,1321559872,29,2,20809
81281582@N07,9700,23,1321539053,1321553469,2,2,14416
81281582@N07,9701,26,1325458785,1325458785,1,1,0
81281582@N07,9702,23,1325964458,1325964495,2,2,37
81281582@N07,9702,26,1325961871,1325963906,3,2,2035
81281582@N07,9703,26,1327034231,1327054272,17,1,20041
81281582@N07,9704,26,1330598301,1330598307,2,2,6
81281582@N07,9704,21,1330598295,1330598295,1,2,0
81281582@N07,9705,26,1331370313,1331380338,4,1,10025
81281582@N07,9706,23,1340634508,1340670304,15,2,35796
81281582@N07,9706,26,1340637258,1340637258,1,2,0
81281582@N07,9707,26,1340755651,1340755651,1,1,0
81281582@N07,9708,26,1340847786,1340847786,1,1,0
81281582@N07,9709,26,1340927429,1340927429,1,1,0
81281582@N07,9710,26,1342045310,1342045551,2,1,241
81281582@N07,9711,26,1342433621,1342433621,1,1,0
81281582@N07,9712,26,1350683253,1350683253,1,1,0
81281582@N07,9713,26,1350735366,1350735366,1,1,0
81281582@N07,9714,26,1357348170,1357348170,1,1,0
81281582@N07,9715,26,1360846998,1360854261,13,1,7263
81281582@N07,9716,26,1360924809,1360932071,16,1,7262
81281582@N07,9717,26,1361624478,1361625059,3,1,581
81281582@N07,9718,26,1361692011,1361710330,44,1,18319
81281582@N07,9719,26,1363314898,1363332134,38,1,17236
81281582@N07,9720,26,1365742127,1365755064,32,1,12937
81281582@N07,9721,26,1370481563,1370497940,17,7,16377
81281582@N07,9721,5,1370492205,1370492205,1,7,0
81281582@N07,9721,25,1370480570,1370480570,1,7,0
81281582@N07,9721,1,1370481815,1370481842,2,7,27
81281582@N07,9721,23,1370484783,1370484783,1,7,0
81281582@N07,9721,10,1370476718,1370494289,3,7,17571
81281582@N07,9721,30,1370483975,1370491056,4,7,7081
81291546@N02,9722,28,1372181251,1372181251,1,1,0
81292745@N00,9723,26,1252924389,1252932989,2,3,8600
81292745@N00,9723,28,1252934930,1252934930,1,3,0
81292745@N00,9723,30,1252913796,1252913796,1,3,0
81322238@N00,9724,31,1257461150,1257466083,12,8,4933
81322238@N00,9724,30,1257465811,1257465841,9,8,30
81322238@N00,9724,14,1257462918,1257463171,4,8,253
81322238@N00,9724,28,1257457749,1257468215,2,8,10466
81322238@N00,9724,29,1257466969,1257467802,19,8,833
81322238@N00,9724,22,1257462023,1257465119,20,8,3096
81322238@N00,9724,20,1257461194,1257464437,44,8,3243
81322238@N00,9724,1,1257468383,1257468503,3,8,120
81348276@N05,9725,1,1449699105,1449699105,1,3,0
81348276@N05,9725,29,1449705239,1449705239,1,3,0
81348276@N05,9725,28,1449699167,1449699167,1,3,0
81348276@N05,9726,30,1459919518,1459919716,2,2,198
81348276@N05,9726,29,1459913348,1459913348,1,2,0
81348276@N05,9727,26,1462147668,1462147668,1,4,0
81348276@N05,9727,19,1462159357,1462159357,1,4,0
81348276@N05,9727,17,1462163742,1462163742,1,4,0
81348276@N05,9727,29,1462154707,1462157475,3,4,2768
81348276@N05,9728,23,1464256781,1464256781,1,2,0
81348276@N05,9728,30,1464262714,1464262714,1,2,0
81348276@N05,9729,1,1465186299,1465186299,1,1,0
81428527@N00,9730,28,1267845301,1267845301,1,1,0
81549686@N02,9731,26,1341884289,1341884289,1,2,0
81549686@N02,9731,18,1341883961,1341883961,1,2,0
81549686@N02,9732,12,1342351558,1342351558,1,3,0
81549686@N02,9732,11,1342351421,1342351421,1,3,0
81549686@N02,9732,28,1342348853,1342348853,1,3,0
81587683@N00,9733,7,1350795523,1350795523,1,1,0
81587683@N00,9734,7,1350903843,1350903843,1,2,0
81587683@N00,9734,13,1350910292,1350910292,1,2,0
8164738@N04,9735,21,1293756354,1293756354,1,1,0
81704044@N06,9736,30,1352700118,1352700118,1,1,0
81704044@N06,9737,29,1362042579,1362042579,1,1,0
81704044@N06,9738,26,1365591538,1365591538,1,1,0
81704044@N06,9739,30,1366720379,1366720379,1,1,0
81704044@N06,9740,12,1367136864,1367136864,1,1,0
81704044@N06,9741,15,1367675195,1367675195,1,1,0
81704044@N06,9742,15,1367707968,1367707968,1,1,0
81704044@N06,9743,30,1369521439,1369521439,1,1,0
81704044@N06,9744,18,1371730478,1371730548,3,1,70
81704044@N06,9745,18,1374056743,1374056743,1,1,0
81704044@N06,9746,20,1375601231,1375601231,1,1,0
81704044@N06,9747,25,1377386430,1377386430,1,1,0
81704044@N06,9748,15,1379196167,1379196167,1,1,0
81704044@N06,9749,29,1380608855,1380608855,1,1,0
81704044@N06,9750,28,1385357314,1385357314,1,1,0
81704044@N06,9751,20,1386047990,1386047990,1,1,0
81704044@N06,9752,30,1387882780,1387882780,1,1,0
81704044@N06,9753,29,1391407181,1391407181,1,1,0
81706316@N00,9754,8,1195212066,1195212227,4,1,161
81706316@N00,9755,8,1195253292,1195290560,19,1,37268
81711337@N00,9756,6,1337845497,1337846967,3,5,1470
81711337@N00,9756,29,1337840233,1337840236,2,5,3
81711337@N00,9756,16,1337855019,1337855043,2,5,24
81711337@N00,9756,26,1337848396,1337848396,1,5,0
81711337@N00,9756,8,1337846944,1337846944,1,5,0
8171888@N03,9757,28,1374834541,1374834560,2,2,19
8171888@N03,9757,25,1374834600,1374834620,2,2,20
8174873@N02,9758,26,1239249388,1239252714,5,8,3326
8174873@N02,9758,17,1239253075,1239256514,7,8,3439
8174873@N02,9758,27,1239250052,1239250763,6,8,711
8174873@N02,9758,15,1239267096,1239267462,2,8,366
8174873@N02,9758,30,1239262774,1239266939,3,8,4165
8174873@N02,9758,10,1239265801,1239266660,5,8,859
8174873@N02,9758,12,1239256810,1239269560,6,8,12750
8174873@N02,9758,22,1239261088,1239261604,3,8,516
8176893@N08,9759,13,1371270034,1371270034,1,1,0
81771394@N02,9760,26,1377131386,1377131386,1,1,0
81812513@N00,9761,26,1274916613,1274934007,3,1,17394
81827168@N00,9762,24,1333937305,1333937305,1,4,0
81827168@N00,9762,26,1333966896,1333966896,1,4,0
81827168@N00,9762,11,1333926317,1333926711,2,4,394
81827168@N00,9762,18,1333957180,1333957180,1,4,0
81855582@N00,9763,19,1213786605,1213786605,1,1,0
8188436@N08,9764,28,1245546734,1245546769,3,2,35
8188436@N08,9764,24,1245542282,1245542430,2,2,148
8188436@N08,9765,28,1245654870,1245654870,1,7,0
8188436@N08,9765,25,1245629545,1245629575,3,7,30
8188436@N08,9765,24,1245650631,1245650631,1,7,0
8188436@N08,9765,19,1245633685,1245633740,3,7,55
8188436@N08,9765,4,1245630780,1245630780,1,7,0
8188436@N08,9765,29,1245643252,1245643752,2,7,500
8188436@N08,9765,26,1245627143,1245627237,4,7,94
8188436@N08,9766,23,1245756613,1245756812,3,1,199
8188436@N08,9767,12,1245802646,1245802660,3,1,14
8188436@N08,9768,16,1359091664,1359091664,1,1,0
8188436@N08,9769,28,1359153930,1359154938,3,4,1008
8188436@N08,9769,15,1359176700,1359176700,1,4,0
8188436@N08,9769,24,1359176722,1359176722,1,4,0
8188436@N08,9769,29,1359164370,1359164370,1,4,0
8192409@N06,9770,28,1331289935,1331289935,1,1,0
8192409@N06,9771,13,1334909975,1334909975,1,1,0
8192409@N06,9772,28,1336643088,1336643088,1,1,0
8192409@N06,9773,7,1336904779,1336906438,2,1,1659
8192409@N06,9774,1,1350748715,1350748715,1,1,0
8192409@N06,9775,18,1358142346,1358142346,1,1,0
8192409@N06,9776,28,1359626284,1359626284,1,1,0
8192409@N06,9777,14,1367877039,1367877039,1,1,0
8192409@N06,9778,11,1381379479,1381379479,1,1,0
8192409@N06,9779,1,1386406555,1386406555,1,1,0
8192409@N06,9780,1,1389070821,1389071284,2,1,463
8192409@N06,9781,1,1389775450,1389775716,2,1,266
8192409@N06,9782,19,1408954614,1408968355,2,1,13741
8192409@N06,9783,28,1409626197,1409626197,1,2,0
8192409@N06,9783,19,1409645574,1409646344,2,2,770
8192409@N06,9784,3,1412652838,1412652838,1,1,0
82022162@N05,9785,1,1370154951,1370154983,2,1,32
82046952@N00,9786,17,1348194256,1348194277,33,1,21
82064146@N00,9787,18,1224145683,1224145683,1,1,0
82072659@N00,9788,12,1231667837,1231667837,1,1,0
82072659@N00,9789,12,1231752246,1231752246,1,1,0
82122838@N00,9790,28,1252492373,1252492373,1,1,0
82207382@N00,9791,15,1280550498,1280550498,1,2,0
82207382@N00,9791,23,1280561837,1280561837,1,2,0
8227117@N08,9792,30,1196963111,1196963111,1,1,0
82297923@N00,9793,17,1369890473,1369890473,1,1,0
82316004@N00,9794,3,1287136166,1287136166,1,2,0
82316004@N00,9794,29,1287117370,1287117833,2,2,463
82339538@N00,9795,26,1333106681,1333106681,1,1,0
82418556@N00,9796,28,1289643259,1289653750,4,3,10491
82418556@N00,9796,25,1289645986,1289645986,1,3,0
82418556@N00,9796,20,1289647037,1289647544,2,3,507
82418556@N00,9797,5,1307358692,1307358747,2,4,55
82418556@N00,9797,18,1307356551,1307356551,1,4,0
82418556@N00,9797,28,1307367253,1307367323,2,4,70
82418556@N00,9797,23,1307353370,1307354967,2,4,1597
82418556@N00,9798,5,1307877872,1307877872,1,5,0
82418556@N00,9798,27,1307879617,1307882458,7,5,2841
82418556@N00,9798,26,1307882825,1307882825,1,5,0
82418556@N00,9798,28,1307877977,1307885112,2,5,7135
82418556@N00,9798,8,1307884476,1307884531,2,5,55
82418556@N00,9799,15,1310469226,1310472035,2,4,2809
82418556@N00,9799,27,1310468675,1310471976,7,4,3301
82418556@N00,9799,1,1310467222,1310467475,3,4,253
82418556@N00,9799,28,1310474349,1310474451,2,4,102
82418556@N00,9800,6,1328345248,1328345302,3,6,54
82418556@N00,9800,29,1328355463,1328355463,1,6,0
82418556@N00,9800,1,1328340573,1328340573,1,6,0
82418556@N00,9800,9,1328345935,1328345935,1,6,0
82418556@N00,9800,27,1328340577,1328340577,1,6,0
82418556@N00,9800,4,1328347785,1328347785,1,6,0
82418556@N00,9801,28,1330518607,1330519455,2,1,848
82418556@N00,9802,26,1337488073,1337492393,2,3,4320
82418556@N00,9802,28,1337489350,1337489350,1,3,0
82418556@N00,9802,27,1337492438,1337492438,1,3,0
82418556@N00,9803,28,1342086004,1342086004,1,1,0
82418556@N00,9804,26,1346532967,1346532967,1,5,0
82418556@N00,9804,15,1346533235,1346533483,2,5,248
82418556@N00,9804,7,1346532882,1346532882,1,5,0
82418556@N00,9804,13,1346533787,1346533787,1,5,0
82418556@N00,9804,28,1346498228,1346543120,4,5,44892
82418556@N00,9805,26,1361072277,1361072277,1,2,0
82418556@N00,9805,28,1361071003,1361071003,1,2,0
82418556@N00,9806,26,1364733028,1364733028,1,5,0
82418556@N00,9806,1,1364704779,1364716214,2,5,11435
82418556@N00,9806,7,1364719323,1364719323,1,5,0
82418556@N00,9806,27,1364719865,1364719865,1,5,0
82418556@N00,9806,17,1364730594,1364730594,1,5,0
82418556@N00,9807,28,1364801024,1364801024,1,1,0
82418556@N00,9808,26,1369407899,1369424026,3,8,16127
82418556@N00,9808,17,1369420070,1369420070,1,8,0
82418556@N00,9808,29,1369417896,1369417896,1,8,0
82418556@N00,9808,1,1369407317,1369425759,3,8,18442
82418556@N00,9808,24,1369409173,1369409173,1,8,0
82418556@N00,9808,28,1369407576,1369407576,1,8,0
82418556@N00,9808,3,1369409668,1369409668,1,8,0
82418556@N00,9808,20,1369416906,1369416906,1,8,0
82418556@N00,9809,23,1371982972,1371982972,1,3,0
82418556@N00,9809,5,1371979660,1371980168,2,3,508
82418556@N00,9809,28,1371987903,1371987903,1,3,0
82418556@N00,9810,3,1377897686,1377898527,2,5,841
82418556@N00,9810,13,1377897626,1377897626,1,5,0
82418556@N00,9810,28,1377896860,1377896860,1,5,0
82418556@N00,9810,30,1377898636,1377898636,1,5,0
82418556@N00,9810,26,1377898578,1377900847,2,5,2269
82418556@N00,9811,15,1377980156,1377980156,1,2,0
82418556@N00,9811,7,1377980199,1377980199,1,2,0
82418556@N00,9812,26,1379081873,1379081873,1,5,0
82418556@N00,9812,28,1379076241,1379077011,2,5,770
82418556@N00,9812,20,1379081683,1379081683,1,5,0
82418556@N00,9812,1,1379085190,1379085190,1,5,0
82418556@N00,9812,30,1379082968,1379082968,1,5,0
82418556@N00,9813,27,1393925577,1393925577,1,4,0
82418556@N00,9813,29,1393914173,1393914173,1,4,0
82418556@N00,9813,26,1393911216,1393911216,1,4,0
82418556@N00,9813,15,1393911604,1393919564,3,4,7960
82418556@N00,9814,27,1397051004,1397051004,1,2,0
82418556@N00,9814,26,1397037924,1397037924,1,2,0
82418556@N00,9815,15,1400242761,1400242761,1,1,0
82418556@N00,9816,20,1400388976,1400388976,1,2,0
82418556@N00,9816,1,1400400438,1400400438,1,2,0
82418556@N00,9817,27,1400872689,1400872689,1,3,0
82418556@N00,9817,23,1400867979,1400867979,1,3,0
82418556@N00,9817,1,1400875691,1400875691,1,3,0
82418556@N00,9818,15,1401004870,1401005832,3,3,962
82418556@N00,9818,20,1401013243,1401013323,2,3,80
82418556@N00,9818,28,1400999722,1401014566,2,3,14844
82418556@N00,9819,20,1401110874,1401110948,2,3,74
82418556@N00,9819,26,1401111035,1401111035,1,3,0
82418556@N00,9819,28,1401114099,1401114099,1,3,0
82418556@N00,9820,7,1401630381,1401632038,2,2,1657
82418556@N00,9820,26,1401633382,1401633382,1,2,0
82418556@N00,9821,14,1402042766,1402050944,2,3,8178
82418556@N00,9821,26,1402065242,1402065242,1,3,0
82418556@N00,9821,6,1402065011,1402065011,1,3,0
82418556@N00,9822,28,1403355740,1403356629,2,1,889
82418556@N00,9823,30,1403425647,1403425647,1,1,0
82418556@N00,9824,15,1404029571,1404029571,1,1,0
82418556@N00,9825,30,1405230044,1405230044,1,4,0
82418556@N00,9825,19,1405227316,1405227316,1,4,0
82418556@N00,9825,17,1405232531,1405232531,1,4,0
82418556@N00,9825,26,1405233232,1405233232,1,4,0
82418556@N00,9826,17,1405600373,1405601727,2,2,1354
82418556@N00,9826,26,1405577802,1405577802,1,2,0
82418556@N00,9827,19,1405865871,1405865871,1,2,0
82418556@N00,9827,26,1405842300,1405842300,1,2,0
82418556@N00,9828,16,1406449082,1406449082,1,4,0
82418556@N00,9828,3,1406433365,1406433365,1,4,0
82418556@N00,9828,19,1406428194,1406428194,1,4,0
82418556@N00,9828,26,1406449370,1406449370,1,4,0
82418556@N00,9829,27,1406721564,1406721564,1,1,0
82418556@N00,9830,28,1407043509,1407043509,1,2,0
82418556@N00,9830,4,1407044528,1407044528,1,2,0
82418556@N00,9831,28,1408032603,1408032603,1,2,0
82418556@N00,9831,18,1408011866,1408011866,1,2,0
82418556@N00,9832,16,1408883935,1408883935,1,5,0
82418556@N00,9832,19,1408843610,1408843610,1,5,0
82418556@N00,9832,20,1408869675,1408881908,2,5,12233
82418556@N00,9832,14,1408870245,1408874414,2,5,4169
82418556@N00,9832,13,1408851264,1408885232,2,5,33968
82418556@N00,9833,19,1409257519,1409257519,1,2,0
82418556@N00,9833,23,1409256256,1409256256,1,2,0
82418556@N00,9834,25,1409343624,1409343624,1,1,0
82418556@N00,9835,15,1409429252,1409429779,2,5,527
82418556@N00,9835,19,1409445268,1409445268,1,5,0
82418556@N00,9835,28,1409444950,1409444950,1,5,0
82418556@N00,9835,21,1409429993,1409429993,1,5,0
82418556@N00,9835,25,1409430392,1409430392,1,5,0
82418556@N00,9836,27,1410087248,1410087248,1,2,0
82418556@N00,9836,1,1410091260,1410091260,1,2,0
82418556@N00,9837,28,1410687083,1410687083,1,3,0
82418556@N00,9837,17,1410686940,1410686940,1,3,0
82418556@N00,9837,20,1410679958,1410705103,3,3,25145
82418556@N00,9838,30,1411273037,1411273037,1,1,0
82418556@N00,9839,3,1411913877,1411913877,1,1,0
82418556@N00,9840,28,1412325823,1412325823,1,1,0
82418556@N00,9841,20,1412399958,1412399958,1,4,0
82418556@N00,9841,26,1412396697,1412406946,2,4,10249
82418556@N00,9841,19,1412395186,1412395186,1,4,0
82418556@N00,9841,28,1412395795,1412395795,1,4,0
82418556@N00,9842,15,1412491031,1412491031,1,2,0
82418556@N00,9842,29,1412511662,1412511662,1,2,0
82418556@N00,9843,26,1412550085,1412550085,1,1,0
82418556@N00,9844,19,1412643843,1412643843,1,1,0
82418556@N00,9845,3,1412680176,1412680176,1,1,0
82418556@N00,9846,30,1413189191,1413189191,1,3,0
82418556@N00,9846,27,1413185714,1413185714,1,3,0
82418556@N00,9846,28,1413198285,1413198285,1,3,0
82418556@N00,9847,30,1413722876,1413722876,1,3,0
82418556@N00,9847,27,1413722692,1413722692,1,3,0
82418556@N00,9847,28,1413723031,1413723031,1,3,0
82418556@N00,9848,15,1418562884,1418562884,1,1,0
82418556@N00,9849,3,1420541679,1420541679,1,1,0
82418556@N00,9850,27,1421319962,1421319962,1,1,0
82418556@N00,9851,18,1425193235,1425193235,1,1,0
82418556@N00,9852,28,1425818192,1425818192,1,1,0
82418556@N00,9853,27,1427022423,1427022423,1,1,0
82418556@N00,9854,18,1433081557,1433081557,1,1,0
82418556@N00,9855,18,1435456731,1435456731,1,1,0
82418556@N00,9856,23,1436080296,1436080296,1,1,0
82418556@N00,9857,28,1437083499,1437083499,1,1,0
82418556@N00,9858,26,1437114673,1437114673,1,1,0
82418556@N00,9859,18,1437292874,1437292874,1,1,0
82418556@N00,9860,6,1439102267,1439102267,1,2,0
82418556@N00,9860,18,1439094996,1439094996,1,2,0
82418556@N00,9861,18,1440913290,1440913290,1,1,0
82418556@N00,9862,20,1441984426,1441984426,1,1,0
82418556@N00,9863,18,1443084592,1443084592,1,1,0
82418556@N00,9864,26,1445150197,1445150197,1,1,0
82418556@N00,9865,18,1446942462,1446942462,1,1,0
82418556@N00,9866,26,1447540095,1447540095,1,1,0
82418556@N00,9867,24,1447648951,1447648951,1,2,0
82418556@N00,9867,15,1447625630,1447625630,1,2,0
82418556@N00,9868,15,1449402380,1449402380,1,1,0
8245538@N06,9869,25,1289624171,1289624171,1,4,0
8245538@N06,9869,16,1289619839,1289620839,3,4,1000
8245538@N06,9869,4,1289622642,1289622760,2,4,118
8245538@N06,9869,28,1289619473,1289619473,1,4,0
82467308@N06,9870,17,1376978862,1376978862,1,2,0
82467308@N06,9870,15,1376983774,1376984028,2,2,254
82467308@N06,9871,1,1377092118,1377092118,1,1,0
8251903@N03,9872,29,1204696058,1204697868,55,1,1810
8251903@N03,9873,11,1340855175,1340855175,1,1,0
8251903@N03,9874,28,1352974068,1352994866,2,1,20798
8251903@N03,9875,1,1354980371,1354980371,1,1,0
82522210@N03,9876,29,1357495406,1357495406,1,1,0
82588563@N04,9877,29,1412071084,1412071084,1,1,0
82590360@N05,9878,26,1364295094,1364295094,1,1,0
82646317@N00,9879,19,1406944617,1406957795,3,2,13178
82646317@N00,9879,30,1406949226,1406949226,1,2,0
82646317@N00,9880,19,1420072704,1420095094,5,1,22390
82646317@N00,9881,18,1435396811,1435396811,1,1,0
82744213@N00,9882,28,1345959693,1345959693,1,1,0
82779205@N00,9883,26,1395977995,1395977995,1,2,0
82779205@N00,9883,28,1395996987,1396020648,2,2,23661
82779205@N00,9884,3,1396140615,1396140615,1,2,0
82779205@N00,9884,26,1396140123,1396140123,1,2,0
82792996@N07,9885,26,1405146747,1405146747,1,1,0
82841979@N04,9886,18,1457931701,1457931701,1,1,0
8284264@N04,9887,27,1301095792,1301095792,1,1,0
82878973@N08,9888,13,1361499779,1361499779,1,1,0
82878973@N08,9889,29,1365732049,1365732049,1,1,0
82878973@N08,9890,27,1371296503,1371296534,4,2,31
82878973@N08,9890,16,1371296416,1371296612,4,2,196
82878973@N08,9891,27,1371357899,1371357899,1,1,0
82878973@N08,9892,16,1374930539,1374930539,1,2,0
82878973@N08,9892,27,1374930447,1374930447,1,2,0
82878973@N08,9893,30,1391391741,1391391741,1,1,0
82878973@N08,9894,30,1415318396,1415318524,2,4,128
82878973@N08,9894,29,1415319911,1415319911,1,4,0
82878973@N08,9894,21,1415317926,1415317926,1,4,0
82878973@N08,9894,31,1415319853,1415319895,3,4,42
82878973@N08,9895,1,1415581673,1415581673,1,2,0
82878973@N08,9895,16,1415581651,1415581651,1,2,0
82878973@N08,9896,1,1420519709,1420519709,1,1,0
82878973@N08,9897,19,1434938231,1434938231,1,1,0
82878973@N08,9898,28,1454824490,1454825227,2,1,737
82878973@N08,9899,26,1465714392,1465714392,1,1,0
82895447@N08,9900,28,1348637867,1348639089,2,1,1222
8289999@N07,9901,18,1262002207,1262002207,1,1,0
8289999@N07,9902,19,1410400087,1410407193,3,2,7106
8289999@N07,9902,25,1410398492,1410398492,1,2,0
8289999@N07,9903,18,1442880356,1442884255,2,2,3899
8289999@N07,9903,13,1442882078,1442882078,1,2,0
8289999@N07,9904,18,1458781390,1458781390,1,1,0
82919069@N04,9905,16,1434084821,1434084979,2,5,158
82919069@N04,9905,26,1434070298,1434096503,2,5,26205
82919069@N04,9905,21,1434065980,1434065980,1,5,0
82919069@N04,9905,14,1434078053,1434078053,1,5,0
82919069@N04,9905,15,1434087399,1434087399,1,5,0
8298711@N08,9906,15,1223093181,1223093181,1,7,0
8298711@N08,9906,24,1223092788,1223095097,7,7,2309
8298711@N08,9906,1,1223076203,1223076203,1,7,0
8298711@N08,9906,28,1223076293,1223097955,3,7,21662
8298711@N08,9906,20,1223080803,1223080803,2,7,0
8298711@N08,9906,22,1223089976,1223090899,8,7,923
8298711@N08,9906,18,1223085264,1223085264,1,7,0
8298711@N08,9907,28,1223171666,1223178482,3,1,6816
8298711@N08,9908,12,1254523238,1254523238,1,3,0
8298711@N08,9908,25,1254531577,1254532763,2,3,1186
8298711@N08,9908,26,1254540982,1254540982,1,3,0
8305696@N06,9909,23,1299901931,1299901931,1,1,0
8307506@N03,9910,10,1191673351,1191673351,1,1,0
83081410@N05,9911,29,1342754302,1342754302,1,1,0
83081410@N05,9912,29,1343439646,1343439646,1,1,0
83104438@N02,9913,19,1407234484,1407234484,1,1,0
8312262@N03,9914,21,1451268561,1451268561,1,8,0
8312262@N03,9914,26,1451264660,1451264662,2,8,2
8312262@N03,9914,11,1451270127,1451270308,5,8,181
8312262@N03,9914,13,1451265504,1451267463,19,8,1959
8312262@N03,9914,4,1451270262,1451270389,3,8,127
8312262@N03,9914,25,1451268551,1451268551,1,8,0
8312262@N03,9914,16,1451264373,1451264373,1,8,0
8312262@N03,9914,1,1451263538,1451263538,1,8,0
8312262@N03,9915,3,1451344190,1451344342,5,8,152
8312262@N03,9915,19,1451338646,1451348478,3,8,9832
8312262@N03,9915,20,1451337466,1451337466,1,8,0
8312262@N03,9915,29,1451338684,1451338684,1,8,0
8312262@N03,9915,18,1451347691,1451348597,4,8,906
8312262@N03,9915,13,1451342679,1451342679,1,8,0
8312262@N03,9915,25,1451340408,1451342296,22,8,1888
8312262@N03,9915,7,1451335318,1451335318,1,8,0
8312262@N03,9916,13,1451434140,1451434468,4,5,328
8312262@N03,9916,4,1451430425,1451430427,2,5,2
8312262@N03,9916,24,1451425805,1451427309,5,5,1504
8312262@N03,9916,12,1451427185,1451427247,5,5,62
8312262@N03,9916,15,1451425091,1451425370,2,5,279
83166333@N00,9917,28,1325404694,1325404694,1,1,0
83166333@N00,9918,26,1350897061,1350897061,1,1,0
83209367@N00,9919,10,1207792803,1207792803,1,11,0
83209367@N00,9919,16,1207792810,1207792810,1,11,0
83209367@N00,9919,28,1207792814,1207792818,3,11,4
83209367@N00,9919,13,1207792812,1207792812,1,11,0
83209367@N00,9919,26,1207792801,1207792816,4,11,15
83209367@N00,9919,22,1207792804,1207792811,2,11,7
83209367@N00,9919,27,1207792802,1207792802,1,11,0
83209367@N00,9919,1,1207792809,1207792809,1,11,0
83209367@N00,9919,31,1207792805,1207792807,2,11,2
83209367@N00,9919,14,1207792806,1207792806,1,11,0
83209367@N00,9919,29,1207792808,1207792808,1,11,0
83209367@N00,9920,26,1225151606,1225153998,3,5,2392
83209367@N00,9920,17,1225153635,1225153854,2,5,219
83209367@N00,9920,29,1225154357,1225154517,2,5,160
83209367@N00,9920,22,1225154189,1225154255,2,5,66
83209367@N00,9920,31,1225154069,1225154069,1,5,0
83286805@N00,9921,30,1217117473,1217117473,1,1,0
83286805@N00,9922,28,1223527702,1223527702,1,3,0
83286805@N00,9922,29,1223527439,1223527439,1,3,0
83286805@N00,9922,30,1223531366,1223531366,1,3,0
83286805@N00,9923,29,1228007754,1228007754,1,3,0
83286805@N00,9923,25,1228005012,1228005012,1,3,0
83286805@N00,9923,21,1228001540,1228001540,1,3,0
83286805@N00,9924,13,1235818923,1235818923,1,2,0
83286805@N00,9924,23,1235822369,1235822369,1,2,0
83286805@N00,9925,28,1237695022,1237695022,1,1,0
83286805@N00,9926,18,1242394523,1242394523,1,1,0
83286805@N00,9927,12,1244436540,1244436540,1,1,0
83286805@N00,9928,1,1244947560,1244947560,1,4,0
83286805@N00,9928,28,1244950302,1244950302,1,4,0
83286805@N00,9928,29,1244952331,1244952331,1,4,0
83286805@N00,9928,6,1244942021,1244942039,2,4,18
83286805@N00,9929,15,1249108111,1249108111,1,6,0
83286805@N00,9929,28,1249100175,1249102449,2,6,2274
83286805@N00,9929,26,1249106278,1249106278,1,6,0
83286805@N00,9929,23,1249105649,1249105649,1,6,0
83286805@N00,9929,18,1249105449,1249105449,1,6,0
83286805@N00,9929,17,1249107975,1249107975,1,6,0
83286805@N00,9930,28,1249775718,1249778837,2,1,3119
83286805@N00,9931,28,1252146665,1252146665,1,1,0
83286805@N00,9932,26,1256465925,1256465925,1,1,0
83286805@N00,9933,28,1257387562,1257387562,1,1,0
83286805@N00,9934,12,1264311825,1264311825,1,1,0
83286805@N00,9935,23,1270290934,1270290934,1,1,0
83286805@N00,9936,28,1277560819,1277560819,1,2,0
83286805@N00,9936,23,1277559179,1277559179,1,2,0
83286805@N00,9937,30,1279326507,1279327977,2,5,1470
83286805@N00,9937,3,1279328621,1279328640,2,5,19
83286805@N00,9937,4,1279328521,1279328521,1,5,0
83286805@N00,9937,23,1279324534,1279324534,1,5,0
83286805@N00,9937,13,1279336708,1279337061,3,5,353
83286805@N00,9938,4,1279367771,1279367902,2,1,131
83286805@N00,9939,26,1281146262,1281146262,1,1,0
83286805@N00,9940,1,1283060385,1283060385,1,1,0
83286805@N00,9941,28,1284866306,1284866306,1,1,0
83286805@N00,9942,23,1286062515,1286062515,1,1,0
83286805@N00,9943,17,1287192490,1287192490,1,1,0
83286805@N00,9944,30,1289707317,1289707317,1,4,0
83286805@N00,9944,21,1289705121,1289705121,1,4,0
83286805@N00,9944,20,1289706452,1289706452,1,4,0
83286805@N00,9944,12,1289705171,1289705171,1,4,0
83286805@N00,9945,13,1298251987,1298251987,1,1,0
83286805@N00,9946,19,1311377779,1311377779,1,3,0
83286805@N00,9946,31,1311376631,1311376631,1,3,0
83286805@N00,9946,12,1311375630,1311375630,1,3,0
83286805@N00,9947,28,1323658251,1323658251,1,1,0
83286805@N00,9948,18,1346507833,1346507833,1,1,0
83286805@N00,9949,18,1366454123,1366454123,1,1,0
83286805@N00,9950,23,1371945456,1371945456,1,1,0
83297140@N00,9951,13,1409635431,1409642832,2,2,7401
83297140@N00,9951,16,1409621319,1409621319,1,2,0
8331103@N07,9952,3,1318138082,1318138082,1,1,0
8331103@N07,9953,28,1322396158,1322396158,1,1,0
8331103@N07,9954,24,1348371617,1348371617,1,1,0
8336246@N06,9955,1,1397861062,1397907914,27,1,46852
83434203@N00,9956,30,1195630146,1195632631,13,5,2485
83434203@N00,9956,26,1195625375,1195625375,1,5,0
83434203@N00,9956,19,1195626059,1195627771,13,5,1712
83434203@N00,9956,18,1195624222,1195625313,3,5,1091
83434203@N00,9956,17,1195633890,1195633890,1,5,0
8347765@N06,9957,23,1351468044,1351482331,3,7,14287
8347765@N06,9957,27,1351486550,1351486550,1,7,0
8347765@N06,9957,20,1351469594,1351469647,2,7,53
8347765@N06,9957,28,1351467908,1351467908,1,7,0
8347765@N06,9957,26,1351485121,1351485121,1,7,0
8347765@N06,9957,7,1351480400,1351480400,1,7,0
8347765@N06,9957,16,1351485162,1351485162,1,7,0
8347765@N06,9958,23,1385504116,1385504116,1,14,0
8347765@N06,9958,31,1385507245,1385507245,1,14,0
8347765@N06,9958,20,1385506389,1385506395,2,14,6
8347765@N06,9958,21,1385510872,1385537224,3,14,26352
8347765@N06,9958,4,1385509952,1385509952,1,14,0
8347765@N06,9958,1,1385532396,1385532396,1,14,0
8347765@N06,9958,28,1385532442,1385551328,4,14,18886
8347765@N06,9958,18,1385504263,1385504348,3,14,85
8347765@N06,9958,13,1385538467,1385539392,3,14,925
8347765@N06,9958,5,1385509601,1385510645,6,14,1044
8347765@N06,9958,26,1385532781,1385546533,4,14,13752
8347765@N06,9958,7,1385509555,1385509555,1,14,0
8347765@N06,9958,15,1385543317,1385543317,1,14,0
8347765@N06,9958,16,1385540146,1385548309,9,14,8163
8347765@N06,9959,28,1395465008,1395465008,1,2,0
8347765@N06,9959,18,1395468569,1395468569,1,2,0
8347765@N06,9960,28,1398045947,1398045947,1,1,0
8347765@N06,9961,30,1403912363,1403912363,1,2,0
8347765@N06,9961,25,1403915823,1403915823,1,2,0
8347765@N06,9962,19,1404003851,1404003851,1,1,0
8347765@N06,9963,30,1407032732,1407032732,1,1,0
8347765@N06,9964,1,1407107248,1407107248,1,2,0
8347765@N06,9964,25,1407134795,1407134795,1,2,0
8347765@N06,9965,19,1414201368,1414201368,1,1,0
8347765@N06,9966,10,1423269324,1423269324,1,8,0
8347765@N06,9966,21,1423272898,1423272898,1,8,0
8347765@N06,9966,29,1423260712,1423302305,6,8,41593
8347765@N06,9966,31,1423264502,1423265168,5,8,666
8347765@N06,9966,18,1423258498,1423258602,2,8,104
8347765@N06,9966,19,1423258730,1423258993,4,8,263
8347765@N06,9966,30,1423264714,1423269628,2,8,4914
8347765@N06,9966,22,1423264757,1423265005,2,8,248
8347765@N06,9967,29,1426906583,1426906594,2,4,11
8347765@N06,9967,31,1426906637,1426907225,4,4,588
8347765@N06,9967,30,1426906384,1426906567,11,4,183
8347765@N06,9967,22,1426906759,1426906836,2,4,77
8347765@N06,9968,1,1443769982,1443769982,1,7,0
8347765@N06,9968,20,1443776284,1443778724,12,7,2440
8347765@N06,9968,24,1443783001,1443783011,6,7,10
8347765@N06,9968,18,1443773562,1443773562,1,7,0
8347765@N06,9968,30,1443785794,1443786718,5,7,924
8347765@N06,9968,22,1443774873,1443774875,2,7,2
8347765@N06,9968,26,1443771076,1443771076,1,7,0
8348059@N02,9969,1,1307604274,1307617535,10,7,13261
8348059@N02,9969,30,1307620737,1307620737,1,7,0
8348059@N02,9969,29,1307616058,1307628073,12,7,12015
8348059@N02,9969,23,1307620665,1307620665,1,7,0
8348059@N02,9969,20,1307624593,1307625727,3,7,1134
8348059@N02,9969,26,1307620568,1307628442,2,7,7874
8348059@N02,9969,28,1307615161,1307628622,89,7,13461
8348059@N02,9970,18,1307671783,1307672079,3,20,296
8348059@N02,9970,25,1307682957,1307684418,28,20,1461
8348059@N02,9970,13,1307682728,1307688176,16,20,5448
8348059@N02,9970,28,1307669988,1307710177,16,20,40189
8348059@N02,9970,10,1307681374,1307681374,1,20,0
8348059@N02,9970,27,1307708091,1307708091,1,20,0
8348059@N02,9970,4,1307682610,1307682610,1,20,0
8348059@N02,9970,19,1307671917,1307671936,2,20,19
8348059@N02,9970,22,1307674401,1307674401,1,20,0
8348059@N02,9970,26,1307689074,1307709892,5,20,20818
8348059@N02,9970,6,1307688773,1307688797,3,20,24
8348059@N02,9970,20,1307674456,1307674456,1,20,0
8348059@N02,9970,1,1307669892,1307710356,11,20,40464
8348059@N02,9970,16,1307707910,1307708881,5,20,971
8348059@N02,9970,3,1307688313,1307688349,2,20,36
8348059@N02,9970,30,1307676176,1307681166,10,20,4990
8348059@N02,9970,11,1307681658,1307681658,1,20,0
8348059@N02,9970,29,1307671825,1307706312,37,20,34487
8348059@N02,9970,23,1307671558,1307678024,12,20,6466
8348059@N02,9970,9,1307682027,1307688693,2,20,6666
8348059@N02,9971,12,1307741542,1307742182,3,9,640
8348059@N02,9971,5,1307740612,1307741435,8,9,823
8348059@N02,9971,19,1307744825,1307744904,2,9,79
8348059@N02,9971,1,1307747076,1307747092,2,9,16
8348059@N02,9971,3,1307742786,1307742786,1,9,0
8348059@N02,9971,30,1307743622,1307744268,3,9,646
8348059@N02,9971,29,1307745325,1307746025,6,9,700
8348059@N02,9971,23,1307744378,1307744506,2,9,128
8348059@N02,9971,9,1307741194,1307742938,4,9,1744
8348059@N02,9972,18,1370817333,1370817333,1,14,0
8348059@N02,9972,28,1370814531,1370814554,2,14,23
8348059@N02,9972,26,1370821086,1370875392,12,14,54306
8348059@N02,9972,27,1370824119,1370824680,3,14,561
8348059@N02,9972,19,1370816688,1370816688,1,14,0
8348059@N02,9972,25,1370822358,1370823170,3,14,812
8348059@N02,9972,22,1370819659,1370819659,1,14,0
8348059@N02,9972,20,1370818831,1370818867,3,14,36
8348059@N02,9972,1,1370835727,1370866030,3,14,30303
8348059@N02,9972,16,1370823741,1370866507,2,14,42766
8348059@N02,9972,29,1370815716,1370868700,7,14,52984
8348059@N02,9972,30,1370820904,1370866719,5,14,45815
8348059@N02,9972,21,1370821777,1370823591,3,14,1814
8348059@N02,9972,23,1370875423,1370875936,11,14,513
8348059@N02,9973,13,1370918261,1370918283,3,14,22
8348059@N02,9973,24,1370915489,1370917075,5,14,1586
8348059@N02,9973,28,1370918951,1370941498,62,14,22547
8348059@N02,9973,5,1370911960,1370911960,1,14,0
8348059@N02,9973,17,1370917258,1370918644,2,14,1386
8348059@N02,9973,27,1370912929,1370914561,4,14,1632
8348059@N02,9973,25,1370918276,1370918276,2,14,0
8348059@N02,9973,15,1370916878,1370916878,1,14,0
8348059@N02,9973,8,1370912539,1370912539,1,14,0
8348059@N02,9973,20,1370942425,1370944040,3,14,1615
8348059@N02,9973,1,1370909383,1370948094,6,14,38711
8348059@N02,9973,16,1370914856,1370914856,1,14,0
8348059@N02,9973,21,1370912290,1370912290,1,14,0
8348059@N02,9973,29,1370917749,1370942836,6,14,25087
8348059@N02,9974,18,1402268595,1402268595,1,11,0
8348059@N02,9974,19,1402268216,1402268365,4,11,149
8348059@N02,9974,28,1402284213,1402304981,58,11,20768
8348059@N02,9974,22,1402271676,1402281061,10,11,9385
8348059@N02,9974,8,1402274587,1402274587,1,11,0
8348059@N02,9974,6,1402274490,1402274490,1,11,0
8348059@N02,9974,20,1402271433,1402271433,1,11,0
8348059@N02,9974,31,1402281464,1402281464,1,11,0
8348059@N02,9974,30,1402272957,1402273464,4,11,507
8348059@N02,9974,29,1402267062,1402298621,6,11,31559
8348059@N02,9974,23,1402267774,1402298003,3,11,30229
8348059@N02,9975,28,1402366224,1402366561,3,7,337
8348059@N02,9975,25,1402354054,1402355187,6,7,1133
8348059@N02,9975,1,1402347399,1402347399,1,7,0
8348059@N02,9975,6,1402350075,1402350075,1,7,0
8348059@N02,9975,30,1402356119,1402356119,1,7,0
8348059@N02,9975,11,1402356000,1402356000,1,7,0
8348059@N02,9975,29,1402359220,1402364304,9,7,5084
8348059@N02,9976,28,1402491017,1402491017,1,2,0
8348059@N02,9976,1,1402488770,1402490635,2,2,1865
83505636@N03,9977,14,1363006466,1363006466,1,1,0
83518369@N00,9978,17,1310178860,1310178860,1,1,0
83518369@N00,9979,1,1313558664,1313558664,1,2,0
83518369@N00,9979,28,1313558411,1313558411,1,2,0
8353257@N07,9980,11,1291766040,1291766040,1,1,0
83551957@N08,9981,19,1419508892,1419508892,1,1,0
83612144@N00,9982,30,1252819291,1252819291,1,1,0
83612144@N00,9983,13,1254883540,1254883540,1,2,0
83612144@N00,9983,11,1254881680,1254881680,1,2,0
83612144@N00,9984,27,1270975073,1270975073,1,1,0
83612144@N00,9985,16,1278671088,1278671088,1,1,0
83612144@N00,9986,15,1280632753,1280632864,2,3,111
83612144@N00,9986,4,1280631392,1280631392,1,3,0
83612144@N00,9986,21,1280630834,1280630834,1,3,0
83612144@N00,9987,13,1281861901,1281861901,1,1,0
83612144@N00,9988,28,1293011228,1293011228,1,1,0
83612144@N00,9989,3,1295770899,1295770899,1,1,0
83612144@N00,9990,7,1304670059,1304670059,1,1,0
83612144@N00,9991,25,1306467595,1306467658,2,1,63
83612144@N00,9992,25,1306735436,1306736933,2,2,1497
83612144@N00,9992,13,1306738267,1306738267,1,2,0
83612144@N00,9993,24,1311932855,1311932855,1,2,0
83612144@N00,9993,21,1311930165,1311930165,1,2,0
83612144@N00,9994,29,1312416034,1312416034,1,2,0
83612144@N00,9994,31,1312416569,1312416622,2,2,53
83612144@N00,9995,12,1313311715,1313311715,1,1,0
83612144@N00,9996,28,1314998948,1314998948,1,1,0
83612144@N00,9997,13,1319934702,1319934702,1,2,0
83612144@N00,9997,1,1319937115,1319937115,1,2,0
83612144@N00,9998,28,1320448863,1320448863,1,1,0
83612144@N00,9999,6,1321135590,1321135590,1,2,0
83612144@N00,9999,12,1321139391,1321139391,1,2,0
83612144@N00,10000,21,1323937507,1323937507,1,2,0
83612144@N00,10000,25,1323935817,1323935817,1,2,0
83612144@N00,10001,24,1325807923,1325807923,1,1,0
83612144@N00,10002,16,1327810769,1327812567,2,1,1798
83612144@N00,10003,3,1331450151,1331450151,1,1,0
83612144@N00,10004,1,1334125434,1334125434,1,1,0
83612144@N00,10005,15,1337135291,1337135970,2,1,679
83612144@N00,10006,18,1337737905,1337737905,1,4,0
83612144@N00,10006,11,1337734800,1337734800,1,4,0
83612144@N00,10006,21,1337729804,1337729829,2,4,25
83612144@N00,10006,25,1337733534,1337734368,4,4,834
83612144@N00,10007,27,1340490167,1340490167,1,1,0
83612144@N00,10008,18,1342946963,1342946963,1,3,0
83612144@N00,10008,20,1342950398,1342950398,1,3,0
83612144@N00,10008,29,1342949889,1342950670,2,3,781
83612144@N00,10009,26,1345802170,1345802170,1,3,0
83612144@N00,10009,14,1345804204,1345804204,1,3,0
83612144@N00,10009,16,1345800877,1345800877,1,3,0
83612144@N00,10010,28,1351147774,1351147774,1,1,0
83612144@N00,10011,29,1357431666,1357431666,1,2,0
83612144@N00,10011,21,1357426286,1357428140,2,2,1854
83612144@N00,10012,24,1357796636,1357796636,1,2,0
83612144@N00,10012,15,1357796431,1357796546,2,2,115
83612144@N00,10013,26,1360828670,1360828670,1,1,0
83612144@N00,10014,31,1362264605,1362265337,2,1,732
83612144@N00,10015,7,1365300080,1365300080,1,2,0
83612144@N00,10015,13,1365301923,1365302664,2,2,741
83612144@N00,10016,13,1369354736,1369354736,1,2,0
83612144@N00,10016,21,1369352469,1369352469,1,2,0
83612144@N00,10017,13,1380415128,1380415128,1,1,0
83612144@N00,10018,14,1384652926,1384652926,1,1,0
83612144@N00,10019,16,1386053131,1386053131,1,1,0
83612144@N00,10020,1,1393117513,1393117513,1,1,0
83612144@N00,10021,22,1394930614,1394931469,2,2,855
83612144@N00,10021,30,1394929006,1394929006,1,2,0
83612144@N00,10022,3,1398645911,1398645911,1,1,0
83612144@N00,10023,13,1403395585,1403395937,2,1,352
83612144@N00,10024,25,1417417848,1417417848,1,1,0
83612144@N00,10025,28,1417767810,1417767859,2,3,49
83612144@N00,10025,19,1417749392,1417749392,1,3,0
83612144@N00,10025,14,1417755820,1417755820,1,3,0
83612144@N00,10026,25,1431218485,1431218485,1,2,0
83612144@N00,10026,13,1431218532,1431218532,1,2,0
83638430@N00,10027,20,1366591078,1366591078,1,1,0
83638430@N00,10028,20,1366707509,1366707509,1,1,0
83659902@N00,10029,18,1447996374,1447996374,1,1,0
83711900@N00,10030,28,1390796182,1390809433,3,6,13251
83711900@N00,10030,18,1390780886,1390780886,1,6,0
83711900@N00,10030,20,1390783429,1390785447,3,6,2018
83711900@N00,10030,31,1390781084,1390781084,1,6,0
83711900@N00,10030,4,1390785725,1390785725,1,6,0
83711900@N00,10030,26,1390785478,1390785478,1,6,0
83711900@N00,10031,28,1390876136,1390879939,6,1,3803
83722986@N00,10032,24,1436848592,1436848592,1,2,0
83722986@N00,10032,15,1436848564,1436849462,11,2,898
8379824@N07,10033,13,1325000102,1325000102,1,2,0
8379824@N07,10033,29,1324997512,1324997558,2,2,46
8386875@N06,10034,18,1187939870,1187941848,145,1,1978
8386875@N06,10035,18,1188285496,1188287553,134,1,2057
8386875@N06,10036,18,1188544863,1188545030,19,1,167
8386875@N06,10037,18,1188800863,1188818193,117,1,17330
8386875@N06,10038,18,1192346207,1192346352,6,1,145
8386875@N06,10039,18,1195789370,1195797731,173,1,8361
8386875@N06,10040,18,1196649814,1196658405,97,2,8591
8386875@N06,10040,26,1196652189,1196652189,1,2,0
8386875@N06,10041,18,1204955247,1204955247,1,1,0
8386875@N06,10042,18,1207030899,1207031660,91,1,761
8386875@N06,10043,18,1207201879,1207204393,84,1,2514
8386875@N06,10044,18,1207618780,1207640239,87,1,21459
8386875@N06,10045,18,1209622726,1209623579,7,1,853
8386875@N06,10046,18,1209707750,1209718571,144,4,10821
8386875@N06,10046,3,1209712687,1209712687,1,4,0
8386875@N06,10046,30,1209709421,1209709421,1,4,0
8386875@N06,10046,16,1209711920,1209711920,1,4,0
8386875@N06,10047,4,1209947426,1209947426,1,7,0
8386875@N06,10047,26,1209946544,1209946544,1,7,0
8386875@N06,10047,16,1209956840,1209957218,2,7,378
8386875@N06,10047,18,1209945908,1209958327,129,7,12419
8386875@N06,10047,3,1209947674,1209956361,4,7,8687
8386875@N06,10047,28,1209945908,1209945908,1,7,0
8386875@N06,10047,13,1209951451,1209954560,2,7,3109
8386875@N06,10048,18,1210057113,1210065994,176,2,8881
8386875@N06,10048,16,1210065652,1210065688,2,2,36
8386875@N06,10049,18,1210140662,1210144665,32,1,4003
8386875@N06,10050,18,1210231188,1210231973,165,1,785
8386875@N06,10051,18,1210316885,1210318801,140,1,1916
8386875@N06,10052,18,1210550453,1210556830,16,1,6377
8386875@N06,10053,23,1211090812,1211090820,2,4,8
8386875@N06,10053,11,1211077554,1211077554,1,4,0
8386875@N06,10053,18,1211077072,1211091052,364,4,13980
8386875@N06,10053,26,1211089391,1211089391,1,4,0
8386875@N06,10054,18,1211869286,1211880318,213,1,11032
8386875@N06,10055,29,1212474330,1212474330,1,2,0
8386875@N06,10055,18,1212473690,1212484411,68,2,10721
8386875@N06,10056,1,1212827425,1212827425,1,2,0
8386875@N06,10056,18,1212826150,1212828163,81,2,2013
8386875@N06,10057,18,1213080196,1213089797,62,3,9601
8386875@N06,10057,11,1213080491,1213082547,2,3,2056
8386875@N06,10057,26,1213089119,1213089687,5,3,568
8386875@N06,10058,18,1213165766,1213165980,2,1,214
8386875@N06,10059,16,1213261622,1213261622,1,3,0
8386875@N06,10059,18,1213261608,1213262614,32,3,1006
8386875@N06,10059,12,1213261906,1213261906,1,3,0
8386875@N06,10060,18,1213574719,1213595555,145,3,20836
8386875@N06,10060,16,1213594678,1213595427,6,3,749
8386875@N06,10060,21,1213594932,1213594932,1,3,0
8386875@N06,10061,18,1213943064,1213951031,115,2,7967
8386875@N06,10061,1,1213950636,1213950637,2,2,1
8386875@N06,10062,18,1214289698,1214296969,67,1,7271
8386875@N06,10063,18,1214468956,1214469824,41,1,868
8386875@N06,10064,18,1214554162,1214556191,44,1,2029
8386875@N06,10065,18,1215499476,1215506502,68,2,7026
8386875@N06,10065,1,1215505136,1215505922,2,2,786
8386875@N06,10066,18,1215674401,1215679380,80,2,4979
8386875@N06,10066,28,1215647553,1215647553,1,2,0
8386875@N06,10067,18,1215760797,1215765991,79,1,5194
8386875@N06,10068,28,1219301196,1219308055,33,2,6859
8386875@N06,10068,11,1219300384,1219303173,3,2,2789
8386875@N06,10069,6,1219820092,1219820092,1,1,0
8386875@N06,10070,26,1219904757,1219904757,1,4,0
8386875@N06,10070,28,1219907792,1219912905,16,4,5113
8386875@N06,10070,1,1219911383,1219912758,11,4,1375
8386875@N06,10070,6,1219907369,1219907369,1,4,0
8386875@N06,10071,1,1221813431,1221813457,2,1,26
8386875@N06,10072,26,1222075255,1222075255,1,1,0
8386875@N06,10073,13,1222671093,1222671143,2,5,50
8386875@N06,10073,1,1222675466,1222675466,1,5,0
8386875@N06,10073,12,1222664847,1222664847,1,5,0
8386875@N06,10073,24,1222668220,1222668220,1,5,0
8386875@N06,10073,29,1222673682,1222673725,2,5,43
8386875@N06,10074,29,1224742655,1224742658,2,2,3
8386875@N06,10074,20,1224744103,1224744402,4,2,299
8386875@N06,10075,3,1226385299,1226387329,30,2,2030
8386875@N06,10075,16,1226385789,1226385792,2,2,3
8386875@N06,10076,16,1228022661,1228024689,135,1,2028
8386875@N06,10077,28,1228377194,1228382046,102,1,4852
8386875@N06,10078,25,1228822742,1228824353,27,1,1611
8386875@N06,10079,3,1236305099,1236305132,2,8,33
8386875@N06,10079,26,1236298253,1236298792,11,8,539
8386875@N06,10079,28,1236297900,1236298120,8,8,220
8386875@N06,10079,21,1236303102,1236309821,9,8,6719
8386875@N06,10079,25,1236303407,1236312125,40,8,8718
8386875@N06,10079,12,1236302413,1236302436,2,8,23
8386875@N06,10079,8,1236302634,1236302729,5,8,95
8386875@N06,10079,16,1236299564,1236308180,16,8,8616
8386875@N06,10080,16,1238716305,1238731842,98,1,15537
8386875@N06,10081,24,1263357983,1263357983,1,1,0
8386875@N06,10082,1,1267505988,1267505988,1,3,0
8386875@N06,10082,28,1267504699,1267506096,3,3,1397
8386875@N06,10082,26,1267508048,1267508048,1,3,0
8386875@N06,10083,19,1275267149,1275267149,1,3,0
8386875@N06,10083,23,1275266413,1275266420,2,3,7
8386875@N06,10083,29,1275267432,1275267432,1,3,0
8386875@N06,10084,25,1275627163,1275627163,1,1,0
8386875@N06,10085,20,1276212154,1276212154,1,3,0
8386875@N06,10085,11,1276215674,1276231035,2,3,15361
8386875@N06,10085,1,1276211354,1276211522,2,3,168
8386875@N06,10086,28,1276503764,1276503764,1,1,0
8386875@N06,10087,11,1276743214,1276743214,1,1,0
8386875@N06,10088,11,1276843880,1276844012,2,1,132
8386875@N06,10089,23,1277988771,1277988771,1,1,0
8386875@N06,10090,24,1279789729,1279789729,1,2,0
8386875@N06,10090,30,1279797006,1279802594,4,2,5588
8386875@N06,10091,18,1279867477,1279868557,3,2,1080
8386875@N06,10091,23,1279884346,1279885578,2,2,1232
8386875@N06,10092,28,1282976272,1282976272,1,1,0
8386875@N06,10093,26,1283568212,1283573593,2,3,5381
8386875@N06,10093,10,1283563530,1283563530,1,3,0
8386875@N06,10093,16,1283555807,1283571035,15,3,15228
8386875@N06,10094,7,1284009174,1284009174,1,1,0
8386875@N06,10095,28,1289454081,1289454494,5,1,413
8386875@N06,10096,28,1289537570,1289538836,50,1,1266
8386875@N06,10097,28,1289894164,1289894164,1,2,0
8386875@N06,10097,26,1289885513,1289885614,2,2,101
8386875@N06,10098,28,1290315749,1290316700,4,1,951
8386875@N06,10099,28,1290401502,1290402270,2,2,768
8386875@N06,10099,1,1290411580,1290411580,1,2,0
8386875@N06,10100,28,1290920331,1290920833,4,1,502
8386875@N06,10101,28,1291519571,1291520562,5,1,991
8386875@N06,10102,28,1292130475,1292130482,4,1,7
8386875@N06,10103,26,1293850965,1293851032,2,1,67
8386875@N06,10104,16,1293891833,1293891879,2,1,46
8386875@N06,10105,29,1296773894,1296774480,5,2,586
8386875@N06,10105,16,1296799392,1296799392,1,2,0
8386875@N06,10106,13,1296971648,1296971648,1,1,0
8386875@N06,10107,1,1297140430,1297140991,4,2,561
8386875@N06,10107,28,1297139713,1297141459,3,2,1746
8386875@N06,10108,16,1298268008,1298268008,1,1,0
8386875@N06,10109,11,1298772263,1298772518,2,1,255
8386875@N06,10110,28,1306819399,1306820258,31,1,859
8386875@N06,10111,15,1306990177,1306994084,2,2,3907
8386875@N06,10111,27,1306994082,1306994082,1,2,0
8386875@N06,10112,9,1307164455,1307164455,1,1,0
8386875@N06,10113,28,1307514198,1307515052,114,1,854
8386875@N06,10114,26,1308021824,1308022862,6,4,1038
8386875@N06,10114,9,1308027200,1308027250,2,4,50
8386875@N06,10114,16,1308032200,1308033227,72,4,1027
8386875@N06,10114,11,1308026874,1308027917,5,4,1043
8386875@N06,10115,28,1308810623,1308819109,110,2,8486
8386875@N06,10115,25,1308809047,1308810024,95,2,977
8386875@N06,10116,28,1308982948,1308983761,70,1,813
8386875@N06,10117,1,1309156146,1309156146,1,1,0
8386875@N06,10118,28,1309415789,1309415789,1,2,0
8386875@N06,10118,16,1309387108,1309400513,2,2,13405
8386875@N06,10119,28,1311302714,1311303062,2,1,348
8386875@N06,10120,1,1313044611,1313044611,1,1,0
83871406@N00,10121,1,1387697140,1387697140,1,2,0
83871406@N00,10121,28,1387702212,1387702246,2,2,34
83871406@N00,10122,15,1387786872,1387791612,3,11,4740
83871406@N00,10122,19,1387762873,1387762873,1,11,0
83871406@N00,10122,7,1387800508,1387800508,1,11,0
83871406@N00,10122,4,1387795300,1387795300,1,11,0
83871406@N00,10122,26,1387758148,1387804389,4,11,46241
83871406@N00,10122,28,1387804638,1387804638,1,11,0
83871406@N00,10122,25,1387782693,1387801854,2,11,19161
83871406@N00,10122,24,1387789519,1387790847,3,11,1328
83871406@N00,10122,29,1387756661,1387767685,2,11,11024
83871406@N00,10122,21,1387776947,1387776947,1,11,0
83871406@N00,10122,18,1387766389,1387766389,1,11,0
83894580@N06,10123,26,1440544713,1440544713,1,2,0
83894580@N06,10123,13,1440555661,1440555661,1,2,0
83894580@N06,10124,28,1440760225,1440760225,1,1,0
83894580@N06,10125,13,1440900601,1440900601,1,1,0
8392824@N04,10126,29,1250506980,1250506980,1,1,0
83950218@N03,10127,26,1366415711,1366415711,1,4,0
83950218@N03,10127,5,1366418934,1366418934,1,4,0
83950218@N03,10127,7,1366418822,1366418822,1,4,0
83950218@N03,10127,25,1366419951,1366419951,1,4,0
83950218@N03,10128,26,1366456377,1366458369,23,1,1992
83959210@N02,10129,22,1430613685,1430616875,2,3,3190
83959210@N02,10129,30,1430618466,1430618466,1,3,0
83959210@N02,10129,14,1430614409,1430614603,3,3,194
83959210@N02,10130,24,1430876031,1430876031,1,1,0
83959210@N02,10131,26,1430960861,1430981513,3,1,20652
83959210@N02,10132,28,1431044627,1431044627,1,4,0
83959210@N02,10132,18,1431049773,1431049773,1,4,0
83959210@N02,10132,1,1431043874,1431073683,3,4,29809
83959210@N02,10132,16,1431048126,1431048126,1,4,0
83959210@N02,10133,16,1456876405,1456876405,1,1,0
83959210@N02,10134,8,1457051373,1457051373,1,2,0
83959210@N02,10134,21,1457048127,1457048127,1,2,0
8398190@N02,10135,16,1203138716,1203138716,1,2,0
8398190@N02,10135,19,1203116415,1203116415,1,2,0
8398190@N02,10136,24,1270961324,1270961324,1,2,0
8398190@N02,10136,13,1270964679,1270964679,1,2,0
8398190@N02,10137,24,1271054748,1271054748,1,2,0
8398190@N02,10137,13,1271054894,1271054894,1,2,0
8398190@N02,10138,16,1272898954,1272898954,1,1,0
8398190@N02,10139,13,1274114475,1274114475,1,1,0
8398190@N02,10140,28,1287926742,1287926742,1,3,0
8398190@N02,10140,27,1287920240,1287920240,1,3,0
8398190@N02,10140,17,1287924767,1287924767,1,3,0
84013956@N00,10141,23,1212242400,1212242400,1,1,0
8402359@N03,10142,13,1285633083,1285633083,1,1,0
8404411@N05,10143,31,1189308744,1189312389,37,3,3645
8404411@N05,10143,23,1189313979,1189313979,1,3,0
8404411@N05,10143,16,1189314931,1189339540,2,3,24609
84057311@N04,10144,21,1432516120,1432516120,1,2,0
84057311@N04,10144,3,1432516565,1432516565,1,2,0
84057311@N04,10145,3,1432636648,1432636648,1,2,0
84057311@N04,10145,28,1432653916,1432653916,1,2,0
84057763@N00,10146,17,1357348301,1357348301,1,1,0
84057763@N00,10147,21,1357446245,1357446245,1,1,0
84057763@N00,10148,28,1368512433,1368513464,2,1,1031
84057763@N00,10149,17,1382331005,1382331005,1,1,0
84057763@N00,10150,29,1386045516,1386045516,1,3,0
84057763@N00,10150,28,1386059826,1386059826,1,3,0
84057763@N00,10150,1,1386050164,1386050164,1,3,0
84059696@N00,10151,26,1188581879,1188610385,93,1,28506
84096356@N03,10152,30,1342265701,1342265701,1,1,0
84110444@N05,10153,28,1425974858,1425974858,1,1,0
84116656@N00,10154,23,1203311251,1203311251,1,1,0
84116656@N00,10155,20,1249529802,1249553347,8,1,23545
84116656@N00,10156,23,1306297178,1306298842,11,1,1664
84116656@N00,10157,20,1327369192,1327397061,53,2,27869
84116656@N00,10157,23,1327370870,1327370953,5,2,83
84116656@N00,10158,4,1328428781,1328429527,4,8,746
84116656@N00,10158,5,1328429413,1328430887,22,8,1474
84116656@N00,10158,9,1328431049,1328431066,2,8,17
84116656@N00,10158,7,1328429396,1328429402,2,8,6
84116656@N00,10158,20,1328424422,1328442576,40,8,18154
84116656@N00,10158,23,1328423595,1328439051,70,8,15456
84116656@N00,10158,29,1328424550,1328424550,1,8,0
84116656@N00,10158,3,1328427206,1328428769,21,8,1563
84116656@N00,10159,28,1347254359,1347254359,1,3,0
84116656@N00,10159,18,1347254836,1347254836,1,3,0
84116656@N00,10159,15,1347260289,1347260289,1,3,0
84116656@N00,10160,20,1352872031,1352872031,1,1,0
84116656@N00,10161,28,1358909734,1358909734,1,1,0
84200004@N02,10162,26,1377883262,1377883262,1,1,0
84213819@N00,10163,10,1280829358,1280829387,2,1,29
8423871@N06,10164,29,1397710397,1397710397,1,1,0
84266989@N04,10165,22,1374050347,1374050353,2,4,6
84266989@N04,10165,6,1374050375,1374050379,2,4,4
84266989@N04,10165,30,1374046415,1374050332,5,4,3917
84266989@N04,10165,28,1374050329,1374050365,2,4,36
8426916@N04,10166,4,1314710007,1314710007,1,1,0
8426916@N04,10167,30,1334318988,1334318988,1,1,0
84269601@N00,10168,26,1196957622,1196957622,1,1,0
84269601@N00,10169,17,1206980749,1206980749,1,1,0
84269601@N00,10170,25,1211229557,1211229557,1,1,0
84269601@N00,10171,1,1211653730,1211653730,1,1,0
84269601@N00,10172,1,1212051916,1212051916,1,1,0
84269601@N00,10173,29,1226597764,1226597764,1,1,0
84269601@N00,10174,26,1277172780,1277172780,1,1,0
84304983@N08,10175,29,1306034846,1306034902,2,4,56
84304983@N08,10175,30,1306037237,1306037237,1,4,0
84304983@N08,10175,31,1306035936,1306036478,3,4,542
84304983@N08,10175,7,1306024281,1306024299,2,4,18
84304983@N08,10176,26,1353404652,1353404652,1,1,0
84322304@N07,10177,21,1421131037,1421131037,1,1,0
84345058@N00,10178,18,1437919589,1437919589,1,1,0
8437808@N05,10179,18,1231546120,1231546120,1,2,0
8437808@N05,10179,10,1231556509,1231556509,1,2,0
8440951@N06,10180,16,1373558689,1373558689,1,1,0
8440951@N06,10181,25,1387022145,1387022145,1,1,0
8446863@N03,10182,28,1230423582,1230423582,1,1,0
8446863@N03,10183,26,1230634910,1230635009,2,1,99
84481364@N05,10184,29,1362193383,1362201434,9,1,8051
84496208@N00,10185,26,1190944974,1190944974,1,1,0
84496208@N00,10186,26,1191023613,1191035751,82,1,12138
84496208@N00,10187,26,1191661271,1191661271,1,1,0
84496208@N00,10188,26,1193429372,1193429453,9,1,81
84496208@N00,10189,26,1194566707,1194566707,1,1,0
84496208@N00,10190,26,1194652765,1194652765,2,1,0
84496208@N00,10191,26,1196711498,1196711498,1,1,0
84496208@N00,10192,26,1198195371,1198195371,1,1,0
84496208@N00,10193,26,1199402377,1199403030,7,1,653
84496208@N00,10194,26,1199751878,1199756551,24,1,4673
84496208@N00,10195,26,1201905582,1201933240,58,1,27658
84496208@N00,10196,26,1202598513,1202605013,37,1,6500
84496208@N00,10197,26,1204106028,1204107658,28,1,1630
84496208@N00,10198,26,1205048517,1205048517,1,1,0
84496208@N00,10199,29,1205639860,1205643586,2,2,3726
84496208@N00,10199,26,1205618886,1205656823,119,2,37937
84496208@N00,10200,29,1205964463,1205964565,2,1,102
84496208@N00,10201,29,1208480203,1208480312,2,1,109
84496208@N00,10202,29,1208728601,1208770468,81,1,41867
84496208@N00,10203,29,1208823328,1208873560,7,1,50232
84496208@N00,10204,26,1210948513,1210948513,1,1,0
84496208@N00,10205,26,1211061262,1211061262,1,1,0
84496208@N00,10206,26,1220211144,1220211144,1,1,0
84531937@N00,10207,15,1264815092,1264815092,1,1,0
8458618@N05,10208,20,1241757885,1241764341,18,5,6456
8458618@N05,10208,17,1241767955,1241768027,6,5,72
8458618@N05,10208,26,1241767419,1241767419,1,5,0
8458618@N05,10208,30,1241758949,1241758991,5,5,42
8458618@N05,10208,25,1241780497,1241780567,5,5,70
84598981@N00,10209,30,1288926103,1288926103,1,1,0
84601962@N00,10210,1,1388190657,1388190657,1,1,0
84601962@N00,10211,26,1396053455,1396053455,1,1,0
84601962@N00,10212,26,1401499785,1401499785,1,1,0
84601962@N00,10213,27,1420167753,1420168307,4,1,554
84601962@N00,10214,19,1420255409,1420255557,3,8,148
84601962@N00,10214,17,1420260061,1420260061,1,8,0
84601962@N00,10214,16,1420274902,1420274921,2,8,19
84601962@N00,10214,28,1420240375,1420243607,2,8,3232
84601962@N00,10214,30,1420242834,1420242834,1,8,0
84601962@N00,10214,18,1420242960,1420242961,3,8,1
84601962@N00,10214,26,1420274771,1420274771,1,8,0
84601962@N00,10214,27,1420260056,1420260057,2,8,1
84601962@N00,10215,13,1452917903,1452917912,2,12,9
84601962@N00,10215,19,1452920594,1452920594,1,12,0
84601962@N00,10215,24,1452905317,1452905317,1,12,0
84601962@N00,10215,4,1452905316,1452905316,1,12,0
84601962@N00,10215,16,1452907312,1452909993,5,12,2681
84601962@N00,10215,28,1452924634,1452924691,4,12,57
84601962@N00,10215,30,1452910008,1452910008,1,12,0
84601962@N00,10215,11,1452917600,1452917600,1,12,0
84601962@N00,10215,15,1452904975,1452904975,1,12,0
84601962@N00,10215,25,1452894545,1452915269,7,12,20724
84601962@N00,10215,27,1452900272,1452908704,14,12,8432
84601962@N00,10215,12,1452913607,1452913607,1,12,0
84652765@N00,10216,16,1419033555,1419038478,4,6,4923
84652765@N00,10216,3,1419034673,1419067079,5,6,32406
84652765@N00,10216,12,1419067094,1419067103,4,6,9
84652765@N00,10216,26,1419075321,1419075321,1,6,0
84652765@N00,10216,6,1419067816,1419067842,5,6,26
84652765@N00,10216,27,1419037335,1419042108,2,6,4773
84658322@N02,10217,17,1449898430,1449898430,1,1,0
84738389@N00,10218,28,1375964355,1375964968,2,1,613
84765974@N00,10219,19,1404453105,1404453105,1,1,0
84765974@N00,10220,15,1404623492,1404623492,1,1,0
84765974@N00,10221,7,1409375697,1409375697,1,1,0
84765974@N00,10222,16,1409469362,1409469362,1,1,0
84765974@N00,10223,18,1442236757,1442236757,1,1,0
84765974@N00,10224,18,1455867036,1455867036,1,1,0
84768005@N00,10225,26,1278506259,1278506259,1,1,0
8480533@N07,10226,18,1425885178,1425885178,1,1,0
84807303@N08,10227,16,1369671497,1369671497,1,1,0
8493453@N08,10228,29,1356123172,1356123172,1,1,0
84951093@N00,10229,26,1248696440,1248696440,1,1,0
84951093@N00,10230,16,1249348306,1249348306,1,1,0
8497732@N03,10231,27,1306574835,1306575154,3,1,319
84984744@N00,10232,26,1240623023,1240623023,1,1,0
8502118@N08,10233,26,1375866955,1375875918,88,7,8963
8502118@N08,10233,1,1375881917,1375881917,1,7,0
8502118@N08,10233,16,1375879157,1375879157,1,7,0
8502118@N08,10233,19,1375865672,1375865950,6,7,278
8502118@N08,10233,18,1375863516,1375865290,22,7,1774
8502118@N08,10233,11,1375868235,1375868235,1,7,0
8502118@N08,10233,27,1375877210,1375877504,2,7,294
8502118@N08,10234,17,1376211803,1376211803,1,12,0
8502118@N08,10234,26,1376220663,1376221467,103,12,804
8502118@N08,10234,25,1376214186,1376215160,38,12,974
8502118@N08,10234,6,1376217341,1376217341,1,12,0
8502118@N08,10234,1,1376211264,1376211264,1,12,0
8502118@N08,10234,28,1376211470,1376225774,5,12,14304
8502118@N08,10234,23,1376225305,1376225460,10,12,155
8502118@N08,10234,30,1376225516,1376225516,1,12,0
8502118@N08,10234,16,1376221050,1376221443,48,12,393
8502118@N08,10234,19,1376222897,1376222969,2,12,72
8502118@N08,10234,27,1376212458,1376212458,1,12,0
8502118@N08,10234,29,1376223635,1376225027,19,12,1392
8502118@N08,10235,28,1439638698,1439640108,87,1,1410
8514057@N08,10236,22,1252025166,1252025166,1,12,0
8514057@N08,10236,18,1252043375,1252043375,1,12,0
8514057@N08,10236,16,1252019908,1252020339,2,12,431
8514057@N08,10236,31,1252025392,1252025399,2,12,7
8514057@N08,10236,13,1252039014,1252039014,1,12,0
8514057@N08,10236,26,1252019877,1252064295,24,12,44418
8514057@N08,10236,12,1252021287,1252021287,1,12,0
8514057@N08,10236,10,1252025408,1252026251,10,12,843
8514057@N08,10236,15,1252020156,1252020321,2,12,165
8514057@N08,10236,25,1252021468,1252053083,2,12,31615
8514057@N08,10236,30,1252024074,1252024902,9,12,828
8514057@N08,10236,28,1252022146,1252026496,2,12,4350
85169502@N00,10237,26,1235713458,1235717155,2,1,3697
85218196@N00,10238,28,1197822383,1197860448,22,1,38065
85218196@N00,10239,28,1197927588,1197936952,11,1,9364
85218196@N00,10240,28,1198078547,1198083595,7,1,5048
85218196@N00,10241,26,1305686813,1305686813,1,1,0
85218196@N00,10242,3,1305944306,1305944306,1,1,0
85218196@N00,10243,27,1362030072,1362030072,1,1,0
85218196@N00,10244,17,1362130677,1362130677,1,1,0
85218196@N00,10245,26,1362444643,1362444643,1,2,0
85218196@N00,10245,12,1362438182,1362438182,1,2,0
85256056@N00,10246,13,1264864335,1264864335,1,1,0
85318305@N00,10247,13,1291955764,1291955820,2,4,56
85318305@N00,10247,1,1291940708,1291940714,2,4,6
85318305@N00,10247,28,1291941067,1291958900,2,4,17833
85318305@N00,10247,26,1291958260,1291958268,2,4,8
85416212@N02,10248,18,1454569416,1454569416,1,1,0
85428086@N00,10249,24,1237601652,1237602013,4,13,361
85428086@N00,10249,1,1237589649,1237612023,7,13,22374
85428086@N00,10249,3,1237628376,1237628376,1,13,0
85428086@N00,10249,30,1237616929,1237616984,5,13,55
85428086@N00,10249,11,1237596474,1237597812,3,13,1338
85428086@N00,10249,4,1237597906,1237597906,1,13,0
85428086@N00,10249,28,1237591847,1237594541,3,13,2694
85428086@N00,10249,21,1237597370,1237598060,10,13,690
85428086@N00,10249,22,1237620285,1237620367,5,13,82
85428086@N00,10249,26,1237595289,1237595291,3,13,2
85428086@N00,10249,29,1237592642,1237618981,2,13,26339
85428086@N00,10249,12,1237598209,1237598209,1,13,0
85428086@N00,10249,10,1237596209,1237596209,1,13,0
85428086@N00,10250,25,1237686495,1237687053,5,3,558
85428086@N00,10250,13,1237688433,1237691643,14,3,3210
85428086@N00,10250,30,1237685173,1237685173,1,3,0
85583013@N04,10251,31,1386571743,1386571743,1,10,0
85583013@N04,10251,24,1386553662,1386553662,1,10,0
85583013@N04,10251,23,1386569101,1386569101,1,10,0
85583013@N04,10251,4,1386560890,1386560890,1,10,0
85583013@N04,10251,26,1386540991,1386581908,5,10,40917
85583013@N04,10251,25,1386541984,1386541984,1,10,0
85583013@N04,10251,11,1386571765,1386571765,1,10,0
85583013@N04,10251,12,1386553909,1386553909,1,10,0
85583013@N04,10251,18,1386569116,1386569698,2,10,582
85583013@N04,10251,13,1386542026,1386565216,2,10,23190
85583013@N04,10252,28,1386755705,1386755708,3,8,3
85583013@N04,10252,22,1386753063,1386753063,1,8,0
85583013@N04,10252,16,1386744371,1386751097,30,8,6726
85583013@N04,10252,23,1386723641,1386723641,1,8,0
85583013@N04,10252,29,1386726279,1386752896,4,8,26617
85583013@N04,10252,26,1386746347,1386746348,2,8,1
85583013@N04,10252,19,1386753606,1386753606,1,8,0
85583013@N04,10252,20,1386752136,1386752978,2,8,842
85583013@N04,10253,3,1386807414,1386807414,1,9,0
85583013@N04,10253,31,1386819257,1386819257,1,9,0
85583013@N04,10253,15,1386806653,1386806653,1,9,0
85583013@N04,10253,24,1386806498,1386806524,2,9,26
85583013@N04,10253,30,1386809495,1386809505,2,9,10
85583013@N04,10253,16,1386796847,1386798220,4,9,1373
85583013@N04,10253,26,1386818148,1386818148,1,9,0
85583013@N04,10253,11,1386796751,1386800581,3,9,3830
85583013@N04,10253,27,1386796778,1386798077,9,9,1299
85583013@N04,10254,16,1394533507,1394533507,1,2,0
85583013@N04,10254,26,1394533511,1394533511,1,2,0
8565602@N03,10255,24,1194252250,1194252437,3,7,187
8565602@N03,10255,16,1194252676,1194252676,1,7,0
8565602@N03,10255,13,1194237402,1194237573,4,7,171
8565602@N03,10255,15,1194254082,1194254082,1,7,0
8565602@N03,10255,17,1194257362,1194257379,2,7,17
8565602@N03,10255,29,1194235998,1194236734,12,7,736
8565602@N03,10255,1,1194235701,1194235894,8,7,193
8565602@N03,10256,10,1194316201,1194332243,19,5,16042
8565602@N03,10256,21,1194314944,1194314975,4,5,31
8565602@N03,10256,19,1194317548,1194319055,2,5,1507
8565602@N03,10256,12,1194343980,1194345875,5,5,1895
8565602@N03,10256,30,1194316625,1194316625,1,5,0
8565602@N03,10257,22,1194424859,1194424859,1,8,0
8565602@N03,10257,24,1194429697,1194429737,2,8,40
8565602@N03,10257,27,1194426217,1194426217,1,8,0
8565602@N03,10257,23,1194404300,1194423873,5,8,19573
8565602@N03,10257,18,1194404102,1194404102,1,8,0
8565602@N03,10257,16,1194426204,1194426204,1,8,0
8565602@N03,10257,30,1194423176,1194423961,5,8,785
8565602@N03,10257,1,1194433045,1194433045,1,8,0
85665489@N00,10258,17,1364421918,1364464172,4,5,42254
85665489@N00,10258,28,1364419182,1364446683,4,5,27501
85665489@N00,10258,22,1364459373,1364459373,1,5,0
85665489@N00,10258,29,1364432919,1364432933,2,5,14
85665489@N00,10258,1,1364417809,1364417809,1,5,0
85665489@N00,10259,5,1408779637,1408779637,1,1,0
85669531@N00,10260,26,1375678492,1375678591,3,2,99
85669531@N00,10260,18,1375678643,1375678643,1,2,0
85669531@N00,10261,13,1375709683,1375709683,1,1,0
85720390@N03,10262,28,1236219079,1236219079,1,1,0
85793123@N00,10263,8,1317459258,1317459258,1,1,0
85793123@N00,10264,26,1330232775,1330232775,1,1,0
85793123@N00,10265,9,1330464451,1330464451,1,2,0
85793123@N00,10265,4,1330463481,1330463998,2,2,517
85793123@N00,10266,28,1357453851,1357463825,7,1,9974
85793123@N00,10267,28,1369370402,1369370402,1,1,0
85793123@N00,10268,1,1374985805,1375004332,5,1,18527
85824217@N00,10269,10,1200714087,1200741847,6,1,27760
85824217@N00,10270,10,1201236749,1201237507,38,1,758
85864407@N08,10271,28,1347153877,1347206323,8,20,52446
85864407@N08,10271,27,1347200315,1347200315,1,20,0
85864407@N08,10271,14,1347164930,1347164932,2,20,2
85864407@N08,10271,1,1347180964,1347206558,4,20,25594
85864407@N08,10271,17,1347178073,1347178073,1,20,0
85864407@N08,10271,6,1347204234,1347204311,2,20,77
85864407@N08,10271,26,1347169533,1347204760,3,20,35227
85864407@N08,10271,24,1347174891,1347176459,2,20,1568
85864407@N08,10271,10,1347194171,1347194171,1,20,0
85864407@N08,10271,25,1347202358,1347202358,1,20,0
85864407@N08,10271,5,1347171905,1347204168,3,20,32263
85864407@N08,10271,22,1347192690,1347192956,2,20,266
85864407@N08,10271,3,1347203748,1347203977,2,20,229
85864407@N08,10271,30,1347166502,1347166502,1,20,0
85864407@N08,10271,29,1347160982,1347161469,3,20,487
85864407@N08,10271,12,1347172227,1347200070,2,20,27843
85864407@N08,10271,13,1347203520,1347203520,1,20,0
85864407@N08,10271,23,1347191234,1347191234,1,20,0
85864407@N08,10271,16,1347199882,1347199882,1,20,0
85864407@N08,10271,18,1347154850,1347154850,1,20,0
85864407@N08,10272,1,1347283343,1347283343,1,7,0
85864407@N08,10272,11,1347255680,1347255680,1,7,0
85864407@N08,10272,6,1347251720,1347251847,2,7,127
85864407@N08,10272,26,1347275902,1347276721,11,7,819
85864407@N08,10272,3,1347279295,1347279295,1,7,0
85864407@N08,10272,24,1347246632,1347248678,2,7,2046
85864407@N08,10272,13,1347277082,1347278872,8,7,1790
85864407@N08,10273,8,1349084503,1349084503,1,2,0
85864407@N08,10273,5,1349084618,1349084618,1,2,0
85864407@N08,10274,3,1356774568,1356774568,1,1,0
85864407@N08,10275,26,1361358599,1361358599,1,1,0
85882671@N00,10276,30,1257559374,1257559374,1,4,0
85882671@N00,10276,24,1257582020,1257582020,1,4,0
85882671@N00,10276,26,1257558442,1257558554,2,4,112
85882671@N00,10276,14,1257562047,1257563039,3,4,992
85882671@N00,10277,20,1257656871,1257658070,17,13,1199
85882671@N00,10277,13,1257664481,1257665659,3,13,1178
85882671@N00,10277,1,1257645310,1257645310,1,13,0
85882671@N00,10277,30,1257660880,1257661520,7,13,640
85882671@N00,10277,31,1257661592,1257661635,4,13,43
85882671@N00,10277,29,1257653070,1257678886,5,13,25816
85882671@N00,10277,24,1257648989,1257650516,6,13,1527
85882671@N00,10277,16,1257647725,1257647725,1,13,0
85882671@N00,10277,7,1257662037,1257662293,2,13,256
85882671@N00,10277,11,1257651816,1257651816,1,13,0
85882671@N00,10277,28,1257645758,1257646269,5,13,511
85882671@N00,10277,3,1257663787,1257663791,2,13,4
85882671@N00,10277,23,1257652422,1257652937,4,13,515
85882671@N00,10278,3,1258159933,1258159933,1,1,0
8589880@N03,10279,26,1385543961,1385543961,1,1,0
85903600@N00,10280,18,1392682819,1392682819,1,2,0
85903600@N00,10280,1,1392711141,1392711141,1,2,0
85977134@N00,10281,28,1293831673,1293871736,5,1,40063
85977134@N00,10282,26,1302308649,1302343231,5,1,34582
85977134@N00,10283,25,1309477918,1309477918,1,5,0
85977134@N00,10283,26,1309493255,1309493255,1,5,0
85977134@N00,10283,17,1309474124,1309474124,1,5,0
85977134@N00,10283,12,1309475688,1309475688,1,5,0
85977134@N00,10283,29,1309505150,1309505150,1,5,0
85977134@N00,10284,13,1325374201,1325375047,2,5,846
85977134@N00,10284,7,1325396578,1325396578,1,5,0
85977134@N00,10284,12,1325380904,1325380904,1,5,0
85977134@N00,10284,5,1325380096,1325380096,1,5,0
85977134@N00,10284,26,1325398551,1325398551,1,5,0
85977134@N00,10285,28,1341022837,1341022837,1,1,0
85977134@N00,10286,28,1350084353,1350084353,1,1,0
85977134@N00,10287,12,1385771091,1385771091,1,1,0
85977134@N00,10288,12,1388535110,1388535110,1,1,0
85977134@N00,10289,3,1396051079,1396051079,1,1,0
85977134@N00,10290,3,1404259962,1404259962,1,1,0
85977134@N00,10291,19,1420067353,1420067353,1,1,0
85979850@N00,10292,17,1302953849,1302953849,1,1,0
8601478@N02,10293,25,1311640641,1311640641,1,1,0
86063712@N00,10294,29,1274058887,1274061840,2,3,2953
86063712@N00,10294,1,1274054838,1274054838,1,3,0
86063712@N00,10294,27,1274071818,1274071980,2,3,162
86063712@N00,10295,22,1274165766,1274165766,1,1,0
86063712@N00,10296,13,1274230253,1274230253,1,1,0
86078640@N00,10297,30,1285978002,1285988326,4,1,10324
86078640@N00,10298,30,1286063936,1286070112,3,1,6176
86078640@N00,10299,30,1286180904,1286183557,3,1,2653
86078640@N00,10300,30,1286267259,1286267300,3,1,41
86111910@N03,10301,28,1309938133,1309938133,1,1,0
86111910@N03,10302,25,1384584937,1384584937,1,1,0
86215268@N02,10303,29,1351155889,1351155889,1,1,0
86249551@N00,10304,17,1371868848,1371868848,1,2,0
86249551@N00,10304,26,1371866036,1371866036,1,2,0
86278660@N00,10305,28,1351320962,1351324741,5,4,3779
86278660@N00,10305,26,1351318284,1351319536,7,4,1252
86278660@N00,10305,1,1351317785,1351317801,2,4,16
86278660@N00,10305,17,1351308686,1351308686,1,4,0
86333958@N00,10306,30,1287831850,1287831850,1,2,0
86333958@N00,10306,26,1287831796,1287831824,3,2,28
86333958@N00,10307,18,1288513330,1288513924,11,2,594
86333958@N00,10307,31,1288512476,1288512487,2,2,11
86333958@N00,10308,1,1289630559,1289630582,4,3,23
86333958@N00,10308,28,1289644091,1289644116,4,3,25
86333958@N00,10308,26,1289639808,1289643353,17,3,3545
86333958@N00,10309,25,1290672968,1290673528,2,2,560
86333958@N00,10309,26,1290672468,1290672468,1,2,0
86333958@N00,10310,1,1291518726,1291518744,3,2,18
86333958@N00,10310,30,1291521654,1291521663,2,2,9
86333958@N00,10311,28,1292648959,1292652128,6,1,3169
86333958@N00,10312,30,1303898285,1303898285,1,1,0
86333958@N00,10313,27,1335180657,1335180657,1,2,0
86333958@N00,10313,23,1335192501,1335192644,2,2,143
86333958@N00,10314,29,1337714831,1337714831,1,1,0
86333958@N00,10315,1,1355328592,1355328592,1,1,0
86342787@N00,10316,28,1216950792,1216950792,1,1,0
86363911@N00,10317,16,1293725839,1293725839,1,1,0
86383576@N00,10318,26,1401007829,1401077816,91,3,69987
86383576@N00,10318,21,1401007990,1401008331,8,3,341
86383576@N00,10318,28,1400999477,1401012332,5,3,12855
86387045@N04,10319,14,1351829457,1351829564,2,1,107
86387045@N04,10320,28,1354614546,1354616720,2,1,2174
86392872@N00,10321,3,1207241786,1207241796,2,2,10
86392872@N00,10321,24,1207244833,1207244986,4,2,153
86392872@N00,10322,28,1207273925,1207274541,3,3,616
86392872@N00,10322,3,1207285011,1207285192,2,3,181
86392872@N00,10322,30,1207283450,1207283450,1,3,0
86392872@N00,10323,22,1207355803,1207355803,1,2,0
86392872@N00,10323,17,1207356037,1207356037,1,2,0
86420008@N02,10324,19,1403860696,1403860696,1,1,0
86446605@N00,10325,15,1386204845,1386206614,3,2,1769
86446605@N00,10325,8,1386204760,1386204760,1,2,0
8645545@N02,10326,6,1240532242,1240532242,1,8,0
8645545@N02,10326,26,1240531363,1240532038,11,8,675
8645545@N02,10326,9,1240532635,1240532635,1,8,0
8645545@N02,10326,21,1240534459,1240534459,1,8,0
8645545@N02,10326,13,1240535464,1240540205,22,8,4741
8645545@N02,10326,31,1240528860,1240528860,1,8,0
8645545@N02,10326,14,1240529346,1240529747,2,8,401
8645545@N02,10326,28,1240527973,1240527973,1,8,0
86456516@N00,10327,16,1234328098,1234328098,1,1,0
86459399@N00,10328,15,1286682730,1286682730,1,1,0
86459399@N00,10329,25,1286712953,1286713002,2,3,49
86459399@N00,10329,21,1286711763,1286711763,1,3,0
86459399@N00,10329,26,1286714920,1286714920,1,3,0
86459399@N00,10330,28,1286765210,1286765800,3,5,590
86459399@N00,10330,26,1286791140,1286796879,2,5,5739
86459399@N00,10330,5,1286766995,1286779516,8,5,12521
86459399@N00,10330,16,1286780465,1286783788,2,5,3323
86459399@N00,10330,1,1286762262,1286762262,1,5,0
86459399@N00,10331,31,1339380009,1339380009,1,1,0
86459399@N00,10332,24,1339498934,1339502286,3,3,3352
86459399@N00,10332,7,1339476351,1339476351,1,3,0
86459399@N00,10332,4,1339478216,1339478216,1,3,0
86459399@N00,10333,14,1339558958,1339558958,1,1,0
86476099@N00,10334,16,1396642227,1396642227,1,1,0
86542064@N00,10335,1,1361531648,1361531648,1,1,0
8657240@N02,10336,30,1313211156,1313211158,2,2,2
8657240@N02,10336,7,1313210027,1313210034,2,2,7
86587932@N00,10337,17,1413452110,1413452110,1,2,0
86587932@N00,10337,13,1413458565,1413459575,2,2,1010
8658893@N04,10338,29,1383981117,1383981117,1,1,0
86604283@N00,10339,26,1225597516,1225597516,1,14,0
86604283@N00,10339,16,1225604378,1225604378,1,14,0
86604283@N00,10339,28,1225580047,1225629577,10,14,49530
86604283@N00,10339,30,1225585171,1225596718,13,14,11547
86604283@N00,10339,17,1225603462,1225603462,1,14,0
86604283@N00,10339,20,1225581843,1225581872,4,14,29
86604283@N00,10339,1,1225579827,1225604705,3,14,24878
86604283@N00,10339,12,1225625378,1225625761,8,14,383
86604283@N00,10339,29,1225580638,1225621701,10,14,41063
86604283@N00,10339,23,1225618557,1225618594,2,14,37
86604283@N00,10339,27,1225599752,1225623563,3,14,23811
86604283@N00,10339,15,1225601284,1225601309,3,14,25
86604283@N00,10339,3,1225617219,1225617812,10,14,593
86604283@N00,10339,22,1225583511,1225585152,3,14,1641
86604283@N00,10340,1,1237008076,1237008076,1,8,0
86604283@N00,10340,16,1236995762,1236995762,1,8,0
86604283@N00,10340,12,1236998001,1236998001,1,8,0
86604283@N00,10340,28,1237007086,1237007086,1,8,0
86604283@N00,10340,25,1237002610,1237005489,27,8,2879
86604283@N00,10340,22,1236985924,1236985931,2,8,7
86604283@N00,10340,18,1236992996,1236993006,2,8,10
86604283@N00,10340,26,1237006565,1237006565,1,8,0
86618086@N02,10341,13,1312440533,1312441248,14,4,715
86618086@N02,10341,7,1312421797,1312421797,1,4,0
86618086@N02,10341,4,1312415258,1312417918,12,4,2660
86618086@N02,10341,16,1312428536,1312438890,4,4,10354
86672131@N04,10342,17,1433459205,1433460563,4,6,1358
86672131@N04,10342,31,1433474339,1433474339,1,6,0
86672131@N04,10342,20,1433461965,1433461965,1,6,0
86672131@N04,10342,27,1433460609,1433460631,2,6,22
86672131@N04,10342,23,1433482289,1433482289,1,6,0
86672131@N04,10342,30,1433461062,1433461062,1,6,0
86684445@N00,10343,1,1263857394,1263857394,1,2,0
86684445@N00,10343,28,1263857678,1263857678,1,2,0
86684445@N00,10344,22,1263948125,1263948125,1,3,0
86684445@N00,10344,12,1263950764,1263950764,1,3,0
86684445@N00,10344,24,1263950858,1263950858,1,3,0
86686519@N00,10345,26,1205705392,1205706082,5,1,690
86686519@N00,10346,26,1205795943,1205796235,6,1,292
86686519@N00,10347,26,1205825116,1205825273,4,1,157
8674970@N04,10348,8,1216635874,1216635874,1,1,0
8674970@N04,10349,10,1223171082,1223171082,1,1,0
8674970@N04,10350,11,1223773154,1223773154,1,1,0
8674970@N04,10351,28,1224982013,1224982013,1,1,0
8674970@N04,10352,6,1227834697,1227834697,1,1,0
8674970@N04,10353,26,1233371307,1233371307,1,1,0
8674970@N04,10354,7,1233447449,1233447449,1,2,0
8674970@N04,10354,28,1233456559,1233456559,1,2,0
8674970@N04,10355,28,1234244307,1234244307,1,1,0
8674970@N04,10356,5,1246059823,1246059823,1,1,0
8674970@N04,10357,26,1252819248,1252819248,1,2,0
8674970@N04,10357,8,1252807240,1252807240,1,2,0
8674970@N04,10358,26,1256430943,1256430943,1,2,0
8674970@N04,10358,28,1256430940,1256430940,1,2,0
8674970@N04,10359,7,1257989871,1257989871,1,2,0
8674970@N04,10359,8,1257989848,1257989848,1,2,0
8674970@N04,10360,26,1269642751,1269645375,2,2,2624
8674970@N04,10360,28,1269642768,1269642768,1,2,0
8674970@N04,10361,11,1276906202,1276906202,1,1,0
8674970@N04,10362,26,1281681884,1281681884,1,1,0
8674970@N04,10363,26,1284791485,1284791485,1,3,0
8674970@N04,10363,18,1284783739,1284783739,1,3,0
8674970@N04,10363,28,1284768707,1284768707,1,3,0
8674970@N04,10364,6,1287103119,1287103119,1,1,0
8674970@N04,10365,26,1289953055,1289953055,1,2,0
8674970@N04,10365,16,1289960905,1289960905,1,2,0
8674970@N04,10366,26,1295051609,1295051609,1,1,0
8674970@N04,10367,26,1296266585,1296267594,2,1,1009
8674970@N04,10368,26,1302047576,1302047576,1,1,0
8674970@N04,10369,26,1306119227,1306126459,3,1,7232
8674970@N04,10370,26,1326413475,1326426896,22,1,13421
8674970@N04,10371,26,1330739782,1330739782,1,1,0
8674970@N04,10372,26,1334447539,1334470886,56,1,23347
8674970@N04,10373,30,1358486550,1358486550,1,1,0
8674970@N04,10374,11,1384483103,1384483103,1,1,0
8674970@N04,10375,18,1399611969,1399611974,2,2,5
8674970@N04,10375,1,1399594060,1399594060,1,2,0
8674970@N04,10376,31,1410483530,1410483560,2,1,30
8674970@N04,10377,1,1422157263,1422161452,16,4,4189
8674970@N04,10377,28,1422167221,1422168128,4,4,907
8674970@N04,10377,12,1422150780,1422150780,1,4,0
8674970@N04,10377,26,1422155826,1422155826,1,4,0
8674970@N04,10378,26,1435197938,1435197938,1,1,0
8674970@N04,10379,26,1451781489,1451781489,1,1,0
8674970@N04,10380,26,1454032398,1454032398,1,1,0
86765221@N00,10381,30,1345785564,1345785564,1,1,0
8677608@N07,10382,28,1347108332,1347108332,1,1,0
8684356@N02,10383,28,1348197425,1348197425,1,1,0
86908163@N08,10384,26,1369889244,1369889244,1,1,0
8691238@N02,10385,26,1206489773,1206506470,71,1,16697
8692132@N05,10386,30,1316905303,1316946074,28,1,40771
8692132@N05,10387,30,1317625052,1317625052,1,1,0
86931317@N00,10388,12,1344048561,1344073757,2,1,25196
86931317@N00,10389,28,1350622773,1350647960,2,1,25187
87028943@N00,10390,18,1452841609,1452841609,1,1,0
87059281@N00,10391,26,1221574943,1221574943,1,1,0
87067940@N00,10392,29,1195608824,1195608855,2,5,31
87067940@N00,10392,24,1195602238,1195602238,1,5,0
87067940@N00,10392,26,1195627285,1195640728,2,5,13443
87067940@N00,10392,12,1195607207,1195607207,1,5,0
87067940@N00,10392,28,1195598637,1195626378,3,5,27741
87067940@N00,10393,28,1201070373,1201070373,1,1,0
87067940@N00,10394,23,1204426326,1204444053,2,4,17727
87067940@N00,10394,21,1204432612,1204432612,1,4,0
87067940@N00,10394,4,1204433632,1204433632,1,4,0
87067940@N00,10394,28,1204447375,1204447375,1,4,0
87067940@N00,10395,16,1204537201,1204537201,1,1,0
87067940@N00,10396,24,1254545934,1254546469,2,1,535
87076987@N05,10397,13,1352604308,1352604308,1,1,0
87076987@N05,10398,12,1352639164,1352639164,1,2,0
87076987@N05,10398,18,1352636397,1352636397,1,2,0
87076987@N05,10399,1,1352697326,1352697326,1,1,0
87076987@N05,10400,20,1352727623,1352728376,2,2,753
87076987@N05,10400,15,1352732078,1352732078,1,2,0
87107768@N00,10401,17,1289861213,1289861213,1,1,0
87107768@N00,10402,15,1363331582,1363331582,1,1,0
87112387@N00,10403,28,1402623471,1402672952,25,1,49481
87136546@N08,10404,10,1343172615,1343205869,10,1,33254
87136546@N08,10405,10,1391898368,1391925135,18,1,26767
8720599@N08,10406,17,1208328246,1208328246,1,6,0
8720599@N08,10406,18,1208326739,1208326739,1,6,0
8720599@N08,10406,12,1208326208,1208326208,1,6,0
8720599@N08,10406,28,1208320662,1208320662,1,6,0
8720599@N08,10406,11,1208334370,1208334370,1,6,0
8720599@N08,10406,29,1208321383,1208321383,1,6,0
87304876@N00,10407,13,1233450453,1233450453,1,9,0
87304876@N00,10407,7,1233446793,1233447045,2,9,252
87304876@N00,10407,1,1233444198,1233444322,2,9,124
87304876@N00,10407,24,1233453456,1233454016,2,9,560
87304876@N00,10407,28,1233444376,1233451209,3,9,6833
87304876@N00,10407,6,1233447766,1233447766,1,9,0
87304876@N00,10407,18,1233445176,1233445176,1,9,0
87304876@N00,10407,17,1233450823,1233450831,2,9,8
87304876@N00,10407,26,1233445352,1233445666,2,9,314
8733295@N08,10408,1,1366426015,1366426015,1,1,0
87337984@N06,10409,20,1346653921,1346653921,1,2,0
87337984@N06,10409,19,1346665966,1346666148,2,2,182
8735775@N04,10410,26,1301635345,1301635345,1,2,0
8735775@N04,10410,25,1301634776,1301634776,1,2,0
87358743@N00,10411,29,1356737852,1356747053,2,6,9201
87358743@N00,10411,20,1356745818,1356745818,1,6,0
87358743@N00,10411,27,1356756117,1356759483,7,6,3366
87358743@N00,10411,7,1356747285,1356747285,1,6,0
87358743@N00,10411,3,1356747332,1356747332,1,6,0
87358743@N00,10411,28,1356761057,1356761057,1,6,0
87358743@N00,10412,29,1366944631,1366974183,5,2,29552
87358743@N00,10412,18,1366964849,1366964849,1,2,0
87358743@N00,10413,20,1379931386,1379931386,1,3,0
87358743@N00,10413,17,1379927740,1379927740,1,3,0
87358743@N00,10413,28,1379917498,1379917498,1,3,0
87358743@N00,10414,1,1389599014,1389599014,1,4,0
87358743@N00,10414,25,1389605998,1389605998,1,4,0
87358743@N00,10414,16,1389595289,1389596510,2,4,1221
87358743@N00,10414,18,1389599421,1389599421,1,4,0
87358743@N00,10415,17,1390735661,1390735661,1,2,0
87358743@N00,10415,27,1390735484,1390735484,1,2,0
87358743@N00,10416,26,1392112750,1392112750,1,1,0
87358743@N00,10417,30,1393125317,1393134355,7,2,9038
87358743@N00,10417,24,1393141441,1393141441,1,2,0
87358743@N00,10418,29,1446802984,1446816552,6,1,13568
87411567@N08,10419,1,1408319230,1408319230,1,1,0
87411567@N08,10420,28,1412512727,1412512727,1,1,0
8741255@N04,10421,30,1257646353,1257648071,2,4,1718
8741255@N04,10421,16,1257652128,1257652128,1,4,0
8741255@N04,10421,26,1257652215,1257652215,1,4,0
8741255@N04,10421,14,1257646359,1257646359,1,4,0
87418912@N00,10422,26,1205325451,1205327141,3,1,1690
8743807@N07,10423,30,1197719441,1197719441,1,1,0
87447493@N00,10424,18,1423349704,1423349704,1,1,0
87478675@N00,10425,16,1362179788,1362179788,1,4,0
87478675@N00,10425,15,1362179875,1362179875,1,4,0
87478675@N00,10425,27,1362180250,1362180250,1,4,0
87478675@N00,10425,28,1362179981,1362179981,1,4,0
87505833@N08,10426,26,1407314447,1407314447,1,6,0
87505833@N08,10426,19,1407287293,1407291217,3,6,3924
87505833@N08,10426,23,1407294408,1407294408,1,6,0
87505833@N08,10426,18,1407293828,1407293828,1,6,0
87505833@N08,10426,29,1407301235,1407301283,2,6,48
87505833@N08,10426,13,1407316699,1407316699,1,6,0
87527417@N04,10427,1,1395486425,1395486425,1,1,0
87566499@N03,10428,26,1410668749,1410695818,11,1,27069
87604302@N07,10429,12,1348695764,1348695764,1,6,0
87604302@N07,10429,16,1348695780,1348695780,1,6,0
87604302@N07,10429,25,1348695761,1348695761,1,6,0
87604302@N07,10429,13,1348695769,1348695776,2,6,7
87604302@N07,10429,26,1348695772,1348695772,1,6,0
87604302@N07,10429,15,1348695762,1348695762,1,6,0
87612985@N04,10430,28,1348473103,1348473103,1,1,0
87621759@N05,10431,27,1387277438,1387277438,1,4,0
87621759@N05,10431,26,1387253721,1387253721,1,4,0
87621759@N05,10431,30,1387258944,1387258944,1,4,0
87621759@N05,10431,23,1387254490,1387254490,1,4,0
87639371@N00,10432,21,1306123389,1306123389,1,1,0
87639371@N00,10433,29,1306280959,1306280959,1,1,0
87639371@N00,10434,1,1438687209,1438694188,4,1,6979
87657273@N00,10435,22,1291861715,1291864081,24,10,2366
87657273@N00,10435,26,1291887948,1291888226,12,10,278
87657273@N00,10435,16,1291887014,1291887048,3,10,34
87657273@N00,10435,28,1291852569,1291889986,19,10,37417
87657273@N00,10435,17,1291886423,1291886423,1,10,0
87657273@N00,10435,18,1291853224,1291856563,40,10,3339
87657273@N00,10435,29,1291857231,1291859862,31,10,2631
87657273@N00,10435,13,1291875580,1291879158,4,10,3578
87657273@N00,10435,12,1291871143,1291873786,6,10,2643
87657273@N00,10435,23,1291852965,1291853180,10,10,215
87657273@N00,10436,16,1292454123,1292454123,1,1,0
87657273@N00,10437,22,1315217529,1315217529,1,1,0
8780153@N02,10438,26,1367810565,1367841018,100,1,30453
87839404@N00,10439,29,1459070321,1459070321,1,2,0
87839404@N00,10439,20,1459043355,1459043355,1,2,0
87839593@N07,10440,31,1313542618,1313542618,1,1,0
87854506@N04,10441,1,1351219320,1351219320,1,1,0
8786056@N07,10442,29,1394540184,1394540184,1,1,0
87889801@N00,10443,13,1198544321,1198544321,1,5,0
87889801@N00,10443,16,1198547140,1198547140,1,5,0
87889801@N00,10443,26,1198547266,1198547266,1,5,0
87889801@N00,10443,3,1198542538,1198542538,1,5,0
87889801@N00,10443,10,1198541060,1198541060,1,5,0
87895332@N08,10444,1,1358992777,1358992777,1,3,0
87895332@N08,10444,28,1358995972,1359009208,3,3,13236
87895332@N08,10444,26,1358995748,1359009429,2,3,13681
87895332@N08,10445,20,1359061891,1359061891,1,4,0
87895332@N08,10445,30,1359061148,1359061253,2,4,105
87895332@N08,10445,29,1359061412,1359061700,2,4,288
87895332@N08,10445,14,1359062093,1359074871,2,4,12778
87895332@N08,10446,18,1359106991,1359107436,3,2,445
87895332@N08,10446,29,1359106865,1359106865,1,2,0
87895332@N08,10447,26,1362300176,1362300176,1,1,0
87895332@N08,10448,13,1371720042,1371720042,1,2,0
87895332@N08,10448,28,1371730718,1371730718,1,2,0
87895332@N08,10449,28,1373801096,1373802634,2,1,1538
87895332@N08,10450,26,1390127517,1390132495,2,3,4978
87895332@N08,10450,18,1390131572,1390131703,2,3,131
87895332@N08,10450,25,1390131897,1390131897,1,3,0
87895332@N08,10451,13,1391949771,1391949771,1,2,0
87895332@N08,10451,28,1391932993,1391932993,1,2,0
87895332@N08,10452,19,1392016984,1392016984,1,1,0
87895332@N08,10453,1,1400796835,1400796835,1,1,0
87895332@N08,10454,29,1403171198,1403171198,1,1,0
87895332@N08,10455,19,1405650252,1405650252,1,1,0
87895332@N08,10456,19,1407653266,1407653266,1,1,0
87895332@N08,10457,27,1428396708,1428396708,1,1,0
87935891@N08,10458,8,1332762038,1332762038,1,3,0
87935891@N08,10458,10,1332762034,1332762034,1,3,0
87935891@N08,10458,26,1332762037,1332762037,1,3,0
87935891@N08,10459,23,1347155370,1347155370,1,1,0
87935891@N08,10460,18,1363089552,1363089552,1,1,0
87935891@N08,10461,26,1381819353,1381819353,1,2,0
87935891@N08,10461,29,1381834472,1381834472,1,2,0
87942779@N00,10462,20,1200562548,1200562548,1,1,0
87942779@N00,10463,28,1201945404,1201949894,2,5,4490
87942779@N00,10463,26,1201918248,1201918334,3,5,86
87942779@N00,10463,15,1201917693,1201917693,1,5,0
87942779@N00,10463,14,1201934102,1201949771,2,5,15669
87942779@N00,10463,27,1201912370,1201912411,3,5,41
87942779@N00,10464,16,1202119528,1202119528,1,1,0
87942779@N00,10465,26,1202604190,1202604658,3,3,468
87942779@N00,10465,29,1202604674,1202604674,1,3,0
87942779@N00,10465,18,1202603566,1202603566,1,3,0
87942779@N00,10466,22,1202904193,1202904193,1,1,0
87942779@N00,10467,28,1207571091,1207571091,1,1,0
87942779@N00,10468,28,1209638379,1209638379,1,1,0
87942779@N00,10469,17,1210852963,1210852963,1,1,0
87942779@N00,10470,15,1246776987,1246776987,1,1,0
87942779@N00,10471,26,1285329200,1285329213,3,1,13
87942779@N00,10472,23,1285393741,1285393748,2,1,7
87974483@N02,10473,10,1283727649,1283770355,280,1,42706
87974483@N02,10474,27,1378685253,1378715446,153,1,30193
88013957@N07,10475,28,1354889610,1354889610,1,1,0
8802344@N03,10476,29,1307073673,1307073673,1,6,0
8802344@N03,10476,28,1307055745,1307055745,1,6,0
8802344@N03,10476,1,1307056308,1307089849,6,6,33541
8802344@N03,10476,19,1307079335,1307079847,2,6,512
8802344@N03,10476,18,1307080616,1307080616,1,6,0
8802344@N03,10476,13,1307063283,1307063283,1,6,0
88042436@N02,10477,26,1400383485,1400383485,1,1,0
88073012@N00,10478,28,1277890581,1277890581,1,1,0
88073012@N00,10479,29,1301388349,1301388349,1,1,0
88073012@N00,10480,27,1305448425,1305448425,1,1,0
88074728@N02,10481,28,1349914014,1349914014,1,1,0
88074728@N02,10482,15,1349950447,1349950447,1,1,0
88074728@N02,10483,28,1349989755,1349989755,1,1,0
88074728@N02,10484,28,1350164694,1350164694,1,1,0
88074728@N02,10485,28,1350214289,1350214289,1,1,0
8807942@N05,10486,13,1290736881,1290736885,3,1,4
88129361@N05,10487,26,1465872237,1465874249,2,1,2012
88158593@N00,10488,15,1302606342,1302606342,1,6,0
88158593@N00,10488,21,1302621453,1302621453,1,6,0
88158593@N00,10488,27,1302596041,1302596041,1,6,0
88158593@N00,10488,28,1302593266,1302593476,2,6,210
88158593@N00,10488,22,1302603188,1302603188,1,6,0
88158593@N00,10488,18,1302611136,1302611136,1,6,0
88211437@N04,10489,3,1351991786,1351991809,2,1,23
88238443@N04,10490,15,1372494348,1372494348,1,1,0
88242284@N03,10491,18,1364353747,1364353747,1,7,0
88242284@N03,10491,1,1364339635,1364339635,1,7,0
88242284@N03,10491,21,1364365675,1364365725,4,7,50
88242284@N03,10491,12,1364365129,1364365129,1,7,0
88242284@N03,10491,16,1364356524,1364364814,8,7,8290
88242284@N03,10491,26,1364339910,1364339919,2,7,9
88242284@N03,10491,19,1364353571,1364353781,3,7,210
88242284@N03,10492,17,1395981843,1395981843,1,4,0
88242284@N03,10492,7,1395986560,1395986560,1,4,0
88242284@N03,10492,24,1395991830,1395991830,1,4,0
88242284@N03,10492,26,1395987547,1395987547,1,4,0
88242284@N03,10493,17,1457751229,1457751229,1,7,0
88242284@N03,10493,13,1457765531,1457765751,2,7,220
88242284@N03,10493,21,1457775269,1457775269,1,7,0
88242284@N03,10493,25,1457775846,1457777665,2,7,1819
88242284@N03,10493,16,1457761479,1457761479,1,7,0
88242284@N03,10493,5,1457739880,1457739880,1,7,0
88242284@N03,10493,4,1457746422,1457746422,1,7,0
88254333@N00,10494,28,1241084282,1241084282,1,3,0
88254333@N00,10494,6,1241083778,1241083778,1,3,0
88254333@N00,10494,31,1241078685,1241078685,1,3,0
88294868@N00,10495,27,1317727667,1317727667,1,2,0
88294868@N00,10495,1,1317720471,1317720471,1,2,0
88328627@N00,10496,18,1425371328,1425371328,1,1,0
8838280@N07,10497,6,1235780824,1235780824,1,4,0
8838280@N07,10497,25,1235789107,1235789107,1,4,0
8838280@N07,10497,21,1235789107,1235789107,1,4,0
8838280@N07,10497,29,1235801292,1235801292,1,4,0
88401211@N06,10498,1,1434085147,1434111404,35,1,26257
88411530@N00,10499,3,1204500142,1204500142,1,2,0
88411530@N00,10499,16,1204500148,1204500148,1,2,0
8848099@N03,10500,16,1356488182,1356488182,2,2,0
8848099@N03,10500,25,1356505399,1356505412,2,2,13
8848099@N03,10501,11,1364540274,1364540274,1,2,0
8848099@N03,10501,25,1364540089,1364540089,1,2,0
88494442@N00,10502,4,1410418164,1410418164,1,2,0
88494442@N00,10502,19,1410395631,1410395631,1,2,0
88494442@N00,10503,14,1410496120,1410496600,3,2,480
88494442@N00,10503,6,1410495814,1410495814,1,2,0
88494442@N00,10504,19,1410678331,1410678331,1,3,0
88494442@N00,10504,13,1410677546,1410677841,3,3,295
88494442@N00,10504,27,1410677472,1410677472,1,3,0
88494442@N00,10505,19,1410762882,1410762882,1,2,0
88494442@N00,10505,26,1410762548,1410762742,2,2,194
88511321@N00,10506,26,1377912648,1377912648,1,1,0
88533186@N07,10507,27,1369685193,1369685193,1,1,0
88537228@N00,10508,24,1216954699,1216954699,1,1,0
88537228@N00,10509,28,1216985359,1216985359,2,1,0
88537228@N00,10510,1,1300766938,1300766955,4,5,17
88537228@N00,10510,13,1300760340,1300760340,1,5,0
88537228@N00,10510,5,1300751958,1300751958,2,5,0
88537228@N00,10510,8,1300755518,1300755519,2,5,1
88537228@N00,10510,26,1300769505,1300788360,2,5,18855
88537228@N00,10511,1,1300926030,1300926045,3,4,15
88537228@N00,10511,4,1300931864,1300931864,1,4,0
88537228@N00,10511,19,1300927169,1300927180,3,4,11
88537228@N00,10511,30,1300929042,1300929235,7,4,193
88537228@N00,10512,5,1300966573,1300966573,1,2,0
88537228@N00,10512,26,1300966772,1300966772,1,2,0
88537228@N00,10513,24,1413855621,1413855621,1,2,0
88537228@N00,10513,14,1413865665,1413865665,1,2,0
8854023@N06,10514,26,1322192828,1322199969,4,12,7141
8854023@N06,10514,27,1322174429,1322174578,3,12,149
8854023@N06,10514,16,1322175535,1322204754,16,12,29219
8854023@N06,10514,28,1322226298,1322226367,2,12,69
8854023@N06,10514,25,1322191387,1322191387,1,12,0
8854023@N06,10514,6,1322182308,1322182308,1,12,0
8854023@N06,10514,5,1322205567,1322205567,1,12,0
8854023@N06,10514,21,1322189635,1322189635,1,12,0
8854023@N06,10514,11,1322187907,1322187924,4,12,17
8854023@N06,10514,1,1322173942,1322173942,1,12,0
8854023@N06,10514,29,1322207906,1322207906,1,12,0
8854023@N06,10514,13,1322195750,1322195750,1,12,0
88649709@N00,10515,30,1389504376,1389510588,25,1,6212
88664007@N06,10516,28,1355742137,1355742137,1,1,0
88664007@N06,10517,28,1355909332,1355909332,1,1,0
88664007@N06,10518,13,1463545578,1463545578,1,1,0
88711965@N00,10519,19,1407073804,1407073804,1,1,0
88719648@N00,10520,1,1393815436,1393815436,1,5,0
88719648@N00,10520,4,1393820825,1393822236,4,5,1411
88719648@N00,10520,19,1393815457,1393815457,1,5,0
88719648@N00,10520,16,1393841604,1393841604,1,5,0
88719648@N00,10520,13,1393836955,1393839539,7,5,2584
88719648@N00,10521,7,1393904674,1393904693,2,5,19
88719648@N00,10521,3,1393903678,1393903696,3,5,18
88719648@N00,10521,28,1393902453,1393932112,7,5,29659
88719648@N00,10521,21,1393905300,1393905300,1,5,0
88719648@N00,10521,5,1393905310,1393905314,2,5,4
88719648@N00,10522,7,1394076873,1394076901,3,4,28
88719648@N00,10522,1,1394074640,1394074924,4,4,284
88719648@N00,10522,6,1394076557,1394076574,4,4,17
88719648@N00,10522,5,1394077665,1394077686,4,4,21
88719648@N00,10523,1,1394112405,1394112405,1,2,0
88719648@N00,10523,16,1394111891,1394111970,6,2,79
88773568@N00,10524,17,1200172498,1200172498,1,2,0
88773568@N00,10524,24,1200186098,1200186098,1,2,0
88773568@N00,10525,30,1210469010,1210469014,3,1,4
88776513@N00,10526,26,1230261278,1230282821,3,1,21543
88787599@N00,10527,22,1189306307,1189306307,1,1,0
88787599@N00,10528,30,1244862308,1244862345,2,1,37
88787599@N00,10529,29,1244894168,1244894203,3,1,35
88787599@N00,10530,28,1252725828,1252725828,1,1,0
88787599@N00,10531,29,1257554607,1257554607,1,1,0
88787599@N00,10532,12,1258626305,1258626305,1,3,0
88787599@N00,10532,28,1258625584,1258625584,1,3,0
88787599@N00,10532,16,1258635810,1258635810,1,3,0
88787599@N00,10533,27,1267245172,1267245172,1,2,0
88787599@N00,10533,1,1267241498,1267241658,3,2,160
88787599@N00,10534,1,1359505747,1359549812,17,1,44065
88790526@N05,10535,1,1365241031,1365241031,1,1,0
88850477@N03,10536,1,1374393841,1374394059,3,1,218
88859913@N00,10537,25,1366532497,1366532497,1,5,0
88859913@N00,10537,1,1366536411,1366543282,2,5,6871
88859913@N00,10537,13,1366533282,1366533282,1,5,0
88859913@N00,10537,3,1366529420,1366529420,1,5,0
88859913@N00,10537,12,1366528549,1366528549,1,5,0
88859913@N00,10538,26,1366588459,1366626069,4,12,37610
88859913@N00,10538,25,1366595664,1366595664,1,12,0
88859913@N00,10538,16,1366589196,1366626593,5,12,37397
88859913@N00,10538,17,1366600619,1366600619,1,12,0
88859913@N00,10538,19,1366607538,1366608228,3,12,690
88859913@N00,10538,18,1366625882,1366625882,1,12,0
88859913@N00,10538,31,1366610398,1366611135,2,12,737
88859913@N00,10538,27,1366599442,1366626529,3,12,27087
88859913@N00,10538,22,1366610924,1366611003,3,12,79
88859913@N00,10538,24,1366598480,1366598480,1,12,0
88859913@N00,10538,8,1366604299,1366604299,1,12,0
88859913@N00,10538,29,1366608830,1366608830,1,12,0
88861583@N06,10539,19,1346218957,1346218957,1,1,0
88891730@N00,10540,23,1313032579,1313048853,9,1,16274
88891730@N00,10541,23,1313122868,1313140542,3,1,17674
88891730@N00,10542,23,1313211993,1313226730,6,1,14737
88935086@N05,10543,28,1356389259,1356394475,2,1,5216
88935086@N05,10544,28,1356427748,1356432341,4,1,4593
88937309@N00,10545,18,1434953956,1434953956,1,1,0
88955553@N00,10546,14,1412554768,1412556748,2,12,1980
88955553@N00,10546,6,1412543248,1412543571,2,12,323
88955553@N00,10546,7,1412544241,1412544241,1,12,0
88955553@N00,10546,21,1412544634,1412546130,6,12,1496
88955553@N00,10546,27,1412548917,1412548917,1,12,0
88955553@N00,10546,28,1412543011,1412572886,3,12,29875
88955553@N00,10546,16,1412547979,1412547979,1,12,0
88955553@N00,10546,29,1412552694,1412552700,2,12,6
88955553@N00,10546,5,1412544100,1412544313,2,12,213
88955553@N00,10546,26,1412543118,1412543118,1,12,0
88955553@N00,10546,13,1412546237,1412546907,8,12,670
88955553@N00,10546,3,1412544724,1412544724,1,12,0
88984016@N00,10547,28,1313541933,1313542005,2,3,72
88984016@N00,10547,27,1313561558,1313561558,1,3,0
88984016@N00,10547,26,1313550403,1313550403,1,3,0
88984016@N00,10548,1,1313644761,1313644761,1,1,0
88984016@N00,10549,28,1313706965,1313714296,2,2,7331
88984016@N00,10549,26,1313708310,1313708310,1,2,0
88984016@N00,10550,26,1314035154,1314035154,1,2,0
88984016@N00,10550,23,1314039742,1314039832,2,2,90
89072528@N00,10551,17,1393727941,1393727941,1,2,0
89072528@N00,10551,28,1393732930,1393733464,5,2,534
89072528@N00,10552,19,1404552289,1404552289,1,1,0
89087405@N00,10553,22,1356138261,1356138261,1,1,0
89091370@N03,10554,12,1375750021,1375750116,3,6,95
89091370@N03,10554,23,1375752092,1375752095,2,6,3
89091370@N03,10554,6,1375755608,1375755608,1,6,0
89091370@N03,10554,24,1375749949,1375750174,7,6,225
89091370@N03,10554,11,1375749945,1375749945,1,6,0
89091370@N03,10554,4,1375765944,1375765944,1,6,0
89095907@N00,10555,6,1360045586,1360045586,1,1,0
89095907@N00,10556,4,1397739597,1397740172,2,2,575
89095907@N00,10556,3,1397738320,1397738320,1,2,0
89095907@N00,10557,14,1397872250,1397872250,1,1,0
89095907@N00,10558,29,1397906400,1397906400,1,1,0
8910343@N04,10559,1,1370515640,1370515640,1,1,0
8913581@N06,10560,16,1366251376,1366251376,1,1,0
89234062@N00,10561,7,1396132312,1396132312,1,1,0
89234062@N00,10562,26,1396296386,1396296386,1,1,0
89253026@N00,10563,26,1305371703,1305371703,1,1,0
8926016@N04,10564,28,1332146724,1332147289,8,1,565
89286166@N02,10565,20,1345924607,1345924716,2,1,109
89286166@N02,10566,20,1350397589,1350397589,1,1,0
89286166@N02,10567,20,1363548703,1363548703,1,1,0
89286166@N02,10568,26,1364071958,1364071958,1,1,0
89286166@N02,10569,30,1365440053,1365440053,1,1,0
8928810@N02,10570,10,1315375027,1315375027,1,1,0
8928810@N02,10571,21,1316678864,1316678864,1,5,0
8928810@N02,10571,26,1316678042,1316678512,2,5,470
8928810@N02,10571,19,1316670712,1316670712,1,5,0
8928810@N02,10571,11,1316673412,1316673412,1,5,0
8928810@N02,10571,30,1316670678,1316670678,1,5,0
89379256@N08,10572,30,1356827987,1356848857,12,1,20870
89379256@N08,10573,30,1356912129,1356938183,14,1,26054
89379256@N08,10574,30,1357085606,1357107085,21,1,21479
89388079@N07,10575,30,1299743336,1299744140,2,1,804
89388079@N07,10576,30,1306380834,1306381618,3,1,784
89388079@N07,10577,20,1325848577,1325848781,2,3,204
89388079@N07,10577,28,1325852721,1325852721,1,3,0
89388079@N07,10577,30,1325843719,1325843719,1,3,0
89388079@N07,10578,7,1330512389,1330512389,1,3,0
89388079@N07,10578,3,1330512111,1330512111,1,3,0
89388079@N07,10578,5,1330512093,1330512093,1,3,0
89388079@N07,10579,26,1331012069,1331012158,3,1,89
89388079@N07,10580,29,1391319316,1391319316,1,1,0
89388079@N07,10581,7,1396349468,1396349468,1,1,0
89388079@N07,10582,22,1403009766,1403009766,1,2,0
89388079@N07,10582,28,1403008737,1403008737,1,2,0
89388079@N07,10583,1,1459668445,1459668445,1,1,0
89399113@N00,10584,28,1354560075,1354560484,4,2,409
89399113@N00,10584,13,1354560045,1354560045,1,2,0
89414761@N00,10585,25,1305416270,1305416270,1,5,0
89414761@N00,10585,22,1305434114,1305434114,1,5,0
89414761@N00,10585,29,1305427794,1305427794,1,5,0
89414761@N00,10585,13,1305421424,1305421424,2,5,0
89414761@N00,10585,28,1305410891,1305410891,1,5,0
89414761@N00,10586,17,1305674326,1305674326,1,3,0
89414761@N00,10586,15,1305676006,1305676006,1,3,0
89414761@N00,10586,3,1305682941,1305682941,1,3,0
89414761@N00,10587,22,1305855130,1305855130,1,2,0
89414761@N00,10587,31,1305855839,1305855839,1,2,0
89414761@N00,10588,21,1306193821,1306193821,1,1,0
89414761@N00,10589,17,1306407094,1306407094,1,1,0
8949620@N08,10590,31,1199639987,1199639987,1,5,0
8949620@N08,10590,29,1199640223,1199640223,1,5,0
8949620@N08,10590,23,1199640177,1199640199,2,5,22
8949620@N08,10590,13,1199639951,1199640022,2,5,71
8949620@N08,10590,12,1199640096,1199640134,2,5,38
8949620@N08,10591,30,1220968800,1220968800,1,5,0
8949620@N08,10591,1,1220968801,1220968817,2,5,16
8949620@N08,10591,28,1220968818,1220968823,3,5,5
8949620@N08,10591,20,1220968824,1220968827,4,5,3
8949620@N08,10591,13,1220968808,1220968808,1,5,0
8949620@N08,10592,22,1221013747,1221013747,1,1,0
8949620@N08,10593,25,1241419699,1241419699,1,2,0
8949620@N08,10593,13,1241419587,1241419587,1,2,0
8949620@N08,10594,25,1241506486,1241506486,1,1,0
89564686@N00,10595,17,1257922802,1257922802,1,1,0
89564686@N00,10596,17,1259128980,1259128980,1,1,0
89564686@N00,10597,17,1261050001,1261050001,1,1,0
89564686@N00,10598,17,1274620382,1274620382,1,1,0
89564686@N00,10599,17,1280658842,1280658842,1,1,0
89564686@N00,10600,17,1287648063,1287650570,2,1,2507
8956474@N05,10601,17,1328021260,1328021295,2,1,35
89608302@N03,10602,1,1358554887,1358554887,1,1,0
89696810@N00,10603,20,1218631153,1218636206,4,7,5053
89696810@N00,10603,1,1218620503,1218620503,1,7,0
89696810@N00,10603,19,1218630571,1218630571,1,7,0
89696810@N00,10603,18,1218622173,1218623553,2,7,1380
89696810@N00,10603,17,1218641113,1218643666,2,7,2553
89696810@N00,10603,29,1218624681,1218624752,2,7,71
89696810@N00,10603,28,1218640037,1218640037,1,7,0
89713825@N00,10604,10,1246515531,1246515531,1,1,0
89804841@N00,10605,13,1296801797,1296807235,17,3,5438
89804841@N00,10605,16,1296779316,1296792209,9,3,12893
89804841@N00,10605,27,1296791118,1296792159,6,3,1041
89804841@N00,10606,16,1296874249,1296874785,10,3,536
89804841@N00,10606,27,1296873279,1296873279,1,3,0
89804841@N00,10606,28,1296875301,1296875358,3,3,57
89804841@N00,10607,28,1296906120,1296907242,8,1,1122
89804841@N00,10608,13,1296957489,1296960197,28,5,2708
89804841@N00,10608,27,1296963900,1296964898,14,5,998
89804841@N00,10608,19,1296970927,1296971787,16,5,860
89804841@N00,10608,16,1296960257,1296964423,5,5,4166
89804841@N00,10608,6,1296968687,1296968959,19,5,272
89857381@N04,10609,11,1377917588,1377917885,3,3,297
89857381@N04,10609,1,1377916871,1377917344,4,3,473
89857381@N04,10609,20,1377916629,1377916629,1,3,0
89857381@N04,10610,30,1379053716,1379053716,1,2,0
89857381@N04,10610,28,1379054067,1379055020,5,2,953
89857381@N04,10611,8,1379581428,1379581428,1,6,0
89857381@N04,10611,28,1379574284,1379574284,1,6,0
89857381@N04,10611,30,1379578882,1379578882,1,6,0
89857381@N04,10611,26,1379581558,1379581558,1,6,0
89857381@N04,10611,7,1379580706,1379581275,3,6,569
89857381@N04,10611,11,1379580181,1379580181,1,6,0
89857381@N04,10612,28,1379723924,1379723924,1,4,0
89857381@N04,10612,26,1379724783,1379724783,1,4,0
89857381@N04,10612,29,1379725518,1379725518,1,4,0
89857381@N04,10612,30,1379725360,1379725360,1,4,0
89857381@N04,10613,1,1380867077,1380867364,3,1,287
89857381@N04,10614,15,1382743955,1382743955,1,4,0
89857381@N04,10614,28,1382737388,1382739288,5,4,1900
89857381@N04,10614,26,1382738120,1382738120,1,4,0
89857381@N04,10614,1,1382738543,1382744583,2,4,6040
89857381@N04,10615,20,1383959114,1383959759,3,4,645
89857381@N04,10615,26,1383947545,1383947545,1,4,0
89857381@N04,10615,29,1383956443,1383959367,6,4,2924
89857381@N04,10615,1,1383944971,1383944971,1,4,0
89857381@N04,10616,28,1384234097,1384234097,1,5,0
89857381@N04,10616,26,1384247855,1384249224,2,5,1369
89857381@N04,10616,3,1384247360,1384247360,1,5,0
89857381@N04,10616,30,1384242782,1384243330,2,5,548
89857381@N04,10616,1,1384233752,1384234349,2,5,597
89857381@N04,10617,28,1384552504,1384554382,2,1,1878
89857381@N04,10618,28,1384725808,1384725808,1,2,0
89857381@N04,10618,15,1384725655,1384725655,1,2,0
89857381@N04,10619,27,1385168492,1385168668,2,5,176
89857381@N04,10619,23,1385163519,1385163519,1,5,0
89857381@N04,10619,28,1385163712,1385163712,1,5,0
89857381@N04,10619,7,1385167149,1385167149,1,5,0
89857381@N04,10619,11,1385166304,1385166304,1,5,0
89857381@N04,10620,28,1385199264,1385199264,1,1,0
89857381@N04,10621,29,1385607485,1385607485,1,3,0
89857381@N04,10621,20,1385608161,1385616024,2,3,7863
89857381@N04,10621,1,1385601544,1385601544,1,3,0
89857381@N04,10622,30,1385688874,1385689299,3,4,425
89857381@N04,10622,28,1385678440,1385678440,1,4,0
89857381@N04,10622,25,1385682665,1385682991,2,4,326
89857381@N04,10622,13,1385684248,1385688310,3,4,4062
89857381@N04,10623,26,1385802840,1385807047,3,2,4207
89857381@N04,10623,24,1385807421,1385807421,1,2,0
89857381@N04,10624,29,1386238893,1386238893,1,1,0
89857381@N04,10625,7,1386392890,1386392890,1,3,0
89857381@N04,10625,1,1386392076,1386405451,2,3,13375
89857381@N04,10625,28,1386388957,1386396421,3,3,7464
89857381@N04,10626,29,1386477033,1386487201,3,1,10168
89857381@N04,10627,29,1389521814,1389522304,2,5,490
89857381@N04,10627,30,1389522005,1389522005,1,5,0
89857381@N04,10627,31,1389521910,1389521910,1,5,0
89857381@N04,10627,13,1389522417,1389522417,1,5,0
89857381@N04,10627,20,1389522096,1389522180,2,5,84
89857381@N04,10628,30,1389850876,1389851206,3,3,330
89857381@N04,10628,28,1389861503,1389861503,1,3,0
89857381@N04,10628,1,1389850752,1389850752,1,3,0
89857381@N04,10629,30,1390551308,1390551433,2,2,125
89857381@N04,10629,1,1390545705,1390545705,1,2,0
89857381@N04,10630,1,1390605098,1390605098,1,2,0
89857381@N04,10630,28,1390601927,1390603738,3,2,1811
89857381@N04,10631,20,1390976712,1390976712,1,6,0
89857381@N04,10631,11,1390987724,1390987724,1,6,0
89857381@N04,10631,7,1390988215,1390988215,1,6,0
89857381@N04,10631,29,1390976255,1390977141,4,6,886
89857381@N04,10631,4,1390985945,1390985945,1,6,0
89857381@N04,10631,28,1390984980,1390984980,1,6,0
89857381@N04,10632,28,1391292337,1391292768,3,2,431
89857381@N04,10632,12,1391292494,1391292494,1,2,0
89857381@N04,10633,30,1391741176,1391741512,3,2,336
89857381@N04,10633,24,1391740152,1391740152,1,2,0
89857381@N04,10634,15,1392594173,1392594561,2,1,388
89857381@N04,10635,20,1392708981,1392708981,1,1,0
89857381@N04,10636,15,1392883997,1392884451,2,1,454
89857381@N04,10637,30,1392961586,1392961586,1,1,0
89857381@N04,10638,1,1393654156,1393654156,1,1,0
89857381@N04,10639,30,1394620525,1394620525,1,1,0
89857381@N04,10640,30,1394774967,1394774967,1,1,0
89857381@N04,10641,27,1398160381,1398160381,1,1,0
89857381@N04,10642,28,1399362673,1399362673,1,1,0
89857381@N04,10643,19,1406329261,1406329261,1,1,0
89857381@N04,10644,30,1406793995,1406793995,1,3,0
89857381@N04,10644,1,1406798516,1406798516,1,3,0
89857381@N04,10644,20,1406796524,1406796524,1,3,0
89857381@N04,10645,28,1408142948,1408142948,1,1,0
89857381@N04,10646,1,1408272688,1408272688,1,1,0
89857381@N04,10647,28,1409902894,1409902894,1,1,0
89857381@N04,10648,20,1410223846,1410223846,1,1,0
89857381@N04,10649,28,1411173107,1411173107,1,1,0
89857381@N04,10650,19,1411282694,1411282694,1,1,0
89857381@N04,10651,30,1412843714,1412843714,1,1,0
89857381@N04,10652,19,1412926261,1412926261,1,1,0
89857381@N04,10653,19,1415402009,1415402009,1,1,0
89857381@N04,10654,3,1415856433,1415856433,1,3,0
89857381@N04,10654,25,1415856744,1415856744,1,3,0
89857381@N04,10654,19,1415870076,1415870076,1,3,0
89857381@N04,10655,28,1416378362,1416378362,1,1,0
89857381@N04,10656,19,1417844453,1417844453,1,1,0
89857381@N04,10657,28,1418425364,1418425364,1,1,0
89857381@N04,10658,18,1427093422,1427093422,1,1,0
89857381@N04,10659,26,1466247630,1466247630,1,1,0
89873814@N00,10660,15,1202470936,1202470936,1,1,0
89873814@N00,10661,31,1203842947,1203842947,1,1,0
89873814@N00,10662,12,1415080069,1415080069,1,1,0
89898604@N00,10663,11,1395788797,1395788797,1,1,0
89898604@N00,10664,25,1395882351,1395882351,1,2,0
89898604@N00,10664,26,1395891234,1395891248,2,2,14
89901660@N00,10665,27,1326593371,1326593371,1,1,0
8996989@N02,10666,16,1215603151,1215603151,1,2,0
8996989@N02,10666,26,1215603786,1215603786,1,2,0
8996989@N02,10667,31,1215667989,1215667989,1,1,0
90008840@N00,10668,20,1350959579,1350960343,2,3,764
90008840@N00,10668,16,1350955134,1350955134,1,3,0
90008840@N00,10668,29,1350959203,1350959247,2,3,44
90008840@N00,10669,18,1449494453,1449494453,1,1,0
90008840@N00,10670,18,1449642913,1449642913,1,10,0
90008840@N00,10670,5,1449632814,1449632975,2,10,161
90008840@N00,10670,23,1449638062,1449638062,1,10,0
90008840@N00,10670,13,1449630056,1449630056,1,10,0
90008840@N00,10670,16,1449640231,1449640231,1,10,0
90008840@N00,10670,12,1449642588,1449642588,1,10,0
90008840@N00,10670,26,1449639021,1449640265,2,10,1244
90008840@N00,10670,3,1449641566,1449641566,1,10,0
90008840@N00,10670,24,1449643393,1449643393,1,10,0
90008840@N00,10670,25,1449628692,1449629436,6,10,744
90008840@N00,10671,26,1449734486,1449734486,1,2,0
90008840@N00,10671,15,1449730185,1449730547,2,2,362
90008840@N00,10672,18,1449796327,1449796327,1,4,0
90008840@N00,10672,17,1449802159,1449802159,1,4,0
90008840@N00,10672,26,1449805814,1449805929,2,4,115
90008840@N00,10672,19,1449798726,1449798726,1,4,0
90015401@N00,10673,26,1367626438,1367626468,2,1,30
90016486@N05,10674,26,1377689793,1377689806,2,1,13
90055788@N00,10675,24,1276490274,1276490274,1,4,0
90055788@N00,10675,10,1276502187,1276502187,1,4,0
90055788@N00,10675,20,1276479562,1276479562,1,4,0
90055788@N00,10675,30,1276476156,1276476156,1,4,0
90093093@N08,10676,29,1367986964,1367987318,2,2,354
90093093@N08,10676,18,1367988035,1367988035,1,2,0
90093093@N08,10677,1,1369201930,1369201930,1,1,0
90146022@N00,10678,25,1391173200,1391173200,1,2,0
90146022@N00,10678,26,1391173200,1391173200,1,2,0
90214320@N00,10679,22,1200027532,1200027532,1,2,0
90214320@N00,10679,27,1200046965,1200046965,1,2,0
90246252@N06,10680,28,1361654396,1361654396,1,1,0
9025385@N07,10681,28,1292841983,1292841983,1,1,0
90269418@N00,10682,1,1382670032,1382704390,20,1,34358
90269418@N00,10683,1,1382741936,1382761903,13,1,19967
90269418@N00,10684,1,1382795885,1382796955,2,1,1070
90269418@N00,10685,1,1382837970,1382844402,3,1,6432
90272587@N00,10686,31,1338357564,1338371934,2,1,14370
90289831@N00,10687,3,1241222602,1241222602,1,19,0
90289831@N00,10687,13,1241219715,1241238206,34,19,18491
90289831@N00,10687,25,1241218609,1241219297,10,19,688
90289831@N00,10687,15,1241266440,1241266451,2,19,11
90289831@N00,10687,30,1241238962,1241239752,12,19,790
90289831@N00,10687,22,1241250366,1241250434,3,19,68
90289831@N00,10687,16,1241245876,1241245993,3,19,117
90289831@N00,10687,11,1241229075,1241229134,3,19,59
90289831@N00,10687,26,1241218239,1241218239,1,19,0
90289831@N00,10687,21,1241226070,1241226081,2,19,11
90289831@N00,10687,28,1241240757,1241264852,51,19,24095
90289831@N00,10687,1,1241268265,1241268265,1,19,0
90289831@N00,10687,29,1241240311,1241240490,7,19,179
90289831@N00,10687,20,1241240220,1241240220,1,19,0
90289831@N00,10687,4,1241226278,1241228022,6,19,1744
90289831@N00,10687,27,1241247381,1241247381,1,19,0
90289831@N00,10687,7,1241229470,1241229704,3,19,234
90289831@N00,10687,5,1241229838,1241229838,1,19,0
90289831@N00,10687,19,1241240614,1241240614,1,19,0
90289831@N00,10688,26,1280916539,1280919905,11,1,3366
90289831@N00,10689,26,1280966166,1280998707,67,1,32541
90296333@N04,10690,22,1364520762,1364520762,1,1,0
90300985@N05,10691,15,1375057248,1375057248,1,1,0
90328132@N00,10692,25,1290258665,1290259203,2,2,538
90328132@N00,10692,5,1290250035,1290250035,1,2,0
90328132@N00,10693,12,1391233362,1391233362,1,4,0
90328132@N00,10693,29,1391245440,1391245440,1,4,0
90328132@N00,10693,20,1391233762,1391233762,1,4,0
90328132@N00,10693,30,1391233439,1391233439,1,4,0
90328132@N00,10694,3,1411788703,1411788703,1,5,0
90328132@N00,10694,20,1411790788,1411791750,4,5,962
90328132@N00,10694,17,1411785200,1411785200,1,5,0
90328132@N00,10694,30,1411793249,1411793249,1,5,0
90328132@N00,10694,19,1411794628,1411794628,1,5,0
90328132@N00,10695,19,1412408376,1412408428,2,1,52
90328132@N00,10696,19,1412471951,1412471951,1,1,0
90328132@N00,10697,28,1419223263,1419223263,1,1,0
90328132@N00,10698,28,1422241315,1422241315,1,3,0
90328132@N00,10698,17,1422241382,1422241382,1,3,0
90328132@N00,10698,29,1422241279,1422241436,3,3,157
90344777@N06,10699,26,1379398345,1379398345,1,1,0
9036889@N06,10700,28,1385704379,1385704379,1,4,0
9036889@N06,10700,11,1385693417,1385694222,7,4,805
9036889@N06,10700,17,1385701236,1385701236,1,4,0
9036889@N06,10700,4,1385693229,1385693229,1,4,0
9036889@N06,10701,1,1447386494,1447422624,10,12,36130
9036889@N06,10701,29,1447387310,1447414684,18,12,27374
9036889@N06,10701,30,1447387249,1447387249,1,12,0
9036889@N06,10701,31,1447387331,1447387979,12,12,648
9036889@N06,10701,20,1447417707,1447417817,2,12,110
9036889@N06,10701,26,1447398906,1447416855,72,12,17949
9036889@N06,10701,21,1447389348,1447399291,5,12,9943
9036889@N06,10701,24,1447394019,1447394244,5,12,225
9036889@N06,10701,12,1447392569,1447392878,9,12,309
9036889@N06,10701,25,1447389169,1447397904,47,12,8735
9036889@N06,10701,13,1447399740,1447399740,1,12,0
9036889@N06,10701,23,1447387255,1447387255,1,12,0
90394757@N00,10702,28,1232760186,1232760186,1,1,0
90394757@N00,10703,25,1260272845,1260272845,1,1,0
90394757@N00,10704,13,1323148786,1323148786,1,1,0
90405256@N00,10705,25,1227391929,1227393135,6,1,1206
90427028@N00,10706,31,1201666495,1201666495,1,6,0
90427028@N00,10706,1,1201649148,1201651273,3,6,2125
90427028@N00,10706,11,1201672146,1201672146,1,6,0
90427028@N00,10706,19,1201673269,1201673269,1,6,0
90427028@N00,10706,21,1201657816,1201657816,1,6,0
90427028@N00,10706,28,1201676727,1201679884,3,6,3157
90427028@N00,10707,6,1201748458,1201748458,1,4,0
90427028@N00,10707,28,1201764977,1201766461,3,4,1484
90427028@N00,10707,30,1201747258,1201747258,1,4,0
90427028@N00,10707,21,1201764459,1201764459,1,4,0
90436343@N04,10708,1,1354019732,1354019732,1,1,0
90494751@N00,10709,1,1188563665,1188563665,1,1,0
90494751@N00,10710,1,1189045260,1189080033,20,1,34773
90494751@N00,10711,1,1195093291,1195093291,1,1,0
90494751@N00,10712,1,1195288601,1195306651,3,1,18050
90494751@N00,10713,1,1196763311,1196772040,4,1,8729
90494751@N00,10714,1,1197114574,1197117527,11,1,2953
90494751@N00,10715,1,1220611427,1220611525,2,1,98
9053157@N02,10716,5,1198230031,1198230031,1,2,0
9053157@N02,10716,26,1198235812,1198235812,1,2,0
9053157@N02,10717,17,1200712219,1200712219,1,1,0
9053157@N02,10718,16,1201931246,1201931291,3,1,45
9053157@N02,10719,30,1204325204,1204325204,1,3,0
9053157@N02,10719,3,1204324471,1204324789,5,3,318
9053157@N02,10719,14,1204326542,1204326549,2,3,7
9053157@N02,10720,16,1204867095,1204867115,2,3,20
9053157@N02,10720,29,1204864680,1204864680,1,3,0
9053157@N02,10720,30,1204869042,1204870535,8,3,1493
9053157@N02,10721,31,1205531310,1205531310,1,1,0
9053157@N02,10722,5,1205577148,1205577148,1,1,0
9053157@N02,10723,29,1211706892,1211706892,1,2,0
9053157@N02,10723,28,1211723274,1211723274,1,2,0
9053157@N02,10724,16,1215176400,1215176400,1,3,0
9053157@N02,10724,1,1215157292,1215178380,6,3,21088
9053157@N02,10724,26,1215176580,1215176580,1,3,0
9053157@N02,10725,24,1216267946,1216267946,1,1,0
9053157@N02,10726,28,1229711904,1229711904,1,1,0
9053157@N02,10727,20,1229771624,1229771624,1,1,0
9053157@N02,10728,4,1230020018,1230020018,1,1,0
9053157@N02,10729,21,1230719829,1230719829,1,1,0
9053157@N02,10730,13,1262217431,1262217431,1,5,0
9053157@N02,10730,14,1262214409,1262214409,1,5,0
9053157@N02,10730,28,1262231627,1262231627,1,5,0
9053157@N02,10730,20,1262213930,1262213930,1,5,0
9053157@N02,10730,25,1262216324,1262216324,1,5,0
9053157@N02,10731,10,1308736756,1308736756,1,1,0
9053157@N02,10732,28,1325345952,1325345952,1,1,0
9053157@N02,10733,10,1328755661,1328755661,1,1,0
9053157@N02,10734,12,1328836170,1328836170,1,1,0
9053157@N02,10735,30,1338295434,1338295434,1,1,0
9053157@N02,10736,31,1338952754,1338952754,1,1,0
9053157@N02,10737,24,1349326717,1349326717,1,1,0
9053157@N02,10738,12,1361936410,1361936410,1,1,0
90547236@N00,10739,25,1343992392,1343992392,1,1,0
90621377@N00,10740,28,1273791575,1273791575,1,2,0
90621377@N00,10740,14,1273802509,1273802509,1,2,0
90621377@N00,10741,28,1273882114,1273887007,2,2,4893
90621377@N00,10741,25,1273891453,1273891453,1,2,0
90621377@N00,10742,28,1273921914,1273921914,1,3,0
90621377@N00,10742,26,1273925902,1273925902,1,3,0
90621377@N00,10742,24,1273926913,1273926913,1,3,0
90673013@N06,10743,28,1370967469,1370980109,5,2,12640
90673013@N06,10743,1,1370966783,1370989234,3,2,22451
9068914@N02,10744,6,1454650536,1454650536,1,1,0
9069058@N02,10745,16,1294552466,1294554479,2,2,2013
9069058@N02,10745,29,1294559809,1294559809,1,2,0
90696399@N07,10746,20,1380431644,1380455680,5,1,24036
90696399@N07,10747,20,1380510130,1380539547,6,1,29417
90696399@N07,10748,20,1380587299,1380634612,17,1,47313
90696399@N07,10749,20,1380680025,1380710931,11,1,30906
90696399@N07,10750,20,1380761535,1380794785,17,1,33250
90696399@N07,10751,20,1469263359,1469263990,16,1,631
90727846@N00,10752,25,1335720587,1335720587,1,1,0
90727846@N00,10753,31,1335766508,1335766508,1,2,0
90727846@N00,10753,15,1335792583,1335792583,1,2,0
90755543@N00,10754,30,1371801733,1371801737,2,7,4
90755543@N00,10754,28,1371806160,1371806160,1,7,0
90755543@N00,10754,13,1371799983,1371800412,3,7,429
90755543@N00,10754,29,1371775095,1371814210,2,7,39115
90755543@N00,10754,21,1371799881,1371799881,1,7,0
90755543@N00,10754,25,1371801752,1371802447,3,7,695
90755543@N00,10754,26,1371792543,1371812317,3,7,19774
90761069@N08,10755,1,1385935117,1385935117,1,3,0
90761069@N08,10755,13,1385952311,1385952311,1,3,0
90761069@N08,10755,20,1385935762,1385937339,2,3,1577
90761069@N08,10756,18,1386052392,1386052392,1,2,0
90761069@N08,10756,30,1386053237,1386053237,1,2,0
90798029@N02,10757,1,1430748636,1430748636,1,1,0
90810256@N08,10758,17,1362192125,1362192125,1,1,0
90832417@N00,10759,23,1375664571,1375664571,1,2,0
90832417@N00,10759,15,1375680916,1375680916,1,2,0
90832417@N00,10760,29,1375745903,1375745903,1,1,0
90896070@N04,10761,28,1376048694,1376050907,2,2,2213
90896070@N04,10761,18,1376040998,1376048026,3,2,7028
90933198@N02,10762,26,1389413304,1389413304,1,1,0
90987666@N00,10763,1,1343962269,1343962269,1,1,0
91033481@N00,10764,24,1295577450,1295577450,1,2,0
91033481@N00,10764,28,1295604490,1295607023,2,2,2533
91033481@N00,10765,26,1295739393,1295739393,1,1,0
91033481@N00,10766,29,1305082857,1305082857,1,6,0
91033481@N00,10766,25,1305090423,1305090423,1,6,0
91033481@N00,10766,16,1305098508,1305098508,1,6,0
91033481@N00,10766,20,1305087339,1305087339,1,6,0
91033481@N00,10766,18,1305096751,1305096751,1,6,0
91033481@N00,10766,26,1305073455,1305073455,1,6,0
91033481@N00,10767,26,1305160728,1305160728,1,2,0
91033481@N00,10767,25,1305180260,1305180260,1,2,0
91033481@N00,10768,28,1319968294,1319968294,1,2,0
91033481@N00,10768,14,1319960296,1319960296,1,2,0
91033481@N00,10769,20,1320041975,1320041975,1,1,0
91033481@N00,10770,20,1320127948,1320127948,1,4,0
91033481@N00,10770,3,1320119962,1320119962,1,4,0
91033481@N00,10770,30,1320121697,1320121697,1,4,0
91033481@N00,10770,7,1320118483,1320118483,1,4,0
91035898@N00,10771,27,1324337624,1324337624,1,2,0
91035898@N00,10771,29,1324346179,1324347175,2,2,996
91087719@N08,10772,22,1375888698,1375888698,1,2,0
91087719@N08,10772,14,1375888012,1375888012,1,2,0
91087719@N08,10773,26,1375928157,1375928157,1,2,0
91087719@N08,10773,8,1375931439,1375931439,1,2,0
91087719@N08,10774,26,1398737778,1398737778,1,1,0
9110121@N02,10775,15,1303032671,1303032671,1,1,0
91103189@N00,10776,1,1411728396,1411740316,7,1,11920
91132276@N07,10777,28,1290770102,1290770102,1,4,0
91132276@N07,10777,3,1290766858,1290766858,1,4,0
91132276@N07,10777,27,1290764282,1290764282,1,4,0
91132276@N07,10777,26,1290768057,1290768604,2,4,547
91132276@N07,10778,26,1294741805,1294741840,2,2,35
91132276@N07,10778,1,1294739442,1294739442,1,2,0
91132276@N07,10779,28,1294792962,1294792962,1,11,0
91132276@N07,10779,3,1294793032,1294793073,2,11,41
91132276@N07,10779,11,1294791510,1294792408,2,11,898
91132276@N07,10779,30,1294792486,1294792486,1,11,0
91132276@N07,10779,17,1294791823,1294791857,2,11,34
91132276@N07,10779,18,1294791476,1294791476,1,11,0
91132276@N07,10779,6,1294791986,1294791986,1,11,0
91132276@N07,10779,29,1294791484,1294791484,1,11,0
91132276@N07,10779,12,1294790462,1294790462,1,11,0
91132276@N07,10779,24,1294790538,1294791291,2,11,753
91132276@N07,10779,26,1294792461,1294792461,1,11,0
91132276@N07,10780,4,1357959543,1357959543,1,1,0
91132276@N07,10781,24,1359287617,1359287617,1,7,0
91132276@N07,10781,17,1359280752,1359280752,1,7,0
91132276@N07,10781,8,1359280772,1359280772,1,7,0
91132276@N07,10781,11,1359287760,1359287760,1,7,0
91132276@N07,10781,30,1359280748,1359280748,1,7,0
91132276@N07,10781,26,1359280759,1359280762,2,7,3
91132276@N07,10781,6,1359280756,1359280756,1,7,0
91132276@N07,10782,14,1363001563,1363001563,1,2,0
91132276@N07,10782,21,1363001553,1363001553,1,2,0
91132276@N07,10783,8,1386104801,1386104801,1,3,0
91132276@N07,10783,12,1386104805,1386104805,1,3,0
91132276@N07,10783,29,1386104810,1386104810,1,3,0
91132276@N07,10784,28,1388973749,1388973749,1,1,0
91132404@N00,10785,28,1331988200,1331990367,2,1,2167
91196251@N05,10786,31,1360032235,1360032235,1,2,0
91196251@N05,10786,3,1360039958,1360039958,1,2,0
91209514@N06,10787,26,1363501007,1363501007,1,1,0
91218125@N07,10788,19,1414914156,1414914156,1,1,0
91218125@N07,10789,14,1416096042,1416096042,1,1,0
91218125@N07,10790,18,1441501010,1441501010,1,1,0
91219241@N05,10791,20,1368329167,1368329167,1,1,0
91219241@N05,10792,17,1368416844,1368416844,1,1,0
91219241@N05,10793,24,1391289211,1391299979,5,1,10768
91219241@N05,10794,24,1394308460,1394315755,8,1,7295
91219241@N05,10795,24,1394422748,1394422748,1,2,0
91219241@N05,10795,20,1394419460,1394419720,2,2,260
91219241@N05,10796,24,1399764032,1399765441,4,1,1409
91219241@N05,10797,24,1399869826,1399869826,1,1,0
91227166@N06,10798,26,1357120931,1357120931,1,2,0
91227166@N06,10798,11,1357120950,1357120950,1,2,0
91227166@N06,10799,20,1381132999,1381132999,1,1,0
91227166@N06,10800,13,1381196777,1381196777,1,5,0
91227166@N06,10800,12,1381196485,1381196485,1,5,0
91227166@N06,10800,18,1381193697,1381193697,1,5,0
91227166@N06,10800,26,1381191155,1381194997,2,5,3842
91227166@N06,10800,21,1381197947,1381197947,1,5,0
91227166@N06,10801,26,1381236060,1381236250,2,2,190
91227166@N06,10801,28,1381236164,1381236164,1,2,0
91227166@N06,10802,23,1381287653,1381287653,1,1,0
91227166@N06,10803,30,1381484520,1381484520,1,1,0
91227166@N06,10804,1,1381954462,1381954462,1,1,0
91230196@N02,10805,26,1365472877,1365472877,1,1,0
91230196@N02,10806,15,1367806576,1367806576,1,1,0
91234299@N07,10807,18,1441156207,1441168080,2,1,11873
9123577@N06,10808,26,1258889896,1258899410,2,1,9514
91262748@N08,10809,29,1391673434,1391673434,1,2,0
91262748@N08,10809,15,1391650330,1391650330,1,2,0
91293550@N08,10810,8,1433376905,1433376905,1,3,0
91293550@N08,10810,1,1433375666,1433375666,1,3,0
91293550@N08,10810,31,1433377350,1433377350,1,3,0
91316948@N08,10811,1,1392440861,1392440861,1,1,0
91377499@N06,10812,14,1361320967,1361320967,1,1,0
91395298@N03,10813,28,1356422973,1356422973,1,1,0
9139667@N06,10814,1,1387582480,1387582869,2,3,389
9139667@N06,10814,16,1387588093,1387588093,1,3,0
9139667@N06,10814,28,1387610045,1387610045,1,3,0
91398168@N02,10815,1,1372653409,1372653409,1,1,0
91398168@N02,10816,27,1372728507,1372728507,1,1,0
91398168@N02,10817,1,1372851588,1372851588,1,1,0
91405598@N02,10818,28,1356430151,1356430206,3,3,55
91405598@N02,10818,25,1356418662,1356418662,1,3,0
91405598@N02,10818,16,1356431699,1356431900,6,3,201
91405970@N00,10819,28,1264151363,1264151382,4,1,19
91405970@N00,10820,14,1295266196,1295266404,2,2,208
91405970@N00,10820,29,1295263718,1295264473,2,2,755
91405970@N00,10821,18,1303547541,1303547541,1,1,0
91405970@N00,10822,7,1310908879,1310908879,1,1,0
91405970@N00,10823,14,1325343290,1325343290,1,2,0
91405970@N00,10823,28,1325341218,1325341218,1,2,0
91405970@N00,10824,7,1330535061,1330535061,1,3,0
91405970@N00,10824,29,1330534981,1330534981,1,3,0
91405970@N00,10824,28,1330533875,1330543356,2,3,9481
91407458@N00,10825,22,1370916413,1370916413,1,1,0
91428589@N00,10826,12,1206613382,1206613382,1,1,0
91428589@N00,10827,12,1299752583,1299752583,1,2,0
91428589@N00,10827,25,1299752590,1299752617,4,2,27
91439732@N06,10828,24,1386145950,1386145950,1,1,0
91456744@N00,10829,28,1193804179,1193804179,1,1,0
91456744@N00,10830,17,1256774955,1256795600,25,1,20645
91466877@N00,10831,6,1388123903,1388123903,1,1,0
91466877@N00,10832,4,1388831507,1388831507,1,1,0
91470130@N02,10833,1,1382606916,1382606916,1,1,0
91488079@N06,10834,26,1260603669,1260603669,1,2,0
91488079@N06,10834,28,1260608007,1260608007,1,2,0
91509272@N00,10835,17,1218929298,1218929298,1,1,0
91509272@N00,10836,28,1284371006,1284371006,1,1,0
91509272@N00,10837,28,1297576573,1297576573,1,1,0
91509272@N00,10838,26,1304808893,1304808893,1,2,0
91509272@N00,10838,30,1304817829,1304817829,1,2,0
91525158@N00,10839,14,1369567374,1369567374,1,1,0
91535662@N06,10840,23,1361321185,1361321185,1,7,0
91535662@N06,10840,24,1361341839,1361341839,1,7,0
91535662@N06,10840,9,1361329631,1361329631,1,7,0
91535662@N06,10840,15,1361328080,1361328080,1,7,0
91535662@N06,10840,1,1361318289,1361318612,2,7,323
91535662@N06,10840,26,1361320798,1361320798,1,7,0
91535662@N06,10840,16,1361320852,1361320852,1,7,0
91550294@N08,10841,18,1406289778,1406289778,1,2,0
91550294@N08,10841,1,1406287530,1406287545,2,2,15
91550294@N08,10842,14,1406347023,1406347040,3,2,17
91550294@N08,10842,28,1406340771,1406340771,1,2,0
91563382@N00,10843,1,1451345564,1451348185,2,3,2621
91563382@N00,10843,25,1451352520,1451352532,2,3,12
91563382@N00,10843,28,1451348203,1451348203,1,3,0
91604003@N02,10844,24,1444287075,1444287075,1,3,0
91604003@N02,10844,30,1444289285,1444294773,2,3,5488
91604003@N02,10844,11,1444288871,1444288871,1,3,0
91604003@N02,10845,27,1444353957,1444354172,2,1,215
91604003@N02,10846,19,1444462224,1444462224,1,3,0
91604003@N02,10846,28,1444456096,1444456096,1,3,0
91604003@N02,10846,31,1444479226,1444479226,1,3,0
91646799@N06,10847,29,1380359488,1380359488,1,2,0
91646799@N06,10847,1,1380373458,1380373458,1,2,0
91673635@N00,10848,11,1243913153,1243913153,1,1,0
91675105@N02,10849,31,1356857707,1356857707,1,12,0
91675105@N02,10849,18,1356857832,1356857832,1,12,0
91675105@N02,10849,19,1356857790,1356857790,1,12,0
91675105@N02,10849,16,1356864164,1356864164,1,12,0
91675105@N02,10849,13,1356848208,1356848208,1,12,0
91675105@N02,10849,29,1356854755,1356857743,3,12,2988
91675105@N02,10849,1,1356846189,1356846189,1,12,0
91675105@N02,10849,28,1356866027,1356866031,2,12,4
91675105@N02,10849,25,1356848327,1356848344,3,12,17
91675105@N02,10849,27,1356859260,1356859260,1,12,0
91675105@N02,10849,15,1356850483,1356852172,5,12,1689
91675105@N02,10849,17,1356852235,1356852255,3,12,20
9171499@N02,10850,16,1221700900,1221700900,1,6,0
9171499@N02,10850,20,1221720834,1221721000,6,6,166
9171499@N02,10850,22,1221703570,1221716369,6,6,12799
9171499@N02,10850,10,1221703465,1221721450,4,6,17985
9171499@N02,10850,26,1221701117,1221701130,2,6,13
9171499@N02,10850,1,1221698365,1221698516,2,6,151
91730208@N02,10851,20,1357447861,1357447861,1,1,0
91731661@N06,10852,3,1346051060,1346051060,1,1,0
9173558@N05,10853,31,1395636199,1395636199,1,15,0
9173558@N05,10853,26,1395635942,1395635958,7,15,16
9173558@N05,10853,5,1395617964,1395619633,3,15,1669
9173558@N05,10853,8,1395636246,1395636269,2,15,23
9173558@N05,10853,4,1395615513,1395623208,13,15,7695
9173558@N05,10853,20,1395646033,1395646034,2,15,1
9173558@N05,10853,30,1395635724,1395648961,6,15,13237
9173558@N05,10853,18,1395638570,1395638583,2,15,13
9173558@N05,10853,21,1395619909,1395620560,2,15,651
9173558@N05,10853,13,1395621705,1395621706,2,15,1
9173558@N05,10853,23,1395648982,1395648986,2,15,4
9173558@N05,10853,16,1395635650,1395635727,3,15,77
9173558@N05,10853,7,1395615504,1395619124,4,15,3620
9173558@N05,10853,22,1395643403,1395643403,1,15,0
9173558@N05,10853,19,1395643873,1395643873,1,15,0
9173558@N05,10854,29,1395884711,1395884718,4,1,7
91746475@N06,10855,26,1379039625,1379039625,1,1,0
91746475@N06,10856,15,1383699533,1383699533,1,1,0
91746475@N06,10857,21,1387424461,1387424461,1,2,0
91746475@N06,10857,17,1387435555,1387435555,1,2,0
91773836@N03,10858,27,1359937594,1359937594,1,1,0
91773836@N03,10859,7,1360557393,1360557393,1,1,0
91773836@N03,10860,27,1363212433,1363212433,1,1,0
91773836@N03,10861,27,1363323664,1363323664,1,1,0
91773836@N03,10862,27,1363430027,1363430027,1,1,0
91773836@N03,10863,12,1366702562,1366702562,1,1,0
91773836@N03,10864,15,1367310987,1367310987,1,1,0
91773836@N03,10865,27,1371341256,1371341256,1,1,0
91785048@N00,10866,25,1336744130,1336744130,1,1,0
91802513@N07,10867,18,1365751441,1365751441,1,1,0
9180370@N05,10868,30,1342273833,1342273833,1,1,0
9180370@N05,10869,30,1368847193,1368847193,1,1,0
91805633@N04,10870,16,1382155373,1382187100,2,10,31727
91805633@N04,10870,28,1382155037,1382155069,3,10,32
91805633@N04,10870,10,1382158464,1382158625,4,10,161
91805633@N04,10870,15,1382155773,1382156321,10,10,548
91805633@N04,10870,29,1382185228,1382185228,1,10,0
91805633@N04,10870,24,1382156926,1382156926,1,10,0
91805633@N04,10870,21,1382157183,1382169966,4,10,12783
91805633@N04,10870,26,1382158857,1382158857,1,10,0
91805633@N04,10870,13,1382165247,1382165607,8,10,360
91805633@N04,10870,1,1382153868,1382153868,1,10,0
91805633@N04,10871,16,1425790299,1425801662,6,1,11363
91805633@N04,10872,16,1427775079,1427798598,8,1,23519
91805633@N04,10873,16,1432523855,1432538933,5,1,15078
91805633@N04,10874,16,1433308243,1433311341,2,1,3098
91824565@N00,10875,16,1250722943,1250723636,4,1,693
91828361@N00,10876,27,1356914123,1356914217,2,2,94
91828361@N00,10876,28,1356905129,1356905129,1,2,0
91828361@N00,10877,26,1357114704,1357114972,3,1,268
91852742@N00,10878,1,1208475168,1208498766,2,5,23598
91852742@N00,10878,19,1208476069,1208476069,1,5,0
91852742@N00,10878,20,1208522929,1208522929,1,5,0
91852742@N00,10878,30,1208485940,1208485940,1,5,0
91852742@N00,10878,14,1208487973,1208487973,1,5,0
91852742@N00,10879,26,1211793775,1211793775,1,1,0
91852742@N00,10880,26,1212148717,1212148717,1,1,0
91852742@N00,10881,26,1212234324,1212234324,1,1,0
91852742@N00,10882,23,1215134207,1215134207,1,2,0
91852742@N00,10882,11,1215146037,1215146037,1,2,0
91852742@N00,10883,21,1215239896,1215239896,1,1,0
91852742@N00,10884,23,1243855102,1243855102,1,4,0
91852742@N00,10884,28,1243851011,1243851011,1,4,0
91852742@N00,10884,26,1243834212,1243834212,1,4,0
91852742@N00,10884,24,1243819396,1243819396,1,4,0
91852742@N00,10885,29,1243951533,1243951533,1,2,0
91852742@N00,10885,28,1243947136,1243947136,1,2,0
9187766@N05,10886,24,1408359252,1408359252,1,3,0
9187766@N05,10886,25,1408354570,1408354570,1,3,0
9187766@N05,10886,10,1408353190,1408353806,4,3,616
9187766@N05,10887,26,1408449542,1408449542,1,2,0
9187766@N05,10887,1,1408439635,1408449840,2,2,10205
91889496@N02,10888,11,1364453238,1364453238,1,7,0
91889496@N02,10888,28,1364460608,1364460654,2,7,46
91889496@N02,10888,12,1364454747,1364454747,1,7,0
91889496@N02,10888,15,1364455196,1364455196,1,7,0
91889496@N02,10888,23,1364457097,1364457097,1,7,0
91889496@N02,10888,29,1364465637,1364465637,1,7,0
91889496@N02,10888,13,1364443796,1364443796,1,7,0
91889496@N02,10889,26,1384085612,1384085823,2,4,211
91889496@N02,10889,23,1384076678,1384076678,1,4,0
91889496@N02,10889,24,1384086868,1384086868,1,4,0
91889496@N02,10889,22,1384082061,1384082061,1,4,0
91889496@N02,10890,15,1387286144,1387286144,1,3,0
91889496@N02,10890,6,1387287092,1387287092,1,3,0
91889496@N02,10890,26,1387287852,1387288045,2,3,193
91889496@N02,10891,29,1387361923,1387361923,1,1,0
91889496@N02,10892,1,1391152013,1391152013,1,1,0
91889496@N02,10893,18,1391267780,1391267780,1,1,0
91889496@N02,10894,29,1391778530,1391778530,1,2,0
91889496@N02,10894,17,1391762203,1391762203,1,2,0
91889496@N02,10895,26,1412640911,1412640911,1,1,0
91889496@N02,10896,26,1418038679,1418038679,1,1,0
91889496@N02,10897,23,1420443297,1420443297,1,1,0
91889496@N02,10898,28,1421227951,1421227951,1,1,0
91889496@N02,10899,28,1422430337,1422430337,1,3,0
91889496@N02,10899,19,1422426974,1422426974,1,3,0
91889496@N02,10899,20,1422398558,1422399072,2,3,514
91889496@N02,10900,29,1422500706,1422501178,2,1,472
91920885@N07,10901,30,1370145643,1370145643,1,1,0
91925628@N02,10902,1,1368229629,1368229629,1,1,0
91929871@N05,10903,19,1406016803,1406016803,1,1,0
91937493@N00,10904,29,1227254006,1227254006,1,1,0
91937493@N00,10905,26,1227284432,1227284432,1,2,0
91937493@N00,10905,29,1227283135,1227283135,1,2,0
9195858@N03,10906,23,1381658710,1381658710,1,1,0
9195858@N03,10907,28,1381899758,1381899758,1,1,0
92025065@N00,10908,22,1347248328,1347248328,1,1,0
92073805@N00,10909,28,1361752544,1361779190,21,2,26646
92073805@N00,10909,23,1361754001,1361754001,1,2,0
92073805@N00,10910,28,1361840429,1361873844,13,1,33415
92087764@N02,10911,1,1366786340,1366801123,5,1,14783
92166021@N04,10912,18,1399872323,1399872323,1,1,0
92171126@N00,10913,20,1340784153,1340784153,1,1,0
92171126@N00,10914,27,1370041939,1370041966,2,5,27
92171126@N00,10914,11,1370044657,1370044657,1,5,0
92171126@N00,10914,21,1370048999,1370048999,1,5,0
92171126@N00,10914,22,1370049445,1370049445,1,5,0
92171126@N00,10914,25,1370049079,1370049481,9,5,402
92171126@N00,10915,29,1370082904,1370082904,1,2,0
92171126@N00,10915,30,1370084764,1370084764,1,2,0
92227871@N00,10916,26,1198222643,1198222643,1,1,0
92227871@N00,10917,26,1198289459,1198289459,1,1,0
92237387@N00,10918,17,1235952972,1235981688,5,1,28716
92237387@N00,10919,28,1268453421,1268453421,1,1,0
92237387@N00,10920,30,1317855393,1317855750,2,5,357
92237387@N00,10920,26,1317854191,1317854191,1,5,0
92237387@N00,10920,23,1317866366,1317866366,1,5,0
92237387@N00,10920,25,1317870531,1317870531,1,5,0
92237387@N00,10920,20,1317863667,1317863667,1,5,0
92237387@N00,10921,26,1318216557,1318216557,1,3,0
92237387@N00,10921,16,1318208403,1318208403,1,3,0
92237387@N00,10921,13,1318210808,1318210808,1,3,0
92237387@N00,10922,19,1336779785,1336779785,1,4,0
92237387@N00,10922,26,1336823658,1336823658,1,4,0
92237387@N00,10922,28,1336794345,1336822301,3,4,27956
92237387@N00,10922,22,1336785843,1336785843,1,4,0
92237387@N00,10923,30,1336872754,1336872754,1,1,0
92237387@N00,10924,28,1363402956,1363402956,1,1,0
92248782@N00,10925,11,1412896043,1412896043,1,9,0
92248782@N00,10925,15,1412908492,1412913498,2,9,5006
92248782@N00,10925,3,1412897948,1412897948,1,9,0
92248782@N00,10925,24,1412915456,1412915456,1,9,0
92248782@N00,10925,27,1412908996,1412908996,1,9,0
92248782@N00,10925,7,1412896626,1412896626,1,9,0
92248782@N00,10925,13,1412901384,1412905494,7,9,4110
92248782@N00,10925,1,1412893336,1412893337,2,9,1
92248782@N00,10925,16,1412918360,1412918360,1,9,0
92248782@N00,10926,26,1413175683,1413175683,1,9,0
92248782@N00,10926,28,1413187851,1413187851,1,9,0
92248782@N00,10926,30,1413175687,1413176072,6,9,385
92248782@N00,10926,24,1413163701,1413163895,2,9,194
92248782@N00,10926,27,1413177093,1413180347,4,9,3254
92248782@N00,10926,12,1413163886,1413163894,2,9,8
92248782@N00,10926,17,1413165684,1413178357,7,9,12673
92248782@N00,10926,14,1413153547,1413187214,2,9,33667
92248782@N00,10926,16,1413177107,1413198529,6,9,21422
92307895@N05,10927,18,1448243333,1448243333,1,1,0
92316033@N06,10928,25,1380533139,1380533139,1,1,0
92328493@N00,10929,13,1437971632,1437971713,2,1,81
92328493@N00,10930,27,1438048539,1438048539,1,2,0
92328493@N00,10930,17,1438048565,1438048599,2,2,34
92328493@N00,10931,13,1438144174,1438144174,1,1,0
92334226@N00,10932,13,1438129860,1438129860,1,3,0
92334226@N00,10932,18,1438129801,1438154330,2,3,24529
92334226@N00,10932,17,1438167308,1438167308,1,3,0
92334226@N00,10933,13,1438205303,1438205303,1,6,0
92334226@N00,10933,29,1438205188,1438205188,1,6,0
92334226@N00,10933,18,1438205230,1438205428,2,6,198
92334226@N00,10933,30,1438212874,1438228301,2,6,15427
92334226@N00,10933,19,1438210449,1438212551,2,6,2102
92334226@N00,10933,1,1438228293,1438228293,1,6,0
92334226@N00,10934,29,1438296525,1438296525,1,1,0
92334226@N00,10935,16,1438390208,1438390208,1,1,0
92391434@N05,10936,27,1377684173,1377684173,1,2,0
92391434@N05,10936,28,1377683863,1377683863,1,2,0
92405885@N00,10937,26,1370772271,1370772271,1,1,0
92461652@N07,10938,15,1418947706,1418947706,1,1,0
92495052@N05,10939,18,1359028675,1359028675,1,1,0
92533979@N00,10940,28,1324587113,1324587113,1,7,0
92533979@N00,10940,7,1324622228,1324622228,1,7,0
92533979@N00,10940,21,1324605627,1324605627,1,7,0
92533979@N00,10940,27,1324589903,1324589903,1,7,0
92533979@N00,10940,26,1324615257,1324615297,2,7,40
92533979@N00,10940,17,1324589251,1324589251,1,7,0
92533979@N00,10940,24,1324614066,1324614066,1,7,0
92536703@N02,10941,17,1361076051,1361076051,1,2,0
92536703@N02,10941,28,1361077805,1361077805,1,2,0
92543707@N00,10942,27,1224167069,1224167069,1,1,0
9255029@N04,10943,26,1313380649,1313418856,36,1,38207
9255029@N04,10944,26,1315556598,1315556598,1,1,0
9255029@N04,10945,26,1316792674,1316792674,1,1,0
92582562@N00,10946,25,1402979886,1402979886,1,1,0
92599451@N08,10947,5,1234411317,1234411629,3,6,312
92599451@N08,10947,25,1234403326,1234403372,2,6,46
92599451@N08,10947,11,1234413381,1234413381,1,6,0
92599451@N08,10947,12,1234401159,1234402625,3,6,1466
92599451@N08,10947,31,1234404219,1234404219,1,6,0
92599451@N08,10947,13,1234408008,1234408378,2,6,370
92599451@N08,10948,29,1234485201,1234485201,1,3,0
92599451@N08,10948,31,1234487820,1234488958,2,3,1138
92599451@N08,10948,19,1234484517,1234486316,2,3,1799
92599451@N08,10949,26,1234830739,1234831039,7,7,300
92599451@N08,10949,20,1234831708,1234831745,2,7,37
92599451@N08,10949,25,1234848534,1234848534,1,7,0
92599451@N08,10949,15,1234836910,1234843975,2,7,7065
92599451@N08,10949,29,1234831312,1234831312,1,7,0
92599451@N08,10949,12,1234830472,1234830472,1,7,0
92599451@N08,10949,10,1234831065,1234834680,2,7,3615
92599451@N08,10950,28,1312499473,1312499500,2,3,27
92599451@N08,10950,1,1312499149,1312499340,2,3,191
92599451@N08,10950,13,1312512165,1312516516,4,3,4351
92599451@N08,10951,12,1312607015,1312607015,1,5,0
92599451@N08,10951,14,1312604545,1312604545,1,5,0
92599451@N08,10951,28,1312607880,1312607880,1,5,0
92599451@N08,10951,20,1312605700,1312605700,1,5,0
92599451@N08,10951,15,1312591559,1312591559,1,5,0
92599451@N08,10952,28,1312673726,1312696098,3,1,22372
92599451@N08,10953,28,1312756004,1312781892,7,5,25888
92599451@N08,10953,20,1312763893,1312763942,2,5,49
92599451@N08,10953,31,1312775388,1312775388,1,5,0
92599451@N08,10953,29,1312763547,1312763632,2,5,85
92599451@N08,10953,26,1312766064,1312775079,7,5,9015
92599451@N08,10954,28,1312950607,1312950607,1,4,0
92599451@N08,10954,31,1312950718,1312952248,4,4,1530
92599451@N08,10954,1,1312944537,1312961031,6,4,16494
92599451@N08,10954,26,1312957500,1312958224,6,4,724
92599451@N08,10955,28,1356165288,1356165600,2,1,312
92599451@N08,10956,28,1356217383,1356240004,6,2,22621
92599451@N08,10956,26,1356218522,1356262869,10,2,44347
92599451@N08,10957,30,1356317784,1356317784,1,8,0
92599451@N08,10957,8,1356340939,1356340939,1,8,0
92599451@N08,10957,14,1356324001,1356324093,3,8,92
92599451@N08,10957,28,1356306354,1356335088,8,8,28734
92599451@N08,10957,25,1356334036,1356334036,1,8,0
92599451@N08,10957,29,1356319494,1356319494,1,8,0
92599451@N08,10957,16,1356340816,1356340816,1,8,0
92599451@N08,10957,26,1356314731,1356343146,14,8,28415
92599451@N08,10958,30,1356402802,1356402802,1,7,0
92599451@N08,10958,28,1356399343,1356399343,1,7,0
92599451@N08,10958,18,1356398266,1356400063,2,7,1797
92599451@N08,10958,10,1356399594,1356399594,1,7,0
92599451@N08,10958,20,1356399601,1356399601,1,7,0
92599451@N08,10958,31,1356401089,1356401089,1,7,0
92599451@N08,10958,29,1356399771,1356399771,1,7,0
92599451@N08,10959,13,1356656712,1356656712,2,2,0
92599451@N08,10959,21,1356653685,1356653685,1,2,0
92599451@N08,10960,28,1356694531,1356694531,1,1,0
92599451@N08,10961,13,1356752927,1356753160,2,2,233
92599451@N08,10961,27,1356742463,1356742463,1,2,0
92662849@N00,10962,20,1199009557,1199009557,1,2,0
92662849@N00,10962,15,1199005392,1199005392,1,2,0
92662849@N00,10963,26,1203214139,1203214175,2,1,36
92662849@N00,10964,27,1217763953,1217763953,1,2,0
92662849@N00,10964,4,1217767055,1217767066,2,2,11
92688599@N00,10965,26,1256607839,1256627783,25,2,19944
92688599@N00,10965,17,1256627763,1256627763,1,2,0
92692548@N02,10966,8,1437809382,1437809382,1,3,0
92692548@N02,10966,26,1437809452,1437809452,1,3,0
92692548@N02,10966,25,1437806105,1437806105,1,3,0
92692548@N02,10967,16,1437903130,1437903222,2,6,92
92692548@N02,10967,13,1437903880,1437904052,2,6,172
92692548@N02,10967,22,1437878726,1437878726,1,6,0
92692548@N02,10967,19,1437874831,1437874831,1,6,0
92692548@N02,10967,24,1437892849,1437892849,1,6,0
92692548@N02,10967,6,1437869348,1437869348,1,6,0
92692548@N02,10968,26,1438050177,1438050177,1,5,0
92692548@N02,10968,4,1438055203,1438055203,1,5,0
92692548@N02,10968,21,1438052810,1438081249,5,5,28439
92692548@N02,10968,11,1438051860,1438051860,1,5,0
92692548@N02,10968,20,1438070518,1438071737,2,5,1219
92692548@N02,10969,16,1438139099,1438139099,1,4,0
92692548@N02,10969,22,1438149195,1438149195,1,4,0
92692548@N02,10969,12,1438142993,1438142993,1,4,0
92692548@N02,10969,24,1438141108,1438143167,2,4,2059
92695692@N00,10970,27,1384653528,1384653528,1,3,0
92695692@N00,10970,16,1384658355,1384675445,2,3,17090
92695692@N00,10970,17,1384674629,1384675377,2,3,748
92806841@N00,10971,18,1348798395,1348798414,3,4,19
92806841@N00,10971,29,1348791013,1348791013,1,4,0
92806841@N00,10971,20,1348791016,1348791028,2,4,12
92806841@N00,10971,28,1348799280,1348799290,2,4,10
92859439@N06,10972,7,1315199540,1315199540,1,1,0
92859439@N06,10973,17,1346273669,1346273669,1,1,0
92859439@N06,10974,16,1346425735,1346425735,1,1,0
92859439@N06,10975,30,1350653513,1350653513,1,1,0
92859439@N06,10976,1,1352644276,1352644276,1,1,0
92859439@N06,10977,17,1354297134,1354297134,1,3,0
92859439@N06,10977,23,1354298635,1354298635,1,3,0
92859439@N06,10977,30,1354304768,1354304768,1,3,0
92859439@N06,10978,18,1357395144,1357395861,3,1,717
92859439@N06,10979,30,1358507309,1358507309,1,1,0
92859439@N06,10980,28,1358703495,1358703495,1,1,0
92859439@N06,10981,26,1359202627,1359209838,3,5,7211
92859439@N06,10981,21,1359213522,1359213522,1,5,0
92859439@N06,10981,28,1359202208,1359213106,2,5,10898
92859439@N06,10981,13,1359206168,1359206168,1,5,0
92859439@N06,10981,12,1359209539,1359209539,1,5,0
92859439@N06,10982,29,1359745325,1359745325,1,4,0
92859439@N06,10982,28,1359720495,1359720495,1,4,0
92859439@N06,10982,30,1359711288,1359713709,2,4,2421
92859439@N06,10982,7,1359706593,1359706593,1,4,0
92859439@N06,10983,24,1359898286,1359898286,1,3,0
92859439@N06,10983,13,1359895097,1359895097,1,3,0
92859439@N06,10983,15,1359904664,1359904664,1,3,0
92859439@N06,10984,20,1360320279,1360320279,1,5,0
92859439@N06,10984,28,1360307269,1360310808,2,5,3539
92859439@N06,10984,13,1360313443,1360313443,1,5,0
92859439@N06,10984,19,1360308677,1360308677,1,5,0
92859439@N06,10984,23,1360317285,1360317285,1,5,0
92859439@N06,10985,26,1360431707,1360431707,1,1,0
92859439@N06,10986,26,1360757798,1360757798,1,1,0
92885634@N00,10987,30,1317900806,1317900806,1,1,0
92885634@N00,10988,20,1318502354,1318502354,1,1,0
92919323@N00,10989,1,1405063065,1405063065,1,2,0
92919323@N00,10989,11,1405067835,1405070181,2,2,2346
92942546@N03,10990,26,1381477163,1381477163,1,1,0
92942546@N03,10991,26,1381531748,1381538278,13,1,6530
92942546@N03,10992,26,1381620690,1381635957,7,1,15267
92942546@N03,10993,26,1401172429,1401187082,5,1,14653
92942546@N03,10994,26,1401235224,1401265474,8,1,30250
92942546@N03,10995,26,1401327793,1401327793,1,1,0
92942546@N03,10996,26,1401510468,1401539108,2,1,28640
92942546@N03,10997,26,1401586913,1401594387,2,1,7474
92942546@N03,10998,26,1401687456,1401688007,2,1,551
92942546@N03,10999,26,1401798587,1401802977,4,1,4390
92942546@N03,11000,26,1401930769,1401930769,1,1,0
92942546@N03,11001,26,1402457624,1402457688,3,1,64
92942546@N03,11002,26,1408749433,1408749558,2,1,125
92942546@N03,11003,26,1409731461,1409731461,9,1,0
92942546@N03,11004,26,1409829358,1409829358,1,1,0
92942546@N03,11005,26,1410141537,1410141537,5,1,0
92942546@N03,11006,26,1416645134,1416650704,27,1,5570
92942546@N03,11007,26,1418103321,1418128373,15,1,25052
92942546@N03,11008,26,1423362277,1423363269,5,1,992
92942546@N03,11009,26,1428050666,1428050666,1,1,0
92942546@N03,11010,26,1428140438,1428147981,6,1,7543
92942546@N03,11011,26,1429430014,1429430188,2,1,174
92942546@N03,11012,26,1429591568,1429593996,4,1,2428
92942546@N03,11013,26,1430303276,1430303955,3,1,679
92942546@N03,11014,26,1430540388,1430540388,1,1,0
92942546@N03,11015,26,1432638558,1432639348,6,1,790
92942546@N03,11016,26,1432904777,1432908738,12,1,3961
92942546@N03,11017,26,1432991202,1432991228,2,1,26
92942546@N03,11018,26,1436009245,1436018481,21,1,9236
92942546@N03,11019,26,1437142554,1437143160,3,1,606
92942546@N03,11020,26,1439973267,1439982412,5,1,9145
92942546@N03,11021,26,1440120961,1440132585,5,1,11624
92942546@N03,11022,26,1442025884,1442045968,3,1,20084
92942546@N03,11023,26,1442140342,1442140342,1,1,0
92942546@N03,11024,26,1442195727,1442209012,4,1,13285
92942546@N03,11025,26,1445065455,1445072675,8,1,7220
92942546@N03,11026,26,1447152835,1447152835,1,1,0
93042417@N04,11027,13,1454463422,1454463571,2,2,149
93042417@N04,11027,17,1454461208,1454461208,1,2,0
93098533@N08,11028,26,1390643744,1390643744,1,1,0
93098533@N08,11029,1,1390692550,1390692550,1,1,0
93098533@N08,11030,24,1390738080,1390738080,1,3,0
93098533@N08,11030,17,1390737535,1390737535,1,3,0
93098533@N08,11030,1,1390741001,1390741001,1,3,0
93140563@N05,11031,28,1308700036,1308700036,1,1,0
93155627@N00,11032,20,1340446666,1340446666,1,1,0
93174687@N06,11033,1,1424554841,1424554841,1,1,0
93174687@N06,11034,1,1424729422,1424729422,1,1,0
93273046@N00,11035,20,1443949734,1443949734,1,1,0
93273458@N00,11036,29,1297992025,1297992350,2,1,325
93273458@N00,11037,11,1299823723,1299823735,2,5,12
93273458@N00,11037,21,1299823906,1299823906,1,5,0
93273458@N00,11037,26,1299818032,1299818273,6,5,241
93273458@N00,11037,20,1299821586,1299822626,2,5,1040
93273458@N00,11037,29,1299818727,1299820433,3,5,1706
93273458@N00,11038,17,1345865517,1345865517,1,2,0
93273458@N00,11038,18,1345866396,1345866396,1,2,0
93273458@N00,11039,29,1345976618,1345976618,1,3,0
93273458@N00,11039,13,1345962339,1345962339,1,3,0
93273458@N00,11039,14,1345969892,1345969892,1,3,0
93273458@N00,11040,24,1346039644,1346039644,1,4,0
93273458@N00,11040,18,1346036286,1346036286,1,4,0
93273458@N00,11040,30,1346054935,1346054935,1,4,0
93273458@N00,11040,29,1346056782,1346058366,4,4,1584
93273458@N00,11041,28,1357171757,1357171757,1,3,0
93273458@N00,11041,20,1357175838,1357181004,2,3,5166
93273458@N00,11041,29,1357177313,1357177313,1,3,0
93273458@N00,11042,18,1357216231,1357216231,1,3,0
93273458@N00,11042,27,1357216708,1357216708,1,3,0
93273458@N00,11042,28,1357219849,1357219849,1,3,0
93273458@N00,11043,8,1357254252,1357254252,1,4,0
93273458@N00,11043,17,1357250815,1357250815,1,4,0
93273458@N00,11043,25,1357255795,1357255795,1,4,0
93273458@N00,11043,26,1357266787,1357266787,1,4,0
93273458@N00,11044,14,1357303448,1357303448,1,5,0
93273458@N00,11044,30,1357301475,1357301475,1,5,0
93273458@N00,11044,27,1357298343,1357298343,1,5,0
93273458@N00,11044,26,1357305670,1357305670,1,5,0
93273458@N00,11044,29,1357300398,1357300398,1,5,0
93273458@N00,11045,29,1357349732,1357349732,1,1,0
93273458@N00,11046,12,1357418511,1357418511,1,3,0
93273458@N00,11046,1,1357416608,1357416608,1,3,0
93273458@N00,11046,26,1357441501,1357441501,1,3,0
93273458@N00,11047,20,1371352758,1371352758,1,3,0
93273458@N00,11047,30,1371347313,1371347313,1,3,0
93273458@N00,11047,29,1371340429,1371340429,1,3,0
93273458@N00,11048,1,1371484325,1371484325,1,1,0
93273458@N00,11049,29,1371522758,1371522758,1,1,0
93273458@N00,11050,12,1378038885,1378038885,1,3,0
93273458@N00,11050,13,1378031244,1378031244,1,3,0
93273458@N00,11050,26,1378034296,1378034296,1,3,0
93294881@N00,11051,19,1413599217,1413599217,1,1,0
93294881@N00,11052,23,1427016227,1427016227,1,1,0
93294881@N00,11053,18,1431241996,1431241996,1,1,0
9329852@N08,11054,22,1193820262,1193820305,4,1,43
9329852@N08,11055,29,1245479005,1245479005,1,4,0
9329852@N08,11055,22,1245475631,1245475631,1,4,0
9329852@N08,11055,16,1245490425,1245490789,3,4,364
9329852@N08,11055,30,1245474709,1245476428,6,4,1719
93384689@N08,11056,15,1446955323,1446955323,1,7,0
93384689@N08,11056,20,1446944636,1446946868,3,7,2232
93384689@N08,11056,28,1446939716,1446939716,1,7,0
93384689@N08,11056,13,1446960849,1446961013,2,7,164
93384689@N08,11056,25,1446951465,1446952630,2,7,1165
93384689@N08,11056,1,1446939589,1446939598,2,7,9
93384689@N08,11056,16,1446956294,1446956294,1,7,0
93456955@N00,11057,28,1203291041,1203291041,1,1,0
93456955@N00,11058,3,1203321103,1203321116,2,1,13
93467796@N03,11059,28,1377074307,1377075276,11,4,969
93467796@N03,11059,16,1377083362,1377083362,1,4,0
93467796@N03,11059,26,1377083087,1377083087,1,4,0
93467796@N03,11059,15,1377077992,1377078410,2,4,418
93467796@N03,11060,13,1377137600,1377139441,2,7,1841
93467796@N03,11060,16,1377157650,1377157650,1,7,0
93467796@N03,11060,5,1377135250,1377135452,2,7,202
93467796@N03,11060,4,1377137011,1377137011,1,7,0
93467796@N03,11060,27,1377158150,1377158150,1,7,0
93467796@N03,11060,1,1377149559,1377149559,1,7,0
93467796@N03,11060,19,1377151381,1377151381,1,7,0
93472335@N02,11061,28,1434282200,1434282326,13,4,126
93472335@N02,11061,4,1434271629,1434271642,4,4,13
93472335@N02,11061,1,1434268968,1434269033,9,4,65
93472335@N02,11061,26,1434269682,1434269687,5,4,5
93472335@N02,11062,1,1450167268,1450167271,2,2,3
93472335@N02,11062,28,1450167397,1450169080,8,2,1683
93472335@N02,11063,6,1465373138,1465373138,1,4,0
93472335@N02,11063,7,1465373067,1465373067,1,4,0
93472335@N02,11063,27,1465384533,1465384541,2,4,8
93472335@N02,11063,25,1465375245,1465376001,5,4,756
93509642@N04,11064,21,1388595015,1388595015,1,2,0
93509642@N04,11064,28,1388599183,1388599183,1,2,0
93525156@N00,11065,30,1354677399,1354678044,2,7,645
93525156@N00,11065,3,1354683361,1354686293,3,7,2932
93525156@N00,11065,28,1354669830,1354669830,1,7,0
93525156@N00,11065,12,1354683549,1354683549,1,7,0
93525156@N00,11065,21,1354674564,1354686050,2,7,11486
93525156@N00,11065,26,1354682670,1354682717,3,7,47
93525156@N00,11065,7,1354676515,1354676515,1,7,0
93525156@N00,11066,24,1354772868,1354772868,1,4,0
93525156@N00,11066,12,1354773548,1354773548,1,4,0
93525156@N00,11066,21,1354773579,1354773579,1,4,0
93525156@N00,11066,25,1354773077,1354773077,1,4,0
93538039@N06,11067,20,1364602539,1364602539,1,1,0
93538039@N06,11068,20,1364850600,1364850812,2,1,212
93538039@N06,11069,29,1365068387,1365068387,1,1,0
93538039@N06,11070,26,1365723551,1365723551,1,1,0
93538039@N06,11071,28,1365859371,1365859502,2,2,131
93538039@N06,11071,17,1365860496,1365860496,1,2,0
93538039@N06,11072,28,1365990599,1365992729,2,1,2130
93538039@N06,11073,12,1367562448,1367562552,2,1,104
93538039@N06,11074,12,1367615533,1367616794,2,3,1261
93538039@N06,11074,14,1367616078,1367616078,1,3,0
93538039@N06,11074,28,1367617033,1367617033,1,3,0
93538039@N06,11075,12,1367842968,1367843097,2,1,129
93538039@N06,11076,20,1368065261,1368065261,1,10,0
93538039@N06,11076,28,1368076982,1368104587,5,10,27605
93538039@N06,11076,3,1368069136,1368069324,2,10,188
93538039@N06,11076,21,1368068805,1368068805,1,10,0
93538039@N06,11076,26,1368067931,1368067931,1,10,0
93538039@N06,11076,31,1368064225,1368064324,2,10,99
93538039@N06,11076,6,1368068136,1368068136,1,10,0
93538039@N06,11076,15,1368073077,1368107622,6,10,34545
93538039@N06,11076,27,1368104720,1368104892,2,10,172
93538039@N06,11076,29,1368065492,1368096792,4,10,31300
93538039@N06,11077,15,1368263881,1368263881,1,2,0
93538039@N06,11077,27,1368263992,1368263992,1,2,0
93538039@N06,11078,20,1370170582,1370171246,2,3,664
93538039@N06,11078,28,1370171590,1370171590,1,3,0
93538039@N06,11078,17,1370171346,1370171346,1,3,0
93538039@N06,11079,28,1383809051,1383809051,1,1,0
93595313@N07,11080,27,1428660503,1428660535,2,2,32
93595313@N07,11080,16,1428660947,1428664584,5,2,3637
93629101@N05,11081,15,1432365432,1432365432,1,13,0
93629101@N05,11081,19,1432361256,1432361256,1,13,0
93629101@N05,11081,29,1432360774,1432362484,7,13,1710
93629101@N05,11081,21,1432363635,1432363635,1,13,0
93629101@N05,11081,20,1432358868,1432360144,13,13,1276
93629101@N05,11081,28,1432357127,1432384340,70,13,27213
93629101@N05,11081,26,1432357489,1432369464,3,13,11975
93629101@N05,11081,17,1432365629,1432369269,13,13,3640
93629101@N05,11081,30,1432357923,1432357923,1,13,0
93629101@N05,11081,3,1432363644,1432364915,25,13,1271
93629101@N05,11081,1,1432356799,1432357024,5,13,225
93629101@N05,11081,8,1432364779,1432364847,5,13,68
93629101@N05,11081,27,1432369118,1432369125,2,13,7
93629101@N05,11082,28,1432530593,1432530593,1,1,0
93649382@N00,11083,26,1427667249,1427667249,1,8,0
93649382@N00,11083,13,1427678360,1427688705,2,8,10345
93649382@N00,11083,4,1427668074,1427668096,3,8,22
93649382@N00,11083,24,1427688954,1427688954,1,8,0
93649382@N00,11083,3,1427669302,1427669302,1,8,0
93649382@N00,11083,1,1427686255,1427689541,6,8,3286
93649382@N00,11083,25,1427673120,1427673512,4,8,392
93649382@N00,11083,20,1427687467,1427687467,1,8,0
93649382@N00,11084,26,1427773626,1427773630,4,7,4
93649382@N00,11084,8,1427773606,1427773606,2,7,0
93649382@N00,11084,15,1427769410,1427769667,8,7,257
93649382@N00,11084,24,1427752792,1427766369,4,7,13577
93649382@N00,11084,16,1427751974,1427751974,1,7,0
93649382@N00,11084,17,1427750166,1427750166,1,7,0
93649382@N00,11084,20,1427777424,1427777440,6,7,16
93652979@N00,11085,29,1321167723,1321167730,2,4,7
93652979@N00,11085,28,1321178052,1321178052,1,4,0
93652979@N00,11085,20,1321172561,1321172561,1,4,0
93652979@N00,11085,31,1321167627,1321167627,1,4,0
93677566@N00,11086,31,1364198587,1364198638,3,2,51
93677566@N00,11086,1,1364183716,1364183716,1,2,0
93677566@N00,11087,27,1385093978,1385094024,2,2,46
93677566@N00,11087,17,1385089939,1385089939,1,2,0
93677566@N00,11088,18,1445497636,1445507598,2,1,9962
93752018@N00,11089,22,1222994804,1223008833,10,15,14029
93752018@N00,11089,19,1222988147,1222991254,3,15,3107
93752018@N00,11089,11,1222997918,1223011218,3,15,13300
93752018@N00,11089,8,1223001116,1223001116,1,15,0
93752018@N00,11089,10,1222999313,1222999384,2,15,71
93752018@N00,11089,4,1223004204,1223010990,7,15,6786
93752018@N00,11089,16,1222987661,1222987661,1,15,0
93752018@N00,11089,28,1222987549,1223034478,3,15,46929
93752018@N00,11089,29,1222991568,1222993137,4,15,1569
93752018@N00,11089,18,1222987739,1222990855,8,15,3116
93752018@N00,11089,12,1223010028,1223013215,2,15,3187
93752018@N00,11089,5,1223003795,1223005506,3,15,1711
93752018@N00,11089,3,1223004509,1223004735,3,15,226
93752018@N00,11089,30,1222998389,1222998389,1,15,0
93752018@N00,11089,17,1223021717,1223021717,1,15,0
93762817@N08,11090,26,1390797726,1390797726,1,1,0
93842606@N05,11091,13,1302314575,1302314725,3,1,150
93842606@N05,11092,13,1302567981,1302567981,1,1,0
93867122@N05,11093,14,1380698910,1380698910,1,1,0
93884582@N00,11094,3,1293578947,1293578947,1,1,0
93886527@N06,11095,19,1415855014,1415855014,1,1,0
93900075@N03,11096,1,1363943289,1363943289,1,1,0
93925784@N00,11097,28,1356999843,1356999843,1,1,0
93929791@N08,11098,14,1429073603,1429073603,1,5,0
93929791@N08,11098,29,1429075566,1429076159,14,5,593
93929791@N08,11098,17,1429078997,1429082593,2,5,3596
93929791@N08,11098,1,1429067610,1429086755,5,5,19145
93929791@N08,11098,19,1429069727,1429074513,3,5,4786
93951343@N00,11099,22,1336968904,1336968904,1,1,0
93973823@N06,11100,17,1345385135,1345385161,2,2,26
93973823@N06,11100,20,1345370631,1345370631,1,2,0
94037364@N04,11101,27,1362784989,1362784989,1,1,0
94063583@N03,11102,1,1382331594,1382331594,1,1,0
94063583@N03,11103,1,1388800313,1388800514,3,1,201
94107540@N00,11104,13,1369787511,1369787511,1,1,0
9414486@N03,11105,30,1396141446,1396143073,2,3,1627
9414486@N03,11105,22,1396141983,1396142103,2,3,120
9414486@N03,11105,31,1396141680,1396141680,1,3,0
9414677@N06,11106,17,1200220004,1200222021,3,4,2017
9414677@N06,11106,10,1200229579,1200229579,1,4,0
9414677@N06,11106,26,1200227361,1200227498,5,4,137
9414677@N06,11106,7,1200227731,1200229016,6,4,1285
9414677@N06,11107,17,1205651145,1205668336,7,4,17191
9414677@N06,11107,24,1205668389,1205668690,4,4,301
9414677@N06,11107,22,1205662650,1205663263,3,4,613
9414677@N06,11107,7,1205665216,1205666679,11,4,1463
9414677@N06,11108,28,1205758143,1205758178,2,4,35
9414677@N06,11108,18,1205753838,1205753838,2,4,0
9414677@N06,11108,22,1205734713,1205735881,6,4,1168
9414677@N06,11108,15,1205718285,1205719422,5,4,1137
94165326@N08,11109,19,1409453816,1409453816,1,1,0
94211311@N06,11110,28,1349095001,1349095001,1,1,0
9428455@N03,11111,28,1376180115,1376224989,16,7,44874
9428455@N03,11111,16,1376191210,1376191210,1,7,0
9428455@N03,11111,7,1376181580,1376181581,2,7,1
9428455@N03,11111,13,1376205360,1376207050,19,7,1690
9428455@N03,11111,1,1376180084,1376224782,2,7,44698
9428455@N03,11111,26,1376213890,1376213995,5,7,105
9428455@N03,11111,21,1376207617,1376207617,1,7,0
94291835@N00,11112,26,1202178544,1202208139,12,5,29595
94291835@N00,11112,1,1202169617,1202169617,1,5,0
94291835@N00,11112,3,1202185414,1202185668,2,5,254
94291835@N00,11112,16,1202170507,1202170507,1,5,0
94291835@N00,11112,22,1202175491,1202175491,1,5,0
94321013@N00,11113,28,1324342875,1324363259,2,1,20384
94363051@N00,11114,24,1266626555,1266626555,1,8,0
94363051@N00,11114,4,1266623377,1266623377,1,8,0
94363051@N00,11114,13,1266635829,1266641755,8,8,5926
94363051@N00,11114,3,1266622049,1266623918,7,8,1869
94363051@N00,11114,10,1266635027,1266635027,1,8,0
94363051@N00,11114,21,1266622302,1266623405,8,8,1103
94363051@N00,11114,15,1266625829,1266631216,5,8,5387
94363051@N00,11114,1,1266619744,1266620143,4,8,399
94439354@N00,11115,27,1320302141,1320302141,1,1,0
94483507@N04,11116,1,1382484850,1382522461,14,1,37611
94518441@N00,11117,16,1223453891,1223454785,14,1,894
94528619@N00,11118,28,1360033560,1360041491,27,15,7931
94528619@N00,11118,20,1360032467,1360032467,1,15,0
94528619@N00,11118,26,1360017434,1360042549,3,15,25115
94528619@N00,11118,27,1360016684,1360016684,1,15,0
94528619@N00,11118,23,1360028316,1360028688,2,15,372
94528619@N00,11118,15,1360069085,1360069085,1,15,0
94528619@N00,11118,24,1360045322,1360045322,1,15,0
94528619@N00,11118,5,1360027763,1360027763,1,15,0
94528619@N00,11118,7,1360026642,1360026642,1,15,0
94528619@N00,11118,29,1360030572,1360030572,1,15,0
94528619@N00,11118,4,1360026769,1360026769,1,15,0
94528619@N00,11118,3,1360027978,1360068617,2,15,40639
94528619@N00,11118,18,1360068414,1360068414,1,15,0
94528619@N00,11118,11,1360026361,1360026961,7,15,600
94528619@N00,11118,16,1360017429,1360021062,3,15,3633
94528619@N00,11119,28,1360146547,1360146547,1,2,0
94528619@N00,11119,4,1360146145,1360146145,1,2,0
94528619@N00,11120,11,1360237769,1360237769,1,1,0
94528619@N00,11121,25,1360315747,1360315747,1,1,0
94528619@N00,11122,18,1444100844,1444100844,1,1,0
94528619@N00,11123,18,1444343398,1444343398,1,1,0
94528619@N00,11124,21,1444391431,1444391431,1,1,0
94528619@N00,11125,18,1444432249,1444432249,1,1,0
94528619@N00,11126,27,1444478286,1444478286,1,1,0
94528619@N00,11127,15,1444528481,1444528481,1,1,0
94528619@N00,11128,18,1444628850,1444628850,1,1,0
94528619@N00,11129,6,1444699535,1444699535,1,1,0
94528619@N00,11130,27,1445432754,1445432754,1,1,0
94528619@N00,11131,25,1457369508,1457369508,1,1,0
9454157@N08,11132,26,1298649328,1298649328,1,1,0
9454157@N08,11133,30,1298710056,1298710056,1,1,0
9454157@N08,11134,26,1298772247,1298772247,1,3,0
9454157@N08,11134,1,1298749083,1298749083,1,3,0
9454157@N08,11134,29,1298741190,1298741190,1,3,0
94588149@N00,11135,28,1261225407,1261231117,10,3,5710
94588149@N00,11135,26,1261191201,1261222019,40,3,30818
94588149@N00,11135,10,1261223668,1261223668,1,3,0
94608516@N07,11136,28,1401007028,1401007559,4,6,531
94608516@N07,11136,12,1400980291,1400980659,2,6,368
94608516@N07,11136,11,1400971492,1400972365,3,6,873
94608516@N07,11136,25,1400982753,1400982753,1,6,0
94608516@N07,11136,19,1401009776,1401009776,1,6,0
94608516@N07,11136,21,1400987231,1400987231,1,6,0
94608516@N07,11137,19,1401094076,1401094076,1,1,0
94628763@N00,11138,31,1317423315,1317423315,1,2,0
94628763@N00,11138,10,1317428794,1317428794,1,2,0
94628763@N00,11139,11,1343129677,1343129677,1,1,0
94628763@N00,11140,28,1348578273,1348578273,1,1,0
94628763@N00,11141,28,1352465834,1352465834,1,1,0
94628763@N00,11142,1,1402539570,1402539570,1,1,0
94628763@N00,11143,26,1429397784,1429397784,1,1,0
94645446@N04,11144,26,1391726918,1391726918,1,2,0
94645446@N04,11144,11,1391727295,1391727295,1,2,0
94657254@N02,11145,18,1453360446,1453360446,1,1,0
94657254@N02,11146,18,1453415507,1453415507,1,1,0
94675251@N02,11147,30,1355932259,1355932259,1,1,0
94734319@N00,11148,3,1238410655,1238410655,1,2,0
94734319@N00,11148,24,1238413348,1238413360,2,2,12
94734319@N00,11149,29,1238492379,1238492405,3,9,26
94734319@N00,11149,10,1238497741,1238497741,1,9,0
94734319@N00,11149,19,1238485423,1238485423,1,9,0
94734319@N00,11149,16,1238500047,1238500051,2,9,4
94734319@N00,11149,31,1238459236,1238459247,2,9,11
94734319@N00,11149,12,1238500054,1238500065,2,9,11
94734319@N00,11149,3,1238500039,1238500044,2,9,5
94734319@N00,11149,30,1238485404,1238485419,4,9,15
94734319@N00,11149,26,1238457452,1238457498,2,9,46
94752424@N00,11150,1,1429506181,1429506354,2,1,173
94774760@N00,11151,17,1371383374,1371383374,1,3,0
94774760@N00,11151,12,1371355925,1371355925,1,3,0
94774760@N00,11151,15,1371388044,1371388044,1,3,0
94774760@N00,11152,17,1432644036,1432644036,1,1,0
9480786@N07,11153,31,1281408972,1281408972,1,1,0
9480786@N07,11154,9,1281561466,1281567252,4,1,5786
9480786@N07,11155,31,1281678515,1281678515,1,1,0
94808878@N00,11156,31,1348642381,1348642381,1,3,0
94808878@N00,11156,30,1348643153,1348643153,1,3,0
94808878@N00,11156,15,1348640326,1348640326,1,3,0
94812957@N00,11157,24,1214558443,1214558569,2,3,126
94812957@N00,11157,17,1214561636,1214562159,3,3,523
94812957@N00,11157,15,1214559336,1214559336,1,3,0
94865168@N00,11158,13,1317543076,1317543076,1,2,0
94865168@N00,11158,26,1317538269,1317538269,1,2,0
94921086@N08,11159,26,1403965151,1403965151,1,3,0
94921086@N08,11159,23,1403943966,1403943966,1,3,0
94921086@N08,11159,29,1403919378,1403957819,3,3,38441
94935685@N00,11160,27,1189007176,1189007176,1,5,0
94935685@N00,11160,26,1189008592,1189008592,1,5,0
94935685@N00,11160,6,1189008063,1189008063,1,5,0
94935685@N00,11160,22,1189011436,1189011436,1,5,0
94935685@N00,11160,17,1189007029,1189007029,1,5,0
94935685@N00,11161,26,1189271530,1189271545,2,1,15
94935685@N00,11162,30,1189433284,1189440023,8,2,6739
94935685@N00,11162,23,1189438579,1189438594,2,2,15
94935685@N00,11163,27,1190466137,1190467296,5,6,1159
94935685@N00,11163,15,1190472000,1190472000,1,6,0
94935685@N00,11163,26,1190487577,1190487577,1,6,0
94935685@N00,11163,24,1190466674,1190469803,3,6,3129
94935685@N00,11163,16,1190466064,1190466542,3,6,478
94935685@N00,11163,17,1190466580,1190469255,6,6,2675
94935685@N00,11164,28,1191603229,1191603330,3,3,101
94935685@N00,11164,30,1191595193,1191595486,4,3,293
94935685@N00,11164,23,1191599931,1191600020,2,3,89
94935685@N00,11165,26,1192897339,1192905954,2,2,8615
94935685@N00,11165,16,1192901948,1192902112,10,2,164
94935685@N00,11166,30,1193506955,1193506955,1,1,0
94935685@N00,11167,27,1195911862,1195911947,2,3,85
94935685@N00,11167,26,1195900382,1195906037,5,3,5655
94935685@N00,11167,17,1195910218,1195911383,10,3,1165
94935685@N00,11168,29,1196581010,1196581393,3,1,383
94935685@N00,11169,26,1198921531,1198921531,1,1,0
94935685@N00,11170,1,1199432436,1199432450,2,3,14
94935685@N00,11170,17,1199438212,1199438212,1,3,0
94935685@N00,11170,25,1199440543,1199440554,2,3,11
94935685@N00,11171,28,1200758283,1200758332,2,2,49
94935685@N00,11171,26,1200772399,1200772399,1,2,0
94935685@N00,11172,17,1200902353,1200902558,5,3,205
94935685@N00,11172,24,1200896644,1200896644,1,3,0
94935685@N00,11172,28,1200891786,1200892378,4,3,592
94935685@N00,11173,28,1202014613,1202014671,7,1,58
94935685@N00,11174,26,1202082212,1202082219,2,1,7
94935685@N00,11175,1,1202556261,1202561271,16,3,5010
94935685@N00,11175,3,1202559005,1202559008,2,3,3
94935685@N00,11175,26,1202557615,1202557615,1,3,0
94942286@N07,11176,15,1302773785,1302773785,1,1,0
94942286@N07,11177,7,1367066377,1367066377,1,1,0
94942286@N07,11178,28,1369385778,1369385778,1,1,0
9496161@N07,11179,30,1318658789,1318658789,1,1,0
94965190@N06,11180,25,1405231611,1405231611,1,1,0
95050769@N05,11181,12,1367367794,1367367794,1,4,0
95050769@N05,11181,5,1367389262,1367389262,1,4,0
95050769@N05,11181,29,1367380090,1367408774,43,4,28684
95050769@N05,11181,7,1367389361,1367389361,1,4,0
95050769@N05,11182,26,1367538594,1367572492,2,4,33898
95050769@N05,11182,29,1367540525,1367586918,12,4,46393
95050769@N05,11182,23,1367568019,1367568019,1,4,0
95050769@N05,11182,28,1367547377,1367547377,1,4,0
95061722@N00,11183,26,1393210159,1393210159,1,7,0
95061722@N00,11183,4,1393227286,1393229968,2,7,2682
95061722@N00,11183,16,1393210154,1393217265,2,7,7111
95061722@N00,11183,19,1393213422,1393213422,1,7,0
95061722@N00,11183,13,1393222681,1393224173,2,7,1492
95061722@N00,11183,28,1393209819,1393209983,2,7,164
95061722@N00,11183,5,1393229981,1393229981,1,7,0
95061722@N00,11184,3,1393282681,1393282821,3,13,140
95061722@N00,11184,26,1393286984,1393287011,3,13,27
95061722@N00,11184,17,1393306214,1393306627,2,13,413
95061722@N00,11184,14,1393279134,1393279134,1,13,0
95061722@N00,11184,18,1393289793,1393289806,2,13,13
95061722@N00,11184,21,1393282285,1393282285,1,13,0
95061722@N00,11184,19,1393288658,1393288661,2,13,3
95061722@N00,11184,23,1393290053,1393290053,1,13,0
95061722@N00,11184,24,1393284128,1393295284,6,13,11156
95061722@N00,11184,15,1393283864,1393285531,4,13,1667
95061722@N00,11184,5,1393281106,1393281970,2,13,864
95061722@N00,11184,12,1393305277,1393305277,1,13,0
95061722@N00,11184,29,1393293020,1393293020,1,13,0
95061722@N00,11185,31,1393384434,1393384940,2,9,506
95061722@N00,11185,1,1393380643,1393380673,3,9,30
95061722@N00,11185,28,1393380326,1393386764,2,9,6438
95061722@N00,11185,16,1393391437,1393391628,3,9,191
95061722@N00,11185,23,1393384313,1393384313,1,9,0
95061722@N00,11185,12,1393388713,1393389222,2,9,509
95061722@N00,11185,30,1393384153,1393384324,3,9,171
95061722@N00,11185,19,1393381258,1393381669,3,9,411
95061722@N00,11185,29,1393384400,1393385482,2,9,1082
95061722@N00,11186,7,1393471298,1393473009,3,15,1711
95061722@N00,11186,14,1393466530,1393467280,6,15,750
95061722@N00,11186,26,1393468318,1393468318,1,15,0
95061722@N00,11186,4,1393471033,1393471693,2,15,660
95061722@N00,11186,6,1393470119,1393472704,3,15,2585
95061722@N00,11186,16,1393473699,1393473887,4,15,188
95061722@N00,11186,24,1393457120,1393475788,2,15,18668
95061722@N00,11186,18,1393463695,1393463707,2,15,12
95061722@N00,11186,17,1393459054,1393459054,1,15,0
95061722@N00,11186,15,1393475298,1393475298,1,15,0
95061722@N00,11186,22,1393467907,1393467907,1,15,0
95061722@N00,11186,11,1393472028,1393472028,1,15,0
95061722@N00,11186,29,1393464744,1393464744,1,15,0
95061722@N00,11186,12,1393473376,1393473376,1,15,0
95061722@N00,11186,28,1393488976,1393489944,11,15,968
95063789@N00,11187,26,1201902601,1201902674,3,2,73
95063789@N00,11187,28,1201902204,1201902224,2,2,20
95063789@N00,11188,26,1202033547,1202033547,1,3,0
95063789@N00,11188,27,1201990639,1202014269,5,3,23630
95063789@N00,11188,1,1202007199,1202007199,1,3,0
95071949@N00,11189,3,1354443651,1354443651,1,6,0
95071949@N00,11189,12,1354420404,1354421704,2,6,1300
95071949@N00,11189,10,1354441325,1354441346,2,6,21
95071949@N00,11189,7,1354442420,1354442420,1,6,0
95071949@N00,11189,25,1354429008,1354443808,3,6,14800
95071949@N00,11189,23,1354430029,1354430029,1,6,0
95090008@N02,11190,26,1362056400,1362056400,1,2,0
95090008@N02,11190,16,1362056400,1362056400,3,2,0
95101667@N00,11191,26,1428317669,1428317669,1,3,0
95101667@N00,11191,28,1428304334,1428304334,1,3,0
95101667@N00,11191,16,1428317691,1428319017,3,3,1326
9510444@N08,11192,4,1450343304,1450343304,1,2,0
9510444@N08,11192,20,1450325298,1450325298,1,2,0
95118343@N00,11193,28,1190775355,1190775355,1,1,0
95118343@N00,11194,3,1262743228,1262743228,1,2,0
95118343@N00,11194,13,1262743227,1262743227,1,2,0
95133089@N00,11195,17,1294740864,1294740864,1,2,0
95133089@N00,11195,29,1294744580,1294744580,1,2,0
95142644@N00,11196,28,1468737607,1468737607,1,4,0
95142644@N00,11196,18,1468715606,1468715660,2,4,54
95142644@N00,11196,9,1468741563,1468741563,1,4,0
95142644@N00,11196,30,1468706647,1468706647,1,4,0
95142644@N00,11197,30,1468881433,1468881436,2,2,3
95142644@N00,11197,28,1468881411,1468881411,1,2,0
95230267@N07,11198,26,1397528934,1397528934,1,1,0
95230267@N07,11199,17,1397816533,1397816533,1,3,0
95230267@N07,11199,30,1397813690,1397813690,1,3,0
95230267@N07,11199,13,1397798115,1397798115,1,3,0
95230267@N07,11200,28,1398016534,1398016534,1,1,0
95230267@N07,11201,14,1398339670,1398339670,1,1,0
95254689@N05,11202,1,1413887188,1413887188,1,1,0
95286803@N00,11203,1,1202191241,1202191241,1,4,0
95286803@N00,11203,28,1202191338,1202191338,1,4,0
95286803@N00,11203,10,1202192367,1202193681,5,4,1314
95286803@N00,11203,26,1202212325,1202218134,6,4,5809
95303040@N00,11204,27,1371519107,1371519107,1,2,0
95303040@N00,11204,20,1371515424,1371555873,34,2,40449
95319148@N07,11205,26,1439984581,1439985261,4,1,680
95341382@N05,11206,11,1425955773,1425955773,1,1,0
95341382@N05,11207,21,1429604636,1429604636,1,1,0
95341382@N05,11208,1,1446507430,1446507430,1,1,0
95356654@N00,11209,16,1370358443,1370358443,1,3,0
95356654@N00,11209,17,1370358998,1370358998,1,3,0
95356654@N00,11209,26,1370364629,1370364629,1,3,0
95364079@N08,11210,21,1300267015,1300267015,1,1,0
95383339@N07,11211,18,1444688756,1444701594,3,3,12838
95383339@N07,11211,28,1444731625,1444733834,2,3,2209
95383339@N07,11211,26,1444722915,1444722915,1,3,0
95383339@N07,11212,4,1445066944,1445066944,1,1,0
95400904@N02,11213,30,1382398815,1382409664,2,2,10849
95400904@N02,11213,26,1382418891,1382419271,2,2,380
95414019@N00,11214,3,1234048733,1234048733,1,6,0
95414019@N00,11214,28,1234044574,1234044574,1,6,0
95414019@N00,11214,18,1234053691,1234053694,2,6,3
95414019@N00,11214,29,1234059198,1234059198,1,6,0
95414019@N00,11214,26,1234066943,1234066943,1,6,0
95414019@N00,11214,1,1234044876,1234069758,6,6,24882
95428663@N03,11215,27,1233365919,1233365919,1,1,0
95428663@N03,11216,23,1233451608,1233458337,8,2,6729
95428663@N03,11216,28,1233472158,1233472487,2,2,329
95450266@N06,11217,30,1440133206,1440154597,7,13,21391
95450266@N06,11217,13,1440132053,1440132359,6,13,306
95450266@N06,11217,18,1440139863,1440158400,4,13,18537
95450266@N06,11217,24,1440126654,1440128721,6,13,2067
95450266@N06,11217,28,1440140857,1440158564,10,13,17707
95450266@N06,11217,25,1440129825,1440153603,4,13,23778
95450266@N06,11217,26,1440125404,1440126359,6,13,955
95450266@N06,11217,31,1440134674,1440134674,1,13,0
95450266@N06,11217,1,1440142709,1440142895,3,13,186
95450266@N06,11217,3,1440153460,1440153460,1,13,0
95450266@N06,11217,29,1440156790,1440157653,4,13,863
95450266@N06,11217,21,1440129299,1440131360,10,13,2061
95450266@N06,11217,15,1440127995,1440128909,5,13,914
95461076@N00,11218,22,1281734477,1281735212,4,6,735
95461076@N00,11218,17,1281749235,1281749904,3,6,669
95461076@N00,11218,1,1281729155,1281729155,1,6,0
95461076@N00,11218,29,1281732073,1281732109,3,6,36
95461076@N00,11218,11,1281761231,1281765856,16,6,4625
95461076@N00,11218,12,1281769254,1281769392,3,6,138
95508147@N03,11219,1,1401416158,1401443673,8,1,27515
95555269@N00,11220,25,1317872790,1317872790,1,4,0
95555269@N00,11220,28,1317869017,1317893730,2,4,24713
95555269@N00,11220,1,1317862409,1317862409,1,4,0
95555269@N00,11220,18,1317884878,1317884878,1,4,0
95559818@N00,11221,29,1207210437,1207210437,1,2,0
95559818@N00,11221,10,1207207700,1207207700,1,2,0
95559818@N00,11222,26,1207266161,1207266756,3,1,595
95559818@N00,11223,10,1283854388,1283856877,6,1,2489
95594534@N05,11224,29,1418721449,1418722867,4,1,1418
95601478@N00,11225,26,1279521155,1279534779,17,1,13624
95601478@N00,11226,26,1279583560,1279621874,49,1,38314
95601478@N00,11227,26,1279675725,1279695356,21,1,19631
95601478@N00,11228,26,1279883197,1279883197,1,1,0
95601478@N00,11229,28,1279952163,1279952166,2,4,3
95601478@N00,11229,17,1279950943,1279950943,1,4,0
95601478@N00,11229,7,1279941418,1279941418,1,4,0
95601478@N00,11229,26,1279972386,1279975343,21,4,2957
95601478@N00,11230,26,1280032437,1280058331,60,1,25894
95611942@N00,11231,22,1249123957,1249123957,1,16,0
95611942@N00,11231,3,1249096015,1249096113,3,16,98
95611942@N00,11231,23,1249087833,1249087833,1,16,0
95611942@N00,11231,17,1249082981,1249082981,1,16,0
95611942@N00,11231,16,1249081419,1249119133,7,16,37714
95611942@N00,11231,18,1249088472,1249121690,5,16,33218
95611942@N00,11231,15,1249085928,1249118220,4,16,32292
95611942@N00,11231,20,1249090834,1249092201,2,16,1367
95611942@N00,11231,28,1249080752,1249126813,9,16,46061
95611942@N00,11231,29,1249090711,1249108453,4,16,17742
95611942@N00,11231,27,1249117367,1249117367,1,16,0
95611942@N00,11231,25,1249096198,1249097450,17,16,1252
95611942@N00,11231,26,1249080916,1249126746,14,16,45830
95611942@N00,11231,12,1249099745,1249099745,1,16,0
95611942@N00,11231,30,1249102323,1249102323,1,16,0
95611942@N00,11231,24,1249116466,1249117796,5,16,1330
95611942@N00,11232,25,1434490380,1434491184,5,12,804
95611942@N00,11232,22,1434502845,1434502845,1,12,0
95611942@N00,11232,3,1434492103,1434492103,1,12,0
95611942@N00,11232,16,1434500961,1434500961,1,12,0
95611942@N00,11232,13,1434497015,1434497015,1,12,0
95611942@N00,11232,28,1434489796,1434521986,2,12,32190
95611942@N00,11232,29,1434528216,1434528216,1,12,0
95611942@N00,11232,4,1434492991,1434494639,7,12,1648
95611942@N00,11232,20,1434528519,1434528821,6,12,302
95611942@N00,11232,26,1434490028,1434524725,5,12,34697
95611942@N00,11232,14,1434488247,1434488291,2,12,44
95611942@N00,11232,9,1434495791,1434495791,1,12,0
95637476@N06,11233,26,1368323119,1368323119,1,1,0
95637476@N06,11234,12,1370763511,1370764868,2,1,1357
95637476@N06,11235,31,1370924851,1370924851,1,2,0
95637476@N06,11235,28,1370923508,1370923508,1,2,0
95672420@N02,11236,13,1371796156,1371796594,2,1,438
95701812@N00,11237,6,1308284084,1308284084,1,8,0
95701812@N00,11237,15,1308278995,1308282230,3,8,3235
95701812@N00,11237,16,1308287332,1308297343,13,8,10011
95701812@N00,11237,1,1308300337,1308303199,7,8,2862
95701812@N00,11237,21,1308275932,1308275932,1,8,0
95701812@N00,11237,26,1308284029,1308314172,2,8,30143
95701812@N00,11237,28,1308283238,1308283238,1,8,0
95701812@N00,11237,13,1308276197,1308278541,7,8,2344
95708853@N00,11238,27,1362464429,1362464880,3,2,451
95708853@N00,11238,28,1362440380,1362466053,2,2,25673
95724996@N04,11239,1,1466832496,1466832496,1,4,0
95724996@N04,11239,28,1466832771,1466832771,1,4,0
95724996@N04,11239,15,1466834046,1466834046,1,4,0
95724996@N04,11239,27,1466834515,1466834515,1,4,0
95769700@N00,11240,15,1325141747,1325141747,1,2,0
95769700@N00,11240,20,1325141746,1325141746,1,2,0
95769700@N00,11241,28,1356223621,1356262139,14,1,38518
95769700@N00,11242,28,1356311317,1356311317,1,1,0
95782054@N05,11243,26,1359187697,1359187703,2,1,6
95867639@N03,11244,26,1372924366,1372924366,1,1,0
95867639@N03,11245,1,1374756418,1374758713,2,1,2295
95867639@N03,11246,1,1375003968,1375018394,5,1,14426
95867639@N03,11247,1,1375058531,1375058531,1,1,0
95867639@N03,11248,1,1375238281,1375238281,1,1,0
95867639@N03,11249,1,1375351942,1375357186,2,1,5244
95867639@N03,11250,1,1375516030,1375529181,2,1,13151
95867639@N03,11251,1,1375608091,1375610650,4,1,2559
95867639@N03,11252,1,1375789099,1375789099,1,1,0
95867639@N03,11253,1,1375860539,1375860539,1,1,0
95867639@N03,11254,1,1376032839,1376047482,6,1,14643
95867639@N03,11255,1,1376209891,1376215221,3,1,5330
95867639@N03,11256,1,1376739779,1376739789,2,1,10
95867639@N03,11257,1,1376995712,1377002720,6,1,7008
95867639@N03,11258,1,1377176059,1377176059,1,1,0
95867639@N03,11259,1,1377347507,1377352299,7,1,4792
95867639@N03,11260,1,1377772366,1377776932,4,1,4566
95867639@N03,11261,1,1377941891,1377956869,7,1,14978
95867639@N03,11262,1,1378012194,1378012692,2,1,498
95867639@N03,11263,1,1378282995,1378282995,1,1,0
95867639@N03,11264,1,1378550168,1378559978,7,1,9810
95867639@N03,11265,1,1379146415,1379164294,5,1,17879
95867639@N03,11266,1,1379491867,1379501338,5,1,9471
95867639@N03,11267,1,1379772380,1379772380,1,1,0
95867639@N03,11268,1,1380179066,1380193655,13,1,14589
95867639@N03,11269,1,1380875039,1380892699,4,1,17660
95867639@N03,11270,1,1380983419,1380983419,1,1,0
95867639@N03,11271,1,1381400303,1381400303,1,1,0
95867639@N03,11272,1,1381437487,1381437487,1,1,0
95867639@N03,11273,1,1381493679,1381493679,1,1,0
95867639@N03,11274,1,1381574144,1381574818,2,1,674
9588819@N06,11275,7,1399482499,1399482499,1,1,0
95899395@N02,11276,13,1369442581,1369443484,2,1,903
95904983@N03,11277,29,1356927772,1356927776,2,1,4
95904983@N03,11278,27,1439456461,1439456986,3,1,525
95924854@N06,11279,26,1341797411,1341821092,2,1,23681
96004001@N00,11280,28,1197757070,1197757307,2,4,237
96004001@N00,11280,23,1197759113,1197759113,1,4,0
96004001@N00,11280,18,1197759511,1197759511,1,4,0
96004001@N00,11280,29,1197762057,1197762372,3,4,315
96004001@N00,11281,30,1422156356,1422187454,2,15,31098
96004001@N00,11281,17,1422181374,1422181374,1,15,0
96004001@N00,11281,7,1422185576,1422185576,1,15,0
96004001@N00,11281,21,1422167303,1422167303,1,15,0
96004001@N00,11281,12,1422169182,1422169182,1,15,0
96004001@N00,11281,4,1422189806,1422189806,1,15,0
96004001@N00,11281,1,1422165489,1422196698,9,15,31209
96004001@N00,11281,23,1422155812,1422155812,1,15,0
96004001@N00,11281,3,1422189919,1422189919,1,15,0
96004001@N00,11281,18,1422155823,1422164542,11,15,8719
96004001@N00,11281,20,1422151791,1422166325,2,15,14534
96004001@N00,11281,28,1422196401,1422196430,2,15,29
96004001@N00,11281,16,1422171639,1422171639,1,15,0
96004001@N00,11281,5,1422179925,1422187136,2,15,7211
96004001@N00,11281,29,1422186537,1422187575,2,15,1038
96004001@N00,11282,1,1422263137,1422263137,1,1,0
96004001@N00,11283,17,1422319775,1422331299,7,6,11524
96004001@N00,11283,12,1422313263,1422313263,1,6,0
96004001@N00,11283,13,1422333982,1422345069,10,6,11087
96004001@N00,11283,15,1422323340,1422335391,25,6,12051
96004001@N00,11283,30,1422315243,1422333018,10,6,17775
96004001@N00,11283,27,1422322683,1422322683,1,6,0
96004001@N00,11284,3,1422430160,1422430478,4,2,318
96004001@N00,11284,29,1422434549,1422435416,6,2,867
96045537@N00,11285,18,1194488200,1194488217,2,6,17
96045537@N00,11285,26,1194501332,1194518071,3,6,16739
96045537@N00,11285,30,1194490828,1194493578,2,6,2750
96045537@N00,11285,13,1194496835,1194497401,6,6,566
96045537@N00,11285,27,1194515900,1194515900,1,6,0
96045537@N00,11285,12,1194498560,1194499803,2,6,1243
96045537@N00,11286,8,1194575758,1194576282,2,1,524
96045537@N00,11287,8,1194605817,1194613771,3,1,7954
96051441@N00,11288,15,1338351473,1338351473,1,1,0
9606104@N07,11289,26,1279177812,1279188611,10,1,10799
9606104@N07,11290,26,1279242321,1279279313,138,1,36992
9606104@N07,11291,26,1279321210,1279340015,52,1,18805
96067265@N02,11292,18,1356937450,1356940625,9,6,3175
96067265@N02,11292,15,1356927847,1356927847,1,6,0
96067265@N02,11292,1,1356938878,1356938878,1,6,0
96067265@N02,11292,13,1356915163,1356915263,3,6,100
96067265@N02,11292,29,1356907721,1356948474,2,6,40753
96067265@N02,11292,28,1356907911,1356951064,10,6,43153
96156793@N00,11293,19,1412292296,1412292296,1,2,0
96156793@N00,11293,3,1412290506,1412290506,1,2,0
96156793@N00,11294,19,1412421560,1412421560,1,4,0
96156793@N00,11294,3,1412421470,1412421470,1,4,0
96156793@N00,11294,18,1412421534,1412421534,1,4,0
96156793@N00,11294,30,1412421429,1412424443,3,4,3014
96156793@N00,11295,19,1412688414,1412688414,1,1,0
96156793@N00,11296,25,1415622570,1415622570,1,2,0
96156793@N00,11296,19,1415622527,1415622644,3,2,117
96156793@N00,11297,18,1454497077,1454497226,2,1,149
96156793@N00,11298,18,1454658707,1454658707,1,1,0
96173146@N00,11299,27,1327288994,1327288994,1,1,0
96175708@N06,11300,30,1381634535,1381634535,1,11,0
96175708@N06,11300,1,1381626010,1381626010,1,11,0
96175708@N06,11300,14,1381630395,1381630395,1,11,0
96175708@N06,11300,20,1381631488,1381631488,1,11,0
96175708@N06,11300,13,1381638163,1381639056,2,11,893
96175708@N06,11300,26,1381626975,1381626998,2,11,23
96175708@N06,11300,28,1381626122,1381626122,1,11,0
96175708@N06,11300,12,1381651261,1381651261,1,11,0
96175708@N06,11300,22,1381630193,1381630193,1,11,0
96175708@N06,11300,17,1381636945,1381636945,1,11,0
96175708@N06,11300,29,1381629011,1381629664,4,11,653
96175708@N06,11301,11,1381739507,1381739507,1,2,0
96175708@N06,11301,29,1381710967,1381710967,1,2,0
96175708@N06,11302,26,1381905251,1381905251,1,2,0
96175708@N06,11302,16,1381907164,1381907164,1,2,0
9628881@N05,11303,26,1236547112,1236571229,36,1,24117
9628881@N05,11304,26,1237152154,1237170378,10,1,18224
9628881@N05,11305,26,1237540759,1237545004,4,1,4245
9628881@N05,11306,26,1238140225,1238144085,11,1,3860
9628881@N05,11307,26,1239962179,1239963520,6,1,1341
9628881@N05,11308,29,1307673496,1307673496,1,2,0
9628881@N05,11308,23,1307669377,1307673594,15,2,4217
96312503@N08,11309,11,1377813440,1377813440,1,2,0
96312503@N08,11309,28,1377829975,1377829975,1,2,0
96312503@N08,11310,14,1377911575,1377911575,1,3,0
96312503@N08,11310,8,1377908441,1377908441,1,3,0
96312503@N08,11310,20,1377910587,1377910587,1,3,0
96312503@N08,11311,14,1378009417,1378009417,1,2,0
96312503@N08,11311,16,1377983643,1377983643,1,2,0
96312503@N08,11312,29,1378092341,1378092341,1,2,0
96312503@N08,11312,20,1378094724,1378094724,1,2,0
96312503@N08,11313,26,1411904591,1411904591,1,1,0
96326655@N08,11314,1,1369400373,1369401252,5,1,879
96326655@N08,11315,1,1369639445,1369639445,1,1,0
96326655@N08,11316,1,1374054955,1374054955,1,1,0
96326655@N08,11317,1,1386591995,1386591995,1,1,0
96326655@N08,11318,1,1397485522,1397485522,1,2,0
96326655@N08,11318,15,1397465054,1397485815,7,2,20761
96326655@N08,11319,19,1408871727,1408873749,3,1,2022
96326655@N08,11320,18,1427663814,1427688802,3,1,24988
96326655@N08,11321,18,1427726397,1427727332,10,1,935
96328796@N02,11322,1,1358567782,1358577010,3,1,9228
96353274@N00,11323,1,1361498502,1361498502,1,2,0
96353274@N00,11323,27,1361516208,1361516208,1,2,0
96355380@N03,11324,28,1364955769,1364955769,1,2,0
96355380@N03,11324,26,1364955775,1364955789,2,2,14
96359838@N06,11325,1,1402361745,1402361745,1,1,0
96366612@N03,11326,21,1306857979,1306857979,1,1,0
96372242@N07,11327,15,1343807477,1343807477,1,1,0
96387804@N07,11328,3,1409271252,1409271252,1,1,0
96387804@N07,11329,31,1413943680,1413943680,1,1,0
9640183@N05,11330,17,1302920176,1302920176,1,1,0
96430093@N05,11331,13,1375767545,1375767651,2,2,106
96430093@N05,11331,28,1375781719,1375784664,2,2,2945
96430093@N05,11332,9,1375845638,1375845638,1,4,0
96430093@N05,11332,5,1375845760,1375845760,1,4,0
96430093@N05,11332,3,1375847521,1375847521,1,4,0
96430093@N05,11332,6,1375842430,1375842430,1,4,0
96430093@N05,11333,29,1376224933,1376224933,1,1,0
96430093@N05,11334,3,1390351623,1390351623,1,3,0
96430093@N05,11334,28,1390349062,1390349062,1,3,0
96430093@N05,11334,17,1390377139,1390377139,1,3,0
96430093@N05,11335,1,1390441158,1390441158,1,1,0
96430093@N05,11336,22,1390610849,1390610849,1,2,0
96430093@N05,11336,23,1390613358,1390613358,1,2,0
96430093@N05,11337,29,1390695935,1390695935,1,3,0
96430093@N05,11337,28,1390692571,1390708266,3,3,15695
96430093@N05,11337,30,1390694369,1390694369,1,3,0
96430093@N05,11338,28,1421820906,1421820906,1,1,0
96430093@N05,11339,30,1421903399,1421903399,1,1,0
96430093@N05,11340,18,1422080351,1422080351,1,1,0
96430093@N05,11341,28,1422514845,1422514845,1,2,0
96430093@N05,11341,25,1422520075,1422520075,1,2,0
96430093@N05,11342,18,1423717811,1423717811,1,1,0
96430093@N05,11343,11,1439439713,1439439713,1,3,0
96430093@N05,11343,27,1439473537,1439473537,1,3,0
96430093@N05,11343,30,1439446868,1439446868,1,3,0
96430093@N05,11344,18,1439725990,1439725990,1,1,0
96430093@N05,11345,18,1439795575,1439795575,1,1,0
96430093@N05,11346,18,1439860457,1439876893,4,1,16436
96433270@N00,11347,18,1452414574,1452414574,1,1,0
96453045@N03,11348,16,1381644857,1381644857,1,1,0
96455082@N00,11349,26,1218809506,1218809506,1,1,0
96455082@N00,11350,26,1223815069,1223815069,1,1,0
96455082@N00,11351,26,1223854540,1223856438,15,1,1898
96467080@N06,11352,29,1445046585,1445046585,1,1,0
96479915@N00,11353,30,1311667633,1311667640,4,4,7
96479915@N00,11353,31,1311654640,1311667953,13,4,13313
96479915@N00,11353,10,1311665999,1311666023,6,4,24
96479915@N00,11353,27,1311662307,1311665147,9,4,2840
96499116@N06,11354,28,1439979794,1439981069,5,1,1275
96499116@N06,11355,28,1440214509,1440229901,17,1,15392
96525992@N08,11356,1,1383983262,1383983262,1,1,0
96541149@N00,11357,26,1222783200,1222783200,31,1,0
96548081@N07,11358,16,1408265968,1408265968,1,2,0
96548081@N07,11358,26,1408279031,1408279031,1,2,0
96573443@N05,11359,26,1375853266,1375853288,2,1,22
96581740@N03,11360,7,1364175014,1364186143,10,16,11129
96581740@N03,11360,22,1364192053,1364192065,6,16,12
96581740@N03,11360,16,1364174115,1364174115,1,16,0
96581740@N03,11360,11,1364175454,1364175454,1,16,0
96581740@N03,11360,28,1364173806,1364204676,41,16,30870
96581740@N03,11360,13,1364180621,1364184775,95,16,4154
96581740@N03,11360,9,1364187347,1364187511,4,16,164
96581740@N03,11360,21,1364184983,1364186732,8,16,1749
96581740@N03,11360,30,1364190825,1364190831,6,16,6
96581740@N03,11360,4,1364186530,1364186568,4,16,38
96581740@N03,11360,6,1364174876,1364186736,5,16,11860
96581740@N03,11360,29,1364191461,1364191478,4,16,17
96581740@N03,11360,3,1364184989,1364184989,2,16,0
96581740@N03,11360,1,1364172715,1364172715,1,16,0
96581740@N03,11360,10,1364174672,1364188241,8,16,13569
96581740@N03,11360,26,1364174155,1364204440,30,16,30285
96626588@N07,11361,4,1388479845,1388487897,4,13,8052
96626588@N07,11361,18,1388495329,1388495670,2,13,341
96626588@N07,11361,1,1388497345,1388497371,4,13,26
96626588@N07,11361,29,1388456095,1388471810,3,13,15715
96626588@N07,11361,16,1388452041,1388452043,2,13,2
96626588@N07,11361,14,1388459867,1388459867,1,13,0
96626588@N07,11361,6,1388452343,1388455634,7,13,3291
96626588@N07,11361,21,1388471851,1388471983,5,13,132
96626588@N07,11361,26,1388452077,1388452196,6,13,119
96626588@N07,11361,23,1388456033,1388456033,1,13,0
96626588@N07,11361,25,1388474895,1388475383,6,13,488
96626588@N07,11361,28,1388451575,1388497162,14,13,45587
96626588@N07,11361,20,1388487905,1388489354,11,13,1449
9664872@N04,11362,15,1453866482,1453866482,1,1,0
9664872@N04,11363,15,1462340114,1462340114,1,1,0
96649001@N00,11364,17,1405914688,1405914688,1,4,0
96649001@N00,11364,19,1405925181,1405925181,1,4,0
96649001@N00,11364,29,1405901015,1405901015,1,4,0
96649001@N00,11364,14,1405914492,1405914492,1,4,0
96649001@N00,11365,26,1406271182,1406272504,2,1,1322
96653558@N00,11366,3,1205227227,1205227227,2,1,0
96717948@N05,11367,18,1372815533,1372815533,1,1,0
96722532@N03,11368,26,1350628931,1350629190,14,1,259
96722532@N03,11369,31,1354225713,1354225717,2,1,4
96722532@N03,11370,1,1357257875,1357296187,24,1,38312
96722532@N03,11371,26,1358239831,1358239834,2,1,3
96722532@N03,11372,1,1358532040,1358536665,10,1,4625
96722532@N03,11373,1,1358617775,1358618381,5,1,606
96722532@N03,11374,26,1362969676,1362969681,2,1,5
96722532@N03,11375,21,1369300817,1369300817,1,6,0
96722532@N03,11375,8,1369309852,1369309852,1,6,0
96722532@N03,11375,6,1369300168,1369309912,5,6,9744
96722532@N03,11375,5,1369305649,1369305654,3,6,5
96722532@N03,11375,26,1369300170,1369309844,8,6,9674
96722532@N03,11375,3,1369300643,1369305567,4,6,4924
96722532@N03,11376,16,1369405005,1369423812,59,1,18807
96722532@N03,11377,26,1371169290,1371169337,2,1,47
96722532@N03,11378,1,1372435347,1372436397,11,1,1050
96722532@N03,11379,7,1377990970,1377990970,1,1,0
96722532@N03,11380,4,1385082146,1385082146,1,1,0
96722532@N03,11381,15,1391302622,1391304103,13,3,1481
96722532@N03,11381,26,1391312117,1391312177,9,3,60
96722532@N03,11381,29,1391307633,1391307636,2,3,3
96722532@N03,11382,5,1400935608,1400935608,1,1,0
96722532@N03,11383,3,1401025201,1401025201,1,3,0
96722532@N03,11383,25,1401025432,1401025584,2,3,152
96722532@N03,11383,26,1401025679,1401025679,1,3,0
96722532@N03,11384,26,1414843153,1414843153,1,1,0
96722532@N03,11385,18,1433686466,1433686466,1,2,0
96722532@N03,11385,26,1433686817,1433686817,1,2,0
9672978@N08,11386,18,1213771072,1213771072,1,1,0
9672978@N08,11387,23,1237008283,1237008283,1,1,0
9672978@N08,11388,23,1237552801,1237552801,1,1,0
96799583@N00,11389,25,1290339300,1290339384,2,4,84
96799583@N00,11389,26,1290337702,1290337735,2,4,33
96799583@N00,11389,28,1290346593,1290346593,1,4,0
96799583@N00,11389,21,1290339232,1290339232,1,4,0
96961309@N00,11390,28,1255227180,1255227295,22,1,115
96981714@N07,11391,26,1370067296,1370067296,1,1,0
96981714@N07,11392,16,1370150968,1370150968,1,1,0
96985020@N07,11393,1,1376550698,1376550698,1,1,0
96985020@N07,11394,28,1389581520,1389581520,1,1,0
96985020@N07,11395,15,1395623865,1395623865,1,1,0
9708101@N02,11396,26,1198489683,1198489683,1,1,0
9708101@N02,11397,29,1214647448,1214651906,4,2,4458
9708101@N02,11397,23,1214646087,1214646087,1,2,0
9708101@N02,11398,28,1215130295,1215130295,1,1,0
97124099@N08,11399,1,1452063845,1452063845,1,2,0
97124099@N08,11399,28,1452087645,1452087645,1,2,0
97137858@N00,11400,15,1416925330,1416925330,1,12,0
97137858@N00,11400,7,1416930538,1416930538,1,12,0
97137858@N00,11400,16,1416927727,1416927727,1,12,0
97137858@N00,11400,18,1416900277,1416934072,6,12,33795
97137858@N00,11400,22,1416904504,1416905081,3,12,577
97137858@N00,11400,5,1416930262,1416930262,1,12,0
97137858@N00,11400,21,1416929622,1416929622,1,12,0
97137858@N00,11400,20,1416903354,1416903354,1,12,0
97137858@N00,11400,19,1416900868,1416911989,9,12,11121
97137858@N00,11400,29,1416900891,1416933406,11,12,32515
97137858@N00,11400,28,1416898663,1416934204,2,12,35541
97137858@N00,11400,27,1416918211,1416918211,1,12,0
97137858@N00,11401,3,1417265615,1417265615,1,8,0
97137858@N00,11401,26,1417265742,1417265742,1,8,0
97137858@N00,11401,12,1417263185,1417263185,1,8,0
97137858@N00,11401,19,1417266510,1417266510,1,8,0
97137858@N00,11401,17,1417258782,1417259554,2,8,772
97137858@N00,11401,25,1417263718,1417265260,19,8,1542
97137858@N00,11401,27,1417262078,1417262202,2,8,124
97137858@N00,11401,21,1417263320,1417263545,4,8,225
97161736@N02,11402,6,1383175607,1383175607,1,18,0
97161736@N02,11402,12,1383176307,1383176403,6,18,96
97161736@N02,11402,30,1383174056,1383174300,12,18,244
97161736@N02,11402,29,1383170354,1383171268,2,18,914
97161736@N02,11402,7,1383175066,1383175066,1,18,0
97161736@N02,11402,18,1383170428,1383170669,4,18,241
97161736@N02,11402,5,1383175712,1383175712,1,18,0
97161736@N02,11402,1,1383168678,1383179745,3,18,11067
97161736@N02,11402,22,1383172621,1383173058,3,18,437
97161736@N02,11402,28,1383168799,1383199389,10,18,30590
97161736@N02,11402,20,1383171737,1383171800,4,18,63
97161736@N02,11402,19,1383169124,1383171111,13,18,1987
97161736@N02,11402,23,1383169014,1383169027,2,18,13
97161736@N02,11402,11,1383174797,1383175004,7,18,207
97161736@N02,11402,26,1383179204,1383179300,7,18,96
97161736@N02,11402,10,1383174891,1383174891,1,18,0
97161736@N02,11402,31,1383171433,1383171553,4,18,120
97161736@N02,11402,15,1383177940,1383178367,10,18,427
97161736@N02,11403,30,1383345246,1383345246,1,9,0
97161736@N02,11403,22,1383344032,1383344750,3,9,718
97161736@N02,11403,23,1383345192,1383345269,2,9,77
97161736@N02,11403,19,1383346108,1383346896,6,9,788
97161736@N02,11403,14,1383344641,1383344641,1,9,0
97161736@N02,11403,29,1383346739,1383346739,1,9,0
97161736@N02,11403,26,1383342749,1383342749,1,9,0
97161736@N02,11403,18,1383346139,1383346834,3,9,695
97161736@N02,11403,31,1383344820,1383344834,2,9,14
97161736@N02,11404,22,1383383286,1383383286,1,3,0
97161736@N02,11404,29,1383381284,1383393290,13,3,12006
97161736@N02,11404,16,1383387391,1383387391,1,3,0
97161736@N02,11405,17,1383470509,1383470509,1,4,0
97161736@N02,11405,1,1383468127,1383468127,1,4,0
97161736@N02,11405,23,1383470886,1383470886,1,4,0
97161736@N02,11405,26,1383440659,1383440758,3,4,99
97161736@N02,11406,12,1383542738,1383542738,1,8,0
97161736@N02,11406,18,1383525786,1383525786,1,8,0
97161736@N02,11406,1,1383527864,1383528729,8,8,865
97161736@N02,11406,28,1383527839,1383527839,1,8,0
97161736@N02,11406,20,1383546163,1383546191,4,8,28
97161736@N02,11406,23,1383525823,1383525935,4,8,112
97161736@N02,11406,26,1383526035,1383526035,1,8,0
97161736@N02,11406,16,1383527015,1383527063,3,8,48
97161736@N02,11407,1,1416780069,1416780069,1,2,0
97161736@N02,11407,28,1416780060,1416780060,1,2,0
97161736@N02,11408,21,1416824110,1416824110,1,2,0
97161736@N02,11408,26,1416821714,1416821714,1,2,0
97173103@N07,11409,23,1423032733,1423032733,1,1,0
97173103@N07,11410,13,1425683696,1425683696,1,1,0
9718370@N07,11411,17,1288411794,1288418313,12,1,6519
97225209@N00,11412,29,1386389086,1386389086,1,2,0
97225209@N00,11412,28,1386380795,1386380795,1,2,0
97225209@N00,11413,18,1444385602,1444385602,1,1,0
97225209@N00,11414,18,1444478923,1444478923,1,1,0
97225209@N00,11415,18,1444541381,1444541381,1,1,0
97286705@N07,11416,1,1456464549,1456464596,3,3,47
97286705@N07,11416,29,1456475449,1456476632,5,3,1183
97286705@N07,11416,14,1456479737,1456480262,10,3,525
97286705@N07,11417,26,1456555208,1456555210,2,3,2
97286705@N07,11417,23,1456555830,1456555837,2,3,7
97286705@N07,11417,14,1456557675,1456557718,6,3,43
97286705@N07,11418,26,1456611460,1456611467,3,5,7
97286705@N07,11418,1,1456605344,1456605344,1,5,0
97286705@N07,11418,13,1456609934,1456610047,3,5,113
97286705@N07,11418,3,1456609603,1456609686,12,5,83
97286705@N07,11418,17,1456608634,1456608703,2,5,69
9728779@N03,11419,24,1409908938,1409908938,1,1,0
97302400@N00,11420,3,1308398515,1308398580,2,1,65
97309002@N00,11421,4,1237348061,1237348061,1,1,0
97314397@N02,11422,27,1393114956,1393114956,1,2,0
97314397@N02,11422,16,1393114122,1393114122,1,2,0
97385633@N00,11423,30,1358469711,1358469711,1,1,0
97405121@N08,11424,1,1337334181,1337334192,2,3,11
97405121@N08,11424,24,1337336071,1337336079,2,3,8
97405121@N08,11424,25,1337336117,1337336639,24,3,522
97405121@N08,11425,30,1385279122,1385279146,4,1,24
97408089@N00,11426,30,1305797475,1305797478,2,1,3
97408089@N00,11427,30,1305850050,1305892884,27,2,42834
97408089@N00,11427,3,1305877900,1305877907,2,2,7
9744114@N08,11428,18,1218597675,1218597675,1,1,0
9744114@N08,11429,6,1315083558,1315083564,2,6,6
9744114@N08,11429,14,1315081828,1315081828,1,6,0
9744114@N08,11429,13,1315084107,1315084107,1,6,0
9744114@N08,11429,28,1315083290,1315083290,1,6,0
9744114@N08,11429,7,1315083541,1315083541,1,6,0
9744114@N08,11429,16,1315083347,1315083347,1,6,0
9744114@N08,11430,26,1377855448,1377855455,3,4,7
9744114@N08,11430,18,1377841861,1377841861,1,4,0
9744114@N08,11430,25,1377859667,1377859667,1,4,0
9744114@N08,11430,13,1377836141,1377836141,1,4,0
9744114@N08,11431,28,1400860372,1400860375,2,4,3
9744114@N08,11431,1,1400860157,1400860160,2,4,3
9744114@N08,11431,13,1400854614,1400854620,2,4,6
9744114@N08,11431,25,1400855358,1400855434,4,4,76
9744114@N08,11432,21,1429878995,1429878997,2,1,2
9744114@N08,11433,7,1431067914,1431067919,2,2,5
9744114@N08,11433,21,1431066886,1431066886,1,2,0
9744114@N08,11434,14,1433725543,1433726907,8,3,1364
9744114@N08,11434,13,1433732096,1433732096,1,3,0
9744114@N08,11434,29,1433718238,1433718238,1,3,0
9744114@N08,11435,25,1443951579,1443951910,5,2,331
9744114@N08,11435,21,1443952012,1443952021,5,2,9
9744114@N08,11436,14,1449354862,1449354862,1,1,0
97460734@N07,11437,1,1366940113,1366967624,6,1,27511
97460734@N07,11438,1,1384046780,1384090185,13,1,43405
97463056@N00,11439,1,1380425349,1380425349,1,1,0
97463056@N00,11440,15,1381038142,1381038218,2,1,76
97472023@N04,11441,28,1462152833,1462152833,1,1,0
97527209@N00,11442,21,1389947476,1389947508,2,3,32
97527209@N00,11442,17,1389939806,1389939806,1,3,0
97527209@N00,11442,27,1389949735,1389949735,1,3,0
97527209@N00,11443,7,1390012468,1390012468,1,2,0
97527209@N00,11443,13,1390006053,1390006053,2,2,0
97527209@N00,11444,17,1390198902,1390198902,1,1,0
97527209@N00,11445,3,1390801146,1390801146,1,1,0
97527209@N00,11446,29,1392168591,1392168591,1,1,0
9753074@N04,11447,14,1289792351,1289792351,1,5,0
9753074@N04,11447,1,1289782315,1289782315,1,5,0
9753074@N04,11447,3,1289795467,1289795467,1,5,0
9753074@N04,11447,18,1289790828,1289791260,3,5,432
9753074@N04,11447,29,1289786881,1289786881,1,5,0
97623972@N06,11448,26,1388922594,1388922694,2,2,100
97623972@N06,11448,17,1388919756,1388919756,1,2,0
97623972@N06,11449,26,1438436183,1438436183,1,1,0
9762956@N03,11450,19,1419743068,1419749634,2,1,6566
97632346@N06,11451,4,1191553424,1191553629,2,5,205
97632346@N06,11451,16,1191569027,1191569027,1,5,0
97632346@N06,11451,1,1191572059,1191572059,1,5,0
97632346@N06,11451,12,1191545315,1191569068,2,5,23753
97632346@N06,11451,31,1191554754,1191554754,1,5,0
97632346@N06,11452,30,1235811297,1235811360,2,4,63
97632346@N06,11452,16,1235796895,1235796895,1,4,0
97632346@N06,11452,20,1235812508,1235812508,1,4,0
97632346@N06,11452,7,1235818466,1235818466,1,4,0
97632346@N06,11453,16,1285133894,1285145494,2,8,11600
97632346@N06,11453,20,1285121554,1285121554,1,8,0
97632346@N06,11453,12,1285113212,1285113248,7,8,36
97632346@N06,11453,14,1285122028,1285122203,2,8,175
97632346@N06,11453,24,1285114702,1285128600,3,8,13898
97632346@N06,11453,5,1285111874,1285111874,1,8,0
97632346@N06,11453,17,1285115475,1285115475,1,8,0
97632346@N06,11453,26,1285145147,1285145208,2,8,61
97632346@N06,11454,25,1309431023,1309431023,1,1,0
97632346@N06,11455,30,1363853286,1363853286,1,2,0
97632346@N06,11455,16,1363862306,1363862306,1,2,0
97634415@N00,11456,26,1260272253,1260272288,2,1,35
97651774@N07,11457,5,1357535183,1357535192,2,1,9
97653878@N07,11458,16,1407065194,1407065967,5,5,773
97653878@N07,11458,19,1407044684,1407044684,1,5,0
97653878@N07,11458,22,1407049536,1407049536,1,5,0
97653878@N07,11458,29,1407046635,1407048817,2,5,2182
97653878@N07,11458,26,1407045612,1407066106,3,5,20494
97653878@N07,11459,19,1407145188,1407159905,2,1,14717
97653878@N07,11460,24,1407314823,1407314823,1,1,0
97653878@N07,11461,28,1438222285,1438256096,4,7,33811
97653878@N07,11461,21,1438237421,1438239746,26,7,2325
97653878@N07,11461,18,1438224810,1438255271,19,7,30461
97653878@N07,11461,24,1438230035,1438230224,6,7,189
97653878@N07,11461,26,1438232443,1438247749,4,7,15306
97653878@N07,11461,29,1438225909,1438225911,2,7,2
97653878@N07,11461,1,1438222108,1438257443,35,7,35335
97665178@N02,11462,1,1368066912,1368087280,3,1,20368
97665178@N02,11463,1,1370571245,1370571245,1,1,0
97665178@N02,11464,1,1372215924,1372229929,6,1,14005
97665178@N02,11465,1,1375861125,1375861125,1,1,0
9766803@N05,11466,18,1432698589,1432698589,1,1,0
9766803@N05,11467,18,1440704150,1440704312,2,1,162
97747865@N00,11468,16,1256965598,1256972941,2,3,7343
97747865@N00,11468,3,1256972523,1256972523,1,3,0
97747865@N00,11468,26,1256968532,1256972138,3,3,3606
97748032@N04,11469,19,1404717274,1404717274,1,1,0
97761705@N00,11470,6,1366250701,1366250701,1,1,0
97761705@N00,11471,6,1366280980,1366280980,1,1,0
97761705@N00,11472,6,1366417813,1366417813,1,1,0
97761705@N00,11473,3,1395298103,1395298103,1,2,0
97761705@N00,11473,6,1395308647,1395308647,1,2,0
97798599@N00,11474,28,1329714687,1329726568,2,1,11881
9785054@N05,11475,27,1438823543,1438823543,1,2,0
9785054@N05,11475,26,1438845055,1438845055,1,2,0
97862183@N05,11476,17,1372686430,1372686430,1,1,0
97864553@N00,11477,28,1369701854,1369701854,1,1,0
97898435@N00,11478,26,1212215361,1212215422,2,3,61
97898435@N00,11478,29,1212195295,1212227534,3,3,32239
97898435@N00,11478,20,1212219363,1212219363,1,3,0
97898435@N00,11479,26,1212288569,1212288569,1,4,0
97898435@N00,11479,17,1212276553,1212297140,4,4,20587
97898435@N00,11479,28,1212293091,1212309613,3,4,16522
97898435@N00,11479,9,1212289420,1212289700,3,4,280
97898435@N00,11480,17,1323211306,1323211306,1,3,0
97898435@N00,11480,14,1323225265,1323225265,1,3,0
97898435@N00,11480,28,1323226080,1323226080,1,3,0
97898435@N00,11481,8,1323422112,1323422112,1,2,0
97898435@N00,11481,21,1323422137,1323422137,1,2,0
97907761@N00,11482,7,1361679100,1361679100,1,1,0
97948161@N05,11483,29,1238334531,1238334628,2,1,97
97987383@N02,11484,1,1394835761,1394835811,2,1,50
98054093@N00,11485,14,1291073759,1291073759,1,7,0
98054093@N00,11485,26,1291100078,1291100078,1,7,0
98054093@N00,11485,20,1291079191,1291079191,1,7,0
98054093@N00,11485,29,1291077276,1291077276,1,7,0
98054093@N00,11485,18,1291099046,1291099046,1,7,0
98054093@N00,11485,24,1291082530,1291082530,1,7,0
98054093@N00,11485,25,1291087584,1291087584,1,7,0
98071415@N05,11486,1,1372485718,1372485718,1,1,0
98071415@N05,11487,1,1373260637,1373260637,1,1,0
98071415@N05,11488,1,1373533306,1373534286,2,1,980
98071415@N05,11489,7,1374017931,1374017931,1,3,0
98071415@N05,11489,28,1374018695,1374018695,1,3,0
98071415@N05,11489,1,1374020306,1374020306,1,3,0
98071415@N05,11490,1,1379738189,1379738189,1,1,0
98071415@N05,11491,1,1380109868,1380109868,1,1,0
98071415@N05,11492,1,1380164383,1380164383,1,1,0
98071415@N05,11493,26,1380284136,1380284136,1,1,0
98071415@N05,11494,28,1380315025,1380315025,1,1,0
98071415@N05,11495,1,1380360085,1380367547,2,1,7462
98071415@N05,11496,1,1380703191,1380703191,1,1,0
98071415@N05,11497,1,1384598111,1384598111,1,1,0
98071415@N05,11498,1,1384978273,1384978273,1,1,0
98071415@N05,11499,1,1385460726,1385460726,1,1,0
98071415@N05,11500,1,1388795220,1388795220,1,1,0
98071415@N05,11501,1,1388877525,1388877525,1,1,0
98111413@N05,11502,15,1470992268,1470992268,1,1,0
98148330@N06,11503,16,1331255017,1331255028,2,1,11
98148330@N06,11504,16,1338956379,1338956395,2,1,16
98182088@N03,11505,12,1430117468,1430117468,1,4,0
98182088@N03,11505,23,1430097299,1430097299,1,4,0
98182088@N03,11505,15,1430131852,1430131852,1,4,0
98182088@N03,11505,26,1430101070,1430101071,2,4,1
98201633@N03,11506,26,1290041220,1290066096,4,1,24876
98201633@N03,11507,26,1290113749,1290129663,5,1,15914
9820882@N06,11508,19,1411900729,1411900729,1,2,0
9820882@N06,11508,30,1411907058,1411907058,1,2,0
9821843@N08,11509,27,1215140201,1215140201,1,1,0
9821843@N08,11510,27,1215226493,1215226512,2,1,19
9821843@N08,11511,4,1220078672,1220078672,1,1,0
9821843@N08,11512,18,1220191147,1220191147,1,1,0
9821843@N08,11513,27,1252111826,1252111831,2,1,5
9821843@N08,11514,27,1278041789,1278041893,4,1,104
9821843@N08,11515,27,1278196698,1278211128,2,1,14430
98235322@N00,11516,25,1353448636,1353448636,1,1,0
98235322@N00,11517,13,1353532790,1353532790,1,1,0
98255736@N00,11518,13,1338707078,1338707078,1,1,0
98274023@N00,11519,16,1193354150,1193354150,1,2,0
98274023@N00,11519,11,1193350026,1193350026,1,2,0
98274023@N00,11520,20,1228991650,1228991650,1,1,0
98274023@N00,11521,29,1243234887,1243234887,1,1,0
98274023@N00,11522,10,1244539903,1244539903,1,1,0
98274023@N00,11523,20,1253871240,1253871240,1,1,0
98274023@N00,11524,14,1256294343,1256294343,1,1,0
98274023@N00,11525,28,1314095517,1314095517,1,1,0
98278862@N00,11526,15,1362896189,1362896189,1,3,0
98278862@N00,11526,28,1362891408,1362891408,1,3,0
98278862@N00,11526,25,1362893154,1362893154,1,3,0
98278862@N00,11527,28,1372735325,1372735325,1,1,0
98278862@N00,11528,28,1380446606,1380446606,1,1,0
98278862@N00,11529,20,1382510095,1382510095,1,2,0
98278862@N00,11529,7,1382508776,1382508776,1,2,0
98278862@N00,11530,13,1412492627,1412492627,1,1,0
98278862@N00,11531,19,1417341522,1417341522,1,1,0
98278862@N00,11532,28,1421649631,1421649631,1,1,0
98278862@N00,11533,18,1434264754,1434264754,1,1,0
9829137@N04,11534,26,1233266577,1233267412,2,1,835
9829137@N04,11535,26,1233298794,1233301912,5,1,3118
98308974@N02,11536,26,1369368095,1369368472,6,4,377
98308974@N02,11536,28,1369379342,1369379367,8,4,25
98308974@N02,11536,14,1369362275,1369362275,1,4,0
98308974@N02,11536,16,1369371909,1369371909,1,4,0
98308974@N02,11537,14,1375338881,1375338910,15,1,29
98308974@N02,11538,8,1375495674,1375495681,4,8,7
98308974@N02,11538,1,1375483038,1375483204,18,8,166
98308974@N02,11538,27,1375489487,1375489487,1,8,0
98308974@N02,11538,28,1375483240,1375491218,7,8,7978
98308974@N02,11538,25,1375484013,1375497897,33,8,13884
98308974@N02,11538,26,1375483427,1375493609,40,8,10182
98308974@N02,11538,16,1375489082,1375489505,26,8,423
98308974@N02,11538,15,1375523844,1375523844,1,8,0
98308974@N02,11539,7,1375756272,1375756296,4,8,24
98308974@N02,11539,17,1375742412,1375743937,8,8,1525
98308974@N02,11539,5,1375756316,1375756322,3,8,6
98308974@N02,11539,26,1375751205,1375752231,14,8,1026
98308974@N02,11539,16,1375741555,1375741555,1,8,0
98308974@N02,11539,22,1375743939,1375745754,18,8,1815
98308974@N02,11539,27,1375741571,1375741587,6,8,16
98308974@N02,11539,30,1375748033,1375748056,5,8,23
98321034@N06,11540,1,1375057596,1375057596,1,1,0
98323495@N00,11541,18,1433830143,1433830143,1,1,0
98343724@N06,11542,28,1383288732,1383288732,1,1,0
98352952@N02,11543,15,1403772992,1403773189,3,6,197
98352952@N02,11543,8,1403788735,1403788735,1,6,0
98352952@N02,11543,1,1403766452,1403766762,3,6,310
98352952@N02,11543,26,1403767330,1403790748,5,6,23418
98352952@N02,11543,6,1403788722,1403788722,1,6,0
98352952@N02,11543,28,1403786239,1403786239,1,6,0
98367299@N00,11544,29,1218349961,1218349961,1,1,0
98367299@N00,11545,29,1304565589,1304565589,1,1,0
98419063@N00,11546,18,1438261129,1438263424,3,1,2295
98453848@N00,11547,29,1453530305,1453530305,1,1,0
98538941@N00,11548,23,1318292719,1318292970,14,9,251
98538941@N00,11548,10,1318305769,1318306633,7,9,864
98538941@N00,11548,28,1318291883,1318291883,1,9,0
98538941@N00,11548,18,1318310014,1318310812,49,9,798
98538941@N00,11548,30,1318293026,1318300653,30,9,7627
98538941@N00,11548,26,1318292054,1318292126,4,9,72
98538941@N00,11548,20,1318294401,1318294783,7,9,382
98538941@N00,11548,31,1318295078,1318296884,5,9,1806
98538941@N00,11548,27,1318300666,1318301740,11,9,1074
98552680@N07,11549,4,1424753744,1424754152,2,13,408
98552680@N07,11549,28,1424738253,1424739968,4,13,1715
98552680@N07,11549,13,1424748820,1424749464,2,13,644
98552680@N07,11549,18,1424760385,1424765635,2,13,5250
98552680@N07,11549,16,1424740581,1424740589,2,13,8
98552680@N07,11549,29,1424755070,1424755593,2,13,523
98552680@N07,11549,26,1424765506,1424765506,1,13,0
98552680@N07,11549,27,1424741867,1424741867,1,13,0
98552680@N07,11549,1,1424738027,1424738027,1,13,0
98552680@N07,11549,25,1424748286,1424748481,4,13,195
98552680@N07,11549,5,1424752455,1424752455,1,13,0
98552680@N07,11549,24,1424746114,1424746114,1,13,0
98552680@N07,11549,7,1424753386,1424753386,1,13,0
98583319@N04,11550,18,1389152603,1389152603,1,1,0
98583319@N04,11551,1,1389524772,1389524772,1,1,0
98583319@N04,11552,29,1391593629,1391593629,1,1,0
9858951@N03,11553,23,1205457167,1205457167,1,1,0
9858951@N03,11554,1,1208762706,1208762706,1,2,0
9858951@N03,11554,26,1208762706,1208763263,14,2,557
9858951@N03,11555,28,1209009580,1209009580,1,3,0
9858951@N03,11555,31,1209010825,1209010825,1,3,0
9858951@N03,11555,19,1209009923,1209009923,1,3,0
9858951@N03,11556,6,1209418462,1209418462,1,4,0
9858951@N03,11556,12,1209418048,1209418048,1,4,0
9858951@N03,11556,8,1209418458,1209418458,1,4,0
9858951@N03,11556,31,1209418465,1209418465,1,4,0
9858951@N03,11557,28,1209493314,1209493314,1,4,0
9858951@N03,11557,4,1209494610,1209494610,1,4,0
9858951@N03,11557,18,1209493336,1209493336,1,4,0
9858951@N03,11557,25,1209493293,1209493295,5,4,2
9858951@N03,11558,24,1211605836,1211608661,5,2,2825
9858951@N03,11558,29,1211609425,1211612745,4,2,3320
9858951@N03,11559,28,1211710936,1211728753,87,10,17817
9858951@N03,11559,1,1211702765,1211729137,18,10,26372
9858951@N03,11559,26,1211711984,1211711984,2,10,0
9858951@N03,11559,17,1211726651,1211726691,7,10,40
9858951@N03,11559,27,1211726702,1211727003,39,10,301
9858951@N03,11559,24,1211718866,1211723652,94,10,4786
9858951@N03,11559,4,1211714672,1211714672,1,10,0
9858951@N03,11559,15,1211726651,1211726691,7,10,40
9858951@N03,11559,5,1211712034,1211718653,16,10,6619
9858951@N03,11559,16,1211702761,1211727057,36,10,24296
9858951@N03,11560,28,1211782291,1211782291,2,9,0
9858951@N03,11560,23,1211834792,1211835433,62,9,641
9858951@N03,11560,26,1211804813,1211805232,6,9,419
9858951@N03,11560,16,1211781944,1211781956,2,9,12
9858951@N03,11560,19,1211779440,1211780517,7,9,1077
9858951@N03,11560,18,1211778901,1211781205,19,9,2304
9858951@N03,11560,1,1211771017,1211807948,23,9,36931
9858951@N03,11560,3,1211804776,1211804871,7,9,95
9858951@N03,11560,21,1211804694,1211804745,8,9,51
9858951@N03,11561,1,1211945400,1211945400,2,1,0
9858951@N03,11562,12,1212540921,1212542601,10,16,1680
9858951@N03,11562,28,1212503014,1212547850,70,16,44836
9858951@N03,11562,26,1212534812,1212534818,3,16,6
9858951@N03,11562,24,1212503569,1212503588,18,16,19
9858951@N03,11562,17,1212503567,1212503567,1,16,0
9858951@N03,11562,1,1212503049,1212552357,22,16,49308
9858951@N03,11562,5,1212503592,1212503592,1,16,0
9858951@N03,11562,16,1212503542,1212543857,15,16,40315
9858951@N03,11562,19,1212503030,1212503030,1,16,0
9858951@N03,11562,7,1212536352,1212536938,37,16,586
9858951@N03,11562,4,1212537140,1212537149,4,16,9
9858951@N03,11562,18,1212503072,1212503072,1,16,0
9858951@N03,11562,15,1212503566,1212503568,2,16,2
9858951@N03,11562,3,1212503591,1212539749,34,16,36158
9858951@N03,11562,21,1212537487,1212537487,1,16,0
9858951@N03,11562,27,1212503546,1212503565,13,16,19
9858951@N03,11563,28,1212806974,1212821559,8,2,14585
9858951@N03,11563,1,1212812731,1212821559,32,2,8828
9858951@N03,11564,29,1212934014,1212935641,38,6,1627
9858951@N03,11564,28,1212929525,1212937607,206,6,8082
9858951@N03,11564,1,1212937550,1212937670,27,6,120
9858951@N03,11564,19,1212932534,1212933699,92,6,1165
9858951@N03,11564,18,1212935666,1212935900,34,6,234
9858951@N03,11564,23,1212932558,1212933090,31,6,532
9858951@N03,11565,28,1212979096,1212979267,13,2,171
9858951@N03,11565,23,1213006685,1213006685,2,2,0
9858951@N03,11566,23,1213405029,1213406267,6,6,1238
9858951@N03,11566,26,1213380224,1213380224,1,6,0
9858951@N03,11566,19,1213405279,1213412186,48,6,6907
9858951@N03,11566,18,1213402924,1213405808,43,6,2884
9858951@N03,11566,10,1213408037,1213408037,1,6,0
9858951@N03,11566,21,1213380225,1213380227,3,6,2
9858951@N03,11567,19,1213567663,1213567663,1,1,0
9858951@N03,11568,19,1213870752,1213870752,1,1,0
9858951@N03,11569,13,1214228160,1214228160,2,2,0
9858951@N03,11569,24,1214228185,1214228222,5,2,37
9858951@N03,11570,19,1214380411,1214380515,4,1,104
9858951@N03,11571,19,1214478953,1214478953,2,1,0
9858951@N03,11572,15,1214554068,1214554068,1,2,0
9858951@N03,11572,13,1214553449,1214553449,1,2,0
9858951@N03,11573,13,1214608716,1214615542,266,4,6826
9858951@N03,11573,15,1214618657,1214622997,36,4,4340
9858951@N03,11573,28,1214606371,1214623553,274,4,17182
9858951@N03,11573,17,1214623213,1214623714,29,4,501
9858951@N03,11574,13,1215059680,1215059680,1,1,0
9858951@N03,11575,15,1215616354,1215616537,26,8,183
9858951@N03,11575,18,1215616086,1215616096,6,8,10
9858951@N03,11575,29,1215616074,1215616076,3,8,2
9858951@N03,11575,13,1215616361,1215616857,134,8,496
9858951@N03,11575,28,1215615963,1215616340,11,8,377
9858951@N03,11575,26,1215616099,1215616107,8,8,8
9858951@N03,11575,23,1215616020,1215616098,26,8,78
9858951@N03,11575,19,1215616058,1215616345,35,8,287
9858951@N03,11576,1,1215773923,1215773923,1,3,0
9858951@N03,11576,29,1215762210,1215762257,4,3,47
9858951@N03,11576,20,1215760915,1215760958,3,3,43
9858951@N03,11577,26,1216253772,1216255026,7,4,1254
9858951@N03,11577,1,1216229992,1216298960,51,4,68968
9858951@N03,11577,27,1216253344,1216253390,3,4,46
9858951@N03,11577,28,1216251861,1216271041,33,4,19180
9858951@N03,11578,28,1216629702,1216629702,2,1,0
9858951@N03,11579,18,1216661851,1216661876,14,8,25
9858951@N03,11579,10,1216661964,1216661964,1,8,0
9858951@N03,11579,29,1216661883,1216661883,1,8,0
9858951@N03,11579,1,1216661562,1216661568,2,8,6
9858951@N03,11579,13,1216660645,1216660646,2,8,1
9858951@N03,11579,19,1216661878,1216661976,10,8,98
9858951@N03,11579,28,1216661369,1216661549,4,8,180
9858951@N03,11579,23,1216661873,1216661880,3,8,7
9858951@N03,11580,17,1218117606,1218117616,11,4,10
9858951@N03,11580,12,1218117605,1218117605,1,4,0
9858951@N03,11580,16,1218117600,1218117604,5,4,4
9858951@N03,11580,15,1218117617,1218117624,8,4,7
9858951@N03,11581,26,1218202461,1218202739,6,18,278
9858951@N03,11581,17,1218178688,1218178926,11,18,238
9858951@N03,11581,8,1218202049,1218202086,5,18,37
9858951@N03,11581,18,1218202879,1218202879,1,18,0
9858951@N03,11581,7,1218201732,1218201736,3,18,4
9858951@N03,11581,10,1218203418,1218203924,22,18,506
9858951@N03,11581,28,1218153242,1218203777,105,18,50535
9858951@N03,11581,14,1218195720,1218199033,4,18,3313
9858951@N03,11581,16,1218177564,1218177796,8,18,232
9858951@N03,11581,22,1218194421,1218194813,11,18,392
9858951@N03,11581,23,1218184665,1218187099,9,18,2434
9858951@N03,11581,24,1218183204,1218183307,27,18,103
9858951@N03,11581,11,1218201008,1218201474,66,18,466
9858951@N03,11581,4,1218201175,1218201586,35,18,411
9858951@N03,11581,5,1218201770,1218201773,2,18,3
9858951@N03,11581,31,1218192838,1218199851,5,18,7013
9858951@N03,11581,1,1218153105,1218204558,14,18,51453
9858951@N03,11581,15,1218178940,1218180862,8,18,1922
9858951@N03,11582,17,1218470976,1218471009,19,6,33
9858951@N03,11582,27,1218470967,1218470967,1,6,0
9858951@N03,11582,24,1218471037,1218471037,1,6,0
9858951@N03,11582,8,1218470952,1218470974,10,6,22
9858951@N03,11582,16,1218470968,1218470970,2,6,2
9858951@N03,11582,15,1218471014,1218471036,11,6,22
9858951@N03,11583,12,1219329651,1219329656,3,11,5
9858951@N03,11583,18,1219329707,1219329712,4,11,5
9858951@N03,11583,3,1219329635,1219329647,2,11,12
9858951@N03,11583,25,1219329596,1219329600,3,11,4
9858951@N03,11583,22,1219329863,1219329899,6,11,36
9858951@N03,11583,29,1219329715,1219329850,76,11,135
9858951@N03,11583,23,1219329704,1219329714,3,11,10
9858951@N03,11583,24,1219329566,1219329703,30,11,137
9858951@N03,11583,21,1219329584,1219329617,12,11,33
9858951@N03,11583,20,1219329829,1219329829,1,11,0
9858951@N03,11583,31,1219329802,1219329898,47,11,96
9858951@N03,11584,14,1219934984,1219935040,44,4,56
9858951@N03,11584,22,1219934982,1219935046,7,4,64
9858951@N03,11584,20,1219935058,1219935093,42,4,35
9858951@N03,11584,31,1219934983,1219935058,15,4,75
9858951@N03,11585,24,1220683086,1220683086,1,1,0
9858951@N03,11586,24,1221352892,1221355677,2,1,2785
9858951@N03,11587,24,1221496007,1221496007,1,1,0
9858951@N03,11588,24,1221567583,1221567583,4,1,0
9858951@N03,11589,18,1221786842,1221787578,4,1,736
9858951@N03,11590,11,1223003481,1223004502,5,5,1021
9858951@N03,11590,29,1222999360,1222999582,5,5,222
9858951@N03,11590,21,1223005502,1223005502,1,5,0
9858951@N03,11590,30,1222999591,1223000472,20,5,881
9858951@N03,11590,28,1223011867,1223012062,8,5,195
9858951@N03,11591,1,1223596426,1223632114,16,4,35688
9858951@N03,11591,16,1223627712,1223628534,33,4,822
9858951@N03,11591,17,1223595087,1223595173,8,4,86
9858951@N03,11591,28,1223596359,1223602870,16,4,6511
9858951@N03,11592,29,1224216473,1224216513,5,5,40
9858951@N03,11592,31,1224206256,1224207869,2,5,1613
9858951@N03,11592,17,1224207844,1224207844,1,5,0
9858951@N03,11592,22,1224206246,1224207772,12,5,1526
9858951@N03,11592,15,1224220125,1224228826,24,5,8701
9858951@N03,11593,18,1224831102,1224832764,5,5,1662
9858951@N03,11593,20,1224803906,1224805315,13,5,1409
9858951@N03,11593,23,1224827059,1224827059,2,5,0
9858951@N03,11593,31,1224809428,1224818438,5,5,9010
9858951@N03,11593,1,1224803061,1224803064,2,5,3
9858951@N03,11594,18,1224890637,1224890637,2,1,0
9858951@N03,11595,20,1225408312,1225414389,54,5,6077
9858951@N03,11595,29,1225425333,1225427385,6,5,2052
9858951@N03,11595,31,1225418456,1225425843,4,5,7387
9858951@N03,11595,30,1225426622,1225428192,23,5,1570
9858951@N03,11595,22,1225414639,1225426128,37,5,11489
9858951@N03,11596,18,1226020077,1226020111,4,9,34
9858951@N03,11596,20,1226022590,1226022590,1,9,0
9858951@N03,11596,29,1226021043,1226027468,57,9,6425
9858951@N03,11596,23,1226020224,1226020224,1,9,0
9858951@N03,11596,16,1226063948,1226064209,11,9,261
9858951@N03,11596,26,1226016691,1226101725,138,9,85034
9858951@N03,11596,1,1226013917,1226014124,9,9,207
9858951@N03,11596,28,1226014666,1226109829,62,9,95163
9858951@N03,11596,6,1226057931,1226063970,20,9,6039
9858951@N03,11597,26,1226213284,1226213284,1,1,0
9858951@N03,11598,26,1226288575,1226291364,11,2,2789
9858951@N03,11598,28,1226278123,1226278123,1,2,0
9858951@N03,11599,10,1226642593,1226642593,1,8,0
9858951@N03,11599,23,1226649940,1226649940,1,8,0
9858951@N03,11599,13,1226618368,1226618368,1,8,0
9858951@N03,11599,26,1226637243,1226640154,39,8,2911
9858951@N03,11599,1,1226617240,1226632645,10,8,15405
9858951@N03,11599,30,1226641241,1226645578,37,8,4337
9858951@N03,11599,28,1226619406,1226630330,38,8,10924
9858951@N03,11599,29,1226645088,1226646170,9,8,1082
9858951@N03,11600,28,1226785177,1226785491,11,1,314
9858951@N03,11601,9,1227228652,1227228652,1,9,0
9858951@N03,11601,25,1227225117,1227226780,13,9,1663
9858951@N03,11601,26,1227227356,1227233890,5,9,6534
9858951@N03,11601,13,1227226786,1227226905,12,9,119
9858951@N03,11601,28,1227222238,1227255850,19,9,33612
9858951@N03,11601,16,1227237224,1227238079,2,9,855
9858951@N03,11601,6,1227227392,1227228428,9,9,1036
9858951@N03,11601,1,1227222078,1227243223,16,9,21145
9858951@N03,11601,21,1227249395,1227249680,5,9,285
9858951@N03,11602,26,1229436247,1229436247,1,1,0
9858951@N03,11603,26,1230201381,1230206436,1415,2,5055
9858951@N03,11603,28,1230200217,1230201320,202,2,1103
9858951@N03,11604,27,1230355252,1230355252,1,6,0
9858951@N03,11604,3,1230360573,1230360573,1,6,0
9858951@N03,11604,26,1230356723,1230356788,20,6,65
9858951@N03,11604,28,1230354829,1230360560,1791,6,5731
9858951@N03,11604,16,1230358959,1230359118,119,6,159
9858951@N03,11604,21,1230360561,1230360655,66,6,94
9858951@N03,11605,24,1232978335,1232978335,1,1,0
9858951@N03,11606,25,1233905981,1233909986,111,3,4005
9858951@N03,11606,28,1233891517,1233891621,5,3,104
9858951@N03,11606,1,1233890033,1233904714,32,3,14681
9858951@N03,11607,5,1234231292,1234231292,1,1,0
9858951@N03,11608,19,1235355472,1235356224,39,9,752
9858951@N03,11608,15,1235364290,1235364527,2,9,237
9858951@N03,11608,18,1235355245,1235358226,9,9,2981
9858951@N03,11608,3,1235364948,1235364948,1,9,0
9858951@N03,11608,29,1235355954,1235356634,22,9,680
9858951@N03,11608,12,1235363844,1235363897,7,9,53
9858951@N03,11608,21,1235364932,1235364945,3,9,13
9858951@N03,11608,24,1235365120,1235365127,3,9,7
9858951@N03,11608,25,1235363382,1235363382,1,9,0
9858951@N03,11609,5,1236419257,1236419257,4,1,0
9858951@N03,11610,30,1236915004,1236915006,3,3,2
9858951@N03,11610,13,1236903342,1236903343,3,3,1
9858951@N03,11610,29,1236916037,1236916864,13,3,827
9858951@N03,11611,1,1236981087,1236981087,1,1,0
9858951@N03,11612,1,1237504931,1237507943,3,3,3012
9858951@N03,11612,27,1237519564,1237519564,1,3,0
9858951@N03,11612,16,1237519583,1237519583,1,3,0
9858951@N03,11613,28,1238221579,1238221579,1,1,0
9858951@N03,11614,28,1238801343,1238801343,1,1,0
9858951@N03,11615,1,1239367111,1239371047,29,6,3936
9858951@N03,11615,28,1239374188,1239375441,30,6,1253
9858951@N03,11615,30,1239367127,1239367152,4,6,25
9858951@N03,11615,14,1239371443,1239372844,6,6,1401
9858951@N03,11615,31,1239369625,1239369625,1,6,0
9858951@N03,11615,26,1239373972,1239373972,1,6,0
9858951@N03,11616,14,1239526940,1239526940,1,1,0
9858951@N03,11617,1,1240034597,1240037803,3,6,3206
9858951@N03,11617,21,1240052651,1240055675,8,6,3024
9858951@N03,11617,11,1240056773,1240056773,1,6,0
9858951@N03,11617,25,1240047004,1240047018,4,6,14
9858951@N03,11617,13,1240049324,1240052675,33,6,3351
9858951@N03,11617,31,1240059733,1240059990,8,6,257
9858951@N03,11618,28,1240296924,1240297157,5,1,233
9858951@N03,11619,28,1240547239,1240547265,2,1,26
9858951@N03,11620,22,1240896459,1240899954,2,2,3495
9858951@N03,11620,14,1240890162,1240890162,1,2,0
9858951@N03,11621,1,1241133530,1241187995,11,4,54465
9858951@N03,11621,28,1241132850,1241172958,13,4,40108
9858951@N03,11621,18,1241170013,1241170016,2,4,3
9858951@N03,11621,29,1241140830,1241156594,43,4,15764
9858951@N03,11622,1,1241879811,1241879823,6,5,12
9858951@N03,11622,15,1241878449,1241878848,41,5,399
9858951@N03,11622,24,1241876010,1241878440,20,5,2430
9858951@N03,11622,27,1241878682,1241879182,6,5,500
9858951@N03,11622,16,1241879163,1241879163,1,5,0
9858951@N03,11623,1,1242811939,1242813723,14,6,1784
9858951@N03,11623,20,1242816428,1242817502,53,6,1074
9858951@N03,11623,28,1242812134,1242819137,31,6,7003
9858951@N03,11623,13,1242817873,1242817895,12,6,22
9858951@N03,11623,25,1242818048,1242818048,4,6,0
9858951@N03,11623,31,1242815809,1242816101,15,6,292
9858951@N03,11624,26,1243118020,1243135581,124,2,17561
9858951@N03,11624,28,1243136039,1243137363,31,2,1324
9858951@N03,11625,26,1243653564,1243660758,6,1,7194
9858951@N03,11626,26,1243750015,1243751689,2,1,1674
9858951@N03,11627,19,1245322369,1245322630,7,1,261
9858951@N03,11628,26,1248512768,1248512768,1,1,0
9858951@N03,11629,13,1248680416,1248680416,2,2,0
9858951@N03,11629,26,1248680414,1248680414,1,2,0
9858951@N03,11630,1,1250313663,1250318280,3,1,4617
9858951@N03,11631,22,1251259205,1251266694,6,2,7489
9858951@N03,11631,30,1251261539,1251261555,3,2,16
9858951@N03,11632,18,1252478890,1252478890,2,1,0
9858951@N03,11633,19,1252738223,1252738249,3,1,26
9858951@N03,11634,6,1254629538,1254629538,1,1,0
9858951@N03,11635,3,1255173337,1255173337,1,2,0
9858951@N03,11635,13,1255162167,1255162179,3,2,12
9858951@N03,11636,13,1255431151,1255431151,1,1,0
9858951@N03,11637,27,1258756227,1258756227,1,1,0
9858951@N03,11638,7,1259480588,1259480588,1,1,0
9858951@N03,11639,7,1259727681,1259727681,1,1,0
9858951@N03,11640,20,1264772278,1264772289,3,1,11
9858951@N03,11641,20,1264864133,1264864147,3,1,14
9858951@N03,11642,24,1271158633,1271158777,7,1,144
9858951@N03,11643,20,1271292873,1271292873,1,2,0
9858951@N03,11643,1,1271288580,1271288580,1,2,0
9858951@N03,11644,25,1271563458,1271563458,1,1,0
9858951@N03,11645,26,1273720006,1273721000,4,1,994
9858951@N03,11646,28,1273781324,1273781424,9,2,100
9858951@N03,11646,21,1273782808,1273785792,23,2,2984
9858951@N03,11647,28,1274258359,1274259736,58,7,1377
9858951@N03,11647,26,1274248820,1274257726,694,7,8906
9858951@N03,11647,12,1274253453,1274253488,9,7,35
9858951@N03,11647,18,1274259776,1274259781,2,7,5
9858951@N03,11647,29,1274265285,1274267153,4,7,1868
9858951@N03,11647,1,1274260691,1274262941,4,7,2250
9858951@N03,11647,23,1274267328,1274267671,12,7,343
9858951@N03,11648,28,1275370252,1275370307,6,4,55
9858951@N03,11648,1,1275370250,1275370310,12,4,60
9858951@N03,11648,16,1275370259,1275370259,1,4,0
9858951@N03,11648,26,1275370262,1275370266,2,4,4
9858951@N03,11649,7,1276921041,1276921041,1,1,0
9858951@N03,11650,28,1282255309,1282255309,1,3,0
9858951@N03,11650,26,1282255312,1282255312,1,3,0
9858951@N03,11650,1,1282255312,1282255322,15,3,10
9858951@N03,11651,25,1316149317,1316149319,2,1,2
9858951@N03,11652,28,1316651765,1316651765,1,1,0
9858951@N03,11653,29,1345006623,1345006623,1,1,0
9858951@N03,11654,19,1345042911,1345042961,3,1,50
9858951@N03,11655,19,1345491978,1345491978,1,5,0
9858951@N03,11655,26,1345491971,1345491976,2,5,5
9858951@N03,11655,20,1345491973,1345491973,1,5,0
9858951@N03,11655,16,1345491967,1345491967,1,5,0
9858951@N03,11655,1,1345491965,1345491965,1,5,0
9858951@N03,11656,29,1345546894,1345546897,3,1,3
9858951@N03,11657,19,1345836843,1345836843,1,2,0
9858951@N03,11657,18,1345844008,1345844008,1,2,0
9858951@N03,11658,25,1346044868,1346044868,1,1,0
9858951@N03,11659,28,1346204320,1346204321,2,1,1
9858951@N03,11660,18,1346742339,1346742339,1,1,0
9858951@N03,11661,23,1346892667,1346892667,1,1,0
9858951@N03,11662,25,1347345638,1347345638,1,1,0
9858951@N03,11663,19,1349104231,1349104231,1,1,0
9858951@N03,11664,19,1349317923,1349317926,2,1,3
9858951@N03,11665,18,1355182313,1355198648,6,1,16335
9858951@N03,11666,18,1355375002,1355382183,4,1,7181
98636389@N06,11667,15,1401347320,1401347328,2,1,8
98663457@N00,11668,30,1359689722,1359689722,1,1,0
98663457@N00,11669,26,1359972126,1359972609,2,1,483
98672552@N00,11670,13,1189912897,1189912897,1,1,0
98672552@N00,11671,29,1190371990,1190371990,1,4,0
98672552@N00,11671,17,1190344193,1190344193,1,4,0
98672552@N00,11671,10,1190347323,1190347323,1,4,0
98672552@N00,11671,28,1190352541,1190371321,4,4,18780
98672552@N00,11672,28,1191564269,1191568302,2,4,4033
98672552@N00,11672,30,1191564835,1191564866,4,4,31
98672552@N00,11672,1,1191563911,1191564040,3,4,129
98672552@N00,11672,29,1191565124,1191567548,6,4,2424
98672552@N00,11673,26,1192940366,1192940369,2,10,3
98672552@N00,11673,30,1192935006,1192944066,12,10,9060
98672552@N00,11673,29,1192941946,1192942187,6,10,241
98672552@N00,11673,25,1192921816,1192921816,1,10,0
98672552@N00,11673,17,1192940052,1192940052,1,10,0
98672552@N00,11673,3,1192923488,1192937219,4,10,13731
98672552@N00,11673,21,1192924823,1192924823,1,10,0
98672552@N00,11673,16,1192938245,1192948979,9,10,10734
98672552@N00,11673,28,1192950234,1192950234,1,10,0
98672552@N00,11673,13,1192921906,1192921906,1,10,0
98672552@N00,11674,26,1256167860,1256167860,1,3,0
98672552@N00,11674,30,1256169369,1256169369,1,3,0
98672552@N00,11674,13,1256177347,1256177347,1,3,0
98672552@N00,11675,7,1264149711,1264149711,1,1,0
98684111@N07,11676,1,1372202198,1372237269,23,3,35071
98684111@N07,11676,24,1372210818,1372210950,3,3,132
98684111@N07,11676,28,1372212710,1372213147,2,3,437
98684111@N07,11677,1,1372291954,1372309182,6,2,17228
98684111@N07,11677,28,1372307146,1372307670,4,2,524
98684111@N07,11678,1,1372414737,1372414737,1,1,0
9868739@N04,11679,12,1364429931,1364429931,1,1,0
98735721@N06,11680,1,1373521159,1373521192,2,1,33
98798579@N00,11681,13,1347093803,1347093803,1,2,0
98798579@N00,11681,16,1347091105,1347091105,1,2,0
98798579@N00,11682,26,1354986830,1354986830,1,1,0
98798579@N00,11683,27,1355122160,1355122160,1,1,0
9885001@N08,11684,13,1311239409,1311239409,1,3,0
9885001@N08,11684,17,1311231207,1311231207,1,3,0
9885001@N08,11684,15,1311230957,1311230957,1,3,0
9885152@N08,11685,1,1451265199,1451265199,1,1,0
98927091@N08,11686,20,1383042481,1383042481,1,1,0
98988031@N02,11687,28,1218752660,1218757082,2,2,4422
98988031@N02,11687,13,1218757552,1218757663,2,2,111
98988031@N02,11688,28,1218809407,1218809415,2,2,8
98988031@N02,11688,26,1218809778,1218809799,3,2,21
99016667@N00,11689,22,1325995234,1325995234,1,3,0
99016667@N00,11689,25,1325992568,1325992568,1,3,0
99016667@N00,11689,21,1325990949,1325990949,1,3,0
99016667@N00,11690,29,1331870043,1331870043,1,3,0
99016667@N00,11690,19,1331856823,1331856823,1,3,0
99016667@N00,11690,11,1331855382,1331855386,2,3,4
99016667@N00,11691,3,1338886230,1338886230,1,4,0
99016667@N00,11691,21,1338884811,1338886353,2,4,1542
99016667@N00,11691,5,1338884867,1338885012,3,4,145
99016667@N00,11691,7,1338884334,1338884334,1,4,0
99020953@N02,11692,22,1458905540,1458905540,1,1,0
99162408@N00,11693,13,1325936563,1325936563,1,1,0
99193556@N06,11694,14,1459224339,1459224462,3,4,123
99193556@N06,11694,15,1459244652,1459248304,8,4,3652
99193556@N06,11694,23,1459240327,1459240327,1,4,0
99193556@N06,11694,29,1459240000,1459240000,1,4,0
99210863@N07,11695,18,1457244359,1457268040,2,1,23681
99238380@N02,11696,13,1371796594,1371796594,1,1,0
99244170@N03,11697,12,1327101085,1327101168,9,11,83
99244170@N03,11697,15,1327101079,1327120602,14,11,19523
99244170@N03,11697,17,1327105425,1327105425,1,11,0
99244170@N03,11697,1,1327124341,1327124377,2,11,36
99244170@N03,11697,16,1327122962,1327123613,17,11,651
99244170@N03,11697,22,1327107070,1327107122,2,11,52
99244170@N03,11697,14,1327106166,1327106259,4,11,93
99244170@N03,11697,29,1327107343,1327108251,4,11,908
99244170@N03,11697,28,1327135732,1327136797,2,11,1065
99244170@N03,11697,24,1327102889,1327103002,5,11,113
99244170@N03,11697,21,1327127879,1327130580,6,11,2701
99253695@N00,11698,23,1317722203,1317722203,1,5,0
99253695@N00,11698,28,1317719869,1317719937,3,5,68
99253695@N00,11698,17,1317726380,1317726683,9,5,303
99253695@N00,11698,26,1317725209,1317725236,5,5,27
99253695@N00,11698,1,1317719792,1317729717,3,5,9925
9926279@N03,11699,6,1416080115,1416080115,1,3,0
9926279@N03,11699,14,1416073899,1416074426,2,3,527
9926279@N03,11699,30,1416079851,1416079851,1,3,0
9926279@N03,11700,30,1421435661,1421435661,1,1,0
9926279@N03,11701,7,1441484355,1441484355,1,2,0
9926279@N03,11701,21,1441484823,1441484827,3,2,4
99292329@N03,11702,1,1382103246,1382103294,5,9,48
99292329@N03,11702,16,1382083657,1382096459,34,9,12802
99292329@N03,11702,20,1382089972,1382089977,2,9,5
99292329@N03,11702,26,1382098630,1382098681,6,9,51
99292329@N03,11702,31,1382089844,1382089853,2,9,9
99292329@N03,11702,11,1382087121,1382087121,1,9,0
99292329@N03,11702,25,1382086297,1382086319,4,9,22
99292329@N03,11702,21,1382086546,1382086546,1,9,0
99292329@N03,11702,28,1382103063,1382103160,5,9,97
99292329@N03,11703,1,1382133393,1382133412,3,1,19
99313869@N04,11704,16,1378870011,1378870011,1,1,0
99357189@N00,11705,1,1360709708,1360709708,1,2,0
99357189@N00,11705,26,1360710602,1360745282,77,2,34680
99364192@N07,11706,22,1364520820,1364520872,2,1,52
9937502@N05,11707,29,1445425824,1445425824,1,1,0
99389853@N03,11708,26,1405489701,1405489701,1,1,0
99395292@N02,11709,11,1413799155,1413799155,1,1,0
99406544@N00,11710,14,1398606203,1398606203,1,2,0
99406544@N00,11710,15,1398605605,1398605605,1,2,0
9943904@N03,11711,21,1261615245,1261615245,1,4,0
9943904@N03,11711,16,1261627444,1261642711,3,4,15267
9943904@N03,11711,28,1261613819,1261648374,4,4,34555
9943904@N03,11711,31,1261622593,1261623959,5,4,1366
99471343@N00,11712,20,1313555214,1313555221,2,1,7
99471343@N00,11713,11,1313621640,1313621640,2,4,0
99471343@N00,11713,4,1313617567,1313617577,5,4,10
99471343@N00,11713,24,1313642541,1313642541,1,4,0
99471343@N00,11713,13,1313625726,1313637655,9,4,11929
99471343@N00,11714,16,1313796840,1313798134,10,1,1294
99472108@N06,11715,28,1377428410,1377428410,1,1,0
99519186@N03,11716,1,1374984529,1374984666,6,2,137
99519186@N03,11716,20,1374984530,1374984530,3,2,0
99519186@N03,11717,29,1375059323,1375059325,10,1,2
99519186@N03,11718,1,1375855167,1375855167,1,1,0
99519186@N03,11719,29,1376212758,1376212761,18,1,3
99519186@N03,11720,29,1377650659,1377651113,3,1,454
99519186@N03,11721,29,1378511948,1378512533,2,1,585
99519186@N03,11722,29,1379147116,1379147116,1,1,0
99519186@N03,11723,29,1379461772,1379461962,2,1,190
99552910@N00,11724,17,1236917713,1236917713,1,1,0
99578286@N04,11725,26,1372228857,1372242668,4,2,13811
99578286@N04,11725,1,1372224130,1372251738,4,2,27608
99578286@N04,11726,29,1380173044,1380173044,1,5,0
99578286@N04,11726,31,1380173260,1380173260,1,5,0
99578286@N04,11726,20,1380175329,1380175612,4,5,283
99578286@N04,11726,30,1380181526,1380181527,15,5,1
99578286@N04,11726,19,1380172991,1380172995,2,5,4
99578286@N04,11727,29,1420422324,1420422324,1,3,0
99578286@N04,11727,1,1420422332,1420422335,2,3,3
99578286@N04,11727,26,1420436907,1420437188,18,3,281
99591369@N06,11728,16,1373086945,1373087112,4,5,167
99591369@N06,11728,26,1373069722,1373078760,15,5,9038
99591369@N06,11728,25,1373073514,1373073514,1,5,0
99591369@N06,11728,27,1373083926,1373083941,2,5,15
99591369@N06,11728,1,1373068812,1373068812,1,5,0
99591369@N06,11729,26,1374133856,1374134096,7,1,240
99591369@N06,11730,16,1375112440,1375112440,1,1,0
99598380@N08,11731,13,1432519875,1432519886,2,2,11
99598380@N08,11731,16,1432516702,1432516951,2,2,249
99608747@N00,11732,30,1342861604,1342865923,2,4,4319
99608747@N00,11732,3,1342872803,1342872803,1,4,0
99608747@N00,11732,15,1342861326,1342861326,1,4,0
99608747@N00,11732,13,1342861493,1342861493,1,4,0
99608747@N00,11733,29,1343136984,1343136984,1,1,0
99608747@N00,11734,1,1374296392,1374296392,1,1,0
99608747@N00,11735,25,1374364153,1374364153,1,1,0
99632250@N07,11736,31,1324685453,1324685453,1,1,0
99707950@N00,11737,7,1323550663,1323550663,1,1,0
99707950@N00,11738,13,1349140509,1349140509,1,1,0
99711918@N00,11739,28,1318849911,1318849911,1,1,0
9979792@N04,11740,29,1279432016,1279432016,1,1,0
9979792@N04,11741,1,1287091330,1287091330,1,1,0
99803265@N00,11742,26,1189571701,1189571701,1,1,0
99804076@N02,11743,1,1444279888,1444279888,1,2,0
99804076@N02,11743,26,1444280149,1444285698,3,2,5549
99804076@N02,11744,5,1444365442,1444365442,1,1,0
99814844@N00,11745,22,1340346378,1340346378,1,1,0
99855129@N00,11746,16,1386423721,1386423721,1,8,0
99855129@N00,11746,23,1386408882,1386408882,1,8,0
99855129@N00,11746,26,1386415619,1386418211,8,8,2592
99855129@N00,11746,29,1386380738,1386380920,6,8,182
99855129@N00,11746,25,1386419760,1386419760,1,8,0
99855129@N00,11746,21,1386418574,1386418642,2,8,68
99855129@N00,11746,18,1386382558,1386382938,2,8,380
99855129@N00,11746,19,1386381473,1386381502,2,8,29
99855129@N00,11747,27,1391867783,1391867783,1,1,0
99855129@N00,11748,15,1427081509,1427082221,7,6,712
99855129@N00,11748,28,1427059546,1427108259,11,6,48713
99855129@N00,11748,17,1427112678,1427112678,1,6,0
99855129@N00,11748,29,1427094538,1427106122,7,6,11584
99855129@N00,11748,18,1427062237,1427062716,4,6,479
99855129@N00,11748,19,1427090596,1427090596,1,6,0
99855129@N00,11749,30,1427259294,1427259309,2,5,15
99855129@N00,11749,20,1427270250,1427270291,3,5,41
99855129@N00,11749,28,1427238307,1427262574,2,5,24267
99855129@N00,11749,26,1427256194,1427256194,1,5,0
99855129@N00,11749,29,1427257685,1427257685,1,5,0
99855129@N00,11750,30,1427328923,1427328923,1,2,0
99855129@N00,11750,28,1427322875,1427322875,1,2,0
99855129@N00,11751,26,1427363538,1427363538,1,2,0
99855129@N00,11751,28,1427363812,1427363944,2,2,132
99855129@N00,11752,13,1427426829,1427426829,1,7,0
99855129@N00,11752,31,1427415741,1427415741,1,7,0
99855129@N00,11752,26,1427422685,1427422687,2,7,2
99855129@N00,11752,16,1427410921,1427428610,5,7,17689
99855129@N00,11752,28,1427408157,1427438991,10,7,30834
99855129@N00,11752,10,1427425113,1427425113,1,7,0
99855129@N00,11752,27,1427408952,1427411637,4,7,2685
9986207@N02,11753,16,1433510341,1433510353,3,3,12
9986207@N02,11753,26,1433504086,1433504923,9,3,837
9986207@N02,11753,20,1433513046,1433513387,2,3,341
99929919@N08,11754,14,1416023069,1416023069,1,1,0
99942665@N00,11755,30,1306562804,1306604886,28,1,42082
99961547@N00,11756,15,1462366322,1462366322,1,1,0
99976517@N00,11757,30,1291440186,1291440186,1,1,0
99987318@N03,11758,26,1424480124,1424480124,1,2,0
99987318@N03,11758,30,1424472568,1424504807,2,2,32239
