userID,trajID,poiID,startTime,endTime,#photo,trajLen,poiDuration
10005149@N03,1,21,1273189220,1273189220,1,2,0
10005149@N03,1,19,1273196253,1273196253,1,2,0
10005149@N03,2,2,1273281442,1273281442,1,2,0
10005149@N03,2,4,1273291600,1273291600,1,2,0
100063617@N06,3,27,1450997221,1450997221,1,1,0
10008488@N07,4,27,1353816367,1353816609,2,4,242
10008488@N07,4,10,1353803001,1353803001,1,4,0
10008488@N07,4,14,1353805071,1353805071,1,4,0
10008488@N07,4,9,1353805944,1353805944,1,4,0
10008488@N07,5,23,1354149324,1354149324,1,1,0
10008488@N07,6,16,1354439014,1354439014,2,5,0
10008488@N07,6,18,1354439892,1354439892,1,5,0
10008488@N07,6,27,1354428271,1354450154,16,5,21883
10008488@N07,6,15,1354435579,1354436727,2,5,1148
10008488@N07,6,14,1354434439,1354435843,2,5,1404
10019322@N03,7,16,1257065143,1257065143,1,1,0
10024384@N04,8,16,1263720608,1263720608,1,2,0
10024384@N04,8,9,1263720566,1263720566,1,2,0
10024384@N04,9,6,1299204515,1299204515,1,2,0
10024384@N04,9,2,1299204970,1299204970,1,2,0
10024384@N04,10,24,1367998824,1367998824,1,1,0
10024384@N04,11,27,1381740690,1381744486,4,1,3796
100346942@N08,12,27,1376898876,1376898876,1,1,0
100354657@N04,13,27,1363422344,1363422344,1,1,0
100363554@N07,14,27,1471729077,1471729077,1,1,0
100436193@N03,15,17,1419315205,1419315205,1,4,0
100436193@N03,15,4,1419300133,1419300133,1,4,0
100436193@N03,15,3,1419305479,1419305479,1,4,0
100436193@N03,15,20,1419285841,1419286127,2,4,286
100448554@N06,16,14,1370860298,1370860298,1,3,0
100448554@N06,16,12,1370860322,1370860329,2,3,7
100448554@N06,16,13,1370860404,1370860404,1,3,0
100448554@N06,17,14,1370916583,1370929525,3,1,12942
100448554@N06,18,27,1371063855,1371063866,2,1,11
100448554@N06,19,27,1371108291,1371108291,1,1,0
100448554@N06,20,14,1371180587,1371215943,2,2,35356
100448554@N06,20,10,1371207566,1371207566,1,2,0
100448554@N06,21,14,1371395012,1371395012,1,1,0
100448554@N06,22,14,1376723103,1376723442,12,1,339
100448554@N06,23,27,1376818230,1376818245,3,1,15
100459519@N02,24,14,1430575063,1430575063,1,2,0
100459519@N02,24,10,1430571542,1430571542,1,2,0
100459519@N02,25,9,1462269575,1462269575,1,1,0
100459519@N02,26,27,1462312739,1462312739,1,1,0
100459519@N02,27,26,1462460505,1462460505,1,1,0
100459519@N02,28,23,1462792291,1462792291,1,1,0
10047035@N00,29,16,1302118486,1302147670,22,1,29184
100483258@N08,30,16,1407673826,1407673826,1,1,0
10048675@N02,31,26,1234302592,1234302772,3,1,180
10048675@N02,32,17,1234568662,1234568668,2,2,6
10048675@N02,32,4,1234570004,1234570027,4,2,23
100506822@N02,33,27,1387666161,1387666161,1,1,0
100506822@N02,34,15,1387696062,1387697010,3,1,948
100506822@N02,35,16,1388007949,1388008956,7,2,1007
100506822@N02,35,14,1388008050,1388018351,16,2,10301
100597270@N04,36,27,1430889471,1430889471,1,1,0
100606614@N05,37,16,1406739929,1406740224,3,1,295
10061441@N03,38,3,1229532977,1229532997,2,1,20
100620414@N03,39,14,1461889222,1461926854,5,7,37632
100620414@N03,39,10,1461891328,1461891363,4,7,35
100620414@N03,39,19,1461904107,1461904110,2,7,3
100620414@N03,39,3,1461895537,1461895537,1,7,0
100620414@N03,39,20,1461904633,1461904633,1,7,0
100620414@N03,39,11,1461892174,1461892778,5,7,604
100620414@N03,39,27,1461887277,1461933036,16,7,45759
100620414@N03,40,27,1467257231,1467257231,1,1,0
100657680@N02,41,16,1383996109,1383996109,1,1,0
100657680@N02,42,16,1392462154,1392462154,1,1,0
100691062@N08,43,27,1403163483,1403167384,5,1,3901
100691062@N08,44,27,1403227687,1403258952,10,1,31265
100691062@N08,45,27,1403296202,1403296216,2,1,14
100747900@N02,46,27,1322270664,1322270664,1,1,0
100775193@N08,47,13,1386364147,1386364147,1,1,0
100775193@N08,48,27,1393227213,1393227213,1,1,0
100775193@N08,49,6,1397613439,1397613439,1,2,0
100775193@N08,49,14,1397600255,1397600255,1,2,0
100775237@N03,50,27,1309442400,1309442400,1,3,0
100775237@N03,50,20,1309442400,1309442400,1,3,0
100775237@N03,50,17,1309442400,1309442400,1,3,0
100775237@N03,51,27,1341064800,1341064800,2,2,0
100775237@N03,51,17,1341064800,1341064800,2,2,0
100775237@N03,52,27,1372600800,1372600800,4,3,0
100775237@N03,52,18,1372600800,1372600800,1,3,0
100775237@N03,52,8,1372600800,1372600800,1,3,0
100775237@N03,53,27,1373078565,1373078615,2,2,50
100775237@N03,53,4,1373064754,1373064754,1,2,0
100775237@N03,54,27,1373290977,1373290977,1,2,0
100775237@N03,54,17,1373285945,1373285945,1,2,0
100775237@N03,55,27,1405584680,1405584680,1,3,0
100775237@N03,55,26,1405590389,1405590438,2,3,49
100775237@N03,55,14,1405585812,1405585812,1,3,0
100775237@N03,56,27,1405680539,1405680539,1,1,0
100775237@N03,57,20,1405909839,1405909839,1,5,0
100775237@N03,57,17,1405911450,1405911450,1,5,0
100775237@N03,57,14,1405901957,1405901957,1,5,0
100775237@N03,57,21,1405906221,1405906221,1,5,0
100775237@N03,57,9,1405900379,1405902093,3,5,1714
100822654@N07,58,14,1400847860,1400847860,1,6,0
100822654@N07,58,27,1400839678,1400841933,3,6,2255
100822654@N07,58,9,1400800378,1400803358,5,6,2980
100822654@N07,58,4,1400835334,1400835334,1,6,0
100822654@N07,58,10,1400800209,1400800685,3,6,476
100822654@N07,58,21,1400823196,1400823290,2,6,94
100822654@N07,59,9,1401154720,1401154885,3,3,165
100822654@N07,59,19,1401154957,1401154957,1,3,0
100822654@N07,59,20,1401155187,1401158631,4,3,3444
10084809@N04,60,16,1459927510,1459927510,1,1,0
10084825@N03,61,26,1319170801,1319171549,2,1,748
10084825@N03,62,9,1319278736,1319279192,3,1,456
100948027@N07,63,17,1315126610,1315126858,2,5,248
100948027@N07,63,15,1315117798,1315117798,1,5,0
100948027@N07,63,1,1315131370,1315131401,2,5,31
100948027@N07,63,13,1315124902,1315124928,2,5,26
100948027@N07,63,18,1315124664,1315124664,1,5,0
100948027@N07,64,16,1315454326,1315454326,1,2,0
100948027@N07,64,9,1315454263,1315454263,1,2,0
100948027@N07,65,22,1315697201,1315697201,2,1,0
101036843@N06,66,27,1392978519,1392978542,2,1,23
10104201@N00,67,12,1416365010,1416365010,1,1,0
10104201@N00,68,17,1416452830,1416452830,1,1,0
101044534@N02,69,2,1381057538,1381057538,1,1,0
101068170@N05,70,7,1372493796,1372493845,2,2,49
101068170@N05,70,8,1372494015,1372494015,1,2,0
101118128@N08,71,10,1446593686,1446593714,2,1,28
101195207@N02,72,27,1466375699,1466375699,1,4,0
101195207@N02,72,3,1466398969,1466398969,1,4,0
101195207@N02,72,2,1466410721,1466410721,1,4,0
101195207@N02,72,6,1466382999,1466383022,2,4,23
101195207@N02,73,27,1467352343,1467352354,2,4,11
101195207@N02,73,4,1467351616,1467351616,1,4,0
101195207@N02,73,6,1467351475,1467351484,2,4,9
101195207@N02,73,26,1467338964,1467338964,1,4,0
10120262@N06,74,27,1240780578,1240794497,3,1,13919
101256016@N07,75,11,1381912641,1381913452,48,3,811
101256016@N07,75,27,1381888618,1381889082,18,3,464
101256016@N07,75,14,1381902719,1381904097,34,3,1378
101324125@N05,76,22,1372927735,1372927735,1,4,0
101324125@N05,76,26,1372929913,1372929931,3,4,18
101324125@N05,76,14,1372914337,1372914337,1,4,0
101324125@N05,76,2,1372945147,1372945147,1,4,0
10135048@N06,77,2,1316494478,1316494478,1,1,0
10139125@N03,78,22,1345695322,1345695322,1,2,0
10139125@N03,78,20,1345691303,1345691303,1,2,0
101402820@N02,79,17,1420336486,1420336486,1,3,0
101402820@N02,79,18,1420351656,1420351656,1,3,0
101402820@N02,79,20,1420344311,1420344368,2,3,57
101445497@N05,80,13,1221982916,1221982916,1,3,0
101445497@N05,80,27,1221990133,1221990133,1,3,0
101445497@N05,80,10,1221974404,1221974404,1,3,0
101445497@N05,81,26,1222179510,1222179510,1,4,0
101445497@N05,81,16,1222158839,1222158839,1,4,0
101445497@N05,81,17,1222179058,1222179058,1,4,0
101445497@N05,81,27,1222158487,1222158487,1,4,0
101445497@N05,82,16,1264330017,1264330017,1,1,0
101445497@N05,83,16,1316777647,1316777647,1,3,0
101445497@N05,83,6,1316771264,1316771264,1,3,0
101445497@N05,83,27,1316759711,1316759711,1,3,0
101445497@N05,84,17,1353230477,1353230477,1,3,0
101445497@N05,84,27,1353205446,1353205882,2,3,436
101445497@N05,84,7,1353219477,1353219477,1,3,0
101445497@N05,85,2,1353470935,1353470935,1,1,0
101445497@N05,86,26,1369711090,1369711090,1,5,0
101445497@N05,86,16,1369707750,1369707750,1,5,0
101445497@N05,86,4,1369749692,1369749692,1,5,0
101445497@N05,86,9,1369745318,1369745318,1,5,0
101445497@N05,86,7,1369734986,1369734986,1,5,0
101445497@N05,87,14,1380953172,1380953172,1,2,0
101445497@N05,87,27,1380948276,1380948547,2,2,271
101445497@N05,88,14,1401750767,1401751971,3,2,1204
101445497@N05,88,27,1401748483,1401748483,1,2,0
101445497@N05,89,16,1401788752,1401789262,8,2,510
101445497@N05,89,27,1401792404,1401792404,1,2,0
101445497@N05,90,27,1410783776,1410783776,1,3,0
101445497@N05,90,10,1410767416,1410767465,2,3,49
101445497@N05,90,24,1410758329,1410758329,1,3,0
101445497@N05,91,4,1432983140,1432983140,1,10,0
101445497@N05,91,19,1432971728,1432971728,1,10,0
101445497@N05,91,13,1432974099,1432975776,4,10,1677
101445497@N05,91,22,1432973596,1432973596,1,10,0
101445497@N05,91,3,1432979729,1432979729,1,10,0
101445497@N05,91,14,1432977870,1432977870,1,10,0
101445497@N05,91,2,1432979775,1432979814,2,10,39
101445497@N05,91,16,1432971116,1432971116,1,10,0
101445497@N05,91,15,1432977724,1432977724,1,10,0
101445497@N05,91,17,1432978135,1432978135,1,10,0
101445497@N05,92,27,1433216480,1433223153,2,3,6673
101445497@N05,92,11,1433211242,1433211242,1,3,0
101445497@N05,92,17,1433213207,1433213207,1,3,0
101445497@N05,93,20,1464604427,1464604427,1,2,0
101445497@N05,93,14,1464593525,1464593525,1,2,0
101445497@N05,94,22,1464851405,1464851405,1,3,0
101445497@N05,94,5,1464855730,1464855730,1,3,0
101445497@N05,94,17,1464858891,1464858891,1,3,0
101473404@N07,95,1,1388525190,1388525190,1,1,0
101473404@N07,96,14,1388656314,1388656314,1,3,0
101473404@N07,96,27,1388667866,1388667866,1,3,0
101473404@N07,96,2,1388660574,1388660574,1,3,0
101473404@N07,97,3,1453724106,1453724106,1,2,0
101473404@N07,97,14,1453724343,1453724343,1,2,0
10152427@N08,98,26,1229874074,1229874074,1,1,0
10152427@N08,99,26,1239503886,1239503886,1,1,0
10152427@N08,100,26,1239624622,1239631485,2,1,6863
10152427@N08,101,26,1261652609,1261652609,1,1,0
10152427@N08,102,26,1302745029,1302745029,1,1,0
10156308@N03,103,8,1418814998,1418814998,1,1,0
10156308@N03,104,24,1418863338,1418863338,1,1,0
10156308@N03,105,10,1419075046,1419075046,1,1,0
10156308@N03,106,22,1419164113,1419164113,1,3,0
10156308@N03,106,27,1419160476,1419182374,5,3,21898
10156308@N03,106,23,1419162447,1419162447,1,3,0
101593101@N02,107,27,1427497269,1427497269,1,1,0
101593101@N02,108,27,1458733140,1458733140,1,2,0
101593101@N02,108,13,1458730557,1458730557,1,2,0
101593101@N02,109,10,1458802416,1458802416,1,3,0
101593101@N02,109,27,1458796949,1458796949,1,3,0
101593101@N02,109,16,1458799868,1458799868,1,3,0
101682305@N06,110,27,1363395864,1363411508,5,1,15644
101682305@N06,111,27,1363480600,1363492104,3,1,11504
101682305@N06,112,27,1364521814,1364536775,2,1,14961
10173248@N05,113,27,1299979390,1299979390,1,1,0
10175710@N03,114,16,1374039803,1374076093,3,3,36290
10175710@N03,114,27,1374020581,1374076899,6,3,56318
10175710@N03,114,15,1374030391,1374030391,1,3,0
101766828@N04,115,27,1301901272,1301901852,2,4,580
101766828@N04,115,9,1301883966,1301883966,1,4,0
101766828@N04,115,18,1301892395,1301892475,3,4,80
101766828@N04,115,5,1301883619,1301883619,1,4,0
10182842@N08,116,1,1214800805,1214800805,1,5,0
10182842@N08,116,27,1214812976,1214812976,1,5,0
10182842@N08,116,16,1214806695,1214806695,1,5,0
10182842@N08,116,4,1214802356,1214802356,1,5,0
10182842@N08,116,22,1214806049,1214806049,1,5,0
10183691@N07,117,12,1236507731,1236508238,10,4,507
10183691@N07,117,16,1236519971,1236519989,2,4,18
10183691@N07,117,5,1236513455,1236513455,1,4,0
10183691@N07,117,4,1236520025,1236520025,1,4,0
101878598@N03,118,27,1455663227,1455663227,1,1,0
101878598@N03,119,14,1455694040,1455694040,1,3,0
101878598@N03,119,16,1455692379,1455692379,1,3,0
101878598@N03,119,15,1455694056,1455694056,1,3,0
101924327@N08,120,15,1416486814,1416486814,1,1,0
10196023@N00,121,14,1221477770,1221477770,1,1,0
10196023@N00,122,27,1343150268,1343150268,1,1,0
10196023@N00,123,27,1343269130,1343269130,1,1,0
10196023@N00,124,22,1401589456,1401589456,1,1,0
10196023@N00,125,8,1422173266,1422173266,1,1,0
10215206@N08,126,16,1277619700,1277619700,1,1,0
10215206@N08,127,16,1277952807,1277952807,1,1,0
102284959@N03,128,27,1378157833,1378157833,1,3,0
102284959@N03,128,16,1378159617,1378159617,1,3,0
102284959@N03,128,13,1378179665,1378179665,1,3,0
102284959@N03,129,22,1378770362,1378770362,1,1,0
102284959@N03,130,27,1380404331,1380404331,1,2,0
102284959@N03,130,16,1380404101,1380404580,4,2,479
102284959@N03,131,20,1380985944,1380985944,1,3,0
102284959@N03,131,16,1380986113,1380986113,1,3,0
102284959@N03,131,13,1380985967,1380986068,3,3,101
102284959@N03,132,27,1398445340,1398445340,1,1,0
102284959@N03,133,13,1442808517,1442808517,1,1,0
102284959@N03,134,15,1443540285,1443540285,1,2,0
102284959@N03,134,13,1443537488,1443537488,1,2,0
102284959@N03,135,16,1443631259,1443631259,1,3,0
102284959@N03,135,22,1443623455,1443623455,1,3,0
102284959@N03,135,18,1443625480,1443625480,1,3,0
102284959@N03,136,16,1458544061,1458544061,1,1,0
10250618@N06,137,16,1207660115,1207660115,1,1,0
10259875@N03,138,19,1231469684,1231469684,1,10,0
10259875@N03,138,27,1231426970,1231491090,7,10,64120
10259875@N03,138,26,1231431604,1231431604,1,10,0
10259875@N03,138,24,1231446352,1231446352,1,10,0
10259875@N03,138,20,1231447142,1231447142,1,10,0
10259875@N03,138,23,1231465125,1231465210,2,10,85
10259875@N03,138,16,1231421464,1231475693,5,10,54229
10259875@N03,138,14,1231474555,1231474555,1,10,0
10259875@N03,138,11,1231421252,1231469749,4,10,48497
10259875@N03,138,17,1231454023,1231456807,2,10,2784
10259875@N03,139,14,1239688279,1239688279,1,1,0
10259875@N03,140,1,1262473018,1262473018,1,7,0
10259875@N03,140,16,1262475558,1262480659,2,7,5101
10259875@N03,140,14,1262478370,1262480606,2,7,2236
10259875@N03,140,27,1262469290,1262483992,8,7,14702
10259875@N03,140,8,1262480281,1262480281,1,7,0
10259875@N03,140,5,1262471114,1262471114,1,7,0
10259875@N03,140,9,1262478659,1262478659,1,7,0
10259875@N03,141,16,1262573683,1262573683,1,6,0
10259875@N03,141,1,1262556534,1262556534,1,6,0
10259875@N03,141,27,1262554504,1262580839,5,6,26335
10259875@N03,141,17,1262573751,1262580048,5,6,6297
10259875@N03,141,19,1262579894,1262579894,1,6,0
10259875@N03,141,26,1262579080,1262579080,1,6,0
10259875@N03,142,4,1262839172,1262850796,2,13,11624
10259875@N03,142,12,1262834687,1262834687,1,13,0
10259875@N03,142,23,1262828537,1262828537,1,13,0
10259875@N03,142,14,1262832676,1262847848,12,13,15172
10259875@N03,142,1,1262839395,1262839395,1,13,0
10259875@N03,142,27,1262838893,1262853027,4,13,14134
10259875@N03,142,13,1262825636,1262826291,5,13,655
10259875@N03,142,20,1262827030,1262827030,1,13,0
10259875@N03,142,19,1262824800,1262837789,5,13,12989
10259875@N03,142,16,1262830246,1262846627,5,13,16381
10259875@N03,142,3,1262850421,1262850421,1,13,0
10259875@N03,142,26,1262828717,1262828717,1,13,0
10259875@N03,142,9,1262845509,1262848899,2,13,3390
10259875@N03,143,27,1274091749,1274094946,5,1,3197
10259875@N03,144,1,1274168773,1274168773,1,14,0
10259875@N03,144,23,1274152421,1274152421,1,14,0
10259875@N03,144,16,1274145934,1274162182,2,14,16248
10259875@N03,144,14,1274162892,1274175424,2,14,12532
10259875@N03,144,27,1274144614,1274178598,6,14,33984
10259875@N03,144,24,1274152209,1274152209,1,14,0
10259875@N03,144,8,1274174327,1274174327,1,14,0
10259875@N03,144,15,1274161836,1274161836,1,14,0
10259875@N03,144,21,1274159602,1274159602,1,14,0
10259875@N03,144,17,1274146051,1274177063,3,14,31012
10259875@N03,144,18,1274151102,1274151102,1,14,0
10259875@N03,144,3,1274170747,1274170747,1,14,0
10259875@N03,144,19,1274147603,1274157144,2,14,9541
10259875@N03,144,9,1274162990,1274176976,2,14,13986
10259875@N03,145,16,1302991403,1302991403,1,2,0
10259875@N03,145,27,1302995233,1302995233,1,2,0
10259875@N03,146,1,1303185317,1303185317,1,8,0
10259875@N03,146,16,1303204934,1303204934,1,8,0
10259875@N03,146,14,1303201451,1303201451,1,8,0
10259875@N03,146,27,1303161639,1303203744,2,8,42105
10259875@N03,146,17,1303201952,1303201952,1,8,0
10259875@N03,146,19,1303204471,1303204471,1,8,0
10259875@N03,146,20,1303202604,1303202604,1,8,0
10259875@N03,146,9,1303201346,1303201346,1,8,0
10259875@N03,147,16,1322206114,1322206114,1,7,0
10259875@N03,147,14,1322204010,1322217430,3,7,13420
10259875@N03,147,27,1322199226,1322220836,5,7,21610
10259875@N03,147,20,1322201293,1322201293,1,7,0
10259875@N03,147,15,1322218212,1322218212,1,7,0
10259875@N03,147,17,1322200063,1322200063,1,7,0
10259875@N03,147,9,1322204622,1322204622,1,7,0
10259875@N03,148,2,1364800211,1364800211,1,11,0
10259875@N03,148,16,1364787998,1364787998,1,11,0
10259875@N03,148,12,1364801791,1364801791,1,11,0
10259875@N03,148,14,1364804279,1364804279,1,11,0
10259875@N03,148,27,1364776226,1364812048,9,11,35822
10259875@N03,148,20,1364781544,1364781544,1,11,0
10259875@N03,148,17,1364780392,1364787899,2,11,7507
10259875@N03,148,10,1364788214,1364789517,4,11,1303
10259875@N03,148,3,1364799467,1364799467,1,11,0
10259875@N03,148,9,1364800579,1364800815,3,11,236
10259875@N03,148,25,1364786843,1364786843,1,11,0
10259875@N03,149,7,1392631911,1392631911,1,14,0
10259875@N03,149,12,1392612773,1392612773,1,14,0
10259875@N03,149,23,1392617491,1392617868,3,14,377
10259875@N03,149,14,1392628447,1392635776,6,14,7329
10259875@N03,149,27,1392603848,1392603848,1,14,0
10259875@N03,149,8,1392632217,1392632217,1,14,0
10259875@N03,149,15,1392622533,1392643114,3,14,20581
10259875@N03,149,17,1392626752,1392626752,1,14,0
10259875@N03,149,19,1392619865,1392619865,1,14,0
10259875@N03,149,10,1392596672,1392634413,5,14,37741
10259875@N03,149,22,1392620939,1392620939,1,14,0
10259875@N03,149,5,1392638164,1392639463,2,14,1299
10259875@N03,149,9,1392633653,1392633653,1,14,0
10259875@N03,149,25,1392641226,1392641226,1,14,0
10259875@N03,150,19,1428655671,1428655671,1,13,0
10259875@N03,150,10,1428612514,1428626619,3,13,14105
10259875@N03,150,2,1428620624,1428620624,1,13,0
10259875@N03,150,26,1428666508,1428666508,1,13,0
10259875@N03,150,15,1428610784,1428612059,2,13,1275
10259875@N03,150,25,1428654302,1428654302,1,13,0
10259875@N03,150,9,1428614197,1428614197,1,13,0
10259875@N03,150,4,1428661101,1428665120,4,13,4019
10259875@N03,150,7,1428613298,1428621607,2,13,8309
10259875@N03,150,17,1428616846,1428657854,3,13,41008
10259875@N03,150,23,1428666073,1428666286,2,13,213
10259875@N03,150,27,1428608724,1428653424,6,13,44700
10259875@N03,150,21,1428667607,1428667607,1,13,0
10295241@N02,151,9,1235899820,1235899820,1,1,0
10295241@N02,152,9,1236156636,1236156636,1,2,0
10295241@N02,152,6,1236152000,1236152432,4,2,432
10295241@N02,153,27,1447035111,1447035234,2,1,123
103400918@N03,154,25,1370731444,1370731490,2,3,46
103400918@N03,154,16,1370742960,1370742974,2,3,14
103400918@N03,154,27,1370754483,1370754483,1,3,0
10350193@N07,155,26,1224890040,1224890040,1,1,0
10350193@N07,156,20,1289054138,1289054138,1,1,0
10350193@N07,157,16,1298703774,1298703774,1,1,0
103690791@N02,158,15,1356325807,1356325807,1,1,0
103845490@N03,159,13,1381743307,1381743307,1,1,0
103845490@N03,160,16,1391407213,1391407213,1,1,0
10386262@N00,161,27,1289345457,1289345457,1,2,0
10386262@N00,161,1,1289360553,1289360553,1,2,0
104019882@N04,162,16,1463687354,1463687376,3,3,22
104019882@N04,162,21,1463687363,1463687363,1,3,0
104019882@N04,162,12,1463687368,1463687371,2,3,3
10403093@N06,163,27,1339195530,1339195530,1,1,0
10403093@N06,164,20,1353288237,1353288237,1,1,0
10403093@N06,165,9,1402097835,1402100463,7,4,2628
10403093@N06,165,27,1402094437,1402094537,3,4,100
10403093@N06,165,10,1402109439,1402110275,8,4,836
10403093@N06,165,3,1402099367,1402099367,1,4,0
10414404@N08,166,19,1405895350,1405895350,1,1,0
104174605@N06,167,27,1403770755,1403770755,1,1,0
10420619@N06,168,27,1353913876,1353931752,10,1,17876
10427995@N00,169,26,1450625754,1450625754,1,1,0
10429949@N00,170,27,1469663274,1469663274,1,1,0
10485077@N06,171,25,1202774460,1202774460,2,2,0
10485077@N06,171,13,1202774460,1202774460,2,2,0
104911618@N08,172,14,1433593420,1433599425,8,6,6005
104911618@N08,172,8,1433594276,1433594276,1,6,0
104911618@N08,172,12,1433594352,1433594352,1,6,0
104911618@N08,172,3,1433596402,1433596433,4,6,31
104911618@N08,172,9,1433590753,1433591432,3,6,679
104911618@N08,172,6,1433589008,1433589905,11,6,897
10494136@N02,173,18,1388026196,1388026196,1,1,0
10495641@N00,174,7,1336203684,1336203684,1,2,0
10495641@N00,174,14,1336201366,1336201366,1,2,0
10495641@N00,175,7,1336263490,1336263490,1,1,0
10500812@N04,176,27,1326791840,1326791840,1,1,0
105156445@N06,177,15,1408239526,1408239553,3,5,27
105156445@N06,177,14,1408233585,1408233590,2,5,5
105156445@N06,177,27,1408231102,1408231329,3,5,227
105156445@N06,177,8,1408235827,1408235836,2,5,9
105156445@N06,177,17,1408239545,1408239545,1,5,0
105156445@N06,178,2,1408325315,1408325339,3,7,24
105156445@N06,178,3,1408337764,1408337766,2,7,2
105156445@N06,178,27,1408321663,1408321670,2,7,7
105156445@N06,178,4,1408326273,1408326273,1,7,0
105156445@N06,178,6,1408331311,1408331311,1,7,0
105156445@N06,178,23,1408323028,1408323029,2,7,1
105156445@N06,178,1,1408323756,1408323756,1,7,0
10529536@N05,179,17,1299128979,1299129165,3,2,186
10529536@N05,179,16,1299117944,1299147376,7,2,29432
10529536@N05,180,16,1299400085,1299400085,1,2,0
10529536@N05,180,27,1299413606,1299414254,3,2,648
10540666@N07,181,27,1292207722,1292207722,1,1,0
10570686@N02,182,14,1268446742,1268462937,10,1,16195
105763347@N06,183,10,1356937802,1356937802,1,1,0
10577359@N08,184,17,1299209822,1299209822,1,1,0
10577359@N08,185,18,1309231425,1309231425,1,1,0
10583070@N05,186,4,1228483706,1228483706,1,5,0
10583070@N05,186,2,1228475410,1228477701,11,5,2291
10583070@N05,186,18,1228481520,1228483057,36,5,1537
10583070@N05,186,27,1228474970,1228486910,15,5,11940
10583070@N05,186,17,1228483337,1228483337,1,5,0
106041775@N07,187,16,1448254605,1448254605,1,1,0
106045902@N02,188,27,1366505831,1366505831,1,1,0
10606860@N02,189,17,1313471184,1313487561,6,9,16377
10606860@N02,189,4,1313470563,1313490925,22,9,20362
10606860@N02,189,16,1313486874,1313486942,3,9,68
10606860@N02,189,18,1313478892,1313478930,2,9,38
10606860@N02,189,25,1313480616,1313480616,1,9,0
10606860@N02,189,27,1313455941,1313458101,5,9,2160
10606860@N02,189,24,1313480573,1313480573,1,9,0
10606860@N02,189,20,1313478996,1313480016,15,9,1020
10606860@N02,189,14,1313472383,1313472383,1,9,0
10617321@N00,190,23,1464516616,1464516616,1,1,0
106331106@N07,191,27,1432237986,1432237986,1,1,0
106474616@N07,192,6,1382550775,1382550775,1,2,0
106474616@N07,192,9,1382550831,1382550831,1,2,0
106558608@N06,193,17,1463012213,1463012213,1,5,0
106558608@N06,193,15,1463012102,1463012222,4,5,120
106558608@N06,193,12,1463012120,1463012267,2,5,147
106558608@N06,193,10,1463038416,1463038940,9,5,524
106558608@N06,193,4,1463047898,1463047903,2,5,5
106558608@N06,194,21,1463096929,1463096929,1,3,0
106558608@N06,194,18,1463101478,1463101478,1,3,0
106558608@N06,194,27,1463092797,1463117654,47,3,24857
106558608@N06,195,14,1463449185,1463449315,3,4,130
106558608@N06,195,12,1463443066,1463443066,1,4,0
106558608@N06,195,3,1463441940,1463442416,3,4,476
106558608@N06,195,27,1463441144,1463441252,5,4,108
10670886@N08,196,8,1397611093,1397611093,1,1,0
10673595@N00,197,27,1463276943,1463276943,1,1,0
10687935@N04,198,16,1336214428,1336214428,1,1,0
106918343@N02,199,16,1413161017,1413161712,2,2,695
106918343@N02,199,27,1413158403,1413175049,49,2,16646
106980455@N06,200,7,1384213061,1384213061,1,2,0
106980455@N06,200,27,1384241002,1384241002,1,2,0
10703707@N07,201,17,1320479490,1320479815,3,4,325
10703707@N07,201,18,1320479204,1320479204,1,4,0
10703707@N07,201,27,1320440623,1320465885,5,4,25262
10703707@N07,201,9,1320476584,1320476584,1,4,0
107434985@N05,202,27,1368353353,1368353353,1,1,0
10766128@N07,203,24,1194929087,1194929087,1,3,0
10766128@N07,203,15,1194927674,1194927674,1,3,0
10766128@N07,203,9,1194925962,1194926151,2,3,189
10766128@N07,204,14,1195887393,1195887393,1,8,0
10766128@N07,204,3,1195866794,1195866794,1,8,0
10766128@N07,204,15,1195886825,1195886825,1,8,0
10766128@N07,204,27,1195860439,1195860461,2,8,22
10766128@N07,204,6,1195861863,1195861863,1,8,0
10766128@N07,204,9,1195875894,1195879969,2,8,4075
10766128@N07,204,4,1195896330,1195898890,2,8,2560
10766128@N07,204,18,1195881858,1195881861,2,8,3
10774763@N05,205,20,1251970760,1251971873,4,14,1113
10774763@N05,205,8,1251974786,1251974991,4,14,205
10774763@N05,205,5,1251975518,1251975869,5,14,351
10774763@N05,205,1,1251975442,1251975462,2,14,20
10774763@N05,205,27,1251968226,1251968294,2,14,68
10774763@N05,205,19,1251972213,1251973844,2,14,1631
10774763@N05,205,21,1251978255,1251979006,3,14,751
10774763@N05,205,9,1251974739,1251974739,1,14,0
10774763@N05,205,13,1251969059,1251970416,3,14,1357
10774763@N05,205,3,1251975946,1251976007,2,14,61
10774763@N05,205,6,1251975303,1251975332,2,14,29
10774763@N05,205,16,1251968961,1251974688,3,14,5727
10774763@N05,205,22,1251977203,1251977203,1,14,0
10774763@N05,205,17,1251970489,1251970489,1,14,0
10782871@N00,206,14,1399789394,1399789402,2,1,8
107853262@N02,207,27,1403484646,1403521336,8,2,36690
107853262@N02,207,11,1403500750,1403502337,12,2,1587
107905375@N06,208,10,1454989101,1454989101,1,1,0
107905375@N06,209,26,1455094118,1455094118,1,9,0
107905375@N06,209,27,1455109737,1455109756,2,9,19
107905375@N06,209,15,1455106746,1455106808,5,9,62
107905375@N06,209,22,1455106460,1455106460,1,9,0
107905375@N06,209,10,1455107365,1455107365,1,9,0
107905375@N06,209,11,1455065347,1455065347,1,9,0
107905375@N06,209,21,1455095365,1455095365,1,9,0
107905375@N06,209,23,1455094104,1455094104,1,9,0
107905375@N06,209,2,1455075967,1455075974,3,9,7
10857883@N05,210,16,1271152026,1271152026,1,3,0
10857883@N05,210,19,1271145965,1271147447,7,3,1482
10857883@N05,210,18,1271146813,1271147217,2,3,404
10858077@N00,211,6,1207101000,1207101333,2,3,333
10858077@N00,211,15,1207093274,1207093320,2,3,46
10858077@N00,211,4,1207098926,1207099024,2,3,98
108611835@N05,212,27,1383559285,1383559285,1,1,0
10871340@N02,213,15,1361691463,1361691463,1,3,0
10871340@N02,213,3,1361674183,1361674183,1,3,0
10871340@N02,213,16,1361694782,1361694782,1,3,0
108906145@N05,214,17,1395135523,1395135523,1,1,0
108918961@N02,215,18,1428308266,1428308266,1,2,0
108918961@N02,215,4,1428312122,1428312122,1,2,0
10899502@N05,216,2,1271818768,1271818768,1,1,0
10910455@N04,217,16,1320471304,1320471304,1,1,0
10925918@N03,218,9,1277162106,1277162106,1,1,0
10925918@N03,219,16,1277778674,1277778674,1,2,0
10925918@N03,219,18,1277802235,1277802235,1,2,0
10925918@N03,220,27,1362384708,1362384708,1,1,0
10925918@N03,221,21,1362456092,1362456092,1,9,0
10925918@N03,221,10,1362474858,1362474858,1,9,0
10925918@N03,221,27,1362439054,1362439054,1,9,0
10925918@N03,221,16,1362466999,1362466999,1,9,0
10925918@N03,221,19,1362439805,1362439805,1,9,0
10925918@N03,221,9,1362450618,1362450907,2,9,289
10925918@N03,221,23,1362457442,1362457442,1,9,0
10925918@N03,221,20,1362443318,1362443318,1,9,0
10925918@N03,221,8,1362437865,1362447105,2,9,9240
109402089@N08,222,16,1381720607,1381720607,1,1,0
109402089@N08,223,26,1382691012,1382691012,1,1,0
10944271@N07,224,22,1307507635,1307507635,1,1,0
109492309@N03,225,16,1385686604,1385704933,2,1,18329
109511520@N03,226,14,1431898305,1431898506,2,1,201
109554486@N07,227,10,1384218502,1384218502,1,8,0
109554486@N07,227,6,1384223491,1384223617,4,8,126
109554486@N07,227,27,1384207787,1384207787,1,8,0
109554486@N07,227,9,1384223104,1384223104,1,8,0
109554486@N07,227,16,1384209418,1384243227,14,8,33809
109554486@N07,227,21,1384247399,1384247399,1,8,0
109554486@N07,227,15,1384212410,1384212418,2,8,8
109554486@N07,227,14,1384208880,1384243247,19,8,34367
109702501@N02,228,4,1449921717,1449921717,1,1,0
10983978@N03,229,19,1207570183,1207570183,1,1,0
10983978@N03,230,26,1218090353,1218090353,1,1,0
10983978@N03,231,19,1220238152,1220238152,1,3,0
10983978@N03,231,27,1220241654,1220241654,1,3,0
10983978@N03,231,17,1220241198,1220241198,1,3,0
10983978@N03,232,20,1227673390,1227673390,1,1,0
10983978@N03,233,16,1230542992,1230545234,3,1,2242
10983978@N03,234,18,1230606971,1230606971,1,1,0
10983978@N03,235,19,1257239175,1257239175,1,1,0
10983978@N03,236,16,1270622471,1270622471,1,1,0
10983978@N03,237,9,1278844526,1278844526,1,1,0
10983978@N03,238,16,1283005131,1283005131,1,1,0
10983978@N03,239,22,1292080623,1292080623,1,1,0
10983978@N03,240,18,1292112476,1292112476,1,1,0
10983978@N03,241,8,1292943262,1292943695,2,2,433
10983978@N03,241,1,1292942813,1292942813,1,2,0
10983978@N03,242,15,1294141502,1294141502,1,3,0
10983978@N03,242,1,1294139474,1294139652,3,3,178
10983978@N03,242,19,1294139751,1294139751,1,3,0
10983978@N03,243,1,1300885200,1300885200,2,1,0
10983978@N03,244,27,1307714400,1307714400,1,4,0
10983978@N03,244,4,1307714400,1307714400,1,4,0
10983978@N03,244,16,1307714400,1307714400,4,4,0
10983978@N03,244,21,1307714400,1307714400,1,4,0
10989907@N07,245,24,1385964882,1385964882,1,7,0
10989907@N07,245,2,1385984068,1385986308,2,7,2240
10989907@N07,245,1,1385984010,1385984010,1,7,0
10989907@N07,245,8,1385949148,1385949291,3,7,143
10989907@N07,245,17,1385969116,1385969116,1,7,0
10989907@N07,245,21,1385983688,1385983785,2,7,97
10989907@N07,245,23,1385965038,1385965038,1,7,0
10989907@N07,246,27,1386202006,1386246741,5,4,44735
10989907@N07,246,16,1386229098,1386229098,1,4,0
10989907@N07,246,4,1386223824,1386223824,1,4,0
10989907@N07,246,17,1386245151,1386245151,1,4,0
10989907@N07,247,23,1417232649,1417232649,1,1,0
109920749@N03,248,9,1409715785,1409715785,1,3,0
109920749@N03,248,14,1409737522,1409737522,1,3,0
109920749@N03,248,19,1409729350,1409729350,1,3,0
11011638@N02,249,27,1400914838,1400920304,4,1,5466
11011638@N02,250,27,1401325463,1401325463,1,1,0
11014059@N02,251,5,1210790541,1210790541,1,2,0
11014059@N02,251,9,1210795173,1210795173,1,2,0
110166673@N02,252,7,1385282841,1385282847,2,9,6
110166673@N02,252,1,1385281077,1385281685,4,9,608
110166673@N02,252,17,1385265577,1385265577,1,9,0
110166673@N02,252,4,1385254592,1385254599,5,9,7
110166673@N02,252,14,1385251106,1385251121,5,9,15
110166673@N02,252,13,1385265640,1385265640,2,9,0
110166673@N02,252,18,1385265866,1385266265,3,9,399
110166673@N02,252,2,1385257188,1385281748,4,9,24560
110166673@N02,252,9,1385289117,1385289127,4,9,10
110166673@N02,253,14,1385625605,1385625605,3,2,0
110166673@N02,253,16,1385625951,1385626950,11,2,999
11017709@N07,254,21,1318657039,1318657039,1,3,0
11017709@N07,254,16,1318652829,1318652829,1,3,0
11017709@N07,254,22,1318656742,1318656742,1,3,0
110223705@N07,255,12,1463807573,1463807956,7,18,383
110223705@N07,255,24,1463811326,1463811803,12,18,477
110223705@N07,255,15,1463789900,1463810450,6,18,20550
110223705@N07,255,22,1463810852,1463810884,4,18,32
110223705@N07,255,9,1463785898,1463793596,11,18,7698
110223705@N07,255,26,1463813218,1463819064,2,18,5846
110223705@N07,255,25,1463802070,1463811692,7,18,9622
110223705@N07,255,14,1463785723,1463807036,15,18,21313
110223705@N07,255,27,1463784527,1463838164,13,18,53637
110223705@N07,255,16,1463785459,1463833502,18,18,48043
110223705@N07,255,20,1463810921,1463822709,3,18,11788
110223705@N07,255,3,1463835067,1463835479,2,18,412
110223705@N07,255,2,1463833765,1463833765,1,18,0
110223705@N07,255,17,1463806764,1463822961,12,18,16197
110223705@N07,255,13,1463791533,1463810410,5,18,18877
110223705@N07,255,21,1463811390,1463822472,6,18,11082
110223705@N07,255,23,1463813721,1463813721,1,18,0
110223705@N07,255,10,1463786131,1463808526,12,18,22395
110270294@N05,256,14,1409907931,1409907931,1,1,0
110333758@N06,257,14,1386326020,1386326020,1,3,0
110333758@N06,257,6,1386323439,1386324186,2,3,747
110333758@N06,257,27,1386317476,1386317476,1,3,0
11041171@N06,258,9,1277609906,1277609906,1,1,0
11041171@N06,259,17,1297297701,1297297701,1,1,0
11041171@N06,260,27,1302483941,1302483941,1,1,0
11041171@N06,261,9,1352245194,1352245194,1,1,0
11041171@N06,262,9,1352767985,1352767985,1,3,0
11041171@N06,262,27,1352781006,1352781006,1,3,0
11041171@N06,262,18,1352777869,1352777869,1,3,0
11041171@N06,263,3,1358131675,1358131675,1,1,0
11041171@N06,264,9,1358294025,1358294025,1,2,0
11041171@N06,264,18,1358301349,1358301349,1,2,0
11041171@N06,265,19,1372484084,1372484084,1,2,0
11041171@N06,265,18,1372484541,1372484541,1,2,0
11041171@N06,266,4,1404523282,1404523282,1,1,0
11041171@N06,267,9,1404912032,1404912032,1,1,0
110670053@N07,268,27,1424992176,1424992176,1,1,0
110670053@N07,269,27,1425032219,1425032219,1,1,0
110670053@N07,270,27,1425339460,1425339460,1,1,0
110670053@N07,271,27,1470484088,1470484088,1,1,0
110708467@N08,272,16,1392864950,1392864950,2,1,0
111075106@N05,273,17,1386601812,1386601825,4,1,13
111107017@N08,274,16,1371806374,1371806374,1,1,0
111107017@N08,275,22,1378510823,1378510823,1,1,0
111107017@N08,276,13,1386470946,1386470946,1,1,0
111364633@N02,277,5,1321917323,1321922560,4,2,5237
111364633@N02,277,4,1321915904,1321929772,3,2,13868
11137977@N00,278,22,1234834429,1234834429,1,1,0
111417007@N03,279,27,1277026810,1277026810,1,1,0
11145342@N04,280,16,1212837007,1212837007,1,1,0
11145342@N04,281,16,1272283134,1272283771,51,1,637
11145342@N04,282,27,1352724350,1352724459,2,1,109
11145342@N04,283,16,1352763619,1352780114,5,2,16495
11145342@N04,283,14,1352767876,1352767876,1,2,0
11145342@N04,284,14,1353065240,1353065240,1,1,0
11145342@N04,285,6,1369135744,1369135744,1,1,0
11149127@N05,286,3,1300027834,1300027834,1,2,0
11149127@N05,286,1,1300026025,1300027609,2,2,1584
111581625@N04,287,4,1354155764,1354155764,1,1,0
111603867@N06,288,27,1390377802,1390389289,3,1,11487
111603867@N06,289,18,1390872773,1390872773,1,1,0
11171054@N04,290,26,1440154591,1440154594,3,3,3
11171054@N04,290,16,1440154597,1440154597,1,3,0
11171054@N04,290,27,1440154622,1440154622,1,3,0
111797858@N08,291,27,1386402652,1386402652,1,1,0
111797858@N08,292,27,1386469381,1386469381,1,1,0
111797858@N08,293,27,1386572074,1386586366,2,1,14292
111797858@N08,294,27,1386649705,1386649705,1,1,0
111797858@N08,295,27,1386680552,1386680552,1,1,0
111797858@N08,296,27,1386894403,1386912007,2,1,17604
111858879@N03,297,7,1305007150,1305007155,2,1,5
11201728@N02,298,27,1215340806,1215340806,1,1,0
11202847@N00,299,24,1370180505,1370180505,1,1,0
11218233@N00,300,12,1276037103,1276037103,1,1,0
11218233@N00,301,14,1276078479,1276078816,3,3,337
11218233@N00,301,16,1276080436,1276080436,1,3,0
11218233@N00,301,9,1276069141,1276069141,1,3,0
11230373@N02,302,21,1189138897,1189162718,3,2,23821
11230373@N02,302,27,1189136969,1189136969,1,2,0
11230735@N07,303,4,1194176149,1194176149,1,3,0
11230735@N07,303,1,1194175671,1194175671,1,3,0
11230735@N07,303,27,1194175500,1194175500,1,3,0
11230735@N07,304,20,1220422068,1220422068,1,1,0
11240815@N03,305,2,1366856064,1366856064,1,1,0
11253577@N05,306,27,1262721035,1262721359,2,2,324
11253577@N05,306,16,1262715958,1262715958,1,2,0
11260538@N06,307,14,1291772570,1291772570,1,1,0
11260538@N06,308,27,1344043365,1344043365,1,1,0
11260538@N06,309,3,1344118206,1344118206,1,2,0
11260538@N06,309,2,1344117845,1344117845,1,2,0
11260538@N06,310,27,1348648836,1348648836,1,2,0
11260538@N06,310,1,1348650200,1348650200,1,2,0
11260538@N06,311,14,1350168705,1350168705,1,1,0
11260538@N06,312,14,1352524017,1352524017,1,1,0
11260538@N06,313,19,1352689366,1352689366,1,4,0
11260538@N06,313,27,1352699308,1352699308,1,4,0
11260538@N06,313,26,1352681873,1352682166,2,4,293
11260538@N06,313,8,1352667899,1352667899,1,4,0
11260538@N06,314,2,1355554063,1355554063,1,1,0
11260538@N06,315,27,1355686204,1355686204,1,1,0
11260538@N06,316,14,1355741980,1355741980,1,1,0
11260538@N06,317,27,1355821903,1355821903,1,1,0
11260538@N06,318,17,1355869867,1355869867,1,2,0
11260538@N06,318,15,1355869992,1355869992,1,2,0
11260538@N06,319,27,1381021016,1381021016,1,1,0
11260538@N06,320,8,1384139849,1384139849,1,1,0
11260538@N06,321,27,1384649290,1384649290,1,2,0
11260538@N06,321,25,1384656936,1384656936,1,2,0
112691972@N02,322,27,1399251705,1399251705,1,3,0
112691972@N02,322,13,1399256579,1399256598,3,3,19
112691972@N02,322,9,1399258826,1399258826,1,3,0
11269849@N03,323,17,1305962511,1305962894,16,1,383
11269849@N03,324,3,1338610620,1338610651,2,1,31
112709393@N04,325,27,1364882846,1364882860,2,1,14
112709393@N04,326,3,1365124272,1365124272,1,2,0
112709393@N04,326,2,1365124351,1365125411,8,2,1060
112729643@N07,327,22,1324167312,1324167312,1,1,0
112734542@N02,328,4,1396606646,1396610057,18,1,3411
112734542@N02,329,14,1396748178,1396748178,1,4,0
112734542@N02,329,27,1396752654,1396752657,2,4,3
112734542@N02,329,12,1396750218,1396750221,2,4,3
112734542@N02,329,8,1396746625,1396747036,4,4,411
112734542@N02,330,16,1396950481,1396951626,3,2,1145
112734542@N02,330,14,1396939225,1396952287,8,2,13062
112734542@N02,331,16,1397253371,1397253371,1,1,0
112791996@N05,332,16,1388833896,1388833896,1,1,0
11279883@N00,333,21,1258280651,1258280651,1,1,0
11279883@N00,334,15,1361675570,1361675570,1,1,0
11284258@N08,335,23,1343526324,1343526324,1,1,0
112858164@N04,336,27,1358379382,1358379382,1,1,0
112861324@N05,337,27,1388220773,1388220773,1,2,0
112861324@N05,337,12,1388209856,1388209856,1,2,0
113022206@N08,338,27,1373067124,1373067124,1,2,0
113022206@N08,338,16,1373090193,1373090193,1,2,0
11315654@N06,339,19,1261442126,1261442126,1,2,0
11315654@N06,339,9,1261437655,1261437655,1,2,0
113200565@N07,340,10,1388231758,1388231791,2,2,33
113200565@N07,340,3,1388235887,1388235887,1,2,0
113200565@N07,341,25,1388412002,1388412115,21,1,113
11342926@N04,342,27,1269072533,1269072683,2,1,150
11342926@N04,343,16,1305606996,1305606996,1,1,0
11346978@N05,344,2,1353653010,1353653010,1,1,0
113472825@N06,345,27,1416285264,1416285264,1,1,0
113531893@N05,346,16,1376270273,1376270273,1,1,0
113552105@N07,347,27,1458083082,1458089279,2,1,6197
113558476@N06,348,2,1426755672,1426755672,1,1,0
11355999@N08,349,16,1374379376,1374379376,1,1,0
11355999@N08,350,16,1374708226,1374708226,1,1,0
11355999@N08,351,13,1374831937,1374831937,1,2,0
11355999@N08,351,18,1374830512,1374830512,1,2,0
11374644@N06,352,11,1257580269,1257580269,1,3,0
11374644@N06,352,17,1257576146,1257585047,8,3,8901
11374644@N06,352,27,1257573652,1257589652,13,3,16000
11374644@N06,353,7,1351688400,1351688400,2,1,0
11374644@N06,354,17,1368231581,1368231616,4,2,35
11374644@N06,354,16,1368231022,1368231357,8,2,335
11374644@N06,355,27,1368618297,1368618369,4,1,72
11374644@N06,356,25,1412667966,1412671869,21,1,3903
11374644@N06,357,9,1412811753,1412811753,1,2,0
11374644@N06,357,10,1412810497,1412811272,9,2,775
11374644@N06,358,27,1413089228,1413089835,4,5,607
11374644@N06,358,13,1413083031,1413083031,1,5,0
11374644@N06,358,17,1413085585,1413087730,32,5,2145
11374644@N06,358,15,1413080967,1413083428,7,5,2461
11374644@N06,358,12,1413083203,1413083203,1,5,0
11374644@N06,359,9,1413194214,1413194276,6,4,62
11374644@N06,359,17,1413198356,1413201219,33,4,2863
11374644@N06,359,16,1413189989,1413190406,12,4,417
11374644@N06,359,27,1413188708,1413188708,1,4,0
11374644@N06,360,17,1413245996,1413245996,1,4,0
11374644@N06,360,22,1413244692,1413244692,1,4,0
11374644@N06,360,16,1413253263,1413253263,1,4,0
11374644@N06,360,21,1413244682,1413244682,1,4,0
113841608@N03,361,16,1325155278,1325155278,1,1,0
11396484@N04,362,4,1330938092,1330938092,1,2,0
11396484@N04,362,17,1330939564,1330939564,1,2,0
114222594@N02,363,17,1388389341,1388389341,1,4,0
114222594@N02,363,26,1388362386,1388362386,1,4,0
114222594@N02,363,14,1388353905,1388353905,1,4,0
114222594@N02,363,27,1388367706,1388367706,1,4,0
114234625@N06,364,7,1470026070,1470033460,3,5,7390
114234625@N06,364,6,1470033451,1470033451,1,5,0
114234625@N06,364,16,1470030403,1470030403,1,5,0
114234625@N06,364,14,1470029599,1470030544,3,5,945
114234625@N06,364,27,1470045954,1470046256,3,5,302
114267358@N08,365,6,1424125533,1424125533,1,2,0
114267358@N08,365,27,1424127276,1424127276,1,2,0
11438118@N00,366,27,1189652716,1189663549,30,6,10833
11438118@N00,366,25,1189655832,1189655832,1,6,0
11438118@N00,366,20,1189662146,1189662300,5,6,154
11438118@N00,366,15,1189656297,1189661577,16,6,5280
11438118@N00,366,17,1189656028,1189656077,3,6,49
11438118@N00,366,13,1189657046,1189660521,10,6,3475
11438118@N00,367,16,1195021927,1195025871,27,1,3944
11438118@N00,368,27,1249019771,1249019784,3,3,13
11438118@N00,368,16,1249019852,1249036022,4,3,16170
11438118@N00,368,20,1249019880,1249019885,2,3,5
11439401@N07,369,27,1232392536,1232392536,1,1,0
11439401@N07,370,8,1234159818,1234159818,1,1,0
11441631@N00,371,2,1348730901,1348730901,1,2,0
11441631@N00,371,14,1348723605,1348723605,1,2,0
11441631@N00,372,17,1348876760,1348876760,1,1,0
114434902@N04,373,25,1400898729,1400900399,4,9,1670
114434902@N04,373,2,1400918672,1400918672,1,9,0
114434902@N04,373,24,1400900260,1400900617,13,9,357
114434902@N04,373,27,1400896467,1400896684,3,9,217
114434902@N04,373,14,1400909620,1400909919,4,9,299
114434902@N04,373,21,1400900169,1400900169,1,9,0
114434902@N04,373,4,1400916798,1400916842,2,9,44
114434902@N04,373,11,1400912615,1400921779,6,9,9164
114434902@N04,373,26,1400901470,1400901470,1,9,0
11464750@N05,374,14,1400470790,1400470790,1,2,0
11464750@N05,374,18,1400486263,1400487396,3,2,1133
114677615@N06,375,10,1350272462,1350296108,4,1,23646
114677615@N06,376,10,1368590009,1368590009,1,1,0
114685617@N08,377,15,1390291934,1390291934,1,1,0
11479795@N00,378,27,1191115526,1191115526,1,2,0
11479795@N00,378,15,1191127903,1191127903,1,2,0
11496089@N08,379,16,1283685237,1283685237,1,1,0
11504889@N06,380,27,1446341382,1446341382,1,1,0
11517266@N02,381,27,1188471861,1188471861,1,1,0
115224926@N07,382,3,1431516612,1431516612,1,3,0
115224926@N07,382,6,1431517757,1431517757,1,3,0
115224926@N07,382,2,1431516576,1431516594,2,3,18
11524912@N05,383,13,1279748576,1279748576,1,2,0
11524912@N05,383,27,1279744656,1279744656,1,2,0
115400338@N03,384,4,1401064145,1401064145,1,4,0
115400338@N03,384,21,1401071268,1401073594,2,4,2326
115400338@N03,384,13,1401075514,1401075514,1,4,0
115400338@N03,384,27,1401063671,1401063671,1,4,0
11541209@N06,385,17,1193908465,1193908465,1,1,0
11541209@N06,386,9,1249717149,1249717149,1,1,0
11541209@N06,387,16,1250242479,1250242479,1,2,0
11541209@N06,387,17,1250248474,1250249047,7,2,573
115511286@N06,388,11,1392412414,1392412414,1,5,0
115511286@N06,388,15,1392414646,1392415603,2,5,957
115511286@N06,388,6,1392411604,1392411604,1,5,0
115511286@N06,388,9,1392411772,1392412321,2,5,549
115511286@N06,388,2,1392409539,1392409539,1,5,0
115688162@N04,389,16,1230086894,1230086894,1,1,0
11581147@N06,390,16,1432538640,1432538640,1,1,0
11581147@N06,391,27,1432688740,1432688755,2,1,15
11581147@N06,392,14,1432719910,1432719910,1,1,0
11586403@N02,393,4,1213506214,1213506214,1,1,0
11632646@N02,394,16,1187949050,1187949050,1,1,0
11632646@N02,395,16,1188855763,1188855763,1,1,0
11654579@N07,396,9,1354233939,1354233939,1,1,0
11654579@N07,397,12,1362808386,1362808386,1,1,0
116615968@N03,398,13,1388792960,1388792960,1,1,0
11711539@N08,399,19,1263773500,1263773584,2,1,84
117362598@N08,400,8,1458786563,1458786563,1,2,0
117362598@N08,400,27,1458781611,1458781611,1,2,0
117362598@N08,401,17,1458823844,1458823844,1,2,0
117362598@N08,401,15,1458824156,1458824505,2,2,349
11752574@N06,402,13,1187931471,1187931471,1,2,0
11752574@N06,402,18,1187918299,1187918299,1,2,0
11752574@N06,403,9,1187963883,1187963883,1,1,0
11752574@N06,404,9,1188044798,1188044798,1,2,0
11752574@N06,404,27,1188045799,1188046928,3,2,1129
11752574@N06,405,16,1188342263,1188348881,4,1,6618
11752574@N06,406,12,1189511455,1189511455,1,1,0
11752574@N06,407,12,1192232694,1192232694,1,1,0
11752574@N06,408,14,1194691457,1194691647,4,7,190
11752574@N06,408,13,1194683906,1194703596,11,7,19690
11752574@N06,408,9,1194692733,1194692733,1,7,0
11752574@N06,408,12,1194686011,1194686219,2,7,208
11752574@N06,408,15,1194699378,1194699378,1,7,0
11752574@N06,408,21,1194688683,1194700489,6,7,11806
11752574@N06,408,16,1194682121,1194682121,1,7,0
11752574@N06,409,13,1194781890,1194782387,5,2,497
11752574@N06,409,16,1194786560,1194786560,1,2,0
11752574@N06,410,15,1195003618,1195003695,3,7,77
11752574@N06,410,19,1195016823,1195017758,2,7,935
11752574@N06,410,21,1195012352,1195012352,1,7,0
11752574@N06,410,1,1195021196,1195021196,1,7,0
11752574@N06,410,14,1194999849,1194999849,1,7,0
11752574@N06,410,9,1195002664,1195002782,9,7,118
11752574@N06,410,22,1195013601,1195015113,7,7,1512
11752574@N06,411,1,1208665188,1208665188,1,1,0
11752574@N06,412,5,1214967772,1214968166,2,1,394
11752574@N06,413,15,1259834591,1259834591,1,6,0
11752574@N06,413,17,1259814839,1259814839,1,6,0
11752574@N06,413,4,1259841110,1259841110,1,6,0
11752574@N06,413,23,1259803587,1259803587,1,6,0
11752574@N06,413,13,1259814315,1259814315,1,6,0
11752574@N06,413,2,1259838601,1259838601,1,6,0
11752574@N06,414,21,1318499686,1318499686,1,3,0
11752574@N06,414,27,1318493361,1318493929,3,3,568
11752574@N06,414,13,1318501726,1318501726,1,3,0
11752574@N06,415,15,1348219892,1348219916,2,5,24
11752574@N06,415,27,1348225893,1348225893,1,5,0
11752574@N06,415,23,1348216226,1348216226,1,5,0
11752574@N06,415,14,1348220048,1348221474,2,5,1426
11752574@N06,415,22,1348222886,1348222886,1,5,0
11755553@N08,416,16,1452078804,1452078804,1,1,0
11755553@N08,417,16,1452503573,1452503573,1,1,0
117724367@N08,418,14,1429109130,1429109130,1,2,0
117724367@N08,418,9,1429109348,1429109348,1,2,0
11785705@N02,419,16,1291801518,1291801518,1,4,0
11785705@N02,419,20,1291800240,1291800240,1,4,0
11785705@N02,419,4,1291801979,1291801979,1,4,0
11785705@N02,419,17,1291779658,1291779658,1,4,0
11785705@N02,420,23,1294917232,1294917232,1,1,0
118043454@N05,421,13,1406469786,1406469786,1,1,0
11825945@N00,422,23,1372828398,1372829386,2,3,988
11825945@N00,422,21,1372829719,1372829719,1,3,0
11825945@N00,422,14,1372843701,1372843701,1,3,0
11825945@N00,423,10,1374139795,1374139795,1,2,0
11825945@N00,423,27,1374136624,1374136781,2,2,157
11825945@N00,424,27,1374296297,1374296297,1,1,0
11825945@N00,425,10,1377396278,1377396278,1,1,0
11825945@N00,426,3,1386805583,1386805583,1,3,0
11825945@N00,426,10,1386810199,1386810199,1,3,0
11825945@N00,426,14,1386810817,1386810817,1,3,0
11825945@N00,427,4,1395984536,1395984536,1,1,0
11831873@N00,428,14,1286353091,1286353465,8,3,374
11831873@N00,428,27,1286351309,1286382028,31,3,30719
11831873@N00,428,8,1286359807,1286359853,8,3,46
11832393@N04,429,9,1320717887,1320717894,3,2,7
11832393@N04,429,12,1320711113,1320711113,1,2,0
11874382@N02,430,14,1275733144,1275733144,1,1,0
11885107@N08,431,27,1388511792,1388511792,1,1,0
11901577@N03,432,13,1432303157,1432303157,1,1,0
119106047@N03,433,1,1394168130,1394168130,1,1,0
11928454@N04,434,20,1244416210,1244428523,4,15,12313
11928454@N04,434,24,1244444676,1244445110,3,15,434
11928454@N04,434,27,1244414769,1244456555,15,15,41786
11928454@N04,434,19,1244428283,1244441035,5,15,12752
11928454@N04,434,4,1244461514,1244462000,3,15,486
11928454@N04,434,25,1244434491,1244445965,15,15,11474
11928454@N04,434,12,1244420348,1244420956,7,15,608
11928454@N04,434,14,1244416506,1244418273,4,15,1767
11928454@N04,434,23,1244432512,1244435051,6,15,2539
11928454@N04,434,21,1244428856,1244432360,7,15,3504
11928454@N04,434,17,1244415816,1244439013,3,15,23197
11928454@N04,434,15,1244416451,1244416451,1,15,0
11928454@N04,434,18,1244437122,1244437657,6,15,535
11928454@N04,434,22,1244421470,1244439624,2,15,18154
11928454@N04,434,26,1244415911,1244460984,24,15,45073
11928454@N04,435,14,1244600804,1244627981,6,15,27177
11928454@N04,435,3,1244590388,1244590388,1,15,0
11928454@N04,435,20,1244596357,1244596357,1,15,0
11928454@N04,435,9,1244597159,1244597670,5,15,511
11928454@N04,435,2,1244591976,1244592257,4,15,281
11928454@N04,435,4,1244590322,1244622430,2,15,32108
11928454@N04,435,21,1244631186,1244631186,1,15,0
11928454@N04,435,6,1244592619,1244592619,1,15,0
11928454@N04,435,17,1244596194,1244628882,3,15,32688
11928454@N04,435,15,1244603386,1244603386,1,15,0
11928454@N04,435,8,1244592705,1244595500,8,15,2795
11928454@N04,435,16,1244601094,1244628525,4,15,27431
11928454@N04,435,11,1244594395,1244595316,4,15,921
11928454@N04,435,22,1244596733,1244596733,1,15,0
11928454@N04,435,26,1244596796,1244631100,32,15,34304
11935368@N00,436,4,1292188567,1292188567,1,6,0
11935368@N00,436,6,1292191536,1292191536,1,6,0
11935368@N00,436,24,1292203706,1292203706,1,6,0
11935368@N00,436,17,1292206915,1292206915,1,6,0
11935368@N00,436,19,1292200488,1292200488,1,6,0
11935368@N00,436,14,1292195334,1292195334,1,6,0
11935368@N00,437,6,1292833767,1292833767,1,2,0
11935368@N00,437,21,1292833760,1292833760,1,2,0
119422749@N03,438,4,1395309053,1395309150,5,3,97
119422749@N03,438,10,1395312314,1395312314,1,3,0
119422749@N03,438,22,1395285128,1395285155,3,3,27
119435566@N06,439,27,1457155512,1457155512,1,1,0
11954862@N00,440,27,1394341547,1394341547,1,2,0
11954862@N00,440,16,1394362123,1394362123,1,2,0
11954862@N00,441,21,1394425638,1394425638,1,3,0
11954862@N00,441,8,1394412959,1394412959,1,3,0
11954862@N00,441,16,1394422585,1394422585,1,3,0
11954862@N00,442,19,1394574976,1394574976,1,1,0
11958538@N02,443,6,1193468204,1193468221,2,1,17
11958538@N02,444,16,1193604030,1193604064,2,2,34
11958538@N02,444,27,1193603884,1193603884,1,2,0
119796978@N03,445,9,1393151038,1393151038,1,5,0
119796978@N03,445,10,1393132193,1393132193,1,5,0
119796978@N03,445,2,1393141125,1393141125,1,5,0
119796978@N03,445,3,1393141300,1393141309,2,5,9
119796978@N03,445,14,1393130044,1393130044,1,5,0
119796978@N03,446,25,1393378587,1393378587,1,4,0
119796978@N03,446,24,1393378404,1393378710,9,4,306
119796978@N03,446,2,1393376465,1393387025,12,4,10560
119796978@N03,446,1,1393387318,1393387318,1,4,0
119796978@N03,447,8,1393577394,1393577394,1,1,0
119887304@N04,448,27,1330476881,1330478565,4,1,1684
119904538@N08,449,14,1390106632,1390106632,1,1,0
12008385@N00,450,27,1291510744,1291510744,1,1,0
120147674@N05,451,20,1395709011,1395709114,2,3,103
120147674@N05,451,14,1395723784,1395723784,1,3,0
120147674@N05,451,27,1395709763,1395709763,1,3,0
120147674@N05,452,25,1395780373,1395780373,1,3,0
120147674@N05,452,16,1395790347,1395790347,1,3,0
120147674@N05,452,3,1395776711,1395776711,1,3,0
120147674@N05,453,20,1395955960,1395955960,1,1,0
12036424@N04,454,27,1271047308,1271047701,2,2,393
12036424@N04,454,14,1271062518,1271062518,1,2,0
12036424@N04,455,13,1305780329,1305797303,9,10,16974
12036424@N04,455,1,1305792431,1305792566,3,10,135
12036424@N04,455,6,1305786339,1305786339,1,10,0
12036424@N04,455,27,1305813785,1305813785,1,10,0
12036424@N04,455,24,1305796088,1305800442,11,10,4354
12036424@N04,455,3,1305790460,1305794317,4,10,3857
12036424@N04,455,18,1305772226,1305773097,4,10,871
12036424@N04,455,2,1305788548,1305789094,6,10,546
12036424@N04,455,12,1305783170,1305783781,18,10,611
12036424@N04,455,14,1305813625,1305813625,1,10,0
12044368@N04,456,27,1395886197,1395886197,1,1,0
120510795@N06,457,27,1224428254,1224428254,1,1,0
120510795@N06,458,27,1229510238,1229510238,1,1,0
120533378@N03,459,22,1443136254,1443136254,1,1,0
120568475@N07,460,16,1398414579,1398414579,1,1,0
12059076@N05,461,18,1188885039,1188885039,1,4,0
12059076@N05,461,27,1188887880,1188892552,2,4,4672
12059076@N05,461,24,1188881745,1188881745,1,4,0
12059076@N05,461,16,1188881319,1188881319,1,4,0
120604622@N02,462,22,1261448803,1261448803,1,1,0
120718576@N08,463,15,1395124898,1395124902,2,2,4
120718576@N08,463,16,1395126086,1395126086,1,2,0
120756153@N05,464,4,1313987700,1313987700,1,1,0
12083014@N05,465,16,1222406823,1222406823,1,2,0
12083014@N05,465,18,1222409701,1222409701,1,2,0
12083014@N05,466,14,1253509918,1253509934,2,1,16
12083014@N05,467,24,1253606962,1253606962,1,1,0
12083014@N05,468,1,1298296463,1298296463,1,3,0
12083014@N05,468,9,1298293325,1298293325,1,3,0
12083014@N05,468,27,1298298071,1298298373,2,3,302
12084245@N08,469,27,1247667539,1247682607,6,1,15068
12084245@N08,470,27,1247745618,1247748555,2,1,2937
12084245@N08,471,27,1271751505,1271751505,1,1,0
12084245@N08,472,27,1273118422,1273118422,1,1,0
120888449@N03,473,16,1400120888,1400120888,1,1,0
120929088@N08,474,13,1426374326,1426374326,1,12,0
120929088@N08,474,10,1426375837,1426375837,1,12,0
120929088@N08,474,4,1426369597,1426391463,3,12,21866
120929088@N08,474,21,1426397154,1426397154,1,12,0
120929088@N08,474,12,1426369793,1426369793,1,12,0
120929088@N08,474,2,1426413977,1426413977,1,12,0
120929088@N08,474,27,1426367712,1426425928,7,12,58216
120929088@N08,474,17,1426373835,1426373971,4,12,136
120929088@N08,474,3,1426407934,1426418711,3,12,10777
120929088@N08,474,5,1426369602,1426369602,1,12,0
120929088@N08,474,26,1426387870,1426387870,1,12,0
120929088@N08,474,1,1426369691,1426370517,2,12,826
12150532@N04,475,14,1426887456,1426887456,1,1,0
12150532@N04,476,4,1426924429,1426924429,1,1,0
121655138@N03,477,16,1395728808,1395736687,5,7,7879
121655138@N03,477,15,1395737842,1395737842,1,7,0
121655138@N03,477,20,1395726874,1395726874,1,7,0
121655138@N03,477,27,1395746784,1395746784,1,7,0
121655138@N03,477,13,1395737903,1395737903,1,7,0
121655138@N03,477,14,1395737655,1395737685,3,7,30
121655138@N03,477,4,1395744244,1395745149,4,7,905
121684518@N03,478,27,1405546967,1405546967,1,1,0
121684518@N03,479,27,1405612813,1405612813,1,1,0
121710355@N07,480,17,1433727454,1433727454,1,1,0
121710355@N07,481,16,1433768277,1433768277,1,1,0
121855015@N07,482,7,1399164950,1399164967,3,7,17
121855015@N07,482,17,1399174657,1399179760,16,7,5103
121855015@N07,482,9,1399188783,1399191120,4,7,2337
121855015@N07,482,15,1399182168,1399182168,1,7,0
121855015@N07,482,14,1399163177,1399163507,5,7,330
121855015@N07,482,12,1399183803,1399184210,11,7,407
121855015@N07,482,13,1399184117,1399184146,4,7,29
121861619@N03,483,2,1423384638,1423384640,2,16,2
121861619@N03,483,14,1423347239,1423355104,2,16,7865
121861619@N03,483,3,1423384405,1423384407,2,16,2
121861619@N03,483,26,1423348586,1423348808,5,16,222
121861619@N03,483,6,1423347046,1423347046,1,16,0
121861619@N03,483,4,1423382033,1423382033,2,16,0
121861619@N03,483,21,1423365958,1423365958,1,16,0
121861619@N03,483,25,1423363596,1423365307,3,16,1711
121861619@N03,483,9,1423354359,1423355258,4,16,899
121861619@N03,483,10,1423353613,1423360291,16,16,6678
121861619@N03,483,19,1423350572,1423350650,14,16,78
121861619@N03,483,17,1423380616,1423381002,5,16,386
121861619@N03,483,20,1423398083,1423398083,1,16,0
121861619@N03,483,22,1423348829,1423368852,25,16,20023
121861619@N03,483,27,1423343899,1423390788,16,16,46889
121861619@N03,483,15,1423348450,1423348450,1,16,0
121861619@N03,484,23,1423783772,1423783772,1,14,0
121861619@N03,484,3,1423821542,1423821542,1,14,0
121861619@N03,484,26,1423785190,1423785255,10,14,65
121861619@N03,484,14,1423778960,1423815225,17,14,36265
121861619@N03,484,25,1423790501,1423790501,1,14,0
121861619@N03,484,9,1423778323,1423781291,18,14,2968
121861619@N03,484,10,1423815472,1423815754,3,14,282
121861619@N03,484,19,1423792008,1423792008,1,14,0
121861619@N03,484,18,1423781568,1423781574,2,14,6
121861619@N03,484,17,1423781436,1423788681,4,14,7245
121861619@N03,484,11,1423792262,1423792262,1,14,0
121861619@N03,484,20,1423791742,1423818983,8,14,27241
121861619@N03,484,24,1423790611,1423790616,2,14,5
121861619@N03,484,15,1423788497,1423788498,2,14,1
121862207@N08,485,17,1396693180,1396693180,1,9,0
121862207@N08,485,7,1396664410,1396664410,1,9,0
121862207@N08,485,15,1396692103,1396692117,2,9,14
121862207@N08,485,2,1396661091,1396661091,1,9,0
121862207@N08,485,13,1396670316,1396674087,7,9,3771
121862207@N08,485,14,1396668290,1396668290,1,9,0
121862207@N08,485,3,1396658365,1396658680,4,9,315
121862207@N08,485,10,1396667517,1396667968,11,9,451
121862207@N08,485,20,1396693360,1396693360,1,9,0
12197785@N03,486,4,1213066407,1213066407,1,1,0
12197785@N03,487,26,1259728722,1259728722,1,1,0
12197785@N03,488,4,1259840469,1259840469,1,4,0
12197785@N03,488,17,1259835454,1259835454,1,4,0
12197785@N03,488,27,1259825363,1259825363,1,4,0
12197785@N03,488,9,1259821855,1259821855,1,4,0
12197785@N03,489,27,1287803118,1287803118,1,3,0
12197785@N03,489,19,1287816059,1287816059,1,3,0
12197785@N03,489,9,1287818586,1287818586,1,3,0
12197785@N03,490,13,1287914389,1287914736,2,1,347
12197785@N03,491,9,1308215267,1308215267,1,4,0
12197785@N03,491,17,1308215663,1308215664,2,4,1
12197785@N03,491,16,1308214587,1308214587,1,4,0
12197785@N03,491,23,1308217417,1308217417,1,4,0
12205233@N02,492,16,1227438126,1227448680,9,1,10554
122353703@N02,493,3,1423199315,1423199315,1,2,0
122353703@N02,493,27,1423176784,1423176784,1,2,0
122353703@N02,494,27,1423476322,1423476322,1,1,0
122353703@N02,495,17,1424841833,1424841844,2,2,11
122353703@N02,495,27,1424835747,1424835747,1,2,0
12241674@N03,496,25,1324183002,1324183002,1,4,0
12241674@N03,496,16,1324170435,1324170435,1,4,0
12241674@N03,496,12,1324169189,1324169189,1,4,0
12241674@N03,496,3,1324196453,1324196453,1,4,0
12241674@N03,497,16,1324418915,1324419138,2,1,223
122536755@N07,498,25,1409552900,1409552900,1,7,0
122536755@N07,498,11,1409551483,1409551508,8,7,25
122536755@N07,498,15,1409554575,1409554575,1,7,0
122536755@N07,498,21,1409553203,1409553228,3,7,25
122536755@N07,498,24,1409552794,1409553059,5,7,265
122536755@N07,498,9,1409550781,1409551526,6,7,745
122536755@N07,498,27,1409549155,1409549865,50,7,710
12256768@N03,499,18,1287145652,1287145652,1,1,0
12256768@N03,500,20,1287192457,1287192457,1,5,0
12256768@N03,500,13,1287193527,1287199790,2,5,6263
12256768@N03,500,19,1287185779,1287185779,1,5,0
12256768@N03,500,17,1287200709,1287200709,1,5,0
12256768@N03,500,18,1287193501,1287199969,2,5,6468
12256768@N03,501,19,1363104172,1363104172,1,2,0
12256768@N03,501,18,1363104167,1363104174,2,2,7
12261016@N00,502,16,1329608280,1329608610,5,3,330
12261016@N00,502,12,1329610038,1329610038,1,3,0
12261016@N00,502,9,1329625369,1329625424,2,3,55
12261016@N00,503,9,1329707330,1329707330,1,1,0
12261830@N04,504,9,1437885091,1437885091,1,1,0
12261830@N04,505,1,1441442049,1441442049,1,1,0
12277777@N04,506,27,1311041654,1311041654,1,2,0
12277777@N04,506,17,1311055837,1311055837,1,2,0
122876725@N05,507,16,1406102285,1406102316,4,17,31
122876725@N05,507,14,1406103043,1406103177,4,17,134
122876725@N05,507,24,1406074410,1406075120,10,17,710
122876725@N05,507,5,1406068196,1406068245,5,17,49
122876725@N05,507,10,1406103290,1406103423,8,17,133
122876725@N05,507,20,1406075813,1406083650,19,17,7837
122876725@N05,507,18,1406089113,1406089113,1,17,0
122876725@N05,507,4,1406071905,1406071929,2,17,24
122876725@N05,507,9,1406102471,1406102639,9,17,168
122876725@N05,507,19,1406081936,1406083502,6,17,1566
122876725@N05,507,23,1406074228,1406074228,1,17,0
122876725@N05,507,21,1406074735,1406074784,4,17,49
122876725@N05,507,2,1406093347,1406093347,1,17,0
122876725@N05,507,15,1406084934,1406084934,1,17,0
122876725@N05,507,27,1406063937,1406095842,41,17,31905
122876725@N05,507,25,1406072091,1406092057,2,17,19966
122876725@N05,507,1,1406066109,1406066220,7,17,111
122876725@N05,508,24,1406627972,1406628002,2,6,30
122876725@N05,508,20,1406623907,1406623907,1,6,0
122876725@N05,508,4,1406632736,1406632775,5,6,39
122876725@N05,508,21,1406625824,1406627949,2,6,2125
122876725@N05,508,27,1406634511,1406634591,6,6,80
122876725@N05,508,3,1406632857,1406632857,1,6,0
122876725@N05,509,16,1407758353,1407758687,14,20,334
122876725@N05,509,13,1407740079,1407740079,1,20,0
122876725@N05,509,24,1407744429,1407745141,6,20,712
122876725@N05,509,5,1407729380,1407752827,12,20,23447
122876725@N05,509,20,1407736625,1407736627,2,20,2
122876725@N05,509,17,1407736297,1407736297,1,20,0
122876725@N05,509,7,1407750805,1407751644,11,20,839
122876725@N05,509,8,1407750838,1407751155,13,20,317
122876725@N05,509,6,1407730126,1407752917,6,20,22791
122876725@N05,509,18,1407738719,1407740060,5,20,1341
122876725@N05,509,9,1407732510,1407732510,1,20,0
122876725@N05,509,23,1407744369,1407745123,9,20,754
122876725@N05,509,22,1407736516,1407744755,7,20,8239
122876725@N05,509,21,1407744026,1407744566,5,20,540
122876725@N05,509,2,1407729213,1407752783,15,20,23570
122876725@N05,509,15,1407736269,1407756168,3,20,19899
122876725@N05,509,27,1407726624,1407762044,22,20,35420
122876725@N05,509,25,1407744856,1407744856,1,20,0
122876725@N05,509,3,1407730443,1407730443,1,20,0
122876725@N05,509,1,1407728097,1407730388,6,20,2291
12316147@N05,510,6,1304137017,1304137893,11,11,876
12316147@N05,510,13,1304146646,1304146646,1,11,0
12316147@N05,510,27,1304127751,1304150613,23,11,22862
12316147@N05,510,9,1304141154,1304143046,15,11,1892
12316147@N05,510,18,1304146533,1304147737,15,11,1204
12316147@N05,510,2,1304138993,1304140832,15,11,1839
12316147@N05,510,17,1304145741,1304148517,16,11,2776
12316147@N05,510,21,1304129501,1304130019,3,11,518
12316147@N05,510,22,1304147940,1304147945,2,11,5
12316147@N05,510,12,1304143535,1304145316,21,11,1781
12316147@N05,510,8,1304130415,1304130599,3,11,184
123349668@N03,511,17,1366356075,1366356075,1,3,0
123349668@N03,511,13,1366353801,1366353801,1,3,0
123349668@N03,511,21,1366361986,1366361986,1,3,0
12336562@N08,512,23,1294358621,1294358621,1,1,0
12336562@N08,513,27,1294557459,1294557677,2,2,218
12336562@N08,513,22,1294560241,1294560241,1,2,0
123398648@N02,514,4,1349604032,1349605194,3,2,1162
123398648@N02,514,17,1349608614,1349609616,46,2,1002
123475115@N06,515,27,1353469987,1353469987,1,1,0
123519116@N08,516,14,1408586355,1408586355,1,1,0
12353441@N02,517,4,1191044147,1191054085,2,1,9938
12361801@N05,518,4,1283826508,1283861711,53,1,35203
12381123@N06,519,27,1324167966,1324190692,6,9,22726
12381123@N06,519,14,1324175751,1324175751,1,9,0
12381123@N06,519,5,1324185893,1324185893,1,9,0
12381123@N06,519,9,1324172866,1324172866,1,9,0
12381123@N06,519,1,1324186366,1324186366,1,9,0
12381123@N06,519,16,1324169192,1324178933,4,9,9741
12381123@N06,519,17,1324179037,1324179037,1,9,0
12381123@N06,519,4,1324169903,1324189501,2,9,19598
12381123@N06,519,2,1324186274,1324186274,1,9,0
12395214@N08,520,21,1262928024,1262928024,1,1,0
12395214@N08,521,21,1263001580,1263012086,7,1,10506
124125208@N07,522,10,1372753061,1372753061,1,1,0
124125208@N07,523,13,1372900850,1372900850,1,1,0
124235757@N05,524,4,1342400288,1342400288,1,2,0
124235757@N05,524,27,1342391349,1342393102,3,2,1753
12440183@N04,525,17,1345954338,1345954338,1,1,0
124495835@N08,526,27,1409341942,1409341942,1,4,0
124495835@N08,526,16,1409342838,1409342838,1,4,0
124495835@N08,526,13,1409343288,1409343288,1,4,0
124495835@N08,526,19,1409344433,1409344433,1,4,0
124495835@N08,527,27,1409434499,1409434499,1,2,0
124495835@N08,527,19,1409435632,1409435638,2,2,6
12456985@N00,528,27,1396742258,1396742258,1,1,0
124601595@N06,529,14,1398421040,1398421091,3,2,51
124601595@N06,529,27,1398420037,1398420037,1,2,0
124601595@N06,530,23,1398757554,1398757566,3,12,12
124601595@N06,530,17,1398757109,1398757140,2,12,31
124601595@N06,530,4,1398750988,1398750988,1,12,0
124601595@N06,530,9,1398755911,1398755911,1,12,0
124601595@N06,530,14,1398755995,1398756710,3,12,715
124601595@N06,530,16,1398756440,1398757021,2,12,581
124601595@N06,530,27,1398750607,1398750607,1,12,0
124601595@N06,530,26,1398757199,1398757203,2,12,4
124601595@N06,530,20,1398757407,1398757409,2,12,2
124601595@N06,530,21,1398757454,1398757473,3,12,19
124601595@N06,530,10,1398756178,1398756178,1,12,0
124601595@N06,530,5,1398751168,1398751168,1,12,0
124948917@N04,531,27,1433301802,1433301802,1,1,0
12508217@N08,532,9,1192152564,1192152564,1,1,0
12508217@N08,533,12,1192264093,1192264093,1,1,0
12508217@N08,534,27,1198907354,1198908894,2,1,1540
12508217@N08,535,3,1201342941,1201342941,1,1,0
12508217@N08,536,6,1201990222,1201990222,1,2,0
12508217@N08,536,14,1201987987,1201988062,2,2,75
12508217@N08,537,17,1313401260,1313401260,1,2,0
12508217@N08,537,13,1313399673,1313400037,11,2,364
12508217@N08,538,22,1330222256,1330223081,12,1,825
12508217@N08,539,22,1330517993,1330519844,14,1,1851
12508217@N08,540,22,1347756969,1347757847,25,5,878
12508217@N08,540,24,1347759818,1347761336,16,5,1518
12508217@N08,540,7,1347762558,1347762558,1,5,0
12508217@N08,540,17,1347755111,1347755111,1,5,0
12508217@N08,540,27,1347752920,1347752920,1,5,0
12508217@N08,541,10,1348796999,1348796999,1,1,0
12508217@N08,542,22,1352972730,1352973095,4,6,365
12508217@N08,542,13,1352974065,1352974207,5,6,142
12508217@N08,542,10,1352975284,1352977177,21,6,1893
12508217@N08,542,17,1352983283,1352985625,31,6,2342
12508217@N08,542,9,1352979307,1352985176,8,6,5869
12508217@N08,542,27,1352971641,1352971641,1,6,0
12508217@N08,543,22,1369342333,1369361998,26,5,19665
12508217@N08,543,10,1369352628,1369354190,12,5,1562
12508217@N08,543,16,1369340275,1369351866,5,5,11591
12508217@N08,543,26,1369362081,1369362081,1,5,0
12508217@N08,543,27,1369337935,1369368229,19,5,30294
12531737@N04,544,4,1366276040,1366276040,1,3,0
12531737@N04,544,6,1366273131,1366273131,1,3,0
12531737@N04,544,1,1366273336,1366273336,1,3,0
125486816@N06,545,18,1465529807,1465529807,1,1,0
12554088@N00,546,27,1288540819,1288540819,1,1,0
12561037@N06,547,27,1235619758,1235619758,1,1,0
125837856@N05,548,1,1404131382,1404131382,1,11,0
125837856@N05,548,16,1404105616,1404105696,5,11,80
125837856@N05,548,10,1404093354,1404096292,8,11,2938
125837856@N05,548,15,1404084841,1404105676,15,11,20835
125837856@N05,548,17,1404084036,1404090597,4,11,6561
125837856@N05,548,12,1404085146,1404085422,4,11,276
125837856@N05,548,24,1404120049,1404120196,4,11,147
125837856@N05,548,9,1404091327,1404091353,5,11,26
125837856@N05,548,7,1404097064,1404109265,16,11,12201
125837856@N05,548,14,1404100808,1404105700,17,11,4892
125837856@N05,548,27,1404082133,1404132807,7,11,50674
12586305@N04,549,12,1266712087,1266712681,4,11,594
12586305@N04,549,22,1266708873,1266711127,3,11,2254
12586305@N04,549,26,1266705871,1266705871,1,11,0
12586305@N04,549,8,1266717676,1266717676,1,11,0
12586305@N04,549,14,1266712954,1266712954,1,11,0
12586305@N04,549,2,1266714878,1266714878,1,11,0
12586305@N04,549,27,1266704101,1266718097,3,11,13996
12586305@N04,549,17,1266705910,1266705910,1,11,0
12586305@N04,549,24,1266705322,1266705322,1,11,0
12586305@N04,549,13,1266712566,1266712566,1,11,0
12586305@N04,549,5,1266714900,1266714900,1,11,0
125863683@N08,550,18,1417750356,1417750356,1,6,0
125863683@N08,550,1,1417736418,1417736418,1,6,0
125863683@N08,550,12,1417753489,1417753489,1,6,0
125863683@N08,550,15,1417751916,1417752261,3,6,345
125863683@N08,550,17,1417747272,1417747771,3,6,499
125863683@N08,550,9,1417741850,1417741850,1,6,0
125863683@N08,551,9,1417937449,1417937449,1,1,0
12592520@N03,552,16,1231040297,1231072218,5,1,31921
12619133@N07,553,24,1196290776,1196290776,1,1,0
126279852@N06,554,16,1419519202,1419519202,1,1,0
126299785@N02,555,27,1468325780,1468325780,1,1,0
12650001@N08,556,3,1388189158,1388189257,4,2,99
12650001@N08,556,9,1388212259,1388212259,1,2,0
126521704@N08,557,17,1404551802,1404551802,1,1,0
126527286@N03,558,20,1325993966,1325994039,2,3,73
126527286@N03,558,27,1325975582,1326013820,18,3,38238
126527286@N03,558,17,1325979067,1325979090,2,3,23
126542481@N08,559,11,1388561546,1388561546,1,1,0
12658090@N00,560,16,1384243291,1384243291,1,1,0
12659736@N02,561,16,1209962865,1209963000,4,7,135
12659736@N02,561,20,1209952728,1209953411,8,7,683
12659736@N02,561,26,1209950990,1209951008,2,7,18
12659736@N02,561,27,1209950532,1209967365,2,7,16833
12659736@N02,561,18,1209953504,1209953821,6,7,317
12659736@N02,561,25,1209964252,1209966242,18,7,1990
12659736@N02,561,23,1209951188,1209952023,4,7,835
12659736@N02,562,20,1294035422,1294035422,1,2,0
12659736@N02,562,9,1294023582,1294023584,2,2,2
12659736@N02,563,8,1327884187,1327884187,1,2,0
12659736@N02,563,6,1327877452,1327877891,39,2,439
12659736@N02,564,7,1376874135,1376874143,2,1,8
12659736@N02,565,26,1376911367,1376912295,42,1,928
12659736@N02,566,2,1420590922,1420590928,8,5,6
12659736@N02,566,27,1420606576,1420606605,4,5,29
12659736@N02,566,1,1420590936,1420590937,4,5,1
12659736@N02,566,6,1420590776,1420590776,2,5,0
12659736@N02,566,25,1420584875,1420587028,14,5,2153
12667563@N04,567,3,1291090536,1291101195,2,2,10659
12667563@N04,567,4,1291090957,1291101194,4,2,10237
126776752@N03,568,27,1434181294,1434181294,1,1,0
12696073@N07,569,27,1378859176,1378859176,1,1,0
126977796@N08,570,12,1460014770,1460018796,3,6,4026
126977796@N08,570,23,1460013889,1460013889,1,6,0
126977796@N08,570,15,1460014729,1460014792,2,6,63
126977796@N08,570,17,1460014333,1460024177,3,6,9844
126977796@N08,570,24,1460013809,1460013809,1,6,0
126977796@N08,570,25,1460010214,1460010214,1,6,0
12697993@N00,571,19,1351380154,1351380154,1,1,0
127015663@N02,572,11,1415414458,1415414458,1,3,0
127015663@N02,572,9,1415414167,1415414167,1,3,0
127015663@N02,572,27,1415409577,1415410450,6,3,873
127099627@N03,573,17,1347712042,1347712042,1,1,0
127099627@N03,574,9,1378683187,1378683187,1,1,0
12711998@N00,575,8,1424775842,1424775842,1,1,0
127121673@N05,576,10,1411567200,1411567200,1,1,0
12720495@N04,577,27,1378293929,1378293929,1,1,0
127278883@N08,578,6,1439442914,1439442914,1,5,0
127278883@N08,578,2,1439430869,1439430869,1,5,0
127278883@N08,578,4,1439428648,1439439335,5,5,10687
127278883@N08,578,27,1439427165,1439427418,10,5,253
127278883@N08,578,9,1439442924,1439445467,5,5,2543
127278883@N08,579,27,1439503540,1439503540,1,1,0
127278883@N08,580,10,1439801394,1439801399,3,4,5
127278883@N08,580,17,1439794347,1439794671,8,4,324
127278883@N08,580,12,1439798810,1439799417,80,4,607
127278883@N08,580,15,1439798767,1439798971,5,4,204
127278883@N08,581,18,1463112349,1463112392,4,1,43
12738795@N00,582,20,1231624150,1231624223,2,2,73
12738795@N00,582,3,1231623624,1231623624,1,2,0
12738795@N00,583,16,1231673378,1231673378,1,1,0
12738795@N00,584,9,1231727044,1231727044,1,1,0
12738795@N00,585,17,1231759585,1231759585,1,1,0
12742129@N00,586,15,1300624588,1300624588,1,1,0
12742129@N00,587,22,1300790958,1300790958,1,1,0
127429516@N03,588,7,1425949054,1425949054,1,1,0
127484878@N05,589,14,1452277513,1452277513,1,1,0
127484878@N05,590,26,1453078366,1453078366,1,1,0
127484878@N05,591,25,1453957377,1453957377,1,1,0
127662106@N04,592,27,1409357528,1409357546,19,1,18
127662106@N04,593,16,1413038428,1413039058,10,1,630
127662106@N04,594,27,1413630236,1413630240,3,1,4
127662106@N04,595,16,1414244884,1414244926,3,1,42
127662106@N04,596,2,1415271343,1415271819,6,3,476
127662106@N04,596,27,1415263873,1415263873,1,3,0
127662106@N04,596,16,1415276562,1415276891,2,3,329
127662106@N04,597,17,1420869844,1420869844,1,4,0
127662106@N04,597,4,1420854783,1420854783,1,4,0
127662106@N04,597,2,1420856415,1420856415,1,4,0
127662106@N04,597,27,1420854400,1420854400,1,4,0
127662106@N04,598,13,1421827477,1421827477,1,2,0
127662106@N04,598,27,1421831046,1421831114,2,2,68
127662106@N04,599,8,1422698783,1422700425,21,1,1642
127662106@N04,600,20,1423374929,1423374975,3,3,46
127662106@N04,600,27,1423369910,1423370260,4,3,350
127662106@N04,600,18,1423371826,1423371826,1,3,0
127802961@N07,601,19,1401254808,1401254808,1,1,0
12784818@N04,602,10,1465003228,1465003987,4,7,759
12784818@N04,602,13,1464999749,1464999774,2,7,25
12784818@N04,602,14,1465005639,1465005639,1,7,0
12784818@N04,602,22,1465006739,1465007497,3,7,758
12784818@N04,602,8,1465005344,1465005344,1,7,0
12784818@N04,602,16,1465005709,1465005806,2,7,97
12784818@N04,602,27,1464990529,1464990529,1,7,0
12786525@N08,603,17,1188435323,1188435323,1,1,0
128025409@N08,604,17,1410069540,1410069540,1,1,0
128025409@N08,605,17,1410274882,1410278314,2,1,3432
128266798@N07,606,27,1449993689,1449993689,1,2,0
128266798@N07,606,17,1450012723,1450012723,1,2,0
128266798@N07,607,9,1458457729,1458457729,1,1,0
12827319@N00,608,27,1194173995,1194173995,1,1,0
128287982@N02,609,27,1442328172,1442328172,1,1,0
12834171@N06,610,16,1192592260,1192592260,1,1,0
12834171@N06,611,12,1192688284,1192688284,1,1,0
12834171@N06,612,16,1192752855,1192752855,1,1,0
128509080@N04,613,14,1409511213,1409511213,1,1,0
128509080@N04,614,21,1417085107,1417085340,2,1,233
128509080@N04,615,19,1417137796,1417137796,1,3,0
128509080@N04,615,27,1417134706,1417163681,3,3,28975
128509080@N04,615,24,1417128187,1417128187,1,3,0
128509080@N04,616,2,1417469805,1417469805,1,9,0
128509080@N04,616,26,1417464561,1417464561,1,9,0
128509080@N04,616,27,1417438800,1417508866,4,9,70066
128509080@N04,616,19,1417438800,1417438800,2,9,0
128509080@N04,616,21,1417461682,1417462112,3,9,430
128509080@N04,616,16,1417438800,1417517366,16,9,78566
128509080@N04,616,5,1417438800,1417438800,1,9,0
128509080@N04,616,20,1417464267,1417464267,1,9,0
128509080@N04,616,17,1417438800,1417438800,2,9,0
128509080@N04,617,21,1417740214,1417740214,1,3,0
128509080@N04,617,13,1417734112,1417734112,1,3,0
128509080@N04,617,20,1417735919,1417736071,4,3,152
128526407@N07,618,19,1414915462,1414915462,1,1,0
128526407@N07,619,14,1415734047,1415734047,1,1,0
128526407@N07,620,22,1415909077,1415909077,1,1,0
128526407@N07,621,26,1416260807,1416260807,1,1,0
128526407@N07,622,16,1416455963,1416455963,1,1,0
128526407@N07,623,16,1416725422,1416725422,1,1,0
128526407@N07,624,18,1416818613,1416818613,1,1,0
128526407@N07,625,6,1416895227,1416895227,1,1,0
128526407@N07,626,26,1416971114,1416971114,1,2,0
128526407@N07,626,25,1416954398,1416954398,1,2,0
128526407@N07,627,2,1417122037,1417122037,1,1,0
128526407@N07,628,10,1417218721,1417218721,1,2,0
128526407@N07,628,16,1417237425,1417237425,1,2,0
128526407@N07,629,11,1418072861,1418072861,1,1,0
128959272@N04,630,27,1421537837,1421570669,3,1,32832
129081011@N02,631,14,1353477379,1353477379,1,1,0
129438227@N06,632,14,1399214802,1399214802,1,1,0
129438227@N06,633,16,1415275923,1415275923,1,1,0
129438227@N06,634,17,1415366943,1415366943,1,1,0
129438227@N06,635,27,1415531064,1415531064,1,1,0
129438227@N06,636,14,1416838081,1416838081,1,1,0
129438227@N06,637,14,1417089230,1417089230,1,1,0
129438227@N06,638,14,1417525268,1417525268,1,1,0
129438227@N06,639,17,1435943161,1435943161,1,1,0
129438227@N06,640,14,1449840657,1449840657,1,1,0
129451096@N08,641,18,1424067150,1424068898,5,5,1748
129451096@N08,641,16,1424057934,1424064523,10,5,6589
129451096@N08,641,19,1424068904,1424069198,5,5,294
129451096@N08,641,14,1424063286,1424063298,2,5,12
129451096@N08,641,2,1424061131,1424061499,6,5,368
129455250@N03,642,14,1438751806,1438779395,2,1,27589
129456803@N08,643,3,1417495750,1417495750,1,1,0
12946812@N03,644,16,1203392643,1203392643,1,2,0
12946812@N03,644,20,1203397604,1203397812,3,2,208
12982579@N00,645,17,1339757994,1339759975,10,12,1981
12982579@N00,645,6,1339755869,1339755869,1,12,0
12982579@N00,645,2,1339754746,1339754746,1,12,0
12982579@N00,645,12,1339756789,1339757234,20,12,445
12982579@N00,645,5,1339754567,1339754567,1,12,0
12982579@N00,645,1,1339754815,1339754864,3,12,49
12982579@N00,645,13,1339757090,1339757090,1,12,0
12982579@N00,645,4,1339754431,1339754529,3,12,98
12982579@N00,645,27,1339753543,1339753962,7,12,419
12982579@N00,645,24,1339758549,1339758609,2,12,60
12982579@N00,645,9,1339755952,1339755952,1,12,0
12982579@N00,645,14,1339756130,1339756237,4,12,107
12989776@N03,646,18,1222830992,1222830992,1,1,0
12989776@N03,647,14,1291347429,1291347429,1,1,0
12989776@N03,648,27,1291776453,1291776453,1,1,0
12989776@N03,649,8,1306286088,1306286088,1,1,0
130069612@N06,650,14,1433412814,1433412814,1,3,0
130069612@N06,650,4,1433419900,1433419900,1,3,0
130069612@N06,650,13,1433421351,1433421351,1,3,0
130069612@N06,651,27,1463436973,1463456327,2,2,19354
130069612@N06,651,16,1463436630,1463436630,1,2,0
130069612@N06,652,10,1463919168,1463919168,1,2,0
130069612@N06,652,16,1463920299,1463922855,3,2,2556
130069612@N06,653,22,1464066268,1464066969,10,1,701
130127205@N04,654,20,1455701556,1455701556,1,5,0
130127205@N04,654,27,1455667749,1455693270,4,5,25521
130127205@N04,654,8,1455673343,1455673827,4,5,484
130127205@N04,654,1,1455681632,1455681643,2,5,11
130127205@N04,654,22,1455699840,1455701311,3,5,1471
13032456@N05,655,13,1381709831,1381709831,1,3,0
13032456@N05,655,17,1381714737,1381714737,1,3,0
13032456@N05,655,12,1381721940,1381721940,1,3,0
13032456@N05,656,10,1381818015,1381818015,1,2,0
13032456@N05,656,2,1381808549,1381808549,1,2,0
130411095@N07,657,8,1430713270,1430713271,2,1,1
13051628@N00,658,3,1251354689,1251354689,1,1,0
13051628@N00,659,4,1251619164,1251622580,2,1,3416
13051628@N00,660,4,1252756811,1252756811,1,2,0
13051628@N00,660,3,1252757064,1252757064,1,2,0
13051628@N00,661,4,1253617181,1253617181,1,1,0
13051628@N00,662,4,1253707759,1253707759,1,2,0
13051628@N00,662,3,1253698944,1253712503,3,2,13559
13051628@N00,663,27,1259652510,1259662327,3,1,9817
13051628@N00,664,27,1288496732,1288496732,1,1,0
13051628@N00,665,27,1291794808,1291808610,6,1,13802
13051628@N00,666,27,1291893398,1291897078,6,3,3680
13051628@N00,666,4,1291895056,1291895056,1,3,0
13051628@N00,666,3,1291894720,1291894720,1,3,0
13051628@N00,667,27,1293012959,1293012959,1,3,0
13051628@N00,667,4,1293036020,1293036020,1,3,0
13051628@N00,667,3,1292996359,1292996359,1,3,0
13051628@N00,668,27,1293076053,1293076053,1,1,0
13051628@N00,669,4,1293116863,1293116863,1,1,0
13051628@N00,670,4,1293530993,1293544912,2,1,13919
13051628@N00,671,4,1293617782,1293617782,1,1,0
13051628@N00,672,4,1294036430,1294047971,4,1,11541
13051628@N00,673,4,1296456273,1296460569,4,2,4296
13051628@N00,673,3,1296463773,1296463773,1,2,0
130829701@N04,674,23,1459218992,1459218992,1,2,0
130829701@N04,674,20,1459224320,1459224391,2,2,71
130895783@N02,675,27,1424738942,1424738942,1,1,0
13091463@N00,676,27,1194906655,1194924146,3,1,17491
13116303@N03,677,9,1330819986,1330819986,1,1,0
13120483@N03,678,27,1423261274,1423261274,1,3,0
13120483@N03,678,15,1423288382,1423288382,1,3,0
13120483@N03,678,2,1423263696,1423263696,1,3,0
13120483@N03,679,27,1423432375,1423432375,1,5,0
13120483@N03,679,10,1423460362,1423460362,1,5,0
13120483@N03,679,1,1423441827,1423442736,2,5,909
13120483@N03,679,9,1423433058,1423436120,2,5,3062
13120483@N03,679,21,1423448448,1423448448,1,5,0
13137063@N05,680,27,1370311770,1370311770,1,2,0
13137063@N05,680,17,1370323985,1370324106,2,2,121
131412080@N05,681,10,1450741889,1450741937,2,15,48
131412080@N05,681,4,1450770720,1450770720,1,15,0
131412080@N05,681,27,1450734377,1450770311,7,15,35934
131412080@N05,681,3,1450771054,1450771486,3,15,432
131412080@N05,681,14,1450738593,1450738702,6,15,109
131412080@N05,681,5,1450747921,1450747921,1,15,0
131412080@N05,681,19,1450750030,1450750030,1,15,0
131412080@N05,681,16,1450739008,1450739008,1,15,0
131412080@N05,681,9,1450736030,1450738020,13,15,1990
131412080@N05,681,11,1450741731,1450741731,1,15,0
131412080@N05,681,24,1450780371,1450781128,6,15,757
131412080@N05,681,8,1450741134,1450741705,2,15,571
131412080@N05,681,2,1450744534,1450745304,2,15,770
131412080@N05,681,17,1450749670,1450749672,2,15,2
131412080@N05,681,21,1450780738,1450780738,1,15,0
131412080@N05,682,22,1450908010,1450911860,5,14,3850
131412080@N05,682,10,1450918759,1450922775,21,14,4016
131412080@N05,682,12,1450916462,1450916800,3,14,338
131412080@N05,682,13,1450914429,1450916718,17,14,2289
131412080@N05,682,14,1450918541,1450918541,1,14,0
131412080@N05,682,19,1450908401,1450913109,8,14,4708
131412080@N05,682,16,1450946156,1450948322,38,14,2166
131412080@N05,682,9,1450940300,1450940300,1,14,0
131412080@N05,682,15,1450916269,1450916352,2,14,83
131412080@N05,682,8,1450940693,1450940693,1,14,0
131412080@N05,682,18,1450911997,1450914614,5,14,2617
131412080@N05,682,20,1450908112,1450910545,20,14,2433
131412080@N05,682,21,1450910187,1450910187,1,14,0
131412080@N05,682,17,1450907914,1450907914,1,14,0
131412080@N05,683,22,1450999566,1450999566,1,12,0
131412080@N05,683,26,1450996354,1450996354,1,12,0
131412080@N05,683,25,1450995965,1450996709,7,12,744
131412080@N05,683,2,1451007090,1451007090,1,12,0
131412080@N05,683,23,1450996965,1450996965,1,12,0
131412080@N05,683,27,1451009318,1451009318,1,12,0
131412080@N05,683,6,1451006941,1451007342,4,12,401
131412080@N05,683,14,1451003781,1451003809,4,12,28
131412080@N05,683,24,1450995490,1450996071,5,12,581
131412080@N05,683,15,1451003363,1451003588,7,12,225
131412080@N05,683,20,1450997432,1450997432,1,12,0
131412080@N05,683,21,1450995662,1450998887,13,12,3225
131437714@N07,684,3,1238131317,1238157750,13,1,26433
13156986@N08,685,16,1392213503,1392225884,2,8,12381
13156986@N08,685,7,1392231015,1392231158,3,8,143
13156986@N08,685,15,1392225769,1392225769,1,8,0
13156986@N08,685,13,1392225643,1392225643,1,8,0
13156986@N08,685,14,1392233839,1392233839,1,8,0
13156986@N08,685,9,1392208756,1392238081,2,8,29325
13156986@N08,685,17,1392213461,1392226745,8,8,13284
13156986@N08,685,26,1392226078,1392226078,1,8,0
131849702@N06,686,22,1436144658,1436144658,1,6,0
131849702@N06,686,14,1436158350,1436159848,2,6,1498
131849702@N06,686,9,1436157694,1436157695,2,6,1
131849702@N06,686,17,1436153430,1436153445,2,6,15
131849702@N06,686,24,1436146339,1436146853,3,6,514
131849702@N06,686,16,1436158370,1436158370,1,6,0
13191676@N07,687,27,1243778400,1243778400,4,5,0
13191676@N07,687,13,1243778400,1243778400,1,5,0
13191676@N07,687,4,1243778400,1243778400,1,5,0
13191676@N07,687,22,1243778400,1243778400,3,5,0
13191676@N07,687,12,1243778400,1243778400,1,5,0
131918782@N02,688,2,1422142016,1422148573,4,11,6557
131918782@N02,688,10,1422151006,1422151290,6,11,284
131918782@N02,688,21,1422157034,1422157035,2,11,1
131918782@N02,688,7,1422171859,1422171872,2,11,13
131918782@N02,688,23,1422157010,1422157328,4,11,318
131918782@N02,688,14,1422152623,1422153185,6,11,562
131918782@N02,688,26,1422178210,1422178279,4,11,69
131918782@N02,688,5,1422148571,1422148571,1,11,0
131918782@N02,688,9,1422149622,1422151476,6,11,1854
131918782@N02,688,27,1422133308,1422161836,3,11,28528
131918782@N02,688,3,1422144804,1422144804,1,11,0
131918782@N02,689,16,1422258093,1422258095,2,5,2
131918782@N02,689,21,1422251659,1422251668,3,5,9
131918782@N02,689,10,1422227045,1422260049,13,5,33004
131918782@N02,689,27,1422224408,1422246156,7,5,21748
131918782@N02,689,3,1422255575,1422255575,1,5,0
131918782@N02,690,18,1422413452,1422414409,5,7,957
131918782@N02,690,6,1422426476,1422426477,2,7,1
131918782@N02,690,26,1422420501,1422420501,1,7,0
131918782@N02,690,14,1422408715,1422409284,16,7,569
131918782@N02,690,25,1422420470,1422420607,5,7,137
131918782@N02,690,13,1422414332,1422414374,3,7,42
131918782@N02,690,17,1422420485,1422420485,1,7,0
131918782@N02,691,2,1442569544,1442569544,1,1,0
13199533@N04,692,18,1310984931,1310984931,1,1,0
13205707@N00,693,16,1242043657,1242043946,3,1,289
132066133@N04,694,10,1461624830,1461624830,1,2,0
132066133@N04,694,27,1461646253,1461646253,1,2,0
132132547@N04,695,15,1427756554,1427756565,2,2,11
132132547@N04,695,10,1427784070,1427784070,1,2,0
132132547@N04,696,15,1428566562,1428575325,2,3,8763
132132547@N04,696,27,1428558033,1428558033,1,3,0
132132547@N04,696,19,1428571400,1428571400,1,3,0
132133260@N06,697,14,1435182851,1435182851,1,1,0
132357461@N07,698,15,1405750703,1405750703,1,1,0
132357461@N07,699,14,1405816518,1405816518,1,1,0
132472019@N05,700,23,1439950917,1439950917,1,3,0
132472019@N05,700,12,1439969526,1439969584,3,3,58
132472019@N05,700,17,1439974928,1439974928,1,3,0
13259518@N00,701,16,1245300007,1245300237,2,5,230
13259518@N00,701,14,1245300451,1245300888,2,5,437
13259518@N00,701,3,1245303923,1245303923,1,5,0
13259518@N00,701,15,1245301200,1245301200,1,5,0
13259518@N00,701,27,1245314588,1245315433,2,5,845
13269428@N04,702,9,1233649391,1233649391,1,1,0
132743212@N07,703,4,1372766628,1372767082,3,1,454
132959156@N02,704,21,1435409734,1435409734,1,2,0
132959156@N02,704,15,1435407640,1435407640,1,2,0
132959156@N02,705,14,1436531802,1436531802,1,1,0
132959156@N02,706,14,1439558504,1439558504,1,2,0
132959156@N02,706,12,1439557048,1439557048,1,2,0
132959156@N02,707,26,1443177074,1443177074,1,1,0
132959156@N02,708,1,1454640441,1454640441,1,1,0
132959156@N02,709,26,1455975077,1455975077,1,1,0
133471560@N03,710,27,1442030296,1442030296,1,1,0
133471560@N03,711,27,1442474448,1442474448,1,1,0
133471560@N03,712,27,1453248483,1453248483,1,1,0
13353749@N06,713,16,1195699479,1195699479,1,1,0
13359849@N00,714,27,1383806670,1383811217,2,1,4547
13415254@N05,715,9,1192608234,1192608234,1,1,0
13417605@N00,716,16,1441247456,1441247456,1,1,0
13417605@N00,717,2,1441696779,1441697113,2,2,334
13417605@N00,717,20,1441691332,1441691332,1,2,0
13444787@N08,718,14,1303368557,1303368557,1,1,0
134814033@N03,719,27,1452036186,1452036186,1,12,0
134814033@N03,719,14,1452063064,1452063064,1,12,0
134814033@N03,719,4,1452036595,1452036595,1,12,0
134814033@N03,719,18,1452055450,1452056825,2,12,1375
134814033@N03,719,13,1452056503,1452056503,1,12,0
134814033@N03,719,20,1452042133,1452042133,2,12,0
134814033@N03,719,25,1452038878,1452048821,4,12,9943
134814033@N03,719,17,1452053570,1452053907,7,12,337
134814033@N03,719,6,1452064668,1452064770,4,12,102
134814033@N03,719,19,1452043679,1452043679,2,12,0
134814033@N03,719,23,1452060724,1452060782,2,12,58
134814033@N03,719,9,1452064224,1452064224,1,12,0
13487696@N04,720,23,1378277735,1378277735,1,1,0
135134438@N07,721,4,1427879784,1427879784,1,1,0
13516406@N00,722,21,1367195884,1367195884,1,4,0
13516406@N00,722,9,1367190178,1367190204,2,4,26
13516406@N00,722,10,1367204930,1367204930,1,4,0
13516406@N00,722,27,1367188670,1367188778,2,4,108
135322752@N06,723,27,1439747754,1439747754,1,4,0
135322752@N06,723,12,1439712628,1439712628,1,4,0
135322752@N06,723,19,1439704169,1439704169,1,4,0
135322752@N06,723,16,1439736013,1439736013,1,4,0
135322752@N06,724,18,1440514949,1440514949,1,1,0
135322752@N06,725,23,1440676388,1440676388,1,1,0
13533794@N00,726,6,1212835016,1212835533,11,14,517
13533794@N00,726,25,1212799182,1212828822,42,14,29640
13533794@N00,726,12,1212803064,1212832799,46,14,29735
13533794@N00,726,7,1212835175,1212835349,14,14,174
13533794@N00,726,9,1212805344,1212834539,14,14,29195
13533794@N00,726,15,1212802568,1212802995,7,14,427
13533794@N00,726,14,1212804023,1212804023,1,14,0
13533794@N00,726,23,1212799858,1212829083,10,14,29225
13533794@N00,726,19,1212801507,1212802211,4,14,704
13533794@N00,726,1,1212807704,1212837042,9,14,29338
13533794@N00,726,27,1212794701,1212825377,20,14,30676
13533794@N00,726,21,1212828116,1212828116,1,14,0
13533794@N00,726,13,1212797031,1212826228,17,14,29197
13533794@N00,726,16,1212837710,1212838813,3,14,1103
13599014@N08,727,27,1376952823,1376952825,6,1,2
13604385@N00,728,19,1352602131,1352602131,1,5,0
13604385@N00,728,25,1352596487,1352619383,7,5,22896
13604385@N00,728,13,1352604236,1352604236,1,5,0
13604385@N00,728,27,1352627607,1352629329,10,5,1722
13604385@N00,728,16,1352625086,1352625086,1,5,0
13613904@N05,729,16,1210762998,1210763495,6,1,497
13613904@N05,730,16,1210936152,1210936176,2,1,24
13613904@N05,731,14,1274673186,1274673186,1,4,0
13613904@N05,731,20,1274670990,1274670990,1,4,0
13613904@N05,731,19,1274671500,1274671500,1,4,0
13613904@N05,731,1,1274680920,1274680920,1,4,0
13613904@N05,732,16,1274886608,1274886608,1,1,0
136325095@N07,733,17,1443007481,1443007481,1,1,0
13636518@N05,734,21,1300185078,1300198290,3,1,13212
13644648@N03,735,13,1254021526,1254021526,1,5,0
13644648@N03,735,20,1254021522,1254021522,1,5,0
13644648@N03,735,17,1254021527,1254021527,1,5,0
13644648@N03,735,8,1254021535,1254021535,1,5,0
13644648@N03,735,3,1254021536,1254021536,1,5,0
13644648@N03,736,13,1254643622,1254643625,3,8,3
13644648@N03,736,17,1254643626,1254643626,1,8,0
13644648@N03,736,3,1254659291,1254659320,2,8,29
13644648@N03,736,18,1254659316,1254659316,1,8,0
13644648@N03,736,4,1254659302,1254659319,2,8,17
13644648@N03,736,15,1254659294,1254659294,1,8,0
13644648@N03,736,21,1254659308,1254659308,1,8,0
13644648@N03,736,19,1254659317,1254659317,1,8,0
13644648@N03,737,20,1287811551,1287812649,7,17,1098
13644648@N03,737,14,1287811537,1287812651,4,17,1114
13644648@N03,737,23,1287811544,1287812640,2,17,1096
13644648@N03,737,22,1287811533,1287812650,6,17,1117
13644648@N03,737,17,1287811535,1287811536,2,17,1
13644648@N03,737,16,1287811540,1287811543,2,17,3
13644648@N03,737,24,1287811541,1287811541,1,17,0
13644648@N03,737,27,1287812625,1287812634,5,17,9
13644648@N03,737,7,1287812636,1287812636,1,17,0
13644648@N03,737,3,1287811542,1287811542,1,17,0
13644648@N03,737,18,1287811537,1287812644,5,17,1107
13644648@N03,737,4,1287812635,1287812635,1,17,0
13644648@N03,737,1,1287812624,1287812624,1,17,0
13644648@N03,737,6,1287812623,1287812623,1,17,0
13644648@N03,737,15,1287811534,1287811540,2,17,6
13644648@N03,737,19,1287811547,1287811552,4,17,5
13644648@N03,737,26,1287812637,1287812639,2,17,2
13656125@N00,738,16,1361654958,1361654958,1,1,0
13656125@N00,739,16,1361696535,1361696535,1,1,0
136975147@N03,740,13,1458708262,1458708264,2,4,2
136975147@N03,740,9,1458710005,1458725019,3,4,15014
136975147@N03,740,23,1458698931,1458698931,1,4,0
136975147@N03,740,27,1458696058,1458696315,3,4,257
13703871@N00,741,21,1320626744,1320626744,1,1,0
13722851@N04,742,16,1302097187,1302097187,1,1,0
13725122@N02,743,27,1368853569,1368853569,1,1,0
13726219@N06,744,17,1209124356,1209124356,1,1,0
13726219@N06,745,17,1243079131,1243079131,1,2,0
13726219@N06,745,27,1243079188,1243079255,2,2,67
13726219@N06,746,24,1291452464,1291452464,1,1,0
13726219@N06,747,25,1291552589,1291552589,1,1,0
13726219@N06,748,25,1291631066,1291631066,1,1,0
13726219@N06,749,4,1291791268,1291791268,1,1,0
13726219@N06,750,21,1350588772,1350588772,1,1,0
13726219@N06,751,21,1350733435,1350733435,1,1,0
13726219@N06,752,21,1350845442,1350861045,6,4,15603
13726219@N06,752,13,1350859183,1350859183,1,4,0
13726219@N06,752,17,1350858425,1350858425,1,4,0
13726219@N06,752,22,1350857595,1350857595,1,4,0
13764100@N05,753,27,1236991460,1237012036,5,1,20576
13764100@N05,754,27,1241854830,1241854830,1,1,0
13764100@N05,755,27,1241928830,1241928830,1,1,0
13764100@N05,756,27,1348728606,1348730317,7,1,1711
13775066@N00,757,27,1382738323,1382787160,29,1,48837
13813159@N00,758,20,1354174054,1354174054,1,5,0
13813159@N00,758,13,1354174139,1354174139,1,5,0
13813159@N00,758,16,1354174259,1354174454,2,5,195
13813159@N00,758,10,1354172635,1354172686,2,5,51
13813159@N00,758,8,1354172891,1354173185,4,5,294
13813159@N00,759,2,1354224390,1354224937,2,1,547
13818837@N05,760,16,1308601629,1308601629,1,3,0
13818837@N05,760,13,1308615558,1308615558,2,3,0
13818837@N05,760,17,1308602011,1308602011,1,3,0
138748094@N04,761,15,1389682766,1389682766,1,1,0
13880897@N06,762,27,1360901354,1360901734,7,2,380
13880897@N06,762,20,1360908432,1360908432,1,2,0
13880897@N06,763,8,1360979893,1360979893,1,5,0
13880897@N06,763,7,1360979919,1360980111,4,5,192
13880897@N06,763,26,1360981734,1360981826,3,5,92
13880897@N06,763,9,1360977357,1360977363,5,5,6
13880897@N06,763,27,1360976645,1360976715,5,5,70
13880897@N06,764,7,1402804507,1402804507,1,3,0
13880897@N06,764,19,1402804350,1402804350,1,3,0
13880897@N06,764,14,1402801066,1402801111,2,3,45
13880897@N06,765,10,1402915352,1402923261,2,3,7909
13880897@N06,765,27,1402900907,1402923089,3,3,22182
13880897@N06,765,14,1402915387,1402915418,2,3,31
13885531@N00,766,15,1226183319,1226183319,1,3,0
13885531@N00,766,14,1226194397,1226194397,1,3,0
13885531@N00,766,17,1226183206,1226188782,2,3,5576
13901020@N02,767,27,1190416279,1190416830,33,3,551
13901020@N02,767,16,1190416871,1190416871,1,3,0
13901020@N02,767,25,1190416563,1190416605,10,3,42
139081931@N05,768,20,1408609000,1408609000,1,1,0
139081931@N05,769,22,1409039011,1409039011,1,2,0
139081931@N05,769,26,1409039035,1409046088,2,2,7053
139081931@N05,770,27,1409179903,1409179903,1,1,0
139081931@N05,771,15,1409638528,1409638528,1,2,0
139081931@N05,771,14,1409632188,1409632540,2,2,352
139081931@N05,772,14,1458382872,1458382882,2,1,10
13915720@N07,773,9,1345978848,1345978848,1,1,0
13929738@N04,774,26,1195099835,1195099835,1,1,0
13933131@N08,775,27,1316894550,1316946814,36,9,52264
13933131@N08,775,25,1316900064,1316906674,4,9,6610
13933131@N08,775,4,1316941369,1316941410,3,9,41
13933131@N08,775,21,1316901309,1316902451,2,9,1142
13933131@N08,775,16,1316941259,1316941259,1,9,0
13933131@N08,775,14,1316912472,1316912472,1,9,0
13933131@N08,775,24,1316907018,1316907018,1,9,0
13933131@N08,775,20,1316946746,1316946746,1,9,0
13933131@N08,775,3,1316951283,1316951283,1,9,0
13933131@N08,776,17,1381542354,1381542354,1,3,0
13933131@N08,776,13,1381542454,1381545316,4,3,2862
13933131@N08,776,11,1381547295,1381547295,1,3,0
13933131@N08,777,9,1381868349,1381870226,6,1,1877
13933131@N08,778,27,1393660636,1393660636,1,2,0
13933131@N08,778,7,1393664516,1393664516,1,2,0
13933131@N08,779,17,1393709887,1393709887,1,1,0
13943185@N00,780,27,1225415221,1225415221,1,1,0
13943185@N00,781,16,1229296415,1229296415,1,1,0
13959240@N08,782,17,1345947365,1345947365,1,2,0
13959240@N08,782,27,1345939964,1345939964,1,2,0
13959240@N08,783,3,1346059709,1346059709,1,1,0
13959240@N08,784,27,1346229983,1346229983,1,1,0
13959240@N08,785,17,1346367812,1346367812,1,2,0
13959240@N08,785,27,1346380612,1346380612,1,2,0
13959240@N08,786,18,1346472165,1346472165,1,1,0
13991097@N02,787,17,1323254761,1323254779,3,2,18
13991097@N02,787,22,1323232536,1323232536,1,2,0
14003861@N06,788,16,1434570702,1434595501,3,1,24799
140621810@N05,789,16,1460958998,1460958998,1,1,0
14125170@N02,790,22,1273413600,1273413615,16,1,15
14125170@N02,791,22,1273759200,1273759213,14,1,13
14129109@N07,792,27,1344580323,1344619210,9,1,38887
14130502@N07,793,27,1310112825,1310116713,14,3,3888
14130502@N07,793,16,1310113082,1310113082,1,3,0
14130502@N07,793,21,1310118429,1310118645,2,3,216
14135751@N07,794,20,1365652329,1365652329,1,7,0
14135751@N07,794,17,1365649750,1365649750,1,7,0
14135751@N07,794,10,1365643048,1365644194,7,7,1146
14135751@N07,794,12,1365646401,1365646401,1,7,0
14135751@N07,794,14,1365646163,1365646299,2,7,136
14135751@N07,794,21,1365655035,1365655035,1,7,0
14135751@N07,794,15,1365642911,1365649744,2,7,6833
14157787@N07,795,16,1369660199,1369660199,1,1,0
141774505@N07,796,6,1459312373,1459312381,2,1,8
14208013@N06,797,14,1392866954,1392866954,1,3,0
14208013@N06,797,9,1392853578,1392853578,1,3,0
14208013@N06,797,10,1392852787,1392852787,1,3,0
14233893@N02,798,16,1328506875,1328506875,1,2,0
14233893@N02,798,27,1328482985,1328482985,1,2,0
14233893@N02,799,27,1328647890,1328647890,1,1,0
14242929@N02,800,27,1190970748,1190970748,1,1,0
14246866@N05,801,17,1296879427,1296879427,1,2,0
14246866@N05,801,27,1296874758,1296874930,4,2,172
14246866@N05,802,18,1331361175,1331361175,1,6,0
14246866@N05,802,14,1331338079,1331339042,5,6,963
14246866@N05,802,27,1331350472,1331350472,1,6,0
14246866@N05,802,9,1331338379,1331338379,1,6,0
14246866@N05,802,1,1331347814,1331347857,4,6,43
14246866@N05,802,23,1331358153,1331359978,2,6,1825
14249123@N02,803,4,1210843790,1210843790,1,1,0
14249123@N02,804,4,1211158306,1211158306,1,3,0
14249123@N02,804,9,1211158315,1211158315,1,3,0
14249123@N02,804,27,1211158279,1211158304,2,3,25
14261584@N00,805,17,1300077574,1300086040,11,8,8466
14261584@N00,805,21,1300071702,1300071702,1,8,0
14261584@N00,805,9,1300078738,1300078803,2,8,65
14261584@N00,805,26,1300075153,1300075153,1,8,0
14261584@N00,805,1,1300079757,1300085369,3,8,5612
14261584@N00,805,13,1300077703,1300077703,1,8,0
14261584@N00,805,27,1300067548,1300067548,1,8,0
14261584@N00,805,6,1300079521,1300079521,1,8,0
14280234@N04,806,17,1330942746,1330942746,1,1,0
14280458@N05,807,5,1284299412,1284299412,1,2,0
14280458@N05,807,4,1284299378,1284303948,3,2,4570
14280458@N05,808,27,1284473093,1284486220,2,3,13127
14280458@N05,808,26,1284476110,1284476110,2,3,0
14280458@N05,808,17,1284476263,1284484691,5,3,8428
14284806@N00,809,16,1256250324,1256251337,14,1,1013
14286456@N07,810,16,1224914931,1224914931,1,1,0
14286456@N07,811,16,1225099498,1225099498,1,1,0
143025564@N02,812,22,1448671315,1448671315,1,1,0
14307363@N05,813,27,1308961934,1308961934,1,1,0
14334279@N02,814,18,1420166482,1420166513,2,2,31
14334279@N02,814,20,1420169358,1420169358,1,2,0
14337325@N03,815,11,1237262176,1237262176,1,1,0
14342625@N04,816,20,1318300044,1318300044,1,1,0
14344313@N05,817,14,1203891514,1203891612,2,3,98
14344313@N05,817,9,1203889839,1203889839,1,3,0
14344313@N05,817,12,1203894219,1203894219,1,3,0
14344313@N05,818,20,1204080780,1204080780,1,3,0
14344313@N05,818,18,1204065008,1204065301,2,3,293
14344313@N05,818,10,1204077706,1204077706,1,3,0
14344313@N05,819,2,1204939948,1204939948,1,1,0
14370802@N05,820,11,1402190664,1402190664,1,1,0
14399815@N07,821,10,1329179041,1329179041,1,2,0
14399815@N07,821,12,1329179063,1329179063,1,2,0
14399815@N07,822,2,1346130413,1346130413,1,1,0
14399815@N07,823,7,1348802852,1348804745,6,2,1893
14399815@N07,823,12,1348807448,1348807503,6,2,55
14404008@N00,824,24,1223426511,1223427012,9,3,501
14404008@N00,824,14,1223418090,1223418102,2,3,12
14404008@N00,824,27,1223414345,1223414461,2,3,116
14404008@N00,825,4,1223773998,1223773998,1,2,0
14404008@N00,825,27,1223762304,1223777992,2,2,15688
14404008@N00,826,27,1224277784,1224279008,2,1,1224
14428367@N00,827,16,1226794038,1226818376,127,2,24338
14428367@N00,827,18,1226813350,1226815590,27,2,2240
14428367@N00,828,18,1227395796,1227395796,1,1,0
14447350@N05,829,2,1321684615,1321684630,2,1,15
144474523@N02,830,21,1247288651,1247288651,1,4,0
144474523@N02,830,14,1247287280,1247287280,1,4,0
144474523@N02,830,18,1247299899,1247299899,1,4,0
144474523@N02,830,19,1247296942,1247296942,1,4,0
14449931@N08,831,16,1378531569,1378531569,1,3,0
14449931@N08,831,27,1378540931,1378540931,1,3,0
14449931@N08,831,20,1378531922,1378531922,1,3,0
14449931@N08,832,27,1378631144,1378631144,1,2,0
14449931@N08,832,8,1378645140,1378645140,1,2,0
14449931@N08,833,15,1378772366,1378772366,1,3,0
14449931@N08,833,10,1378774073,1378774073,1,3,0
14449931@N08,833,9,1378785333,1378785333,1,3,0
14449931@N08,834,14,1379065599,1379065599,1,2,0
14449931@N08,834,8,1379074597,1379074597,1,2,0
14449931@N08,835,14,1400042691,1400042691,1,1,0
14449931@N08,836,10,1400370447,1400373972,2,1,3525
14449931@N08,837,14,1400423762,1400423762,1,1,0
14449931@N08,838,27,1411118247,1411118247,1,1,0
14449931@N08,839,11,1411254301,1411257647,2,1,3346
14453171@N00,840,10,1322973371,1322973371,1,6,0
14453171@N00,840,14,1322951444,1322951444,1,6,0
14453171@N00,840,24,1322959730,1322962807,3,6,3077
14453171@N00,840,23,1322969062,1322973377,4,6,4315
14453171@N00,840,18,1322966794,1322966794,1,6,0
14453171@N00,840,22,1322969069,1322969069,1,6,0
14472753@N02,841,15,1270191894,1270191894,1,1,0
14479515@N03,842,25,1199669323,1199669866,14,13,543
14479515@N03,842,19,1199672677,1199672677,1,13,0
14479515@N03,842,17,1199669161,1199682757,5,13,13596
14479515@N03,842,18,1199680631,1199680686,5,13,55
14479515@N03,842,14,1199684002,1199690680,12,13,6678
14479515@N03,842,3,1199685613,1199685751,4,13,138
14479515@N03,842,8,1199684679,1199684679,1,13,0
14479515@N03,842,13,1199677608,1199677690,4,13,82
14479515@N03,842,27,1199667891,1199695897,58,13,28006
14479515@N03,842,24,1199670076,1199671761,23,13,1685
14479515@N03,842,9,1199684413,1199691013,2,13,6600
14479515@N03,842,2,1199685553,1199685564,2,13,11
14479515@N03,842,26,1199669980,1199679460,2,13,9480
14479515@N03,843,4,1254280171,1254292247,11,1,12076
14479515@N03,844,4,1254379514,1254391530,7,1,12016
14479515@N03,845,4,1254444378,1254444415,6,1,37
14484378@N08,846,27,1189851098,1189851098,1,1,0
14484378@N08,847,27,1190023613,1190023705,2,1,92
14484378@N08,848,27,1190371749,1190372434,13,1,685
14484378@N08,849,27,1191017467,1191018258,5,1,791
14484378@N08,850,27,1192377003,1192379439,5,1,2436
14484378@N08,851,27,1192749610,1192750590,3,1,980
14484378@N08,852,27,1193125771,1193125771,1,1,0
14484378@N08,853,27,1193941219,1193941219,1,1,0
14484378@N08,854,27,1194127794,1194128360,3,1,566
14484378@N08,855,27,1201969539,1201969902,6,1,363
14484378@N08,856,27,1205758449,1205758471,2,1,22
14484378@N08,857,27,1205855927,1205855927,1,1,0
14484378@N08,858,27,1210177236,1210177314,4,1,78
14484378@N08,859,27,1210919286,1210925989,8,1,6703
14484378@N08,860,27,1214321887,1214321887,1,1,0
14484378@N08,861,27,1214410948,1214411158,11,1,210
14484378@N08,862,27,1215449169,1215449171,2,1,2
14484378@N08,863,27,1215534631,1215534631,1,1,0
14484378@N08,864,27,1215706996,1215707071,2,1,75
14484378@N08,865,27,1215987693,1215987693,1,1,0
14484378@N08,866,27,1216227076,1216227076,1,1,0
14484378@N08,867,27,1216916969,1216917103,3,1,134
14484378@N08,868,27,1217349238,1217349244,2,1,6
14484378@N08,869,27,1219256978,1219257707,2,1,729
14484378@N08,870,27,1220047428,1220047437,2,1,9
14484378@N08,871,27,1220544353,1220545945,4,1,1592
14484378@N08,872,27,1220973157,1220977320,10,1,4163
14484378@N08,873,27,1221062000,1221064220,10,1,2220
14484378@N08,874,27,1221321070,1221321283,3,1,213
14484378@N08,875,27,1221667609,1221669368,5,1,1759
14484378@N08,876,27,1222014759,1222014764,4,1,5
14484378@N08,877,27,1222100910,1222100925,2,1,15
14484378@N08,878,27,1222440153,1222441704,13,1,1551
14484378@N08,879,27,1222526896,1222533118,2,1,6222
14484378@N08,880,27,1222982403,1222982403,1,1,0
14484378@N08,881,27,1223238788,1223239857,3,1,1069
14484378@N08,882,11,1224789169,1224789371,4,1,202
14484378@N08,883,11,1224937988,1224937988,1,1,0
14484378@N08,884,11,1225990278,1225990587,5,1,309
14484378@N08,885,11,1226147617,1226147617,1,1,0
14484378@N08,886,11,1226232603,1226232603,1,1,0
14484378@N08,887,27,1226434891,1226434942,2,1,51
14484378@N08,888,11,1226614270,1226614372,2,1,102
14484378@N08,889,11,1227220886,1227220886,1,1,0
14484378@N08,890,11,1227305349,1227305349,1,2,0
14484378@N08,890,27,1227310177,1227310177,1,2,0
14484378@N08,891,11,1227714117,1227714117,1,1,0
14484378@N08,892,11,1230082754,1230082754,1,1,0
14484378@N08,893,11,1230176926,1230176926,1,1,0
14484378@N08,894,11,1234584295,1234584295,1,1,0
14487451@N00,895,14,1354666877,1354666877,1,1,0
14487451@N00,896,27,1354761661,1354761661,1,1,0
14487451@N00,897,11,1354931903,1354931903,1,1,0
14489732@N00,898,16,1275817917,1275817917,1,1,0
14500034@N06,899,19,1388211003,1388211003,1,1,0
14504365@N00,900,11,1359076842,1359076842,1,4,0
14504365@N00,900,16,1359060159,1359060159,1,4,0
14504365@N00,900,15,1359072765,1359072765,1,4,0
14504365@N00,900,8,1359081719,1359082478,2,4,759
14504365@N00,901,24,1359242834,1359242834,1,7,0
14504365@N00,901,26,1359240770,1359240770,1,7,0
14504365@N00,901,14,1359253494,1359254557,4,7,1063
14504365@N00,901,23,1359241883,1359241886,2,7,3
14504365@N00,901,18,1359254476,1359254476,1,7,0
14504365@N00,901,27,1359256529,1359256529,1,7,0
14504365@N00,901,13,1359243569,1359254301,2,7,10732
14506090@N06,902,17,1273289314,1273289314,1,1,0
14514934@N04,903,16,1227158198,1227158198,1,1,0
14518451@N06,904,14,1394547411,1394547411,1,4,0
14518451@N06,904,10,1394554398,1394554398,1,4,0
14518451@N06,904,9,1394557931,1394557946,2,4,15
14518451@N06,904,27,1394528230,1394530005,3,4,1775
14572041@N08,905,17,1448253476,1448253476,1,1,0
14580956@N08,906,18,1284535631,1284537608,8,11,1977
14580956@N08,906,11,1284531062,1284533728,9,11,2666
14580956@N08,906,9,1284514837,1284514986,3,11,149
14580956@N08,906,14,1284509016,1284510582,5,11,1566
14580956@N08,906,16,1284508096,1284525035,17,11,16939
14580956@N08,906,13,1284512963,1284513115,2,11,152
14580956@N08,906,17,1284523896,1284528132,13,11,4236
14580956@N08,906,21,1284529159,1284529159,1,11,0
14580956@N08,906,24,1284515359,1284516185,3,11,826
14580956@N08,906,2,1284540131,1284540131,1,11,0
14580956@N08,906,27,1284507596,1284547160,7,11,39564
14617498@N00,907,14,1227252521,1227252521,1,3,0
14617498@N00,907,21,1227261676,1227261676,1,3,0
14617498@N00,907,13,1227252001,1227252145,2,3,144
14617498@N00,908,13,1255682796,1255691420,3,2,8624
14617498@N00,908,9,1255681151,1255681151,1,2,0
14617498@N00,909,21,1296270725,1296270725,1,2,0
14617498@N00,909,11,1296264643,1296264643,1,2,0
14621985@N05,910,25,1327380769,1327380769,1,4,0
14621985@N05,910,16,1327379258,1327379258,1,4,0
14621985@N05,910,27,1327380486,1327380486,1,4,0
14621985@N05,910,23,1327380259,1327380259,1,4,0
14621985@N05,911,9,1327430470,1327430470,1,1,0
14621985@N05,912,25,1327715851,1327715851,1,6,0
14621985@N05,912,16,1327717434,1327727479,2,6,10045
14621985@N05,912,26,1327715944,1327715944,1,6,0
14621985@N05,912,27,1327715398,1327716038,2,6,640
14621985@N05,912,6,1327717224,1327717224,1,6,0
14621985@N05,912,23,1327715522,1327715522,1,6,0
14625004@N00,913,27,1195343433,1195358699,5,1,15266
14625004@N00,914,27,1195726817,1195727489,4,1,672
14625004@N00,915,6,1195812962,1195812962,1,2,0
14625004@N00,915,4,1195809599,1195809599,1,2,0
14627430@N00,916,7,1258876374,1258876374,1,1,0
14631943@N08,917,16,1190512151,1190512277,6,1,126
14631943@N08,918,16,1192016139,1192016139,1,1,0
14764161@N00,919,15,1383224400,1383224400,1,1,0
14769156@N08,920,27,1414228694,1414229556,86,2,862
14769156@N08,920,4,1414229560,1414229560,1,2,0
14769156@N08,921,26,1417955338,1417955348,2,4,10
14769156@N08,921,15,1417954028,1417954028,1,4,0
14769156@N08,921,22,1417955448,1417955518,6,4,70
14769156@N08,921,24,1417954242,1417954242,1,4,0
14769156@N08,922,12,1423271708,1423271708,1,2,0
14769156@N08,922,21,1423272973,1423273004,2,2,31
14769156@N08,923,27,1439903688,1439903688,1,4,0
14769156@N08,923,14,1439903739,1439903765,2,4,26
14769156@N08,923,9,1439903724,1439903724,1,4,0
14769156@N08,923,8,1439903764,1439903764,1,4,0
14769156@N08,924,9,1441889932,1441889932,1,1,0
14802142@N02,925,21,1421466274,1421475980,3,1,9706
14805586@N03,926,26,1274170389,1274170389,1,4,0
14805586@N03,926,16,1274152477,1274153537,5,4,1060
14805586@N03,926,9,1274153558,1274161265,9,4,7707
14805586@N03,926,17,1274165448,1274167695,9,4,2247
14831331@N07,927,13,1420891888,1420891888,1,1,0
14831331@N07,928,8,1420948404,1420948404,1,1,0
14845075@N00,929,14,1407236916,1407237040,3,2,124
14845075@N00,929,23,1407218720,1407218720,1,2,0
14847653@N00,930,18,1324097551,1324097551,1,2,0
14847653@N00,930,24,1324082395,1324082395,1,2,0
14852593@N00,931,16,1344568591,1344570408,2,1,1817
14898307@N00,932,1,1360217107,1360217107,1,3,0
14898307@N00,932,21,1360227483,1360227483,1,3,0
14898307@N00,932,2,1360223478,1360223478,1,3,0
14898307@N00,933,15,1360276634,1360276634,1,1,0
14898307@N00,934,14,1360490841,1360491136,2,1,295
14898307@N00,935,20,1360632197,1360632197,1,1,0
14904592@N04,936,2,1292048043,1292048043,1,1,0
14912537@N04,937,27,1394251262,1394251262,1,1,0
14915921@N00,938,16,1196579428,1196579436,2,1,8
14934218@N03,939,27,1251584584,1251585110,4,4,526
14934218@N03,939,26,1251592582,1251595121,3,4,2539
14934218@N03,939,14,1251622274,1251622274,1,4,0
14934218@N03,939,16,1251609595,1251625109,3,4,15514
14934218@N03,940,16,1251668783,1251668783,1,1,0
14958748@N00,941,16,1380423268,1380423268,1,1,0
15021432@N00,942,24,1190332486,1190332486,1,1,0
15021432@N00,943,26,1193991513,1193991513,1,1,0
15021432@N00,944,20,1201945211,1201945735,5,2,524
15021432@N00,944,26,1201940249,1201940249,1,2,0
15021432@N00,945,21,1222421624,1222421624,1,3,0
15021432@N00,945,2,1222398958,1222398958,1,3,0
15021432@N00,945,16,1222405077,1222405477,2,3,400
15021432@N00,946,27,1229409712,1229409712,1,3,0
15021432@N00,946,20,1229386586,1229386586,1,3,0
15021432@N00,946,14,1229397812,1229397812,1,3,0
15021432@N00,947,22,1229834352,1229835482,16,1,1130
15021432@N00,948,2,1237027405,1237027405,1,1,0
15066420@N00,949,21,1208056603,1208056603,1,1,0
15066420@N00,950,23,1210630554,1210630554,1,1,0
15066420@N00,951,26,1212756334,1212756535,3,5,201
15066420@N00,951,13,1212754922,1212754922,1,5,0
15066420@N00,951,17,1212754012,1212754012,1,5,0
15066420@N00,951,14,1212753080,1212753080,1,5,0
15066420@N00,951,19,1212758573,1212758902,4,5,329
15079826@N00,952,17,1400859642,1400859737,2,19,95
15079826@N00,952,18,1400834879,1400847585,14,19,12706
15079826@N00,952,8,1400797874,1400798595,3,19,721
15079826@N00,952,15,1400830935,1400830935,1,19,0
15079826@N00,952,9,1400794045,1400803404,13,19,9359
15079826@N00,952,25,1400815475,1400872934,4,19,57459
15079826@N00,952,27,1400788512,1400875222,15,19,86710
15079826@N00,952,14,1400790518,1400792297,4,19,1779
15079826@N00,952,22,1400823300,1400848760,18,19,25460
15079826@N00,952,12,1400803996,1400803996,1,19,0
15079826@N00,952,7,1400792932,1400792939,2,19,7
15079826@N00,952,16,1400807658,1400870989,11,19,63331
15079826@N00,952,20,1400811236,1400853215,4,19,41979
15079826@N00,952,23,1400824279,1400824289,2,19,10
15079826@N00,952,21,1400825194,1400825194,1,19,0
15079826@N00,952,19,1400805059,1400854004,11,19,48945
15079826@N00,952,2,1400798962,1400800074,6,19,1112
15079826@N00,952,6,1400802267,1400843658,9,19,41391
15079826@N00,952,10,1400806839,1400806839,1,19,0
15102029@N00,953,2,1276483656,1276493617,3,1,9961
15225068@N03,954,17,1292401083,1292401340,2,2,257
15225068@N03,954,16,1292401987,1292401987,1,2,0
15261067@N00,955,14,1401334040,1401334040,1,3,0
15261067@N00,955,25,1401344166,1401344166,1,3,0
15261067@N00,955,3,1401365388,1401365388,1,3,0
15261067@N00,956,3,1401451513,1401451513,1,1,0
15265115@N06,957,16,1359259328,1359270671,10,7,11343
15265115@N06,957,27,1359252220,1359270782,8,7,18562
15265115@N06,957,14,1359259916,1359259916,1,7,0
15265115@N06,957,17,1359253966,1359258892,7,7,4926
15265115@N06,957,18,1359257301,1359258633,4,7,1332
15265115@N06,957,13,1359257311,1359257311,1,7,0
15265115@N06,957,19,1359258157,1359258581,2,7,424
15268966@N00,958,16,1212816845,1212823094,2,1,6249
15268966@N00,959,12,1300359807,1300359807,1,1,0
15292348@N00,960,14,1200806033,1200809449,22,5,3416
15292348@N00,960,3,1200795562,1200795661,5,5,99
15292348@N00,960,16,1200797499,1200809480,2,5,11981
15292348@N00,960,4,1200795152,1200795175,3,5,23
15292348@N00,960,27,1200794537,1200794556,2,5,19
15406459@N00,961,14,1210460379,1210460415,4,4,36
15406459@N00,961,27,1210473976,1210473976,1,4,0
15406459@N00,961,11,1210471836,1210472024,7,4,188
15406459@N00,961,8,1210461553,1210461553,1,4,0
15406459@N00,962,11,1255771036,1255771036,1,1,0
15409357@N07,963,16,1393413281,1393413281,1,2,0
15409357@N07,963,12,1393408169,1393408169,1,2,0
15409357@N07,964,21,1393621699,1393621699,1,1,0
15409357@N07,965,3,1393681314,1393681314,1,1,0
15409357@N07,966,27,1393714426,1393714426,1,1,0
15409357@N07,967,27,1420018458,1420018458,1,1,0
15409357@N07,968,20,1420069356,1420069356,1,1,0
15409357@N07,969,20,1431698943,1431698943,1,1,0
15473418@N00,970,27,1212569995,1212569995,1,1,0
15473418@N00,971,16,1212667251,1212667913,14,2,662
15473418@N00,971,27,1212664013,1212668581,9,2,4568
15473418@N00,972,17,1212755860,1212759598,3,7,3738
15473418@N00,972,1,1212766220,1212766220,1,7,0
15473418@N00,972,14,1212753695,1212754280,13,7,585
15473418@N00,972,26,1212767219,1212767317,2,7,98
15473418@N00,972,16,1212767953,1212767953,1,7,0
15473418@N00,972,4,1212749701,1212750030,2,7,329
15473418@N00,972,6,1212759917,1212760011,3,7,94
15473418@N00,973,16,1212801628,1212804545,5,2,2917
15473418@N00,973,27,1212801297,1212801297,1,2,0
15473418@N00,974,16,1215831614,1215831617,2,1,3
15515205@N02,975,24,1226360576,1226360576,1,6,0
15515205@N02,975,12,1226364366,1226364366,1,6,0
15515205@N02,975,7,1226376319,1226376319,1,6,0
15515205@N02,975,21,1226360717,1226361424,2,6,707
15515205@N02,975,27,1226356999,1226356999,1,6,0
15515205@N02,975,19,1226358977,1226358977,1,6,0
15515205@N02,976,21,1226536380,1226536380,1,1,0
15515205@N02,977,16,1226568650,1226571073,7,1,2423
15525927@N04,978,17,1331085598,1331085598,1,2,0
15525927@N04,978,22,1331085602,1331085602,1,2,0
15530177@N05,979,27,1319057998,1319065108,10,4,7110
15530177@N05,979,6,1319063122,1319063165,6,4,43
15530177@N05,979,25,1319059279,1319062040,13,4,2761
15530177@N05,979,14,1319063370,1319064589,12,4,1219
15530177@N05,980,20,1319107586,1319111927,24,1,4341
15530177@N05,981,4,1319246399,1319246484,4,6,85
15530177@N05,981,26,1319243174,1319245095,3,6,1921
15530177@N05,981,19,1319239568,1319239907,10,6,339
15530177@N05,981,27,1319237535,1319239361,7,6,1826
15530177@N05,981,21,1319239958,1319243019,5,6,3061
15530177@N05,981,2,1319246614,1319247067,6,6,453
15531512@N00,982,7,1426636004,1426636004,1,3,0
15531512@N00,982,14,1426651839,1426651839,1,3,0
15531512@N00,982,17,1426643551,1426643551,1,3,0
15531512@N00,983,27,1426741888,1426741888,1,8,0
15531512@N00,983,4,1426760657,1426760669,2,8,12
15531512@N00,983,15,1426739667,1426739796,13,8,129
15531512@N00,983,12,1426739760,1426740135,29,8,375
15531512@N00,983,9,1426732226,1426758952,24,8,26726
15531512@N00,983,13,1426739979,1426740109,13,8,130
15531512@N00,983,10,1426735354,1426757733,15,8,22379
15531512@N00,983,23,1426723043,1426723716,3,8,673
15531512@N00,984,14,1426808214,1426808565,2,1,351
15531512@N00,985,9,1458766963,1458767009,2,1,46
15533594@N00,986,17,1296942058,1296942058,1,2,0
15533594@N00,986,27,1296943426,1296943426,1,2,0
15551876@N04,987,16,1376820257,1376820257,1,1,0
15605437@N08,988,17,1203602129,1203602187,5,1,58
15652554@N07,989,17,1224903267,1224945451,92,1,42184
15756745@N06,990,23,1271764525,1271764525,1,1,0
15790231@N02,991,27,1222294190,1222294190,1,1,0
15790231@N02,992,13,1222660902,1222662144,7,9,1242
15790231@N02,992,26,1222660502,1222660665,2,9,163
15790231@N02,992,23,1222668662,1222668800,2,9,138
15790231@N02,992,21,1222668068,1222671500,10,9,3432
15790231@N02,992,27,1222674848,1222675006,3,9,158
15790231@N02,992,3,1222656834,1222657503,3,9,669
15790231@N02,992,16,1222660341,1222660641,2,9,300
15790231@N02,992,4,1222654606,1222654614,2,9,8
15790231@N02,992,22,1222662482,1222672730,5,9,10248
15790231@N02,993,11,1222737584,1222763190,5,7,25606
15790231@N02,993,12,1222769445,1222769445,1,7,0
15790231@N02,993,17,1222726515,1222726534,2,7,19
15790231@N02,993,14,1222725890,1222774245,6,7,48355
15790231@N02,993,27,1222725521,1222725593,3,7,72
15790231@N02,993,16,1222725852,1222774974,23,7,49122
15790231@N02,993,8,1222763261,1222764152,14,7,891
15790231@N02,994,19,1253797408,1253797672,3,1,264
15802258@N04,995,21,1360371849,1360400079,43,1,28230
15802258@N04,996,27,1433561096,1433561096,1,1,0
15802258@N04,997,19,1446336451,1446338717,2,5,2266
15802258@N04,997,27,1446332173,1446332173,1,5,0
15802258@N04,997,3,1446357171,1446357171,1,5,0
15802258@N04,997,21,1446334567,1446334567,1,5,0
15802258@N04,997,12,1446351328,1446351328,1,5,0
15802258@N04,998,18,1452902397,1452902397,1,1,0
15823562@N00,999,14,1275977464,1275977464,1,1,0
15834837@N08,1000,10,1375703617,1375704697,7,1,1080
15834837@N08,1001,15,1375754852,1375754852,2,2,0
15834837@N08,1001,27,1375752110,1375752359,2,2,249
15834837@N08,1002,15,1376456364,1376456364,1,2,0
15834837@N08,1002,12,1376456376,1376456376,1,2,0
15834837@N08,1003,27,1381497473,1381497717,2,1,244
15931336@N05,1004,14,1229129450,1229129450,1,2,0
15931336@N05,1004,9,1229127796,1229127796,1,2,0
15954126@N00,1005,6,1298772004,1298772006,3,1,2
16035349@N05,1006,1,1234767563,1234767563,1,5,0
16035349@N05,1006,15,1234782044,1234782082,2,5,38
16035349@N05,1006,17,1234742249,1234742249,1,5,0
16035349@N05,1006,14,1234735684,1234740945,12,5,5261
16035349@N05,1006,16,1234735618,1234735618,1,5,0
16088786@N03,1007,9,1402813387,1402813387,1,5,0
16088786@N03,1007,16,1402825280,1402841329,4,5,16049
16088786@N03,1007,15,1402814878,1402842928,2,5,28050
16088786@N03,1007,14,1402826247,1402826247,1,5,0
16088786@N03,1007,11,1402816474,1402818556,8,5,2082
16088786@N03,1008,16,1403007076,1403007076,1,1,0
16088786@N03,1009,16,1403170369,1403170369,1,5,0
16088786@N03,1009,17,1403163276,1403163284,2,5,8
16088786@N03,1009,15,1403159439,1403159809,3,5,370
16088786@N03,1009,14,1403157862,1403157995,2,5,133
16088786@N03,1009,10,1403157042,1403157185,2,5,143
16088786@N03,1010,11,1403420741,1403420836,2,4,95
16088786@N03,1010,10,1403414378,1403414467,2,4,89
16088786@N03,1010,19,1403419763,1403419788,3,4,25
16088786@N03,1010,7,1403422512,1403422512,1,4,0
16088786@N03,1011,16,1403711359,1403716596,28,1,5237
16088786@N03,1012,15,1403765375,1403765666,3,1,291
16088786@N03,1013,27,1404521434,1404521434,1,3,0
16088786@N03,1013,16,1404521404,1404521445,4,3,41
16088786@N03,1013,19,1404521407,1404521442,2,3,35
16088786@N03,1014,20,1404729616,1404729917,2,1,301
16088786@N03,1015,16,1455537839,1455537839,1,1,0
16093042@N00,1016,23,1351654060,1351654060,1,5,0
16093042@N00,1016,17,1351633739,1351635428,3,5,1689
16093042@N00,1016,13,1351641188,1351641188,1,5,0
16093042@N00,1016,1,1351628675,1351628675,1,5,0
16093042@N00,1016,25,1351652799,1351652799,1,5,0
16137863@N00,1017,26,1345447897,1345447897,1,2,0
16137863@N00,1017,22,1345448071,1345448071,1,2,0
16272116@N03,1018,9,1207041796,1207041796,1,2,0
16272116@N03,1018,4,1207041798,1207041805,3,2,7
16355945@N00,1019,14,1323498773,1323498773,1,1,0
16355945@N00,1020,14,1351802690,1351802690,1,3,0
16355945@N00,1020,27,1351816198,1351816198,1,3,0
16355945@N00,1020,19,1351813118,1351813118,1,3,0
16355945@N00,1021,27,1397012161,1397012161,1,1,0
16429538@N00,1022,25,1246615130,1246615572,2,3,442
16429538@N00,1022,16,1246609691,1246610028,6,3,337
16429538@N00,1022,27,1246619751,1246619807,3,3,56
16429538@N00,1023,16,1246697858,1246697858,1,5,0
16429538@N00,1023,18,1246665535,1246665535,1,5,0
16429538@N00,1023,27,1246705173,1246705868,10,5,695
16429538@N00,1023,3,1246673185,1246673650,2,5,465
16429538@N00,1023,12,1246670126,1246670252,3,5,126
16429538@N00,1024,27,1246881826,1246882047,2,1,221
16429538@N00,1025,19,1247092571,1247093059,9,2,488
16429538@N00,1025,27,1247104770,1247106229,11,2,1459
16605470@N00,1026,16,1348571953,1348571953,1,1,0
16644192@N02,1027,16,1217685600,1217685600,4,1,0
16691514@N07,1028,26,1411542967,1411542967,1,1,0
16717012@N00,1029,27,1382533393,1382533393,1,1,0
16811913@N00,1030,1,1398218997,1398218997,1,1,0
16860181@N02,1031,16,1355477031,1355477031,1,1,0
16866921@N00,1032,16,1256347468,1256379058,7,3,31590
16866921@N00,1032,19,1256365100,1256365209,2,3,109
16866921@N00,1032,17,1256369341,1256371338,2,3,1997
16878544@N06,1033,8,1353193213,1353196408,7,6,3195
16878544@N06,1033,10,1353197340,1353197769,4,6,429
16878544@N06,1033,4,1353192006,1353192006,1,6,0
16878544@N06,1033,7,1353192784,1353196762,4,6,3978
16878544@N06,1033,3,1353191772,1353192118,3,6,346
16878544@N06,1033,11,1353195765,1353195841,7,6,76
16935127@N04,1034,20,1423354453,1423354453,1,1,0
16985502@N04,1035,22,1324099628,1324099628,1,1,0
16985502@N04,1036,27,1353759808,1353759808,1,1,0
16994861@N08,1037,15,1380959041,1380959568,2,4,527
16994861@N08,1037,11,1380961275,1380961528,5,4,253
16994861@N08,1037,14,1380960587,1380968307,21,4,7720
16994861@N08,1037,27,1380959511,1380959511,1,4,0
16994861@N08,1038,1,1381139873,1381139873,1,9,0
16994861@N08,1038,14,1381143068,1381144454,3,9,1386
16994861@N08,1038,22,1381116675,1381116675,1,9,0
16994861@N08,1038,19,1381113815,1381121562,7,9,7747
16994861@N08,1038,27,1381111403,1381152443,5,9,41040
16994861@N08,1038,26,1381111932,1381112320,4,9,388
16994861@N08,1038,16,1381118613,1381118725,6,9,112
16994861@N08,1038,18,1381117231,1381117276,2,9,45
16994861@N08,1038,24,1381115398,1381115483,2,9,85
17007166@N00,1039,27,1346716817,1346742880,8,1,26063
17007166@N00,1040,27,1347259693,1347259757,7,1,64
17007166@N00,1041,27,1348593876,1348594134,7,1,258
17017714@N04,1042,27,1284514234,1284514234,1,2,0
17017714@N04,1042,6,1284521497,1284521507,3,2,10
17057923@N06,1043,22,1311045780,1311045858,5,14,78
17057923@N06,1043,9,1311030339,1311035597,53,14,5258
17057923@N06,1043,3,1311034217,1311038906,15,14,4689
17057923@N06,1043,8,1311062290,1311066520,5,14,4230
17057923@N06,1043,27,1311028791,1311033093,11,14,4302
17057923@N06,1043,6,1311032848,1311039439,16,14,6591
17057923@N06,1043,18,1311046493,1311047422,5,14,929
17057923@N06,1043,13,1311053261,1311053384,3,14,123
17057923@N06,1043,21,1311041933,1311045401,4,14,3468
17057923@N06,1043,24,1311040881,1311044946,38,14,4065
17057923@N06,1043,17,1311055317,1311055317,1,14,0
17057923@N06,1043,4,1311038439,1311038439,1,14,0
17057923@N06,1043,14,1311060587,1311064061,4,14,3474
17057923@N06,1043,12,1311059078,1311061793,3,14,2715
17057923@N06,1044,22,1311411696,1311413776,7,7,2080
17057923@N06,1044,9,1311419344,1311419344,1,7,0
17057923@N06,1044,21,1311408831,1311410867,3,7,2036
17057923@N06,1044,27,1311406532,1311408056,26,7,1524
17057923@N06,1044,16,1311417209,1311417618,4,7,409
17057923@N06,1044,14,1311414213,1311416339,10,7,2126
17057923@N06,1044,5,1311418531,1311424517,86,7,5986
17057923@N06,1045,23,1311476097,1311479666,19,7,3569
17057923@N06,1045,9,1311458661,1311462957,29,7,4296
17057923@N06,1045,21,1311473266,1311473282,2,7,16
17057923@N06,1045,3,1311460706,1311464331,7,7,3625
17057923@N06,1045,27,1311454123,1311457593,8,7,3470
17057923@N06,1045,2,1311461031,1311464506,3,7,3475
17057923@N06,1045,1,1311464865,1311467735,4,7,2870
17062172@N00,1046,16,1216086903,1216086903,1,1,0
17099253@N00,1047,5,1350094222,1350094222,1,8,0
17099253@N00,1047,14,1350107663,1350109188,2,8,1525
17099253@N00,1047,13,1350104795,1350105541,3,8,746
17099253@N00,1047,3,1350095048,1350095048,1,8,0
17099253@N00,1047,2,1350095040,1350126582,5,8,31542
17099253@N00,1047,17,1350091017,1350091243,2,8,226
17099253@N00,1047,15,1350109155,1350109175,3,8,20
17099253@N00,1047,27,1350091042,1350091042,1,8,0
17099253@N00,1048,27,1350213704,1350213704,1,1,0
17099253@N00,1049,1,1350284106,1350284106,1,6,0
17099253@N00,1049,17,1350292790,1350293371,4,6,581
17099253@N00,1049,20,1350297001,1350297001,1,6,0
17099253@N00,1049,13,1350286132,1350286132,1,6,0
17099253@N00,1049,19,1350294410,1350294410,1,6,0
17099253@N00,1049,2,1350283004,1350283004,1,6,0
17099253@N00,1050,9,1350780244,1350780244,1,2,0
17099253@N00,1050,17,1350780090,1350780090,1,2,0
17145135@N00,1051,23,1318479090,1318479090,1,6,0
17145135@N00,1051,13,1318493427,1318493427,1,6,0
17145135@N00,1051,27,1318477492,1318477492,1,6,0
17145135@N00,1051,3,1318487215,1318487215,1,6,0
17145135@N00,1051,6,1318490410,1318490410,1,6,0
17145135@N00,1051,17,1318484201,1318484201,1,6,0
17145135@N00,1052,18,1330469880,1330469880,1,14,0
17145135@N00,1052,2,1330453697,1330454868,2,14,1171
17145135@N00,1052,21,1330462407,1330462407,1,14,0
17145135@N00,1052,14,1330531275,1330531275,1,14,0
17145135@N00,1052,25,1330460096,1330460096,1,14,0
17145135@N00,1052,4,1330490830,1330490830,1,14,0
17145135@N00,1052,20,1330462960,1330462960,1,14,0
17145135@N00,1052,1,1330483804,1330483804,1,14,0
17145135@N00,1052,3,1330480439,1330483347,2,14,2908
17145135@N00,1052,6,1330518679,1330518679,1,14,0
17145135@N00,1052,27,1330453403,1330536006,3,14,82603
17145135@N00,1052,9,1330532189,1330532189,1,14,0
17145135@N00,1052,17,1330492324,1330492324,1,14,0
17145135@N00,1052,15,1330459633,1330459633,1,14,0
17221206@N00,1053,15,1336050615,1336050615,1,1,0
17299643@N00,1054,18,1301976267,1301985680,3,12,9413
17299643@N00,1054,27,1301969644,1301969860,5,12,216
17299643@N00,1054,25,1301970410,1301970410,1,12,0
17299643@N00,1054,13,1301985839,1301985839,1,12,0
17299643@N00,1054,9,1301992267,1301992267,1,12,0
17299643@N00,1054,20,1301975221,1301976311,5,12,1090
17299643@N00,1054,21,1301972943,1301972971,5,12,28
17299643@N00,1054,6,1301996531,1301996531,1,12,0
17299643@N00,1054,22,1301971199,1301981538,21,12,10339
17299643@N00,1054,23,1301970555,1301970961,2,12,406
17299643@N00,1054,17,1301988954,1301988954,1,12,0
17299643@N00,1054,14,1301990726,1301991809,3,12,1083
17367211@N00,1055,21,1217806512,1217806512,1,4,0
17367211@N00,1055,22,1217812185,1217812185,1,4,0
17367211@N00,1055,11,1217815596,1217836471,2,4,20875
17367211@N00,1055,23,1217806953,1217806953,1,4,0
17419748@N03,1056,14,1305363766,1305363766,1,1,0
17424601@N00,1057,17,1417580287,1417580287,1,4,0
17424601@N00,1057,22,1417603146,1417603146,1,4,0
17424601@N00,1057,4,1417566573,1417566573,1,4,0
17424601@N00,1057,19,1417583786,1417583786,1,4,0
17567960@N00,1058,27,1322694204,1322694231,2,3,27
17567960@N00,1058,17,1322702986,1322703204,4,3,218
17567960@N00,1058,3,1322695907,1322695907,1,3,0
17599044@N08,1059,22,1220324526,1220324526,1,2,0
17599044@N08,1059,16,1220332875,1220332875,1,2,0
17599044@N08,1060,16,1220444002,1220444002,1,1,0
17599044@N08,1061,16,1262040953,1262040953,1,1,0
17620798@N08,1062,16,1279536791,1279536791,1,1,0
17657655@N00,1063,27,1193198483,1193198483,1,1,0
17657655@N00,1064,17,1234163343,1234163343,1,1,0
17657655@N00,1065,27,1308229368,1308229368,1,1,0
17671095@N04,1066,17,1243427156,1243432867,3,2,5711
17671095@N04,1066,26,1243433060,1243433060,1,2,0
17725987@N00,1067,9,1353072450,1353072450,1,1,0
17725987@N00,1068,14,1386887435,1386887435,1,1,0
17725987@N00,1069,27,1400105872,1400109097,2,1,3225
17754571@N02,1070,16,1352961215,1352961215,1,4,0
17754571@N02,1070,14,1352930353,1352930353,1,4,0
17754571@N02,1070,13,1352936493,1352936493,1,4,0
17754571@N02,1070,19,1352932113,1352932113,1,4,0
17804775@N00,1071,16,1192782601,1192782601,1,1,0
17864008@N00,1072,17,1192833353,1192863475,3,1,30122
17963840@N07,1073,23,1337013239,1337013239,1,1,0
17982436@N03,1074,25,1319150574,1319150574,1,1,0
18081271@N00,1075,27,1324413980,1324413980,1,2,0
18081271@N00,1075,18,1324422427,1324422427,1,2,0
18081271@N00,1076,17,1324601840,1324601840,1,2,0
18081271@N00,1076,27,1324600323,1324600323,1,2,0
18097936@N00,1077,17,1330428981,1330455833,71,1,26852
18097936@N00,1078,17,1331006594,1331007507,2,1,913
18214853@N00,1079,8,1345954138,1345954138,1,3,0
18214853@N00,1079,22,1345940959,1345940959,1,3,0
18214853@N00,1079,4,1345949946,1345949946,1,3,0
18291524@N00,1080,16,1291850748,1291850789,2,2,41
18291524@N00,1080,18,1291851515,1291851901,2,2,386
18291524@N00,1081,16,1292059232,1292059232,1,1,0
18307147@N00,1082,1,1293079600,1293079600,1,8,0
18307147@N00,1082,13,1293076393,1293076393,1,8,0
18307147@N00,1082,19,1293072788,1293072788,1,8,0
18307147@N00,1082,27,1293067347,1293067598,5,8,251
18307147@N00,1082,17,1293078421,1293078421,1,8,0
18307147@N00,1082,18,1293076430,1293076739,3,8,309
18307147@N00,1082,16,1293074590,1293074598,2,8,8
18307147@N00,1082,25,1293069903,1293070095,4,8,192
18307147@N00,1083,27,1387782768,1387783036,6,7,268
18307147@N00,1083,17,1387781320,1387781320,1,7,0
18307147@N00,1083,10,1387761201,1387761201,1,7,0
18307147@N00,1083,8,1387762401,1387767443,3,7,5042
18307147@N00,1083,16,1387753929,1387754900,11,7,971
18307147@N00,1083,11,1387769774,1387769861,6,7,87
18307147@N00,1083,15,1387757130,1387757447,4,7,317
18334814@N00,1084,9,1461039757,1461039757,1,2,0
18334814@N00,1084,6,1461042766,1461042766,1,2,0
18384077@N00,1085,14,1381901011,1381901011,1,1,0
18425733@N00,1086,16,1399989616,1399989616,1,1,0
18581554@N04,1087,27,1304420547,1304420766,3,1,219
18647653@N08,1088,11,1208671357,1208671357,1,1,0
18647653@N08,1089,4,1376961421,1376961421,1,1,0
18748204@N00,1090,23,1400986257,1400986257,1,8,0
18748204@N00,1090,20,1400989583,1400994668,4,8,5085
18748204@N00,1090,22,1400994706,1400994876,8,8,170
18748204@N00,1090,1,1401003180,1401003719,4,8,539
18748204@N00,1090,2,1400998763,1401003038,7,8,4275
18748204@N00,1090,3,1400999232,1400999232,1,8,0
18748204@N00,1090,17,1400996625,1400996631,2,8,6
18748204@N00,1090,27,1400982388,1401004407,7,8,22019
18748204@N00,1091,7,1401523894,1401524080,3,5,186
18748204@N00,1091,14,1401516047,1401516047,1,5,0
18748204@N00,1091,6,1401511522,1401512475,5,5,953
18748204@N00,1091,9,1401510714,1401511500,8,5,786
18748204@N00,1091,8,1401524268,1401524903,4,5,635
18862724@N00,1092,2,1338866033,1338866033,1,1,0
19017254@N03,1093,17,1394429833,1394429833,1,1,0
19026178@N00,1094,4,1194823542,1194823542,1,13,0
19026178@N00,1094,26,1194834490,1194834623,4,13,133
19026178@N00,1094,12,1194837512,1194837512,1,13,0
19026178@N00,1094,14,1194839660,1194839726,2,13,66
19026178@N00,1094,6,1194823930,1194823930,1,13,0
19026178@N00,1094,17,1194834747,1194834747,1,13,0
19026178@N00,1094,3,1194823597,1194825623,9,13,2026
19026178@N00,1094,23,1194830555,1194830555,1,13,0
19026178@N00,1094,16,1194839792,1194839826,3,13,34
19026178@N00,1094,21,1194831844,1194831900,2,13,56
19026178@N00,1094,27,1194821199,1194842176,24,13,20977
19026178@N00,1094,9,1194860268,1194861398,2,13,1130
19026178@N00,1094,22,1194833261,1194833624,2,13,363
19026178@N00,1095,23,1195009276,1195010421,2,5,1145
19026178@N00,1095,26,1195010322,1195010322,1,5,0
19026178@N00,1095,17,1194997609,1195008814,3,5,11205
19026178@N00,1095,25,1195008492,1195008492,1,5,0
19026178@N00,1095,27,1194988321,1195010982,17,5,22661
19118140@N04,1096,4,1228540268,1228540268,1,4,0
19118140@N04,1096,15,1228532990,1228532990,1,4,0
19118140@N04,1096,16,1228547625,1228547627,2,4,2
19118140@N04,1096,5,1228543153,1228543153,1,4,0
19262297@N03,1097,22,1286953951,1286954033,2,1,82
19344501@N00,1098,25,1276470358,1276470358,1,3,0
19344501@N00,1098,27,1276467903,1276497620,2,3,29717
19344501@N00,1098,3,1276489789,1276489789,1,3,0
19358630@N00,1099,27,1321996746,1322001919,24,1,5173
19555551@N00,1100,17,1198029855,1198029855,1,9,0
19555551@N00,1100,24,1198041371,1198041371,1,9,0
19555551@N00,1100,13,1198028188,1198033359,2,9,5171
19555551@N00,1100,19,1198033755,1198040455,2,9,6700
19555551@N00,1100,27,1198019786,1198043580,3,9,23794
19555551@N00,1100,21,1198034017,1198036220,2,9,2203
19555551@N00,1100,16,1198020570,1198057864,7,9,37294
19555551@N00,1100,12,1198026949,1198026949,1,9,0
19555551@N00,1100,4,1198020646,1198020646,1,9,0
19555551@N00,1101,14,1277097569,1277109014,2,3,11445
19555551@N00,1101,16,1277097580,1277097580,1,3,0
19555551@N00,1101,13,1277109925,1277109925,1,3,0
19555551@N00,1102,21,1277353491,1277354228,4,1,737
19585456@N00,1103,27,1323339207,1323340580,2,1,1373
19594436@N00,1104,14,1242643641,1242644071,4,1,430
19594436@N00,1105,14,1242773564,1242790589,46,1,17025
19609393@N03,1106,13,1303293924,1303293924,1,5,0
19609393@N03,1106,17,1303273478,1303273478,1,5,0
19609393@N03,1106,24,1303267393,1303267405,2,5,12
19609393@N03,1106,12,1303293821,1303293866,2,5,45
19609393@N03,1106,14,1303267796,1303267796,1,5,0
19682872@N00,1107,27,1451253453,1451300465,30,1,47012
19682872@N00,1108,27,1451514324,1451524491,15,1,10167
19709423@N04,1109,27,1278871265,1278872439,6,1,1174
19709423@N04,1110,14,1279048194,1279048194,1,8,0
19709423@N04,1110,27,1279047028,1279063342,2,8,16314
19709423@N04,1110,24,1279061481,1279061481,1,8,0
19709423@N04,1110,5,1279057719,1279057729,2,8,10
19709423@N04,1110,2,1279056639,1279058398,23,8,1759
19709423@N04,1110,23,1279059484,1279059791,7,8,307
19709423@N04,1110,4,1279052383,1279055798,11,8,3415
19709423@N04,1110,1,1279056822,1279056869,4,8,47
19709423@N04,1111,7,1285133666,1285133679,3,5,13
19709423@N04,1111,20,1285141492,1285141499,2,5,7
19709423@N04,1111,18,1285141696,1285141696,1,5,0
19709423@N04,1111,14,1285134490,1285135388,23,5,898
19709423@N04,1111,9,1285133853,1285133875,4,5,22
19731939@N00,1112,27,1400304926,1400304926,1,2,0
19731939@N00,1112,4,1400329346,1400329346,1,2,0
19762975@N06,1113,16,1329865874,1329865874,1,1,0
19762975@N06,1114,27,1330043696,1330044573,2,1,877
19763323@N00,1115,4,1285568721,1285568721,1,1,0
19787790@N08,1116,6,1369181024,1369181029,2,1,5
19860395@N08,1117,21,1372828556,1372828556,1,1,0
19887807@N00,1118,16,1329547070,1329547070,1,1,0
19932288@N00,1119,27,1225877998,1225892557,15,1,14559
19936517@N07,1120,27,1385897317,1385897317,1,1,0
19944325@N00,1121,4,1463120610,1463120610,1,2,0
19944325@N00,1121,17,1463128705,1463128705,1,2,0
19951106@N03,1122,3,1319935668,1319935668,1,4,0
19951106@N03,1122,2,1319937685,1319953924,4,4,16239
19951106@N03,1122,6,1319941870,1319941870,1,4,0
19951106@N03,1122,16,1319955571,1319955571,1,4,0
19951106@N03,1123,6,1320059362,1320059362,1,2,0
19951106@N03,1123,27,1320041798,1320063434,6,2,21636
19988671@N00,1124,4,1284390133,1284390133,1,1,0
20008009@N05,1125,21,1430708240,1430708240,1,1,0
20035490@N00,1126,15,1355802734,1355802734,1,1,0
20154444@N04,1127,27,1255658097,1255658097,1,1,0
20154444@N04,1128,16,1261045739,1261045739,1,1,0
20154444@N04,1129,3,1265772891,1265772891,1,1,0
20154444@N04,1130,13,1272695904,1272695904,1,1,0
20154444@N04,1131,17,1307931132,1307931132,1,1,0
20154444@N04,1132,13,1372989326,1372989326,1,1,0
20154444@N04,1133,13,1437705875,1437705875,1,1,0
20154444@N04,1134,10,1437738990,1437738990,1,1,0
20154444@N04,1135,14,1469355100,1469355100,1,1,0
20164875@N03,1136,14,1249481397,1249481397,1,1,0
20184646@N04,1137,6,1317180752,1317180752,1,4,0
20184646@N04,1137,13,1317171334,1317172471,3,4,1137
20184646@N04,1137,9,1317181187,1317184355,11,4,3168
20184646@N04,1137,20,1317186479,1317187576,9,4,1097
20184646@N04,1138,27,1317289763,1317289763,1,1,0
20196064@N00,1139,14,1349676129,1349676129,1,2,0
20196064@N00,1139,16,1349679567,1349679567,1,2,0
20229609@N03,1140,7,1341273523,1341274679,14,8,1156
20229609@N03,1140,20,1341271282,1341271282,1,8,0
20229609@N03,1140,6,1341304917,1341304917,1,8,0
20229609@N03,1140,27,1341270400,1341303637,4,8,33237
20229609@N03,1140,22,1341270917,1341270917,1,8,0
20229609@N03,1140,4,1341304137,1341304169,3,8,32
20229609@N03,1140,14,1341315285,1341324063,12,8,8778
20229609@N03,1140,8,1341280364,1341280422,2,8,58
20229609@N03,1141,7,1341445705,1341445705,1,5,0
20229609@N03,1141,27,1341444480,1341463405,16,5,18925
20229609@N03,1141,12,1341454293,1341455667,13,5,1374
20229609@N03,1141,17,1341453352,1341461265,2,5,7913
20229609@N03,1141,9,1341458436,1341459724,6,5,1288
20279868@N06,1142,27,1344746691,1344746691,1,1,0
20287222@N00,1143,26,1289773395,1289773395,1,2,0
20287222@N00,1143,6,1289770787,1289770787,1,2,0
20322483@N05,1144,16,1198792307,1198792307,1,2,0
20322483@N05,1144,12,1198794819,1198794819,1,2,0
20322483@N05,1145,3,1198962059,1198962059,1,1,0
20322483@N05,1146,16,1199056529,1199056529,1,5,0
20322483@N05,1146,9,1199008436,1199008436,1,5,0
20322483@N05,1146,25,1199009734,1199039483,2,5,29749
20322483@N05,1146,24,1199010028,1199011809,2,5,1781
20322483@N05,1146,13,1198998079,1198998086,2,5,7
20322483@N05,1147,12,1199086216,1199086216,1,1,0
20322483@N05,1148,1,1201702813,1201702813,1,1,0
20322483@N05,1149,27,1204262015,1204262015,1,1,0
20322483@N05,1150,17,1204341332,1204341332,1,2,0
20322483@N05,1150,24,1204339378,1204339378,1,2,0
20322483@N05,1151,25,1204421701,1204421701,1,1,0
20322483@N05,1152,13,1218421210,1218421210,1,3,0
20322483@N05,1152,25,1218419880,1218420241,2,3,361
20322483@N05,1152,5,1218422993,1218422993,1,3,0
20322483@N05,1153,3,1218582266,1218595028,4,2,12762
20322483@N05,1153,1,1218589612,1218589612,1,2,0
20322483@N05,1154,2,1218714940,1218714974,3,6,34
20322483@N05,1154,21,1218680932,1218680932,1,6,0
20322483@N05,1154,19,1218685065,1218685065,1,6,0
20322483@N05,1154,4,1218691149,1218691149,1,6,0
20322483@N05,1154,27,1218679663,1218709894,3,6,30231
20322483@N05,1154,8,1218703265,1218703265,1,6,0
20322483@N05,1155,20,1225406934,1225406934,1,2,0
20322483@N05,1155,27,1225405231,1225409601,2,2,4370
20322483@N05,1156,6,1225492372,1225492372,1,3,0
20322483@N05,1156,13,1225490227,1225490341,2,3,114
20322483@N05,1156,27,1225503656,1225503656,1,3,0
20322483@N05,1157,17,1225586922,1225586922,1,3,0
20322483@N05,1157,24,1225591155,1225591155,1,3,0
20322483@N05,1157,27,1225591699,1225591699,1,3,0
20494010@N00,1158,15,1414394891,1414394891,1,1,0
20544000@N00,1159,14,1363008193,1363008193,1,1,0
20544000@N00,1160,13,1367425210,1367425210,1,1,0
20544648@N06,1161,19,1285298156,1285298214,2,8,58
20544648@N06,1161,17,1285297783,1285297783,1,8,0
20544648@N06,1161,20,1285298104,1285298104,1,8,0
20544648@N06,1161,16,1285298373,1285298373,1,8,0
20544648@N06,1161,18,1285298248,1285298248,1,8,0
20544648@N06,1161,27,1285297101,1285297101,1,8,0
20544648@N06,1161,22,1285297924,1285298018,3,8,94
20544648@N06,1161,25,1285298289,1285298289,1,8,0
20544648@N06,1162,12,1285577075,1285577075,1,5,0
20544648@N06,1162,16,1285576268,1285576839,3,5,571
20544648@N06,1162,14,1285576910,1285577318,2,5,408
20544648@N06,1162,27,1285577547,1285578367,8,5,820
20544648@N06,1162,6,1285577351,1285577504,3,5,153
20635459@N00,1163,14,1352457701,1352457701,1,1,0
20635459@N00,1164,23,1352703852,1352703852,1,1,0
20644717@N00,1165,4,1397217017,1397217021,2,2,4
20644717@N00,1165,2,1397217145,1397217195,4,2,50
20675126@N00,1166,6,1335744688,1335744688,1,10,0
20675126@N00,1166,9,1335742496,1335743684,6,10,1188
20675126@N00,1166,4,1335771534,1335771588,4,10,54
20675126@N00,1166,23,1335775542,1335775604,2,10,62
20675126@N00,1166,20,1335758110,1335758392,2,10,282
20675126@N00,1166,8,1335745182,1335745182,1,10,0
20675126@N00,1166,5,1335742950,1335743042,3,10,92
20675126@N00,1166,14,1335742258,1335742258,1,10,0
20675126@N00,1166,27,1335770924,1335770924,1,10,0
20675126@N00,1166,22,1335757294,1335757412,2,10,118
20675126@N00,1167,9,1335834242,1335834242,1,6,0
20675126@N00,1167,6,1335832106,1335852390,5,6,20284
20675126@N00,1167,7,1335834928,1335834928,1,6,0
20675126@N00,1167,18,1335841348,1335841348,1,6,0
20675126@N00,1167,27,1335829750,1335830032,4,6,282
20675126@N00,1167,26,1335841352,1335841412,4,6,60
20675126@N00,1168,16,1349577218,1349577218,1,2,0
20675126@N00,1168,27,1349574947,1349574947,1,2,0
20677928@N06,1169,8,1236807754,1236808108,2,8,354
20677928@N06,1169,17,1236797887,1236797887,1,8,0
20677928@N06,1169,27,1236779094,1236779100,2,8,6
20677928@N06,1169,25,1236777645,1236810544,9,8,32899
20677928@N06,1169,16,1236781030,1236781030,1,8,0
20677928@N06,1169,14,1236803524,1236803545,2,8,21
20677928@N06,1169,23,1236791258,1236791412,2,8,154
20677928@N06,1169,26,1236785873,1236785873,1,8,0
20677928@N06,1170,25,1236869272,1236901457,5,1,32185
20677928@N06,1171,14,1237249701,1237249701,1,3,0
20677928@N06,1171,27,1237214976,1237214976,1,3,0
20677928@N06,1171,25,1237233166,1237233166,1,3,0
20677928@N06,1172,27,1237527191,1237527191,1,1,0
20677928@N06,1173,21,1237594187,1237594187,1,3,0
20677928@N06,1173,23,1237599869,1237599869,1,3,0
20677928@N06,1173,27,1237589757,1237589757,1,3,0
20677928@N06,1174,14,1237659922,1237659922,1,6,0
20677928@N06,1174,6,1237670655,1237670655,1,6,0
20677928@N06,1174,17,1237652946,1237652946,1,6,0
20677928@N06,1174,23,1237646151,1237646151,1,6,0
20677928@N06,1174,9,1237669479,1237669479,1,6,0
20677928@N06,1174,25,1237631032,1237643802,7,6,12770
20677928@N06,1175,25,1237725132,1237736259,3,1,11127
20677928@N06,1176,23,1238103175,1238103193,2,3,18
20677928@N06,1176,27,1238070360,1238071186,4,3,826
20677928@N06,1176,25,1238081860,1238081860,1,3,0
20677928@N06,1177,25,1238294788,1238294788,1,1,0
20701570@N00,1178,1,1319074100,1319074100,1,1,0
20701570@N00,1179,22,1348912665,1348912665,2,1,0
20701570@N00,1180,27,1349071358,1349071358,1,2,0
20701570@N00,1180,20,1349060072,1349060072,1,2,0
20701570@N00,1181,10,1379844540,1379844540,1,1,0
20701570@N00,1182,18,1402198607,1402198607,1,6,0
20701570@N00,1182,2,1402198610,1402198610,1,6,0
20701570@N00,1182,22,1402198607,1402198607,1,6,0
20701570@N00,1182,14,1402198651,1402198651,1,6,0
20701570@N00,1182,4,1402198610,1402198610,1,6,0
20701570@N00,1182,21,1402198604,1402198604,1,6,0
20704576@N04,1183,22,1197970718,1197971268,2,2,550
20704576@N04,1183,27,1197982382,1197982382,1,2,0
20715134@N00,1184,26,1237760602,1237760602,1,5,0
20715134@N00,1184,16,1237761014,1237761014,1,5,0
20715134@N00,1184,5,1237761257,1237761257,1,5,0
20715134@N00,1184,24,1237784147,1237784147,1,5,0
20715134@N00,1184,13,1237779129,1237779129,1,5,0
20719638@N00,1185,27,1206741433,1206744102,4,2,2669
20719638@N00,1185,4,1206742132,1206742132,1,2,0
20727999@N06,1186,13,1304900001,1304906775,2,10,6774
20727999@N06,1186,4,1304893673,1304942647,4,10,48974
20727999@N06,1186,20,1304906930,1304907924,2,10,994
20727999@N06,1186,21,1304898195,1304908203,2,10,10008
20727999@N06,1186,22,1304908181,1304908181,1,10,0
20727999@N06,1186,26,1304896306,1304928306,2,10,32000
20727999@N06,1186,16,1304895997,1304935300,6,10,39303
20727999@N06,1186,19,1304907601,1304907675,3,10,74
20727999@N06,1186,14,1304928653,1304928653,1,10,0
20727999@N06,1186,17,1304906687,1304906687,1,10,0
20727999@N06,1187,9,1429347122,1429347122,1,5,0
20727999@N06,1187,13,1429351215,1429351215,1,5,0
20727999@N06,1187,27,1429333395,1429333395,1,5,0
20727999@N06,1187,21,1429340596,1429340596,1,5,0
20727999@N06,1187,14,1429347690,1429347859,2,5,169
20727999@N06,1188,9,1429692009,1429692009,1,4,0
20727999@N06,1188,10,1429691531,1429691727,4,4,196
20727999@N06,1188,12,1429699689,1429699689,1,4,0
20727999@N06,1188,14,1429692515,1429692745,2,4,230
20741443@N00,1189,1,1272611971,1272611971,1,2,0
20741443@N00,1189,27,1272618752,1272618752,1,2,0
20761691@N00,1190,2,1368091791,1368091791,1,1,0
20771338@N00,1191,27,1222147462,1222158463,94,1,11001
20835167@N00,1192,16,1298799890,1298802168,2,1,2278
20885794@N00,1193,14,1467528505,1467528505,1,2,0
20885794@N00,1193,7,1467529664,1467529664,1,2,0
20895877@N04,1194,22,1194572574,1194605495,16,1,32921
20895877@N04,1195,22,1198838482,1198840450,46,1,1968
20895877@N04,1196,22,1212811618,1212849867,74,1,38249
20895877@N04,1197,22,1218347062,1218350913,9,1,3851
20895877@N04,1198,22,1245420000,1245420071,72,1,71
20895877@N04,1199,22,1265979600,1265979600,1,1,0
20895877@N04,1200,22,1267850168,1267883261,19,1,33093
20895877@N04,1201,22,1267995839,1267995874,3,1,35
20895877@N04,1202,22,1268637935,1268637935,1,1,0
20911185@N07,1203,16,1428652377,1428652377,1,1,0
20925955@N03,1204,27,1208775385,1208775385,1,1,0
20962532@N05,1205,17,1258870834,1258870834,1,1,0
20962532@N05,1206,17,1259150457,1259150457,1,1,0
21030940@N06,1207,10,1395960650,1395960651,2,5,1
21030940@N06,1207,14,1395959407,1395959507,6,5,100
21030940@N06,1207,27,1395955682,1395955684,2,5,2
21030940@N06,1207,9,1395960591,1395960591,1,5,0
21030940@N06,1207,25,1395967629,1395967641,3,5,12
21030940@N06,1208,10,1396081439,1396081465,6,5,26
21030940@N06,1208,7,1396080156,1396080183,4,5,27
21030940@N06,1208,9,1396049902,1396049909,4,5,7
21030940@N06,1208,25,1396071476,1396071481,3,5,5
21030940@N06,1208,2,1396060899,1396060913,4,5,14
21038859@N08,1209,26,1209625799,1209625918,2,1,119
21038859@N08,1210,16,1210034954,1210034954,1,1,0
21068473@N06,1211,16,1408875740,1408877209,2,1,1469
21122985@N02,1212,21,1202085726,1202085726,1,1,0
21122985@N02,1213,21,1360038251,1360038290,11,1,39
21122985@N02,1214,21,1360748356,1360748421,15,1,65
21122985@N02,1215,21,1382570747,1382571091,9,1,344
21122985@N02,1216,21,1399687868,1399687893,16,1,25
21134819@N00,1217,27,1259020762,1259020762,1,1,0
21138471@N00,1218,3,1224803363,1224803369,2,1,6
21138471@N00,1219,27,1224914093,1224914146,2,1,53
21138471@N00,1220,1,1224970695,1224970695,1,2,0
21138471@N00,1220,7,1224973616,1224973616,1,2,0
21138471@N00,1221,17,1348272493,1348272493,1,2,0
21138471@N00,1221,27,1348285423,1348285423,1,2,0
21143202@N08,1222,17,1262611446,1262611446,1,1,0
21143202@N08,1223,15,1276177820,1276177820,1,1,0
21151445@N02,1224,5,1460614133,1460614133,1,7,0
21151445@N02,1224,4,1460613870,1460613870,1,7,0
21151445@N02,1224,15,1460599033,1460599048,2,7,15
21151445@N02,1224,22,1460613081,1460613167,2,7,86
21151445@N02,1224,19,1460607181,1460608302,8,7,1121
21151445@N02,1224,8,1460617197,1460617371,3,7,174
21151445@N02,1224,20,1460610874,1460611186,4,7,312
21159284@N08,1225,8,1447569812,1447569815,2,5,3
21159284@N08,1225,17,1447573089,1447573091,2,5,2
21159284@N08,1225,7,1447569636,1447569648,3,5,12
21159284@N08,1225,10,1447566710,1447566710,1,5,0
21159284@N08,1225,14,1447570378,1447570436,2,5,58
21212744@N07,1226,16,1199145747,1199145747,1,2,0
21212744@N07,1226,27,1199144048,1199145604,8,2,1556
21242740@N00,1227,4,1263626655,1263628938,4,1,2283
21242740@N00,1228,4,1263714159,1263719880,2,1,5721
21242740@N00,1229,4,1266656870,1266663200,5,1,6330
21254904@N02,1230,4,1219715784,1219715784,1,1,0
21299180@N02,1231,3,1364100627,1364100627,1,1,0
21301462@N02,1232,16,1311429653,1311430108,11,2,455
21301462@N02,1232,27,1311422415,1311423121,10,2,706
21301462@N02,1233,21,1311651038,1311651607,2,2,569
21301462@N02,1233,13,1311646474,1311646956,5,2,482
21328392@N06,1234,4,1311315492,1311315492,1,9,0
21328392@N06,1234,27,1311289729,1311343268,3,9,53539
21328392@N06,1234,5,1311314817,1311314817,1,9,0
21328392@N06,1234,23,1311302800,1311302800,1,9,0
21328392@N06,1234,24,1311306060,1311306060,1,9,0
21328392@N06,1234,18,1311319995,1311320187,3,9,192
21328392@N06,1234,19,1311320363,1311320363,1,9,0
21328392@N06,1234,17,1311299195,1311301057,2,9,1862
21328392@N06,1234,26,1311297474,1311297602,2,9,128
21329192@N06,1235,16,1249189837,1249189837,1,1,0
21361334@N02,1236,16,1255006288,1255006288,1,1,0
21369373@N00,1237,17,1353741304,1353741304,1,2,0
21369373@N00,1237,25,1353741279,1353741279,1,2,0
21377282@N00,1238,20,1220835053,1220835053,1,1,0
21383026@N06,1239,14,1244265299,1244265299,1,1,0
21383026@N06,1240,27,1248601371,1248601371,1,2,0
21383026@N06,1240,11,1248595709,1248595709,1,2,0
21383026@N06,1241,11,1249044933,1249044964,5,1,31
21383026@N06,1242,11,1249184747,1249184747,1,1,0
21383026@N06,1243,11,1249819070,1249822592,5,1,3522
21383026@N06,1244,11,1249898324,1249908346,2,1,10022
21383026@N06,1245,11,1250423300,1250423305,2,1,5
21383026@N06,1246,18,1251017759,1251017759,1,1,0
21383026@N06,1247,21,1255598280,1255598280,1,1,0
21383026@N06,1248,9,1256036914,1256036914,1,1,0
21383026@N06,1249,26,1257395711,1257395711,1,1,0
21383026@N06,1250,16,1259205792,1259206376,5,1,584
21383026@N06,1251,14,1259746524,1259746524,1,1,0
21383026@N06,1252,14,1260335154,1260335251,2,1,97
21383026@N06,1253,9,1262047142,1262047142,1,1,0
21383026@N06,1254,17,1281845057,1281845057,1,1,0
21383026@N06,1255,11,1283748763,1283748763,1,1,0
21383026@N06,1256,11,1284607764,1284607764,1,1,0
21383026@N06,1257,27,1286672243,1286672243,1,1,0
21383026@N06,1258,27,1287468291,1287468291,1,1,0
21383026@N06,1259,11,1289042501,1289042655,3,1,154
21383026@N06,1260,17,1289121663,1289122035,2,1,372
21383026@N06,1261,11,1289455692,1289455692,1,1,0
21383026@N06,1262,27,1292384984,1292394790,9,1,9806
21383026@N06,1263,11,1293853485,1293853485,1,1,0
21383026@N06,1264,9,1294195272,1294195272,1,1,0
21383026@N06,1265,14,1295310485,1295310485,1,1,0
21383026@N06,1266,9,1296546741,1296547170,2,1,429
21383026@N06,1267,8,1297328938,1297328938,1,1,0
21383026@N06,1268,26,1297571320,1297571324,2,2,4
21383026@N06,1268,27,1297569894,1297570204,2,2,310
21383026@N06,1269,27,1298779541,1298779541,1,1,0
21383026@N06,1270,9,1299636096,1299636144,3,1,48
21383026@N06,1271,26,1300416800,1300416800,1,1,0
21383026@N06,1272,21,1301111421,1301111421,1,3,0
21383026@N06,1272,25,1301109933,1301109933,1,3,0
21383026@N06,1272,9,1301122400,1301122402,2,3,2
21383026@N06,1273,16,1302528542,1302528542,1,2,0
21383026@N06,1273,25,1302516039,1302516039,1,2,0
21383026@N06,1274,16,1302669945,1302701425,16,1,31480
21383026@N06,1275,14,1305196315,1305196315,1,2,0
21383026@N06,1275,9,1305197905,1305197905,1,2,0
21383026@N06,1276,16,1305602414,1305603053,10,8,639
21383026@N06,1276,14,1305606067,1305606067,1,8,0
21383026@N06,1276,21,1305611612,1305611612,1,8,0
21383026@N06,1276,27,1305623192,1305623192,1,8,0
21383026@N06,1276,9,1305617645,1305617655,4,8,10
21383026@N06,1276,18,1305629264,1305629264,1,8,0
21383026@N06,1276,13,1305629029,1305629920,4,8,891
21383026@N06,1276,20,1305610189,1305610483,5,8,294
21383026@N06,1277,16,1306380486,1306380575,2,2,89
21383026@N06,1277,21,1306372632,1306372632,1,2,0
21383026@N06,1278,15,1310035997,1310035997,1,2,0
21383026@N06,1278,21,1310050064,1310050064,1,2,0
21383026@N06,1279,27,1311254484,1311254484,1,1,0
21383026@N06,1280,4,1315907998,1315923082,13,3,15084
21383026@N06,1280,17,1315918157,1315918163,3,3,6
21383026@N06,1280,27,1315907350,1315908584,2,3,1234
21383026@N06,1281,16,1320395098,1320395098,1,2,0
21383026@N06,1281,27,1320392124,1320392597,2,2,473
21422300@N00,1282,15,1220096311,1220096311,1,1,0
21422300@N00,1283,16,1337074210,1337074210,1,1,0
21472383@N03,1284,14,1200554076,1200557841,2,1,3765
21537074@N06,1285,19,1262184482,1262184482,1,1,0
21537772@N02,1286,19,1196114415,1196114680,2,6,265
21537772@N02,1286,5,1196097283,1196097283,1,6,0
21537772@N02,1286,16,1196095047,1196116336,6,6,21289
21537772@N02,1286,7,1196098875,1196098875,1,6,0
21537772@N02,1286,27,1196092005,1196092005,1,6,0
21537772@N02,1286,22,1196112037,1196113210,9,6,1173
21541613@N06,1287,27,1434494470,1434494470,1,1,0
21541613@N06,1288,27,1447906137,1447906137,1,1,0
21591624@N00,1289,22,1215666550,1215666550,1,1,0
21591624@N00,1290,16,1345703677,1345703677,1,1,0
21592589@N00,1291,20,1460186084,1460186084,1,2,0
21592589@N00,1291,1,1460167355,1460167355,1,2,0
21637807@N07,1292,13,1242367346,1242367346,1,9,0
21637807@N07,1292,4,1242347408,1242347408,1,9,0
21637807@N07,1292,14,1242356843,1242359806,5,9,2963
21637807@N07,1292,6,1242348133,1242352963,5,9,4830
21637807@N07,1292,16,1242360949,1242360949,1,9,0
21637807@N07,1292,18,1242367275,1242368528,9,9,1253
21637807@N07,1292,20,1242365319,1242374182,4,9,8863
21637807@N07,1292,11,1242353384,1242355104,7,9,1720
21637807@N07,1292,12,1242362152,1242362618,3,9,466
21637807@N07,1293,4,1242560679,1242560679,1,1,0
21641933@N00,1294,10,1377657060,1377657060,1,4,0
21641933@N00,1294,25,1377652159,1377652159,1,4,0
21641933@N00,1294,2,1377664033,1377664038,2,4,5
21641933@N00,1294,8,1377660680,1377660680,1,4,0
21652490@N06,1295,16,1217512800,1217512800,70,1,0
21652490@N06,1296,16,1228050000,1228050000,92,1,0
21652490@N06,1297,16,1254319200,1254319200,89,1,0
21652490@N06,1298,16,1275314400,1275314400,39,1,0
21667128@N00,1299,8,1293603387,1293603387,1,2,0
21667128@N00,1299,17,1293613697,1293613697,1,2,0
21668671@N04,1300,17,1337484204,1337484204,1,2,0
21668671@N04,1300,9,1337486935,1337487160,2,2,225
21685693@N02,1301,17,1195470704,1195470704,1,4,0
21685693@N02,1301,12,1195493888,1195493888,1,4,0
21685693@N02,1301,21,1195468990,1195468997,2,4,7
21685693@N02,1301,26,1195485528,1195486144,15,4,616
21685693@N02,1302,26,1197159753,1197159753,1,1,0
21685693@N02,1303,12,1257118865,1257118865,1,6,0
21685693@N02,1303,27,1257111088,1257113068,2,6,1980
21685693@N02,1303,17,1257136389,1257137089,11,6,700
21685693@N02,1303,14,1257121096,1257121096,1,6,0
21685693@N02,1303,2,1257123031,1257123031,2,6,0
21685693@N02,1303,15,1257118783,1257118783,1,6,0
21685693@N02,1304,11,1257208275,1257208275,1,2,0
21685693@N02,1304,19,1257202484,1257202484,1,2,0
21739162@N04,1305,2,1254092598,1254094621,4,16,2023
21739162@N04,1305,20,1254110756,1254110756,1,16,0
21739162@N04,1305,18,1254104917,1254104917,1,16,0
21739162@N04,1305,15,1254102199,1254104566,4,16,2367
21739162@N04,1305,14,1254100200,1254100200,1,16,0
21739162@N04,1305,13,1254105018,1254105018,1,16,0
21739162@N04,1305,26,1254108836,1254108836,1,16,0
21739162@N04,1305,27,1254089580,1254120004,21,16,30424
21739162@N04,1305,22,1254110514,1254110598,2,16,84
21739162@N04,1305,23,1254113486,1254115575,2,16,2089
21739162@N04,1305,5,1254092644,1254092644,1,16,0
21739162@N04,1305,9,1254099737,1254099737,1,16,0
21739162@N04,1305,17,1254106191,1254108690,4,16,2499
21739162@N04,1305,3,1254092683,1254092683,1,16,0
21739162@N04,1305,16,1254116473,1254116533,3,16,60
21739162@N04,1305,6,1254094043,1254099656,5,16,5613
21739162@N04,1306,1,1302304203,1302304203,1,8,0
21739162@N04,1306,2,1302304101,1302308056,6,8,3955
21739162@N04,1306,7,1302306583,1302306583,1,8,0
21739162@N04,1306,13,1302321029,1302321034,2,8,5
21739162@N04,1306,27,1302333531,1302334420,10,8,889
21739162@N04,1306,9,1302355322,1302355322,1,8,0
21739162@N04,1306,17,1302315962,1302315962,1,8,0
21739162@N04,1306,6,1302306189,1302355304,3,8,49115
21739162@N04,1307,18,1302571354,1302572680,3,5,1326
21739162@N04,1307,13,1302572763,1302572763,1,5,0
21739162@N04,1307,27,1302564503,1302564503,1,5,0
21739162@N04,1307,22,1302569543,1302569543,1,5,0
21739162@N04,1307,23,1302568917,1302569003,3,5,86
21748548@N00,1308,16,1420625810,1420625883,4,3,73
21748548@N00,1308,10,1420618902,1420619840,8,3,938
21748548@N00,1308,27,1420617066,1420617546,4,3,480
21748548@N00,1309,9,1420836496,1420836502,2,8,6
21748548@N00,1309,20,1420837166,1420837166,1,8,0
21748548@N00,1309,14,1420836553,1420836579,3,8,26
21748548@N00,1309,16,1420836671,1420836671,1,8,0
21748548@N00,1309,22,1420837085,1420837085,1,8,0
21748548@N00,1309,4,1420835768,1420835821,2,8,53
21748548@N00,1309,17,1420836923,1420836923,1,8,0
21748548@N00,1309,5,1420836035,1420836035,1,8,0
21748548@N00,1310,4,1420922461,1420922475,2,8,14
21748548@N00,1310,24,1420955867,1420955867,1,8,0
21748548@N00,1310,27,1420949360,1420950875,29,8,1515
21748548@N00,1310,21,1420955464,1420955633,2,8,169
21748548@N00,1310,20,1420923136,1420923136,1,8,0
21748548@N00,1310,16,1420922730,1420922769,2,8,39
21748548@N00,1310,14,1420922715,1420922740,3,8,25
21748548@N00,1310,22,1420923011,1420923054,2,8,43
21801897@N04,1311,21,1289354886,1289354886,1,1,0
21801897@N04,1312,1,1307520583,1307520583,1,1,0
21807174@N04,1313,26,1310102004,1310102004,1,2,0
21807174@N04,1313,27,1310094892,1310127368,2,2,32476
21807174@N04,1314,27,1354781729,1354800372,2,1,18643
21893264@N00,1315,21,1236315367,1236315532,6,3,165
21893264@N00,1315,16,1236318573,1236318573,1,3,0
21893264@N00,1315,14,1236318361,1236318361,1,3,0
21920009@N05,1316,6,1303989075,1303989075,1,1,0
21933943@N02,1317,14,1379736669,1379736669,1,1,0
21933943@N02,1318,27,1379785279,1379785279,1,1,0
21935793@N05,1319,4,1227947890,1227947890,1,1,0
21978090@N03,1320,27,1322702563,1322714124,3,1,11561
21978090@N03,1321,26,1322790477,1322790501,2,3,24
21978090@N03,1321,17,1322792327,1322792327,1,3,0
21978090@N03,1321,20,1322784989,1322784989,1,3,0
21978090@N03,1322,14,1323054993,1323055149,4,2,156
21978090@N03,1322,3,1323047503,1323047503,1,2,0
21978090@N03,1323,27,1323246588,1323246611,2,3,23
21978090@N03,1323,17,1323252239,1323252239,1,3,0
21978090@N03,1323,22,1323248360,1323249945,3,3,1585
21978090@N03,1324,27,1323388096,1323392114,4,4,4018
21978090@N03,1324,26,1323404577,1323404792,2,4,215
21978090@N03,1324,5,1323388449,1323388449,1,4,0
21978090@N03,1324,6,1323388947,1323389248,2,4,301
22004642@N00,1325,2,1196166892,1196166892,1,1,0
22046456@N04,1326,1,1280142697,1280142697,1,1,0
22068918@N00,1327,20,1237843746,1237843746,1,6,0
22068918@N00,1327,3,1237850674,1237851354,5,6,680
22068918@N00,1327,27,1237865250,1237876328,8,6,11078
22068918@N00,1327,26,1237871081,1237871749,3,6,668
22068918@N00,1327,16,1237846614,1237846614,1,6,0
22068918@N00,1327,5,1237848575,1237848967,5,6,392
22093605@N05,1328,17,1317587563,1317587563,1,1,0
22107206@N00,1329,14,1369442507,1369442508,2,3,1
22107206@N00,1329,7,1369436995,1369436995,1,3,0
22107206@N00,1329,20,1369445271,1369445271,1,3,0
22119513@N00,1330,18,1251251253,1251251253,1,1,0
22131083@N08,1331,14,1379130808,1379130808,1,1,0
22151340@N02,1332,13,1198641328,1198641328,1,1,0
22151340@N02,1333,1,1207833567,1207833567,1,2,0
22151340@N02,1333,13,1207834448,1207834448,1,2,0
22151340@N02,1334,20,1212286496,1212286496,1,6,0
22151340@N02,1334,19,1212297739,1212298264,3,6,525
22151340@N02,1334,21,1212288298,1212288298,1,6,0
22151340@N02,1334,1,1212294587,1212295411,2,6,824
22151340@N02,1334,4,1212288735,1212288735,1,6,0
22151340@N02,1334,13,1212292414,1212319278,3,6,26864
22151340@N02,1335,19,1215235566,1215235566,1,1,0
22151340@N02,1336,6,1216517528,1216517528,1,1,0
22151340@N02,1337,4,1217380925,1217381924,2,1,999
22151340@N02,1338,13,1217567072,1217567072,1,1,0
22151340@N02,1339,14,1235177258,1235197593,4,3,20335
22151340@N02,1339,3,1235180891,1235207318,2,3,26427
22151340@N02,1339,27,1235191543,1235191543,1,3,0
22152932@N08,1340,26,1398241727,1398241727,1,3,0
22152932@N08,1340,19,1398246969,1398246969,1,3,0
22152932@N08,1340,16,1398241527,1398241527,1,3,0
22158588@N00,1341,22,1201325295,1201325881,4,3,586
22158588@N00,1341,27,1201322620,1201322620,1,3,0
22158588@N00,1341,5,1201328794,1201328794,1,3,0
22158588@N00,1342,17,1203234709,1203234709,1,3,0
22158588@N00,1342,5,1203236921,1203236921,1,3,0
22158588@N00,1342,18,1203233656,1203233656,1,3,0
22158588@N00,1343,16,1204349407,1204349407,1,2,0
22158588@N00,1343,2,1204348120,1204348120,1,2,0
22158588@N00,1344,17,1206940115,1206940115,1,1,0
22158588@N00,1345,17,1207376824,1207382702,3,3,5878
22158588@N00,1345,20,1207380501,1207381932,4,3,1431
22158588@N00,1345,26,1207377277,1207377277,1,3,0
22161498@N00,1346,27,1195262505,1195262898,6,10,393
22161498@N00,1346,16,1195263358,1195278984,7,10,15626
22161498@N00,1346,26,1195269867,1195269969,6,10,102
22161498@N00,1346,2,1195280911,1195280911,1,10,0
22161498@N00,1346,23,1195263713,1195267622,9,10,3909
22161498@N00,1346,11,1195276120,1195277442,12,10,1322
22161498@N00,1346,3,1195282035,1195282035,1,10,0
22161498@N00,1346,24,1195272229,1195272563,8,10,334
22161498@N00,1346,21,1195264524,1195265763,2,10,1239
22161498@N00,1346,25,1195270487,1195270576,3,10,89
22161498@N00,1347,22,1195531226,1195536064,23,3,4838
22161498@N00,1347,17,1195526357,1195526357,1,3,0
22161498@N00,1347,6,1195528636,1195528675,2,3,39
22175508@N08,1348,17,1431749507,1431750167,3,1,660
22185077@N06,1349,14,1357111645,1357112959,2,1,1314
22232518@N05,1350,12,1313138666,1313140974,2,1,2308
22247605@N07,1351,27,1340690583,1340690583,1,1,0
22255270@N04,1352,14,1194578519,1194578838,3,5,319
22255270@N04,1352,4,1194568830,1194568830,1,5,0
22255270@N04,1352,1,1194585752,1194585752,1,5,0
22255270@N04,1352,27,1194564358,1194571008,4,5,6650
22255270@N04,1352,16,1194580553,1194603320,6,5,22767
22261589@N00,1353,27,1194131576,1194131891,2,2,315
22261589@N00,1353,16,1194144990,1194144990,1,2,0
22261589@N00,1354,27,1194514731,1194514731,1,1,0
22261589@N00,1355,2,1194653928,1194653928,1,3,0
22261589@N00,1355,16,1194652786,1194652786,1,3,0
22261589@N00,1355,27,1194650592,1194650592,1,3,0
22261589@N00,1356,16,1195108138,1195110866,2,1,2728
22261589@N00,1357,9,1266656162,1266656162,1,1,0
22261589@N00,1358,27,1270030739,1270030739,1,1,0
22261589@N00,1359,14,1291534505,1291534505,1,3,0
22261589@N00,1359,17,1291535695,1291550476,5,3,14781
22261589@N00,1359,15,1291529156,1291529156,1,3,0
22261589@N00,1360,27,1291961176,1291961176,1,1,0
22261589@N00,1361,11,1292196389,1292196389,1,2,0
22261589@N00,1361,9,1292198523,1292198523,1,2,0
22261589@N00,1362,17,1292229010,1292231394,3,1,2384
22261589@N00,1363,9,1337221029,1337221029,1,6,0
22261589@N00,1363,5,1337219978,1337219997,2,6,19
22261589@N00,1363,27,1337232175,1337232269,2,6,94
22261589@N00,1363,21,1337229378,1337229378,1,6,0
22261589@N00,1363,22,1337225301,1337225301,1,6,0
22261589@N00,1363,12,1337217261,1337217600,3,6,339
22261589@N00,1364,27,1337735284,1337762344,2,2,27060
22261589@N00,1364,17,1337736312,1337738995,2,2,2683
22261589@N00,1365,9,1342168969,1342168969,1,3,0
22261589@N00,1365,14,1342168992,1342169006,2,3,14
22261589@N00,1365,27,1342168980,1342168980,1,3,0
22261589@N00,1366,27,1346764773,1346764773,1,4,0
22261589@N00,1366,21,1346764784,1346764784,1,4,0
22261589@N00,1366,12,1346764761,1346764761,1,4,0
22261589@N00,1366,18,1346764738,1346764738,1,4,0
22261589@N00,1367,20,1385893769,1385893769,1,4,0
22261589@N00,1367,26,1385883043,1385883043,1,4,0
22261589@N00,1367,19,1385883049,1385883049,1,4,0
22261589@N00,1367,12,1385879638,1385879638,1,4,0
22261589@N00,1368,27,1386888674,1386889402,4,1,728
22261589@N00,1369,15,1391161593,1391161593,1,1,0
22265703@N06,1370,16,1200142800,1200142800,2,2,0
22265703@N06,1370,15,1200142800,1200142800,1,2,0
22265703@N06,1371,18,1200211389,1200211584,5,12,195
22265703@N06,1371,13,1200186087,1200188225,5,12,2138
22265703@N06,1371,25,1200208051,1200208699,39,12,648
22265703@N06,1371,17,1200210027,1200210769,2,12,742
22265703@N06,1371,15,1200186453,1200192606,33,12,6153
22265703@N06,1371,27,1200219674,1200220079,7,12,405
22265703@N06,1371,23,1200208733,1200209859,8,12,1126
22265703@N06,1371,20,1200213199,1200214247,5,12,1048
22265703@N06,1371,19,1200211170,1200211554,5,12,384
22265703@N06,1371,4,1200203050,1200203118,4,12,68
22265703@N06,1371,26,1200207877,1200207877,1,12,0
22265703@N06,1371,16,1200189148,1200218916,126,12,29768
22273519@N07,1372,27,1315363925,1315363944,2,3,19
22273519@N07,1372,19,1315366018,1315366018,1,3,0
22273519@N07,1372,9,1315369603,1315369603,1,3,0
22287142@N02,1373,16,1239588589,1239588589,1,1,0
22311971@N04,1374,2,1322198631,1322201074,4,12,2443
22311971@N04,1374,9,1322198892,1322201476,3,12,2584
22311971@N04,1374,21,1322176724,1322176724,1,12,0
22311971@N04,1374,25,1322174037,1322176232,7,12,2195
22311971@N04,1374,24,1322174203,1322174203,1,12,0
22311971@N04,1374,27,1322170051,1322171655,3,12,1604
22311971@N04,1374,19,1322179076,1322179645,3,12,569
22311971@N04,1374,4,1322195273,1322202996,3,12,7723
22311971@N04,1374,16,1322189284,1322189284,1,12,0
22311971@N04,1374,17,1322173922,1322173922,1,12,0
22311971@N04,1374,14,1322188936,1322188936,1,12,0
22311971@N04,1374,13,1322183438,1322184770,3,12,1332
22375931@N03,1375,1,1298695463,1298695463,1,1,0
22404194@N03,1376,27,1371295739,1371303215,2,1,7476
22416200@N05,1377,3,1270089936,1270089936,1,2,0
22416200@N05,1377,18,1270077498,1270077498,1,2,0
22423587@N03,1378,17,1217676117,1217678769,10,11,2652
22423587@N03,1378,12,1217665672,1217666602,2,11,930
22423587@N03,1378,16,1217677750,1217679710,2,11,1960
22423587@N03,1378,21,1217657724,1217659522,2,11,1798
22423587@N03,1378,13,1217660389,1217665000,4,11,4611
22423587@N03,1378,5,1217667681,1217667681,1,11,0
22423587@N03,1378,14,1217656615,1217656657,2,11,42
22423587@N03,1378,1,1217670724,1217670724,1,11,0
22423587@N03,1378,4,1217671101,1217671651,2,11,550
22423587@N03,1378,2,1217653114,1217653114,1,11,0
22423587@N03,1378,15,1217665232,1217679755,2,11,14523
22423587@N03,1379,14,1256303693,1256303693,1,1,0
22423587@N03,1380,16,1268292218,1268292218,1,1,0
22423587@N03,1381,8,1270959346,1270959346,1,2,0
22423587@N03,1381,11,1270959036,1270959036,1,2,0
22423587@N03,1382,1,1284864805,1284864805,1,4,0
22423587@N03,1382,11,1284865917,1284865917,1,4,0
22423587@N03,1382,13,1284867340,1284867340,1,4,0
22423587@N03,1382,18,1284867186,1284867186,1,4,0
22423587@N03,1383,17,1287229117,1287229117,1,2,0
22423587@N03,1383,4,1287233174,1287233220,2,2,46
22423587@N03,1384,16,1291802844,1291802844,1,2,0
22423587@N03,1384,27,1291808660,1291808660,1,2,0
22423587@N03,1385,13,1291872219,1291872219,1,1,0
22423587@N03,1386,22,1293254452,1293254452,1,1,0
22423587@N03,1387,17,1303459553,1303459553,1,3,0
22423587@N03,1387,16,1303458617,1303458617,1,3,0
22423587@N03,1387,9,1303460619,1303460619,1,3,0
22423587@N03,1388,13,1307243175,1307243175,1,1,0
22423587@N03,1389,27,1317444745,1317445353,2,1,608
22446827@N02,1390,17,1401077751,1401077751,1,2,0
22446827@N02,1390,8,1401075889,1401075889,1,2,0
22462637@N00,1391,27,1301551760,1301551877,2,1,117
22462637@N00,1392,16,1301711662,1301711662,1,4,0
22462637@N00,1392,17,1301699766,1301699811,2,4,45
22462637@N00,1392,3,1301717704,1301717704,1,4,0
22462637@N00,1392,21,1301725439,1301725439,1,4,0
22473198@N00,1393,27,1319166709,1319181204,2,2,14495
22473198@N00,1393,21,1319168363,1319168363,1,2,0
22474934@N00,1394,13,1382612917,1382614146,2,7,1229
22474934@N00,1394,21,1382610743,1382610868,2,7,125
22474934@N00,1394,2,1382603765,1382604557,2,7,792
22474934@N00,1394,27,1382615842,1382615842,1,7,0
22474934@N00,1394,6,1382603539,1382606019,7,7,2480
22474934@N00,1394,10,1382607126,1382607126,1,7,0
22474934@N00,1394,18,1382612623,1382612906,2,7,283
22496843@N03,1395,27,1207717154,1207743100,30,4,25946
22496843@N03,1395,4,1207732371,1207742899,5,4,10528
22496843@N03,1395,5,1207733502,1207734872,2,4,1370
22496843@N03,1395,20,1207720419,1207720669,4,4,250
22500161@N06,1396,17,1330499342,1330499342,1,1,0
22507625@N00,1397,6,1385459375,1385459375,1,1,0
22541015@N00,1398,27,1212829675,1212829675,1,1,0
22597539@N03,1399,16,1301818820,1301818820,1,1,0
22616926@N08,1400,16,1198835247,1198836772,3,1,1525
22616926@N08,1401,16,1410237186,1410252708,2,1,15522
22616926@N08,1402,16,1410317933,1410317933,1,1,0
22659528@N06,1403,27,1347170126,1347170126,1,3,0
22659528@N06,1403,4,1347191728,1347191728,1,3,0
22659528@N06,1403,16,1347175192,1347175192,1,3,0
22659528@N06,1404,14,1347530307,1347530307,1,1,0
22659528@N06,1405,27,1348232325,1348232325,1,2,0
22659528@N06,1405,16,1348216535,1348216535,1,2,0
22659528@N06,1406,10,1403679053,1403679053,1,1,0
22659528@N06,1407,14,1404211955,1404211955,1,1,0
22659528@N06,1408,10,1407665867,1407665867,1,1,0
22684438@N02,1409,21,1199356550,1199356550,1,7,0
22684438@N02,1409,17,1199326184,1199326184,1,7,0
22684438@N02,1409,18,1199332699,1199333254,2,7,555
22684438@N02,1409,27,1199319903,1199319914,2,7,11
22684438@N02,1409,19,1199333876,1199340198,5,7,6322
22684438@N02,1409,13,1199326669,1199328322,3,7,1653
22684438@N02,1409,16,1199343809,1199344401,4,7,592
22687691@N02,1410,16,1194168314,1194168314,1,2,0
22687691@N02,1410,27,1194173573,1194173573,1,2,0
22687691@N02,1411,27,1195035923,1195035976,2,1,53
22687691@N02,1412,4,1195898096,1195898096,1,1,0
22687691@N02,1413,6,1196075896,1196075896,1,1,0
22687691@N02,1414,22,1199606076,1199606076,1,1,0
22687691@N02,1415,14,1207829778,1207829778,1,1,0
22687691@N02,1416,14,1209468968,1209468968,1,1,0
22687691@N02,1417,9,1209811962,1209811962,1,1,0
22687691@N02,1418,9,1225590705,1225590705,1,2,0
22687691@N02,1418,27,1225580730,1225581095,2,2,365
22687691@N02,1419,13,1225954479,1225954479,1,1,0
22696986@N08,1420,14,1283820097,1283820097,1,1,0
22707445@N00,1421,23,1409374587,1409374587,1,1,0
22720103@N06,1422,7,1345874280,1345874285,2,2,5
22720103@N06,1422,27,1345871149,1345871184,4,2,35
22720103@N06,1423,27,1346020459,1346020520,3,6,61
22720103@N06,1423,20,1346034074,1346035186,2,6,1112
22720103@N06,1423,17,1346063343,1346063343,1,6,0
22720103@N06,1423,14,1346025348,1346025348,1,6,0
22720103@N06,1423,23,1346059358,1346059358,1,6,0
22720103@N06,1423,16,1346023101,1346024066,3,6,965
22721767@N08,1424,16,1358061739,1358061739,1,2,0
22721767@N08,1424,9,1358060369,1358066427,2,2,6058
22737269@N05,1425,2,1265256460,1265256460,1,1,0
22742343@N00,1426,27,1373684143,1373684143,1,1,0
22768390@N00,1427,21,1462858228,1462858904,20,17,676
22768390@N00,1427,9,1462853334,1462874251,9,17,20917
22768390@N00,1427,22,1462857141,1462857267,12,17,126
22768390@N00,1427,27,1462838378,1462839451,7,17,1073
22768390@N00,1427,16,1462840122,1462840122,1,17,0
22768390@N00,1427,15,1462842805,1462844805,8,17,2000
22768390@N00,1427,12,1462842874,1462845428,33,17,2554
22768390@N00,1427,14,1462840194,1462875036,9,17,34842
22768390@N00,1427,13,1462845052,1462845296,12,17,244
22768390@N00,1427,3,1462868856,1462869356,5,17,500
22768390@N00,1427,10,1462850543,1462851308,28,17,765
22768390@N00,1427,20,1462858443,1462859946,6,17,1503
22768390@N00,1427,25,1462854871,1462863714,10,17,8843
22768390@N00,1427,6,1462866513,1462874376,3,17,7863
22768390@N00,1427,4,1462868812,1462871177,3,17,2365
22768390@N00,1427,2,1462869477,1462872974,16,17,3497
22768390@N00,1427,7,1462847774,1462848047,8,17,273
22786107@N06,1428,20,1206876302,1206882685,18,1,6383
22791773@N07,1429,18,1280225213,1280225213,1,3,0
22791773@N07,1429,22,1280229839,1280229839,1,3,0
22791773@N07,1429,16,1280231380,1280231380,1,3,0
22791773@N07,1430,16,1368007462,1368007462,1,1,0
22802028@N08,1431,2,1209699626,1209703184,2,4,3558
22802028@N08,1431,12,1209705986,1209709445,13,4,3459
22802028@N08,1431,27,1209675962,1209679845,4,4,3883
22802028@N08,1431,3,1209698215,1209698849,5,4,634
22802028@N08,1432,13,1209907287,1209907287,1,2,0
22802028@N08,1432,27,1209899436,1209900215,7,2,779
22802028@N08,1433,20,1210124864,1210126171,3,6,1307
22802028@N08,1433,13,1210132835,1210132852,2,6,17
22802028@N08,1433,18,1210132940,1210132940,1,6,0
22802028@N08,1433,21,1210128335,1210129018,3,6,683
22802028@N08,1433,22,1210126818,1210130622,9,6,3804
22802028@N08,1433,3,1210141838,1210141838,1,6,0
22802028@N08,1434,2,1239056284,1239056290,2,9,6
22802028@N08,1434,20,1239075887,1239082914,7,9,7027
22802028@N08,1434,13,1239073408,1239102433,5,9,29025
22802028@N08,1434,1,1239063918,1239063918,1,9,0
22802028@N08,1434,21,1239099333,1239099333,1,9,0
22802028@N08,1434,19,1239073476,1239103460,2,9,29984
22802028@N08,1434,16,1239084811,1239096466,2,9,11655
22802028@N08,1434,9,1239107065,1239107086,2,9,21
22802028@N08,1434,27,1239054537,1239054537,1,9,0
22808487@N04,1435,13,1259991676,1259991722,3,2,46
22808487@N04,1435,27,1259987184,1260004795,11,2,17611
22810906@N06,1436,27,1281533956,1281533956,1,1,0
22810906@N06,1437,4,1324772939,1324772939,1,3,0
22810906@N06,1437,14,1324813756,1324813756,1,3,0
22810906@N06,1437,3,1324795966,1324795966,1,3,0
22810906@N06,1438,27,1325314208,1325314208,1,4,0
22810906@N06,1438,26,1325305739,1325305739,1,4,0
22810906@N06,1438,4,1325320873,1325320873,1,4,0
22810906@N06,1438,14,1325304223,1325304223,1,4,0
22832552@N08,1439,16,1222690646,1222690873,2,3,227
22832552@N08,1439,14,1222679785,1222679785,1,3,0
22832552@N08,1439,20,1222690100,1222690100,1,3,0
22832552@N08,1440,14,1222936137,1222936137,1,1,0
22832552@N08,1441,16,1292590451,1292590451,1,1,0
22854594@N07,1442,14,1379933586,1379933586,1,2,0
22854594@N07,1442,27,1379933868,1379933868,1,2,0
22854594@N07,1443,27,1379967215,1379967215,1,1,0
22854594@N07,1444,27,1381886754,1381886754,1,1,0
22854594@N07,1445,27,1382897505,1382897505,1,1,0
22854594@N07,1446,27,1383156908,1383199280,6,1,42372
22866792@N00,1447,9,1291858653,1291858653,1,4,0
22866792@N00,1447,16,1291866334,1291866334,1,4,0
22866792@N00,1447,14,1291858586,1291858760,2,4,174
22866792@N00,1447,15,1291858773,1291858773,1,4,0
22884021@N06,1448,16,1262510711,1262515077,14,5,4366
22884021@N06,1448,23,1262489205,1262489205,1,5,0
22884021@N06,1448,26,1262488826,1262488826,1,5,0
22884021@N06,1448,21,1262489193,1262489269,3,5,76
22884021@N06,1448,27,1262487299,1262512083,7,5,24784
22884021@N06,1449,14,1262594413,1262594417,2,1,4
22925214@N04,1450,24,1420079075,1420079085,2,4,10
22925214@N04,1450,21,1420078152,1420078152,1,4,0
22925214@N04,1450,15,1420068897,1420068897,1,4,0
22925214@N04,1450,1,1420063361,1420063364,2,4,3
22925214@N04,1451,21,1420153704,1420154578,6,1,874
22937808@N04,1452,10,1367844795,1367844795,1,2,0
22937808@N04,1452,4,1367834047,1367834047,1,2,0
22937808@N04,1453,16,1399281980,1399281980,1,2,0
22937808@N04,1453,26,1399293774,1399293774,1,2,0
22937808@N04,1454,15,1430747008,1430747008,1,2,0
22937808@N04,1454,17,1430741053,1430741053,1,2,0
22937808@N04,1455,15,1431126903,1431126903,1,1,0
22937808@N04,1456,27,1462274826,1462274826,1,2,0
22937808@N04,1456,26,1462269340,1462269340,1,2,0
22938081@N06,1457,24,1214834400,1214834400,1,6,0
22938081@N06,1457,22,1214834400,1214834400,2,6,0
22938081@N06,1457,19,1214834400,1214834400,1,6,0
22938081@N06,1457,16,1214834400,1214834400,2,6,0
22938081@N06,1457,20,1214834400,1214834400,1,6,0
22938081@N06,1457,18,1214834400,1214834400,2,6,0
22938081@N06,1458,24,1232360811,1232360811,1,4,0
22938081@N06,1458,26,1232360816,1232360816,1,4,0
22938081@N06,1458,16,1232360799,1232360799,1,4,0
22938081@N06,1458,18,1232360874,1232360897,3,4,23
23012921@N08,1459,16,1324550470,1324550470,1,1,0
23021321@N02,1460,14,1324617792,1324617792,1,2,0
23021321@N02,1460,20,1324604496,1324604496,1,2,0
23031334@N00,1461,16,1296867351,1296886697,2,1,19346
23036992@N08,1462,27,1264976916,1264976916,1,3,0
23036992@N08,1462,18,1264986188,1264986188,1,3,0
23036992@N08,1462,16,1264977734,1264977734,1,3,0
23041412@N08,1463,26,1243165713,1243165713,1,4,0
23041412@N08,1463,18,1243160534,1243160554,2,4,20
23041412@N08,1463,7,1243159627,1243159661,2,4,34
23041412@N08,1463,27,1243140640,1243143023,7,4,2383
23041412@N08,1464,27,1243413310,1243413644,3,1,334
23041412@N08,1465,27,1243489037,1243489037,1,1,0
23043254@N03,1466,14,1198048912,1198048912,1,1,0
23043254@N03,1467,22,1217018108,1217018108,1,1,0
23043254@N03,1468,14,1241488652,1241488652,1,1,0
23071360@N02,1469,16,1194478123,1194503370,3,1,25247
23071360@N02,1470,16,1194849805,1194860617,20,1,10812
23071450@N02,1471,4,1283841850,1283841850,1,1,0
23071450@N02,1472,27,1287986434,1287986434,1,1,0
23071450@N02,1473,11,1288328942,1288328942,1,2,0
23071450@N02,1473,14,1288311846,1288311846,1,2,0
23074913@N00,1474,22,1298757681,1298757681,1,1,0
23074913@N00,1475,27,1299410110,1299410110,1,1,0
23074913@N00,1476,8,1352850836,1352850836,1,1,0
23074913@N00,1477,26,1393118007,1393118007,1,1,0
23082655@N04,1478,19,1241156022,1241156022,1,1,0
23108813@N00,1479,19,1207115143,1207115143,1,2,0
23108813@N00,1479,1,1207132230,1207132230,1,2,0
23108813@N00,1480,8,1237620509,1237620509,1,1,0
23108813@N00,1481,27,1258876825,1258876825,1,1,0
23108813@N00,1482,14,1264826348,1264826348,1,1,0
23108813@N00,1483,17,1264925178,1264925178,1,1,0
23108813@N00,1484,17,1267078076,1267078076,1,1,0
23108813@N00,1485,19,1273042181,1273042181,1,1,0
23108813@N00,1486,27,1275456564,1275460851,2,2,4287
23108813@N00,1486,6,1275465141,1275465141,1,2,0
23108813@N00,1487,14,1281080089,1281080089,1,1,0
23108813@N00,1488,20,1281313056,1281313056,1,1,0
23108813@N00,1489,27,1281773835,1281773835,1,1,0
23108813@N00,1490,1,1283591203,1283591203,1,1,0
23108813@N00,1491,8,1285225609,1285225609,1,1,0
23108813@N00,1492,27,1287367419,1287367419,1,1,0
23108813@N00,1493,27,1291174086,1291174086,1,1,0
23108813@N00,1494,9,1292484538,1292484538,1,1,0
23108813@N00,1495,24,1294023198,1294023198,1,1,0
23108813@N00,1496,2,1294464706,1294464706,1,1,0
23108813@N00,1497,14,1296188572,1296188572,1,1,0
23108813@N00,1498,27,1296293646,1296293646,1,1,0
23108813@N00,1499,7,1297394700,1297394700,1,1,0
23108813@N00,1500,25,1306638138,1306638138,1,1,0
23108813@N00,1501,27,1309748172,1309748172,1,1,0
23108813@N00,1502,17,1314858960,1314858960,1,1,0
23108813@N00,1503,23,1315190113,1315190113,1,1,0
23108813@N00,1504,27,1317615229,1317615229,1,1,0
23108813@N00,1505,27,1320121254,1320121254,1,1,0
23108813@N00,1506,12,1320561971,1320561971,1,1,0
23108813@N00,1507,27,1322630136,1322630136,1,1,0
23108813@N00,1508,27,1322796689,1322796689,1,1,0
23108813@N00,1509,17,1323133694,1323133694,1,1,0
23108813@N00,1510,17,1323239694,1323239694,1,1,0
23108813@N00,1511,27,1324274873,1324274873,1,1,0
23108813@N00,1512,27,1330488781,1330488781,1,1,0
23108813@N00,1513,14,1338427525,1338427525,1,1,0
23108813@N00,1514,5,1346301405,1346301405,1,1,0
23108813@N00,1515,7,1349400398,1349400398,1,1,0
23108813@N00,1516,10,1351416917,1351416917,1,1,0
23108813@N00,1517,9,1354792075,1354792075,1,1,0
23108813@N00,1518,5,1365145804,1365145804,1,1,0
23108813@N00,1519,23,1367556352,1367556352,1,1,0
23108813@N00,1520,17,1367892798,1367892798,1,1,0
23108813@N00,1521,8,1389854231,1389854231,1,1,0
23108813@N00,1522,10,1395906206,1395906206,1,1,0
23108813@N00,1523,9,1400742689,1400742689,1,1,0
23108813@N00,1524,9,1401423669,1401423669,1,1,0
23108813@N00,1525,14,1402368071,1402368071,1,1,0
23108813@N00,1526,20,1420337624,1420337624,1,1,0
23108813@N00,1527,5,1437907042,1437907042,1,1,0
23108813@N00,1528,27,1439114457,1439114457,1,1,0
23108813@N00,1529,27,1441708677,1441708677,1,1,0
23108813@N00,1530,10,1442574728,1442574728,1,2,0
23108813@N00,1530,27,1442586381,1442586381,1,2,0
23108813@N00,1531,27,1448082281,1448082281,1,1,0
23108813@N00,1532,9,1450608158,1450608158,1,1,0
23108813@N00,1533,27,1451190567,1451190567,1,1,0
23113465@N08,1534,9,1425354373,1425354373,1,6,0
23113465@N08,1534,23,1425335919,1425335919,1,6,0
23113465@N08,1534,15,1425344505,1425344505,1,6,0
23113465@N08,1534,27,1425340462,1425340462,1,6,0
23113465@N08,1534,16,1425350712,1425350712,1,6,0
23113465@N08,1534,21,1425336056,1425336056,1,6,0
23113465@N08,1535,9,1453429653,1453429653,1,3,0
23113465@N08,1535,19,1453429347,1453429347,1,3,0
23113465@N08,1535,1,1453429678,1453429678,1,3,0
23117061@N05,1536,21,1331201103,1331201103,1,1,0
23126267@N02,1537,16,1411028981,1411029525,5,2,544
23126267@N02,1537,14,1411029457,1411029486,2,2,29
23126267@N02,1538,14,1411136457,1411136457,1,2,0
23126267@N02,1538,27,1411136916,1411137177,7,2,261
23126267@N02,1539,10,1411267267,1411267267,1,4,0
23126267@N02,1539,27,1411261892,1411261892,1,4,0
23126267@N02,1539,11,1411263654,1411263654,1,4,0
23126267@N02,1539,26,1411251739,1411251739,1,4,0
23156708@N02,1540,12,1362395371,1362395371,1,1,0
23172783@N07,1541,19,1339200565,1339200565,1,2,0
23172783@N07,1541,27,1339196152,1339196152,1,2,0
23172783@N07,1542,27,1343388054,1343388054,1,1,0
23172783@N07,1543,26,1344127817,1344127817,1,3,0
23172783@N07,1543,17,1344128016,1344128016,1,3,0
23172783@N07,1543,25,1344126149,1344126149,1,3,0
23186244@N07,1544,16,1322295244,1322295244,1,1,0
23186244@N07,1545,27,1322352995,1322352995,1,1,0
23186244@N07,1546,21,1450523230,1450523230,1,1,0
23198304@N02,1547,27,1189077501,1189077501,1,1,0
23205379@N02,1548,5,1400780901,1400780901,1,2,0
23205379@N02,1548,14,1400802495,1400802495,1,2,0
23205379@N02,1549,25,1400901551,1400901551,1,3,0
23205379@N02,1549,14,1400893520,1400893520,1,3,0
23205379@N02,1549,15,1400887133,1400887133,1,3,0
23205379@N02,1550,14,1401080823,1401080823,1,1,0
23205379@N02,1551,25,1408693239,1408693239,1,1,0
23205379@N02,1552,26,1425009246,1425009246,1,1,0
23212779@N04,1553,27,1287707228,1287707228,1,1,0
23212779@N04,1554,27,1287777091,1287777416,2,1,325
23212779@N04,1555,27,1291869929,1291886113,2,2,16184
23212779@N04,1555,16,1291894052,1291894154,2,2,102
23212779@N04,1556,24,1298944413,1298944413,1,2,0
23212779@N04,1556,21,1298942557,1298942557,1,2,0
23212779@N04,1557,21,1301059019,1301059019,1,1,0
23212779@N04,1558,27,1301134704,1301140884,2,1,6180
23212779@N04,1559,21,1301214015,1301214015,1,1,0
23212779@N04,1560,2,1302384138,1302384138,1,1,0
23212779@N04,1561,27,1348864351,1348864351,1,1,0
23212779@N04,1562,8,1348912166,1348912166,1,1,0
23214682@N06,1563,27,1377985305,1377986335,3,1,1030
23214682@N06,1564,27,1378038284,1378038400,2,1,116
23214682@N06,1565,12,1378093468,1378093468,1,1,0
23258663@N00,1566,4,1324709721,1324709721,1,1,0
23288611@N00,1567,16,1232367020,1232367020,1,4,0
23288611@N00,1567,1,1232346000,1232346000,1,4,0
23288611@N00,1567,24,1232326422,1232326422,1,4,0
23288611@N00,1567,17,1232350720,1232350720,1,4,0
23311397@N04,1568,14,1246832498,1246872419,149,1,39921
23319775@N04,1569,16,1394363097,1394363105,2,2,8
23319775@N04,1569,14,1394370552,1394377424,2,2,6872
23322134@N02,1570,8,1201332885,1201332885,1,16,0
23322134@N02,1570,27,1201307283,1201341913,18,16,34630
23322134@N02,1570,21,1201342298,1201342922,2,16,624
23322134@N02,1570,4,1201329520,1201329520,1,16,0
23322134@N02,1570,19,1201343537,1201343939,3,16,402
23322134@N02,1570,2,1201308773,1201308773,1,16,0
23322134@N02,1570,7,1201332765,1201332765,1,16,0
23322134@N02,1570,16,1201321837,1201322593,4,16,756
23322134@N02,1570,5,1201307975,1201329662,3,16,21687
23322134@N02,1570,17,1201312201,1201312201,1,16,0
23322134@N02,1570,13,1201320195,1201320882,3,16,687
23322134@N02,1570,26,1201314985,1201314985,1,16,0
23322134@N02,1570,12,1201331282,1201331282,1,16,0
23322134@N02,1570,1,1201327308,1201327308,1,16,0
23322134@N02,1570,18,1201310951,1201314454,3,16,3503
23322134@N02,1570,3,1201309488,1201335091,2,16,25603
23322134@N02,1571,27,1201688687,1201688687,1,1,0
23322134@N02,1572,26,1201743599,1201743599,1,1,0
23322134@N02,1573,4,1202157377,1202157377,1,2,0
23322134@N02,1573,16,1202182936,1202182936,1,2,0
23322134@N02,1574,14,1202325909,1202325909,1,1,0
23322134@N02,1575,9,1202416018,1202416018,1,1,0
23322134@N02,1576,27,1202673144,1202676797,2,2,3653
23322134@N02,1576,14,1202675912,1202675912,1,2,0
23322134@N02,1577,13,1202759405,1202759405,1,1,0
23322134@N02,1578,15,1203013872,1203013872,1,1,0
23322134@N02,1579,9,1209452387,1209452387,1,1,0
23322134@N02,1580,16,1213647598,1213647598,1,4,0
23322134@N02,1580,9,1213648479,1213648479,1,4,0
23322134@N02,1580,27,1213658803,1213658803,1,4,0
23322134@N02,1580,4,1213658550,1213658550,1,4,0
23322134@N02,1581,26,1213692017,1213692017,1,7,0
23322134@N02,1581,13,1213702249,1213702298,2,7,49
23322134@N02,1581,20,1213693080,1213693080,1,7,0
23322134@N02,1581,11,1213699198,1213699198,1,7,0
23322134@N02,1581,27,1213691432,1213691432,1,7,0
23322134@N02,1581,15,1213701085,1213701133,2,7,48
23322134@N02,1581,17,1213691883,1213691883,1,7,0
23322134@N02,1582,26,1213772269,1213772269,1,16,0
23322134@N02,1582,16,1213781546,1213781546,1,16,0
23322134@N02,1582,13,1213770169,1213770248,2,16,79
23322134@N02,1582,24,1213774005,1213774005,1,16,0
23322134@N02,1582,20,1213765712,1213765712,1,16,0
23322134@N02,1582,23,1213755087,1213764847,3,16,9760
23322134@N02,1582,2,1213757345,1213757345,1,16,0
23322134@N02,1582,27,1213743423,1213743423,1,16,0
23322134@N02,1582,8,1213744324,1213757533,2,16,13209
23322134@N02,1582,14,1213782179,1213782179,1,16,0
23322134@N02,1582,21,1213755872,1213755872,1,16,0
23322134@N02,1582,6,1213743941,1213743941,1,16,0
23322134@N02,1582,3,1213761027,1213761027,1,16,0
23322134@N02,1582,19,1213766137,1213766137,1,16,0
23322134@N02,1582,22,1213766830,1213772051,2,16,5221
23322134@N02,1582,1,1213757979,1213757979,1,16,0
23322134@N02,1583,16,1226641758,1226641758,1,12,0
23322134@N02,1583,13,1226644017,1226645951,2,12,1934
23322134@N02,1583,9,1226661782,1226661782,1,12,0
23322134@N02,1583,1,1226650758,1226667927,4,12,17169
23322134@N02,1583,2,1226650341,1226650341,1,12,0
23322134@N02,1583,27,1226655784,1226670181,2,12,14397
23322134@N02,1583,15,1226642627,1226664718,4,12,22091
23322134@N02,1583,14,1226642086,1226661030,4,12,18944
23322134@N02,1583,5,1226649697,1226649697,1,12,0
23322134@N02,1583,22,1226647714,1226647714,1,12,0
23322134@N02,1583,12,1226643537,1226665730,3,12,22193
23322134@N02,1583,17,1226646304,1226646304,1,12,0
23322134@N02,1584,2,1226717938,1226717938,1,2,0
23322134@N02,1584,27,1226714595,1226721488,4,2,6893
23322134@N02,1585,16,1226804594,1226804882,2,6,288
23322134@N02,1585,18,1226805414,1226805414,1,6,0
23322134@N02,1585,20,1226806317,1226807772,4,6,1455
23322134@N02,1585,27,1226818440,1226818440,1,6,0
23322134@N02,1585,21,1226810942,1226812103,5,6,1161
23322134@N02,1585,19,1226809083,1226809503,2,6,420
23322134@N02,1586,20,1230036687,1230036687,1,3,0
23322134@N02,1586,14,1230031892,1230031892,1,3,0
23322134@N02,1586,19,1230027841,1230037434,2,3,9593
23322134@N02,1587,13,1245059828,1245071475,3,6,11647
23322134@N02,1587,9,1245073837,1245073837,1,6,0
23322134@N02,1587,12,1245026802,1245027001,2,6,199
23322134@N02,1587,21,1245035698,1245035698,1,6,0
23322134@N02,1587,5,1245043544,1245043544,1,6,0
23322134@N02,1587,14,1245056536,1245065411,2,6,8875
23322134@N02,1588,13,1254464980,1254464980,1,7,0
23322134@N02,1588,27,1254461110,1254486623,8,7,25513
23322134@N02,1588,15,1254491131,1254491131,1,7,0
23322134@N02,1588,21,1254468419,1254468419,1,7,0
23322134@N02,1588,6,1254470943,1254470943,1,7,0
23322134@N02,1588,4,1254494360,1254494360,1,7,0
23322134@N02,1588,17,1254463828,1254463828,1,7,0
23322134@N02,1589,26,1254620103,1254620103,1,5,0
23322134@N02,1589,13,1254632553,1254649467,2,5,16914
23322134@N02,1589,19,1254612972,1254612972,1,5,0
23322134@N02,1589,27,1254636746,1254636746,1,5,0
23322134@N02,1589,4,1254629318,1254629318,1,5,0
23322134@N02,1590,18,1259882341,1259882341,1,2,0
23322134@N02,1590,13,1259882615,1259882615,1,2,0
23322134@N02,1591,27,1259919488,1259919488,1,1,0
23322134@N02,1592,17,1265954349,1265954349,1,5,0
23322134@N02,1592,26,1265965924,1265965924,1,5,0
23322134@N02,1592,18,1265954671,1265954671,1,5,0
23322134@N02,1592,1,1265939340,1265939340,1,5,0
23322134@N02,1592,15,1265941150,1265941709,2,5,559
23322134@N02,1593,27,1267650208,1267697785,5,7,47577
23322134@N02,1593,14,1267652779,1267652779,1,7,0
23322134@N02,1593,4,1267657873,1267695278,2,7,37405
23322134@N02,1593,17,1267668040,1267668040,1,7,0
23322134@N02,1593,16,1267651308,1267651308,1,7,0
23322134@N02,1593,18,1267688737,1267688737,1,7,0
23322134@N02,1593,20,1267667365,1267667365,1,7,0
23322134@N02,1594,5,1273323889,1273323889,1,1,0
23322134@N02,1595,21,1273460007,1273460007,1,6,0
23322134@N02,1595,3,1273464985,1273464985,1,6,0
23322134@N02,1595,13,1273456271,1273456271,1,6,0
23322134@N02,1595,9,1273446735,1273446735,1,6,0
23322134@N02,1595,1,1273444274,1273444274,1,6,0
23322134@N02,1595,20,1273461522,1273461522,1,6,0
23322134@N02,1596,27,1291458986,1291458986,1,4,0
23322134@N02,1596,4,1291472486,1291472486,1,4,0
23322134@N02,1596,9,1291443466,1291443466,1,4,0
23322134@N02,1596,20,1291468020,1291468020,1,4,0
23322134@N02,1597,5,1298098587,1298098587,1,1,0
23322134@N02,1598,2,1301481145,1301481145,1,7,0
23322134@N02,1598,27,1301468206,1301468206,1,7,0
23322134@N02,1598,21,1301469945,1301469945,1,7,0
23322134@N02,1598,3,1301480290,1301480290,1,7,0
23322134@N02,1598,13,1301439119,1301439119,1,7,0
23322134@N02,1598,9,1301435232,1301435232,1,7,0
23322134@N02,1598,20,1301441145,1301441145,1,7,0
23322134@N02,1599,27,1310142937,1310142937,1,3,0
23322134@N02,1599,22,1310138864,1310138864,1,3,0
23322134@N02,1599,17,1310141904,1310141904,1,3,0
23322134@N02,1600,9,1310250862,1310250862,1,2,0
23322134@N02,1600,27,1310245114,1310245114,1,2,0
23322134@N02,1601,4,1331334016,1331334016,1,1,0
23322134@N02,1602,22,1331375810,1331375810,1,1,0
23337755@N02,1603,27,1469960429,1469960429,1,1,0
23380822@N05,1604,27,1385086131,1385108431,50,1,22300
23380822@N05,1605,10,1385262945,1385262945,1,2,0
23380822@N05,1605,2,1385274851,1385274853,13,2,2
23385510@N00,1606,27,1220506244,1220506244,1,1,0
23385510@N00,1607,9,1220576284,1220578453,20,6,2169
23385510@N00,1607,20,1220591762,1220591837,3,6,75
23385510@N00,1607,23,1220594851,1220595335,3,6,484
23385510@N00,1607,14,1220581559,1220583362,4,6,1803
23385510@N00,1607,27,1220597467,1220597766,3,6,299
23385510@N00,1607,24,1220594858,1220594858,1,6,0
23385595@N07,1608,27,1189826388,1189826388,1,1,0
23385595@N07,1609,27,1205988552,1205998671,5,1,10119
23386094@N02,1610,12,1224544014,1224544014,1,1,0
23386796@N00,1611,27,1373179020,1373179020,1,1,0
23400894@N08,1612,27,1419350468,1419350468,1,1,0
23416852@N00,1613,16,1349422561,1349422561,1,1,0
23441093@N02,1614,16,1291295496,1291295496,1,1,0
23492103@N03,1615,19,1223260390,1223260390,1,2,0
23492103@N03,1615,4,1223260060,1223260060,1,2,0
23506877@N07,1616,17,1269139017,1269139017,1,1,0
23531496@N02,1617,10,1407578670,1407578670,1,1,0
23539088@N07,1618,27,1399285965,1399285965,1,1,0
23539088@N07,1619,27,1399337457,1399373961,22,1,36504
23539088@N07,1620,27,1399431254,1399454237,3,1,22983
23539088@N07,1621,27,1399503742,1399554815,81,1,51073
23566994@N06,1622,4,1233275355,1233289609,4,1,14254
23567711@N06,1623,10,1363157732,1363157732,1,2,0
23567711@N06,1623,19,1363149171,1363149171,1,2,0
23573205@N05,1624,14,1278826251,1278826251,1,9,0
23573205@N05,1624,2,1278822586,1278822586,1,9,0
23573205@N05,1624,15,1278828049,1278829217,2,9,1168
23573205@N05,1624,12,1278826976,1278826976,1,9,0
23573205@N05,1624,16,1278826151,1278832052,3,9,5901
23573205@N05,1624,1,1278819863,1278825918,5,9,6055
23573205@N05,1624,27,1278812955,1278814876,3,9,1921
23573205@N05,1624,4,1278815303,1278822897,2,9,7594
23573205@N05,1624,26,1278831022,1278831364,3,9,342
23574966@N04,1625,12,1269366699,1269366699,1,1,0
23594107@N04,1626,22,1289730102,1289766970,6,1,36868
23612601@N07,1627,19,1435207497,1435207497,1,1,0
23673310@N02,1628,27,1199935431,1199939988,26,1,4557
23673310@N02,1629,27,1200082927,1200082927,1,5,0
23673310@N02,1629,16,1200083373,1200083426,2,5,53
23673310@N02,1629,26,1200083572,1200083572,1,5,0
23673310@N02,1629,9,1200083230,1200083329,2,5,99
23673310@N02,1629,4,1200083023,1200108073,3,5,25050
23673310@N02,1630,26,1200172842,1200172905,2,2,63
23673310@N02,1630,5,1200172520,1200172520,1,2,0
23673310@N02,1631,12,1200613654,1200614568,19,10,914
23673310@N02,1631,18,1200621637,1200631660,18,10,10023
23673310@N02,1631,4,1200625508,1200629644,5,10,4136
23673310@N02,1631,15,1200611949,1200613201,4,10,1252
23673310@N02,1631,19,1200619134,1200619134,1,10,0
23673310@N02,1631,13,1200614677,1200615900,5,10,1223
23673310@N02,1631,27,1200606903,1200607006,5,10,103
23673310@N02,1631,6,1200624033,1200624033,1,10,0
23673310@N02,1631,9,1200611524,1200611669,3,10,145
23673310@N02,1631,21,1200617627,1200621395,9,10,3768
23673310@N02,1632,17,1200729060,1200729092,3,5,32
23673310@N02,1632,11,1200726335,1200726869,8,5,534
23673310@N02,1632,27,1200723842,1200723842,1,5,0
23673310@N02,1632,24,1200733536,1200733823,2,5,287
23673310@N02,1632,21,1200732470,1200732896,8,5,426
23673310@N02,1633,2,1202113386,1202113386,1,2,0
23673310@N02,1633,16,1202113140,1202113437,3,2,297
23673310@N02,1634,16,1202677451,1202677451,1,1,0
23673310@N02,1635,11,1204376189,1204376869,18,2,680
23673310@N02,1635,9,1204375896,1204376148,7,2,252
23673310@N02,1636,11,1209286516,1209286536,4,2,20
23673310@N02,1636,3,1209286545,1209286545,1,2,0
23673310@N02,1637,12,1213364629,1213364792,4,7,163
23673310@N02,1637,20,1213357449,1213358188,9,7,739
23673310@N02,1637,17,1213362717,1213369826,33,7,7109
23673310@N02,1637,25,1213352730,1213352942,5,7,212
23673310@N02,1637,24,1213354338,1213354975,5,7,637
23673310@N02,1637,14,1213365377,1213365870,2,7,493
23673310@N02,1637,9,1213369366,1213369366,1,7,0
23673310@N02,1638,1,1213656587,1213656587,1,2,0
23673310@N02,1638,27,1213656977,1213675897,6,2,18920
23673310@N02,1639,12,1292112946,1292113520,7,5,574
23673310@N02,1639,17,1292125860,1292127297,21,5,1437
23673310@N02,1639,15,1292118773,1292118899,2,5,126
23673310@N02,1639,9,1292108958,1292109632,5,5,674
23673310@N02,1639,21,1292121755,1292121764,2,5,9
23673310@N02,1640,27,1292818419,1292819436,43,3,1017
23673310@N02,1640,16,1292839772,1292848057,76,3,8285
23673310@N02,1640,24,1292848404,1292848404,1,3,0
23673310@N02,1641,13,1304148829,1304149747,10,3,918
23673310@N02,1641,10,1304150096,1304150260,3,3,164
23673310@N02,1641,20,1304146949,1304147291,5,3,342
23673310@N02,1642,20,1339507434,1339508350,20,1,916
23673310@N02,1643,23,1339726428,1339726428,1,5,0
23673310@N02,1643,6,1339722394,1339722394,1,5,0
23673310@N02,1643,11,1339721216,1339721216,1,5,0
23673310@N02,1643,26,1339726201,1339726201,1,5,0
23673310@N02,1643,9,1339720784,1339722131,5,5,1347
23673310@N02,1644,27,1414661922,1414673013,8,4,11091
23673310@N02,1644,14,1414670974,1414670974,1,4,0
23673310@N02,1644,9,1414667048,1414667055,3,4,7
23673310@N02,1644,17,1414667845,1414669916,40,4,2071
23673310@N02,1645,10,1415571436,1415571441,2,2,5
23673310@N02,1645,27,1415569436,1415569724,5,2,288
23673310@N02,1646,1,1415617886,1415617906,3,3,20
23673310@N02,1646,16,1415608144,1415616014,109,3,7870
23673310@N02,1646,27,1415604816,1415604843,2,3,27
23673310@N02,1647,27,1415924972,1415931405,2,1,6433
23684642@N08,1648,6,1232683841,1232683841,1,1,0
23684642@N08,1649,6,1241738500,1241746652,3,1,8152
23684642@N08,1650,25,1252980254,1252980254,1,5,0
23684642@N08,1650,18,1252988735,1252989659,3,5,924
23684642@N08,1650,5,1252979036,1252984261,7,5,5225
23684642@N08,1650,24,1252987117,1252987117,1,5,0
23684642@N08,1650,14,1252990742,1252990742,3,5,0
23684642@N08,1651,16,1254039597,1254039597,1,2,0
23684642@N08,1651,5,1254030211,1254030211,1,2,0
23684642@N08,1652,23,1254196862,1254196862,1,5,0
23684642@N08,1652,26,1254197221,1254197221,1,5,0
23684642@N08,1652,18,1254186106,1254186106,1,5,0
23684642@N08,1652,27,1254199517,1254199517,1,5,0
23684642@N08,1652,24,1254207414,1254207414,1,5,0
23684642@N08,1653,2,1259804153,1259804153,1,1,0
23684642@N08,1654,9,1260749233,1260785665,2,4,36432
23684642@N08,1654,27,1260763771,1260763771,1,4,0
23684642@N08,1654,14,1260749603,1260798306,2,4,48703
23684642@N08,1654,17,1260770993,1260770993,1,4,0
23684642@N08,1655,18,1261188522,1261188522,1,4,0
23684642@N08,1655,8,1261193091,1261194142,7,4,1051
23684642@N08,1655,11,1261193110,1261193416,2,4,306
23684642@N08,1655,6,1261196438,1261196438,1,4,0
23684642@N08,1656,13,1264557516,1264557516,1,7,0
23684642@N08,1656,25,1264577090,1264577090,1,7,0
23684642@N08,1656,18,1264562563,1264562563,1,7,0
23684642@N08,1656,4,1264550644,1264550644,1,7,0
23684642@N08,1656,24,1264566767,1264566767,1,7,0
23684642@N08,1656,17,1264569732,1264569732,1,7,0
23684642@N08,1656,2,1264551916,1264551916,1,7,0
23684642@N08,1657,2,1271901990,1271901994,2,2,4
23684642@N08,1657,14,1271910960,1271934441,2,2,23481
23684642@N08,1658,9,1275282880,1275298488,3,4,15608
23684642@N08,1658,26,1275281404,1275281404,1,4,0
23684642@N08,1658,14,1275286567,1275286567,1,4,0
23684642@N08,1658,2,1275295573,1275295573,1,4,0
23684642@N08,1659,16,1275388548,1275388548,2,2,0
23684642@N08,1659,17,1275382861,1275382861,2,2,0
23684642@N08,1660,14,1285131497,1285146915,3,5,15418
23684642@N08,1660,17,1285148499,1285148499,1,5,0
23684642@N08,1660,4,1285147263,1285147263,1,5,0
23684642@N08,1660,2,1285147026,1285147026,1,5,0
23684642@N08,1660,9,1285145247,1285150061,3,5,4814
23684642@N08,1661,9,1287981287,1287981528,2,1,241
23693999@N05,1662,1,1224925899,1224925899,1,1,0
23693999@N05,1663,2,1243292832,1243292832,1,2,0
23693999@N05,1663,3,1243292884,1243292884,1,2,0
23693999@N05,1664,27,1346066327,1346066327,1,1,0
23693999@N05,1665,19,1346293155,1346293185,2,6,30
23693999@N05,1665,9,1346301885,1346302025,2,6,140
23693999@N05,1665,16,1346297080,1346302261,6,6,5181
23693999@N05,1665,5,1346300170,1346300170,1,6,0
23693999@N05,1665,20,1346291549,1346291549,1,6,0
23693999@N05,1665,4,1346298929,1346298929,1,6,0
23693999@N05,1666,6,1346487289,1346487289,1,3,0
23693999@N05,1666,12,1346463800,1346463800,1,3,0
23693999@N05,1666,13,1346466751,1346467045,2,3,294
23693999@N05,1667,1,1346662040,1346662061,2,2,21
23693999@N05,1667,20,1346662137,1346662137,1,2,0
23693999@N05,1668,3,1346910118,1346910118,1,1,0
23716112@N06,1669,27,1408263879,1408263879,1,1,0
23716112@N06,1670,14,1408299655,1408299655,1,1,0
23716112@N06,1671,10,1408587884,1408587931,2,1,47
23716112@N06,1672,26,1408708384,1408708384,1,1,0
23720661@N08,1673,27,1215305685,1215305685,1,1,0
23720661@N08,1674,19,1244356468,1244356468,1,1,0
23720661@N08,1675,8,1244522179,1244522179,1,4,0
23720661@N08,1675,27,1244507326,1244523209,2,4,15883
23720661@N08,1675,16,1244507345,1244507345,1,4,0
23720661@N08,1675,20,1244508256,1244508256,1,4,0
23720661@N08,1676,18,1244765941,1244765941,1,7,0
23720661@N08,1676,21,1244777078,1244777078,1,7,0
23720661@N08,1676,19,1244763501,1244774674,7,7,11173
23720661@N08,1676,3,1244772097,1244772097,1,7,0
23720661@N08,1676,15,1244769197,1244786791,2,7,17594
23720661@N08,1676,13,1244766337,1244766635,3,7,298
23720661@N08,1676,20,1244774390,1244774838,2,7,448
23720661@N08,1677,21,1245202558,1245202712,2,5,154
23720661@N08,1677,27,1245199205,1245199205,1,5,0
23720661@N08,1677,19,1245203809,1245203809,1,5,0
23720661@N08,1677,16,1245199177,1245205785,3,5,6608
23720661@N08,1677,17,1245205395,1245205395,1,5,0
23720661@N08,1678,2,1262496819,1262496819,1,6,0
23720661@N08,1678,23,1262487110,1262487110,1,6,0
23720661@N08,1678,21,1262489291,1262489291,1,6,0
23720661@N08,1678,26,1262491698,1262491698,1,6,0
23720661@N08,1678,27,1262486068,1262510320,4,6,24252
23720661@N08,1678,16,1262510607,1262513219,2,6,2612
23720661@N08,1679,13,1262661973,1262661973,1,5,0
23720661@N08,1679,27,1262653558,1262653558,1,5,0
23720661@N08,1679,19,1262654191,1262654195,2,5,4
23720661@N08,1679,3,1262657319,1262657537,2,5,218
23720661@N08,1679,20,1262653982,1262653982,1,5,0
23720661@N08,1680,26,1262854947,1262854947,1,4,0
23720661@N08,1680,2,1262850212,1262850212,1,4,0
23720661@N08,1680,5,1262853110,1262853110,1,4,0
23720661@N08,1680,14,1262852412,1262852412,1,4,0
23720661@N08,1681,16,1262911471,1262911471,1,3,0
23720661@N08,1681,15,1262913831,1262913831,1,3,0
23720661@N08,1681,13,1262915874,1262915874,1,3,0
23720661@N08,1682,27,1263013894,1263013894,1,4,0
23720661@N08,1682,2,1263005640,1263005640,1,4,0
23720661@N08,1682,1,1263005667,1263005667,1,4,0
23720661@N08,1682,21,1263011357,1263011544,2,4,187
23720661@N08,1683,27,1275200233,1275200233,1,5,0
23720661@N08,1683,20,1275185619,1275191643,3,5,6024
23720661@N08,1683,24,1275193120,1275193425,2,5,305
23720661@N08,1683,21,1275189559,1275190365,2,5,806
23720661@N08,1683,13,1275197024,1275197024,1,5,0
23720661@N08,1684,22,1275470889,1275470889,1,7,0
23720661@N08,1684,16,1275462635,1275462635,1,7,0
23720661@N08,1684,27,1275461979,1275462328,5,7,349
23720661@N08,1684,18,1275470064,1275470099,2,7,35
23720661@N08,1684,14,1275474266,1275474266,1,7,0
23720661@N08,1684,21,1275471606,1275471606,1,7,0
23720661@N08,1684,13,1275469587,1275469587,1,7,0
23720661@N08,1685,26,1275621278,1275621278,1,5,0
23720661@N08,1685,20,1275621391,1275621391,1,5,0
23720661@N08,1685,27,1275617745,1275617745,1,5,0
23720661@N08,1685,18,1275622457,1275622457,1,5,0
23720661@N08,1685,21,1275620479,1275620479,1,5,0
23720661@N08,1686,22,1275810100,1275810100,1,5,0
23720661@N08,1686,26,1275809792,1275809792,1,5,0
23720661@N08,1686,17,1275809945,1275809945,1,5,0
23720661@N08,1686,2,1275801380,1275804196,2,5,2816
23720661@N08,1686,27,1275798126,1275798126,1,5,0
23720661@N08,1687,18,1301969608,1301969608,1,1,0
23720661@N08,1688,3,1307084481,1307084617,2,9,136
23720661@N08,1688,4,1307086308,1307086308,2,9,0
23720661@N08,1688,26,1307074453,1307074453,1,9,0
23720661@N08,1688,17,1307074384,1307074384,1,9,0
23720661@N08,1688,24,1307068014,1307070999,5,9,2985
23720661@N08,1688,27,1307064779,1307064943,3,9,164
23720661@N08,1688,18,1307075078,1307083476,3,9,8398
23720661@N08,1688,21,1307067428,1307079373,2,9,11945
23720661@N08,1688,13,1307072185,1307072185,1,9,0
23720661@N08,1689,19,1307241466,1307241466,1,6,0
23720661@N08,1689,16,1307235464,1307247635,5,6,12171
23720661@N08,1689,26,1307240274,1307240274,1,6,0
23720661@N08,1689,17,1307240351,1307240351,1,6,0
23720661@N08,1689,18,1307242917,1307242917,1,6,0
23720661@N08,1689,13,1307238132,1307242072,4,6,3940
23720661@N08,1690,25,1307434420,1307435782,2,3,1362
23720661@N08,1690,19,1307430545,1307430545,1,3,0
23720661@N08,1690,16,1307436206,1307436206,1,3,0
23720661@N08,1691,2,1307507358,1307507358,1,7,0
23720661@N08,1691,27,1307496681,1307514114,3,7,17433
23720661@N08,1691,14,1307503786,1307503786,1,7,0
23720661@N08,1691,13,1307501007,1307501007,1,7,0
23720661@N08,1691,22,1307498152,1307498152,1,7,0
23720661@N08,1691,4,1307507703,1307507703,1,7,0
23720661@N08,1691,16,1307507627,1307507776,2,7,149
23720661@N08,1692,25,1331008622,1331008622,1,9,0
23720661@N08,1692,24,1331014478,1331014523,2,9,45
23720661@N08,1692,27,1330993976,1331016277,3,9,22301
23720661@N08,1692,21,1330997029,1331008123,3,9,11094
23720661@N08,1692,3,1331011139,1331012775,3,9,1636
23720661@N08,1692,22,1331001555,1331005059,2,9,3504
23720661@N08,1692,4,1331009540,1331013493,2,9,3953
23720661@N08,1692,16,1331013736,1331015986,3,9,2250
23720661@N08,1692,20,1330994310,1330995215,3,9,905
23720661@N08,1693,2,1331258143,1331285253,7,13,27110
23720661@N08,1693,27,1331248959,1331286447,4,13,37488
23720661@N08,1693,5,1331285333,1331285333,1,13,0
23720661@N08,1693,18,1331250199,1331254251,6,13,4052
23720661@N08,1693,6,1331259238,1331259238,1,13,0
23720661@N08,1693,1,1331259300,1331263483,3,13,4183
23720661@N08,1693,13,1331250114,1331251357,7,13,1243
23720661@N08,1693,3,1331260324,1331260324,1,13,0
23720661@N08,1693,22,1331249765,1331254099,2,13,4334
23720661@N08,1693,4,1331262569,1331285701,4,13,23132
23720661@N08,1693,16,1331257608,1331282063,3,13,24455
23720661@N08,1693,26,1331253714,1331253714,1,13,0
23720661@N08,1693,17,1331254112,1331257752,4,13,3640
23720661@N08,1694,27,1331430023,1331430023,1,6,0
23720661@N08,1694,18,1331433393,1331433405,2,6,12
23720661@N08,1694,21,1331434863,1331435024,6,6,161
23720661@N08,1694,13,1331437284,1331437284,1,6,0
23720661@N08,1694,15,1331437911,1331437911,1,6,0
23720661@N08,1694,17,1331438382,1331438382,1,6,0
23720661@N08,1695,27,1369446027,1369448988,4,8,2961
23720661@N08,1695,18,1369453964,1369456421,2,8,2457
23720661@N08,1695,14,1369457843,1369457843,1,8,0
23720661@N08,1695,21,1369447338,1369447338,1,8,0
23720661@N08,1695,13,1369449985,1369451598,2,8,1613
23720661@N08,1695,11,1369448270,1369448270,1,8,0
23720661@N08,1695,19,1369447843,1369456006,11,8,8163
23720661@N08,1695,16,1369457837,1369457837,1,8,0
23720661@N08,1696,27,1369534894,1369534894,1,9,0
23720661@N08,1696,18,1369550862,1369550862,1,9,0
23720661@N08,1696,21,1369556435,1369556435,1,9,0
23720661@N08,1696,13,1369550500,1369551409,2,9,909
23720661@N08,1696,3,1369543759,1369543759,1,9,0
23720661@N08,1696,4,1369549967,1369549967,1,9,0
23720661@N08,1696,16,1369535226,1369535226,1,9,0
23720661@N08,1696,26,1369535737,1369535737,1,9,0
23720661@N08,1696,17,1369541400,1369541400,1,9,0
23720661@N08,1697,27,1369711560,1369711560,1,1,0
23720661@N08,1698,5,1369972790,1369972790,1,7,0
23720661@N08,1698,18,1369965539,1369965539,1,7,0
23720661@N08,1698,9,1369968557,1369968557,1,7,0
23720661@N08,1698,21,1369963585,1369964900,6,7,1315
23720661@N08,1698,26,1369965688,1369965924,3,7,236
23720661@N08,1698,15,1369968321,1369968321,1,7,0
23720661@N08,1698,17,1369965569,1369965569,1,7,0
23727506@N07,1699,17,1241078652,1241078652,1,1,0
23727506@N07,1700,26,1323942095,1323942419,2,1,324
23809141@N05,1701,16,1277521498,1277521498,1,1,0
23809141@N05,1702,16,1277637982,1277637982,1,1,0
23813932@N07,1703,27,1342774249,1342774249,1,1,0
23828731@N02,1704,1,1226471854,1226471894,5,11,40
23828731@N02,1704,6,1226468964,1226469395,3,11,431
23828731@N02,1704,14,1226454626,1226465121,5,11,10495
23828731@N02,1704,27,1226445719,1226445719,1,11,0
23828731@N02,1704,8,1226468046,1226468076,2,11,30
23828731@N02,1704,20,1226452386,1226452397,2,11,11
23828731@N02,1704,4,1226476268,1226476291,3,11,23
23828731@N02,1704,3,1226472444,1226473773,8,11,1329
23828731@N02,1704,12,1226454633,1226454895,3,11,262
23828731@N02,1704,2,1226470122,1226470146,2,11,24
23828731@N02,1704,5,1226473914,1226473943,2,11,29
23828731@N02,1705,1,1340605664,1340605889,6,7,225
23828731@N02,1705,17,1340607153,1340607187,3,7,34
23828731@N02,1705,23,1340606617,1340606617,1,7,0
23828731@N02,1705,22,1340606983,1340606983,1,7,0
23828731@N02,1705,4,1340605956,1340605956,1,7,0
23828731@N02,1705,5,1340605895,1340605914,2,7,19
23828731@N02,1705,16,1340600286,1340601862,2,7,1576
23828731@N02,1706,9,1341312159,1341312652,4,6,493
23828731@N02,1706,15,1341311908,1341311908,1,6,0
23828731@N02,1706,17,1341306776,1341307857,4,6,1081
23828731@N02,1706,14,1341311952,1341311992,2,6,40
23828731@N02,1706,27,1341305674,1341305674,1,6,0
23828731@N02,1706,26,1341306768,1341306799,2,6,31
23828731@N02,1707,27,1344841055,1344841055,1,1,0
23828731@N02,1708,27,1347266939,1347266939,1,1,0
23828731@N02,1709,10,1350527182,1350535622,117,1,8440
23828731@N02,1710,1,1353226203,1353226203,1,4,0
23828731@N02,1710,22,1353229432,1353229432,1,4,0
23828731@N02,1710,27,1353225514,1353225514,1,4,0
23828731@N02,1710,10,1353227763,1353227763,1,4,0
23828731@N02,1711,1,1363508548,1363508548,1,1,0
23828731@N02,1712,1,1366270854,1366270854,1,3,0
23828731@N02,1712,16,1366273030,1366273080,4,3,50
23828731@N02,1712,27,1366267749,1366268501,2,3,752
23828731@N02,1713,27,1367464398,1367464497,4,1,99
23833168@N04,1714,13,1222660690,1222661781,4,9,1091
23833168@N04,1714,20,1222659436,1222659436,1,9,0
23833168@N04,1714,19,1222659486,1222660181,10,9,695
23833168@N04,1714,27,1222656401,1222656495,2,9,94
23833168@N04,1714,6,1222657402,1222657408,2,9,6
23833168@N04,1714,22,1222660387,1222660387,1,9,0
23833168@N04,1714,9,1222665086,1222665317,5,9,231
23833168@N04,1714,23,1222658449,1222658449,1,9,0
23833168@N04,1714,21,1222658530,1222658530,1,9,0
23833168@N04,1715,5,1354613652,1354614179,5,8,527
23833168@N04,1715,4,1354608358,1354608358,1,8,0
23833168@N04,1715,8,1354609222,1354610085,7,8,863
23833168@N04,1715,27,1354606850,1354607864,3,8,1014
23833168@N04,1715,22,1354606284,1354606284,1,8,0
23833168@N04,1715,7,1354608948,1354613578,7,8,4630
23833168@N04,1715,23,1354605855,1354605855,1,8,0
23833168@N04,1715,14,1354607279,1354608198,4,8,919
23833168@N04,1716,8,1354861250,1354871113,36,4,9863
23833168@N04,1716,27,1354857065,1354857065,1,4,0
23833168@N04,1716,3,1354859494,1354860833,14,4,1339
23833168@N04,1716,11,1354861244,1354861244,1,4,0
23833168@N04,1717,17,1355293375,1355293388,3,8,13
23833168@N04,1717,8,1355293494,1355293504,3,8,10
23833168@N04,1717,27,1355299265,1355300650,47,8,1385
23833168@N04,1717,25,1355291641,1355291854,5,8,213
23833168@N04,1717,7,1355293509,1355293974,3,8,465
23833168@N04,1717,9,1355283130,1355302668,21,8,19538
23833168@N04,1717,21,1355308189,1355310427,4,8,2238
23833168@N04,1717,14,1355305350,1355305357,2,8,7
23833168@N04,1718,7,1355463322,1355463335,2,4,13
23833168@N04,1718,1,1355470760,1355471136,6,4,376
23833168@N04,1718,6,1355470746,1355470754,2,4,8
23833168@N04,1718,14,1355467438,1355469737,6,4,2299
23870387@N06,1719,9,1294068445,1294068445,1,1,0
23942903@N00,1720,15,1326586399,1326586399,1,6,0
23942903@N00,1720,9,1326598413,1326598446,2,6,33
23942903@N00,1720,4,1326600175,1326600175,1,6,0
23942903@N00,1720,6,1326596995,1326597008,2,6,13
23942903@N00,1720,27,1326573195,1326575514,2,6,2319
23942903@N00,1720,5,1326596929,1326596929,1,6,0
23942903@N00,1721,27,1326832660,1326832660,1,1,0
23942903@N00,1722,22,1326938674,1326938784,4,6,110
23942903@N00,1722,27,1326946404,1326946861,6,6,457
23942903@N00,1722,16,1326954123,1326954317,2,6,194
23942903@N00,1722,25,1326954873,1326954873,1,6,0
23942903@N00,1722,18,1326941060,1326941060,1,6,0
23942903@N00,1722,14,1326928963,1326929039,2,6,76
23953488@N03,1723,27,1226873900,1226873900,1,1,0
23966768@N03,1724,14,1369030640,1369030640,1,1,0
23966768@N03,1725,12,1403424606,1403424606,1,3,0
23966768@N03,1725,26,1403435728,1403436288,4,3,560
23966768@N03,1725,14,1403403546,1403427859,4,3,24313
23980087@N02,1726,27,1356385223,1356385223,1,1,0
24004706@N00,1727,19,1208273639,1208273726,2,6,87
24004706@N00,1727,25,1208269971,1208269971,1,6,0
24004706@N00,1727,18,1208273196,1208274412,3,6,1216
24004706@N00,1727,14,1208280892,1208280892,1,6,0
24004706@N00,1727,27,1208269058,1208269058,1,6,0
24004706@N00,1727,23,1208270376,1208271914,4,6,1538
24021297@N00,1728,16,1338605007,1338605007,1,1,0
24021297@N00,1729,3,1338813942,1338813942,1,1,0
24021297@N00,1730,27,1343395761,1343396213,2,3,452
24021297@N00,1730,1,1343401805,1343401805,1,3,0
24021297@N00,1730,19,1343400588,1343400588,1,3,0
24021297@N00,1731,27,1350371115,1350371731,3,1,616
24021297@N00,1732,27,1355570267,1355570267,1,2,0
24021297@N00,1732,17,1355564273,1355564273,1,2,0
24021297@N00,1733,14,1371262485,1371262485,1,1,0
24042252@N05,1734,14,1304233388,1304245929,7,3,12541
24042252@N05,1734,27,1304221577,1304222311,2,3,734
24042252@N05,1734,4,1304222861,1304233185,7,3,10324
24048284@N02,1735,3,1204258396,1204258493,2,7,97
24048284@N02,1735,22,1204264036,1204264036,1,7,0
24048284@N02,1735,1,1204263767,1204263875,4,7,108
24048284@N02,1735,4,1204256503,1204256503,1,7,0
24048284@N02,1735,27,1204243785,1204264095,2,7,20310
24048284@N02,1735,2,1204256593,1204256593,1,7,0
24048284@N02,1735,25,1204263947,1204263947,1,7,0
24083444@N03,1736,20,1192233664,1192233664,1,1,0
24083444@N03,1737,14,1309297607,1309297607,1,1,0
24107582@N06,1738,2,1233485023,1233485023,1,1,0
24113932@N04,1739,27,1390041622,1390042201,3,6,579
24113932@N04,1739,16,1390035031,1390041376,2,6,6345
24113932@N04,1739,13,1390040377,1390040377,1,6,0
24113932@N04,1739,2,1390029639,1390032727,5,6,3088
24113932@N04,1739,9,1390032941,1390032941,1,6,0
24113932@N04,1739,8,1390033523,1390033523,1,6,0
24143798@N08,1740,16,1199609042,1199616604,9,3,7562
24143798@N08,1740,9,1199612635,1199612635,1,3,0
24143798@N08,1740,27,1199608776,1199608938,3,3,162
24143798@N08,1741,9,1418462619,1418462619,1,1,0
24152284@N06,1742,9,1211220193,1211220193,1,3,0
24152284@N06,1742,11,1211225405,1211225569,2,3,164
24152284@N06,1742,21,1211210724,1211210724,1,3,0
24153575@N00,1743,20,1239959963,1239959963,1,1,0
24153575@N00,1744,13,1240392788,1240392788,1,1,0
24153575@N00,1745,13,1257325935,1257325935,1,1,0
24153575@N00,1746,16,1302394268,1302394268,1,1,0
24153575@N00,1747,18,1408159435,1408159435,1,1,0
24230954@N06,1748,27,1265844967,1265844967,1,1,0
24232695@N00,1749,12,1325204265,1325204265,1,1,0
24232695@N00,1750,4,1325251626,1325251637,2,4,11
24232695@N00,1750,5,1325245713,1325251910,17,4,6197
24232695@N00,1750,17,1325243401,1325243401,1,4,0
24232695@N00,1750,9,1325249743,1325249919,5,4,176
24232695@N00,1751,5,1325568698,1325568720,2,1,22
24254019@N08,1752,16,1217592196,1217592679,5,1,483
24276365@N03,1753,11,1388373385,1388373385,1,5,0
24276365@N03,1753,5,1388360772,1388360772,1,5,0
24276365@N03,1753,15,1388368880,1388368880,1,5,0
24276365@N03,1753,16,1388363106,1388363106,1,5,0
24276365@N03,1753,3,1388356920,1388356920,1,5,0
24306356@N00,1754,16,1386043383,1386043383,1,6,0
24306356@N00,1754,20,1386040458,1386040458,1,6,0
24306356@N00,1754,3,1386031194,1386031194,1,6,0
24306356@N00,1754,26,1386036020,1386036020,1,6,0
24306356@N00,1754,23,1386037153,1386037153,1,6,0
24306356@N00,1754,27,1386019945,1386019945,1,6,0
24309093@N06,1755,16,1373262343,1373262343,1,2,0
24309093@N06,1755,19,1373255272,1373255272,1,2,0
24332304@N08,1756,2,1272684369,1272684369,1,1,0
24364870@N00,1757,19,1277020331,1277020331,1,2,0
24364870@N00,1757,14,1277015664,1277015664,1,2,0
24385217@N00,1758,27,1238504400,1238504400,1,1,0
24386268@N05,1759,6,1205050617,1205050617,1,4,0
24386268@N05,1759,21,1205058290,1205058290,1,4,0
24386268@N05,1759,14,1205035967,1205042032,4,4,6065
24386268@N05,1759,27,1205034915,1205035059,2,4,144
24386374@N00,1760,16,1378178051,1378206721,6,1,28670
24386374@N00,1761,16,1378259531,1378279078,18,1,19547
24386374@N00,1762,16,1378430969,1378442997,7,1,12028
24391317@N05,1763,14,1252733156,1252733156,1,1,0
24435279@N00,1764,27,1193553367,1193553399,5,1,32
24435279@N00,1765,26,1203137301,1203137307,2,4,6
24435279@N00,1765,20,1203144540,1203146402,20,4,1862
24435279@N00,1765,27,1203147498,1203152474,14,4,4976
24435279@N00,1765,21,1203146488,1203146539,7,4,51
24435279@N00,1766,26,1205642600,1205642600,1,8,0
24435279@N00,1766,20,1205642597,1205642599,4,8,2
24435279@N00,1766,9,1205642644,1205642649,6,8,5
24435279@N00,1766,1,1205642641,1205642643,3,8,2
24435279@N00,1766,27,1205642656,1205642656,1,8,0
24435279@N00,1766,5,1205642638,1205642644,5,8,6
24435279@N00,1766,14,1205642650,1205642659,3,8,9
24435279@N00,1766,13,1205642651,1205642655,4,8,4
24435279@N00,1767,9,1208737688,1208743188,6,8,5500
24435279@N00,1767,15,1208743489,1208743495,3,8,6
24435279@N00,1767,1,1208739864,1208739905,4,8,41
24435279@N00,1767,8,1208742413,1208742514,9,8,101
24435279@N00,1767,11,1208742965,1208742987,3,8,22
24435279@N00,1767,22,1208738949,1208745049,6,8,6100
24435279@N00,1767,14,1208737810,1208743313,6,8,5503
24435279@N00,1767,6,1208737151,1208737174,3,8,23
24435279@N00,1768,4,1217590845,1217590845,1,4,0
24435279@N00,1768,27,1217595384,1217595461,5,4,77
24435279@N00,1768,5,1217590875,1217590913,4,4,38
24435279@N00,1768,13,1217593625,1217593649,3,4,24
24435279@N00,1769,26,1217645950,1217647835,19,6,1885
24435279@N00,1769,20,1217652619,1217653667,13,6,1048
24435279@N00,1769,3,1217657708,1217657876,11,6,168
24435279@N00,1769,27,1217640063,1217640507,7,6,444
24435279@N00,1769,5,1217657994,1217658035,4,6,41
24435279@N00,1769,21,1217651019,1217651498,9,6,479
24435279@N00,1770,3,1222825179,1222825179,1,3,0
24435279@N00,1770,27,1222845297,1222845426,4,3,129
24435279@N00,1770,26,1222823053,1222823062,2,3,9
24435279@N00,1771,20,1224225619,1224225643,3,2,24
24435279@N00,1771,1,1224224838,1224224857,3,2,19
24435279@N00,1772,4,1224306727,1224306797,2,4,70
24435279@N00,1772,27,1224293013,1224294332,5,4,1319
24435279@N00,1772,19,1224302023,1224302030,2,4,7
24435279@N00,1772,20,1224297320,1224302054,4,4,4734
24435279@N00,1773,3,1237616591,1237616598,6,3,7
24435279@N00,1773,4,1237615714,1237615738,4,3,24
24435279@N00,1773,1,1237616497,1237616574,16,3,77
24435279@N00,1774,14,1237700117,1237700550,16,2,433
24435279@N00,1774,26,1237694549,1237696255,3,2,1706
24435279@N00,1775,11,1240660735,1240660735,1,4,0
24435279@N00,1775,27,1240665352,1240665450,9,4,98
24435279@N00,1775,2,1240660208,1240660261,4,4,53
24435279@N00,1775,1,1240660430,1240660487,3,4,57
24435279@N00,1776,14,1241253502,1241253564,5,4,62
24435279@N00,1776,13,1241257071,1241257405,5,4,334
24435279@N00,1776,21,1241248353,1241248376,4,4,23
24435279@N00,1776,19,1241256908,1241257043,21,4,135
24435279@N00,1777,4,1241333940,1241333943,2,4,3
24435279@N00,1777,27,1241333542,1241343891,4,4,10349
24435279@N00,1777,2,1241334267,1241334273,2,4,6
24435279@N00,1777,19,1241338084,1241338111,6,4,27
24496852@N00,1778,13,1328090453,1328090453,1,1,0
24496852@N00,1779,13,1328371946,1328371946,1,2,0
24496852@N00,1779,16,1328367923,1328367923,1,2,0
24503701@N02,1780,9,1330825817,1330825817,1,1,0
24519194@N08,1781,2,1380961615,1380961615,1,2,0
24519194@N08,1781,25,1380964463,1380964463,1,2,0
24519194@N08,1782,27,1381316236,1381316236,1,1,0
24519194@N08,1783,27,1381578179,1381584282,2,1,6103
24568538@N00,1784,27,1305407465,1305416243,5,1,8778
24616128@N00,1785,18,1286155244,1286157841,6,12,2597
24616128@N00,1785,20,1286147088,1286147088,1,12,0
24616128@N00,1785,14,1286192628,1286192867,3,12,239
24616128@N00,1785,13,1286155169,1286155169,1,12,0
24616128@N00,1785,19,1286144952,1286159423,7,12,14471
24616128@N00,1785,25,1286187971,1286190852,11,12,2881
24616128@N00,1785,4,1286181590,1286181639,3,12,49
24616128@N00,1785,24,1286149172,1286149528,6,12,356
24616128@N00,1785,23,1286150648,1286151639,4,12,991
24616128@N00,1785,27,1286141326,1286142192,2,12,866
24616128@N00,1785,16,1286193029,1286193029,1,12,0
24616128@N00,1785,11,1286160006,1286161292,7,12,1286
24616128@N00,1786,17,1286354381,1286358523,29,1,4142
24626151@N06,1787,16,1445753606,1445753606,1,1,0
24638406@N08,1788,27,1377389883,1377389883,1,1,0
24638406@N08,1789,20,1377952105,1377952105,1,1,0
24640659@N05,1790,10,1188090340,1188090523,2,1,183
24640659@N05,1791,10,1188129777,1188129917,4,1,140
24675445@N00,1792,2,1352074614,1352077828,2,1,3214
24701440@N07,1793,16,1215591544,1215591544,1,2,0
24701440@N07,1793,27,1215591547,1215591547,1,2,0
24704473@N07,1794,27,1189319151,1189319180,4,5,29
24704473@N07,1794,24,1189323139,1189323410,7,5,271
24704473@N07,1794,19,1189322427,1189322427,1,5,0
24704473@N07,1794,23,1189319738,1189319738,1,5,0
24704473@N07,1794,21,1189319730,1189324720,3,5,4990
24704473@N07,1795,27,1189650441,1189651449,13,13,1008
24704473@N07,1795,3,1189636083,1189638170,16,13,2087
24704473@N07,1795,9,1189640159,1189640664,10,13,505
24704473@N07,1795,1,1189650213,1189650213,1,13,0
24704473@N07,1795,18,1189645138,1189645533,3,13,395
24704473@N07,1795,17,1189645138,1189649985,9,13,4847
24704473@N07,1795,14,1189640772,1189650208,5,13,9436
24704473@N07,1795,15,1189642510,1189647580,3,13,5070
24704473@N07,1795,5,1189638199,1189640105,6,13,1906
24704473@N07,1795,12,1189642503,1189644482,10,13,1979
24704473@N07,1795,13,1189645280,1189647466,8,13,2186
24704473@N07,1795,4,1189638170,1189640203,3,13,2033
24704473@N07,1795,2,1189638016,1189638151,3,13,135
24704473@N07,1796,27,1233040332,1233040332,1,1,0
24704473@N07,1797,4,1237797642,1237797642,1,23,0
24704473@N07,1797,22,1237783348,1237790538,7,23,7190
24704473@N07,1797,25,1237791137,1237797481,30,23,6344
24704473@N07,1797,27,1237798530,1237800108,14,23,1578
24704473@N07,1797,24,1237795957,1237796393,7,23,436
24704473@N07,1797,6,1237765823,1237766503,3,23,680
24704473@N07,1797,3,1237766884,1237769500,22,23,2616
24704473@N07,1797,1,1237766516,1237769757,4,23,3241
24704473@N07,1797,9,1237765711,1237776409,8,23,10698
24704473@N07,1797,20,1237782890,1237784889,6,23,1999
24704473@N07,1797,7,1237765289,1237765632,6,23,343
24704473@N07,1797,26,1237782733,1237794734,19,23,12001
24704473@N07,1797,8,1237764739,1237765313,12,23,574
24704473@N07,1797,5,1237770131,1237773058,5,23,2927
24704473@N07,1797,18,1237780710,1237781048,2,23,338
24704473@N07,1797,17,1237780627,1237783058,10,23,2431
24704473@N07,1797,14,1237776787,1237776873,2,23,86
24704473@N07,1797,21,1237786290,1237789175,17,23,2885
24704473@N07,1797,15,1237780503,1237781018,3,23,515
24704473@N07,1797,23,1237789315,1237794999,21,23,5684
24704473@N07,1797,12,1237779408,1237780213,11,23,805
24704473@N07,1797,13,1237781232,1237782257,10,23,1025
24704473@N07,1797,2,1237766397,1237797433,10,23,31036
24704473@N07,1798,4,1238027492,1238033290,11,19,5798
24704473@N07,1798,22,1238021442,1238023445,8,19,2003
24704473@N07,1798,25,1238016154,1238029708,2,19,13554
24704473@N07,1798,27,1238034589,1238035150,9,19,561
24704473@N07,1798,3,1238027399,1238028416,2,19,1017
24704473@N07,1798,9,1238017787,1238017787,1,19,0
24704473@N07,1798,20,1238018710,1238023419,13,19,4709
24704473@N07,1798,1,1238027021,1238033596,5,19,6575
24704473@N07,1798,26,1238018658,1238022913,14,19,4255
24704473@N07,1798,8,1238026703,1238026932,5,19,229
24704473@N07,1798,5,1238027269,1238028441,3,19,1172
24704473@N07,1798,19,1238023512,1238026407,16,19,2895
24704473@N07,1798,14,1238016378,1238018242,17,19,1864
24704473@N07,1798,16,1238016371,1238034177,3,19,17806
24704473@N07,1798,15,1238016600,1238018454,10,19,1854
24704473@N07,1798,23,1238031540,1238031547,2,19,7
24704473@N07,1798,12,1238016993,1238017365,8,19,372
24704473@N07,1798,21,1238031796,1238031833,3,19,37
24704473@N07,1798,2,1238027459,1238028202,5,19,743
24733811@N04,1799,14,1218344781,1218344781,1,2,0
24733811@N04,1799,9,1218342724,1218343573,3,2,849
24733811@N04,1800,8,1218444874,1218444889,2,1,15
24733811@N04,1801,9,1218504993,1218504993,1,2,0
24733811@N04,1801,16,1218508465,1218511358,2,2,2893
24733811@N04,1802,20,1218763929,1218763929,1,1,0
24733811@N04,1803,9,1247278273,1247278273,1,1,0
24733811@N04,1804,14,1247309125,1247309125,1,1,0
24738734@N00,1805,27,1228281718,1228281718,1,1,0
24738911@N08,1806,26,1218887187,1218887187,1,1,0
24738911@N08,1807,13,1221217998,1221217998,1,1,0
24738911@N08,1808,27,1254458508,1254459530,5,1,1022
24738911@N08,1809,27,1264977900,1264977900,1,1,0
24738911@N08,1810,26,1266301968,1266301968,1,1,0
24738911@N08,1811,27,1297057448,1297057448,1,1,0
24738911@N08,1812,16,1309899169,1309903139,2,1,3970
24738911@N08,1813,27,1313579294,1313579294,1,1,0
24738911@N08,1814,24,1331761301,1331761301,1,1,0
24738911@N08,1815,21,1365628702,1365628702,1,1,0
24745847@N00,1816,19,1330388043,1330388043,1,1,0
24745847@N00,1817,27,1330753302,1330753302,1,1,0
24745847@N00,1818,17,1362191352,1362191416,2,1,64
24751464@N06,1819,14,1385803638,1385804340,7,1,702
24756124@N02,1820,27,1357857724,1357857724,1,1,0
24767349@N02,1821,16,1208005290,1208005803,3,1,513
24771256@N00,1822,27,1275443311,1275443343,2,3,32
24771256@N00,1822,16,1275443566,1275443591,2,3,25
24771256@N00,1822,17,1275443527,1275443527,1,3,0
24850040@N07,1823,17,1244974249,1244974249,1,1,0
24850040@N07,1824,21,1245234123,1245244965,7,4,10842
24850040@N07,1824,4,1245242504,1245242689,2,4,185
24850040@N07,1824,26,1245243545,1245243545,1,4,0
24850040@N07,1824,1,1245240108,1245240108,1,4,0
24850040@N07,1825,18,1245295673,1245298183,3,6,2510
24850040@N07,1825,19,1245297008,1245297962,4,6,954
24850040@N07,1825,8,1245294990,1245294990,1,6,0
24850040@N07,1825,1,1245293439,1245293453,2,6,14
24850040@N07,1825,2,1245293311,1245293311,1,6,0
24850040@N07,1825,17,1245296023,1245296023,1,6,0
24850040@N07,1826,26,1249994150,1249994150,1,3,0
24850040@N07,1826,21,1249994194,1249994194,1,3,0
24850040@N07,1826,2,1249994334,1249994334,1,3,0
24850040@N07,1827,3,1412140276,1412140276,1,5,0
24850040@N07,1827,4,1412140073,1412140788,3,5,715
24850040@N07,1827,27,1412143725,1412144234,6,5,509
24850040@N07,1827,10,1412141621,1412141621,1,5,0
24850040@N07,1827,17,1412142368,1412142368,1,5,0
24872311@N07,1828,27,1317426368,1317426385,2,3,17
24872311@N07,1828,9,1317438014,1317438014,1,3,0
24872311@N07,1828,6,1317436238,1317436238,1,3,0
24872311@N07,1829,27,1317631622,1317631635,2,2,13
24872311@N07,1829,16,1317635296,1317644304,3,2,9008
24884155@N08,1830,27,1336550995,1336550995,1,1,0
24889779@N03,1831,12,1253087562,1253087562,1,2,0
24889779@N03,1831,20,1253087591,1253087602,11,2,11
24889779@N03,1832,12,1254702073,1254707131,3,1,5058
24889779@N03,1833,20,1254892907,1254892907,1,1,0
24897645@N04,1834,27,1207197460,1207197460,1,1,0
24897645@N04,1835,21,1207360673,1207360673,1,1,0
24897645@N04,1836,16,1208675201,1208675379,4,1,178
24897645@N04,1837,11,1209097618,1209097744,2,1,126
24897645@N04,1838,21,1210832560,1210832560,1,2,0
24897645@N04,1838,16,1210834835,1210835269,10,2,434
24897645@N04,1839,9,1211290293,1211290317,3,1,24
24897645@N04,1840,27,1211494568,1211494568,1,2,0
24897645@N04,1840,2,1211494569,1211494569,1,2,0
24897645@N04,1841,16,1211698272,1211698571,6,1,299
24897645@N04,1842,16,1212047564,1212052658,17,1,5094
24897645@N04,1843,16,1212465873,1212475457,2,1,9584
24897645@N04,1844,21,1212563384,1212585300,3,3,21916
24897645@N04,1844,9,1212581939,1212581939,1,3,0
24897645@N04,1844,14,1212578642,1212578642,1,3,0
24897645@N04,1845,21,1212819013,1212819013,1,1,0
24897645@N04,1846,18,1213590374,1213590374,1,1,0
24897645@N04,1847,27,1214196532,1214199000,8,1,2468
24897645@N04,1848,16,1214376115,1214384097,7,2,7982
24897645@N04,1848,1,1214378731,1214378731,1,2,0
24897645@N04,1849,21,1214896041,1214896041,1,1,0
24897645@N04,1850,15,1215073241,1215073241,1,4,0
24897645@N04,1850,4,1215071885,1215071885,1,4,0
24897645@N04,1850,21,1215068922,1215068922,1,4,0
24897645@N04,1850,16,1215074594,1215075228,46,4,634
24897645@N04,1851,16,1215401341,1215401341,1,1,0
24897645@N04,1852,27,1216177124,1216177138,2,2,14
24897645@N04,1852,17,1216191630,1216191630,1,2,0
24897645@N04,1853,17,1217467657,1217467657,1,1,0
24897645@N04,1854,16,1217646200,1217646833,19,2,633
24897645@N04,1854,1,1217649303,1217649303,1,2,0
24897645@N04,1855,22,1217824664,1217824664,1,4,0
24897645@N04,1855,16,1217804686,1217804686,1,4,0
24897645@N04,1855,21,1217809327,1217809327,1,4,0
24897645@N04,1855,14,1217806318,1217806318,1,4,0
24897645@N04,1856,17,1218258808,1218258957,3,2,149
24897645@N04,1856,16,1218264229,1218268301,16,2,4072
24897645@N04,1857,21,1218353173,1218353173,1,1,0
24897645@N04,1858,16,1218437679,1218441288,23,1,3609
24897645@N04,1859,21,1218611464,1218612685,9,1,1221
24897645@N04,1860,16,1218793735,1218797091,7,1,3356
24897645@N04,1861,27,1219662168,1219662173,2,1,5
24897645@N04,1862,21,1223015057,1223018280,6,4,3223
24897645@N04,1862,20,1223010272,1223010272,1,4,0
24897645@N04,1862,27,1223004454,1223012411,26,4,7957
24897645@N04,1862,16,1223018996,1223024090,94,4,5094
24897645@N04,1863,8,1223127681,1223127966,2,7,285
24897645@N04,1863,21,1223104180,1223128129,6,7,23949
24897645@N04,1863,9,1223122002,1223122002,1,7,0
24897645@N04,1863,11,1223115541,1223129796,3,7,14255
24897645@N04,1863,14,1223133973,1223133982,2,7,9
24897645@N04,1863,15,1223133910,1223133910,1,7,0
24897645@N04,1863,22,1223127571,1223127571,1,7,0
24897645@N04,1864,17,1256525744,1256525744,1,1,0
24897645@N04,1865,14,1275369921,1275369921,1,1,0
24897645@N04,1866,21,1280305790,1280305808,2,9,18
24897645@N04,1866,20,1280305662,1280305662,1,9,0
24897645@N04,1866,17,1280305395,1280305395,1,9,0
24897645@N04,1866,27,1280304153,1280304229,2,9,76
24897645@N04,1866,13,1280305306,1280305306,1,9,0
24897645@N04,1866,9,1280304826,1280304952,7,9,126
24897645@N04,1866,14,1280304989,1280304989,1,9,0
24897645@N04,1866,15,1280305100,1280305100,1,9,0
24897645@N04,1866,12,1280305130,1280305214,4,9,84
24897645@N04,1867,12,1280729744,1280729854,6,11,110
24897645@N04,1867,21,1280733803,1280733803,1,11,0
24897645@N04,1867,20,1280733980,1280733980,1,11,0
24897645@N04,1867,17,1280734142,1280734172,2,11,30
24897645@N04,1867,27,1280729017,1280729263,2,11,246
24897645@N04,1867,1,1280732834,1280733219,2,11,385
24897645@N04,1867,9,1280732439,1280732473,2,11,34
24897645@N04,1867,11,1280732660,1280732660,1,11,0
24897645@N04,1867,14,1280732373,1280732373,1,11,0
24897645@N04,1867,15,1280729724,1280729820,3,11,96
24897645@N04,1867,2,1280733325,1280733330,2,11,5
24929160@N00,1868,16,1317683986,1317683986,1,2,0
24929160@N00,1868,26,1317707833,1317707833,1,2,0
24939177@N00,1869,16,1351320461,1351320461,1,2,0
24939177@N00,1869,27,1351332170,1351332170,1,2,0
24942927@N03,1870,17,1238495032,1238495032,1,1,0
25001372@N02,1871,24,1292553906,1292553906,1,1,0
25001998@N08,1872,2,1259401325,1259401325,1,2,0
25001998@N08,1872,27,1259400799,1259400799,1,2,0
25027171@N08,1873,14,1399805457,1399805713,8,10,256
25027171@N08,1873,6,1399805281,1399805281,1,10,0
25027171@N08,1873,15,1399807930,1399808037,14,10,107
25027171@N08,1873,10,1399805774,1399807200,22,10,1426
25027171@N08,1873,27,1399803929,1399816358,29,10,12429
25027171@N08,1873,17,1399810489,1399811683,5,10,1194
25027171@N08,1873,9,1399805087,1399805087,1,10,0
25027171@N08,1873,7,1399806699,1399806699,1,10,0
25027171@N08,1873,12,1399807969,1399808425,40,10,456
25027171@N08,1873,13,1399808228,1399808718,25,10,490
25027171@N08,1874,19,1399861871,1399862224,7,15,353
25027171@N08,1874,18,1399861842,1399868798,4,15,6956
25027171@N08,1874,10,1399854551,1399886630,61,15,32079
25027171@N08,1874,27,1399852308,1399878770,29,15,26462
25027171@N08,1874,17,1399861259,1399886252,86,15,24993
25027171@N08,1874,4,1399875725,1399875741,3,15,16
25027171@N08,1874,9,1399852748,1399852802,3,15,54
25027171@N08,1874,26,1399861482,1399861489,2,15,7
25027171@N08,1874,14,1399861053,1399861053,1,15,0
25027171@N08,1874,16,1399861113,1399886275,10,15,25162
25027171@N08,1874,21,1399891747,1399892761,6,15,1014
25027171@N08,1874,12,1399888455,1399888457,2,15,2
25027171@N08,1874,20,1399862282,1399862733,9,15,451
25027171@N08,1874,22,1399864618,1399865242,12,15,624
25027171@N08,1874,13,1399869943,1399869943,1,15,0
25027171@N08,1875,14,1400114150,1400114153,2,3,3
25027171@N08,1875,10,1400113731,1400113741,2,3,10
25027171@N08,1875,9,1400113225,1400120059,5,3,6834
25027171@N08,1876,27,1401457674,1401457674,1,1,0
25027171@N08,1877,17,1449466574,1449466584,3,1,10
25027171@N08,1878,27,1449532401,1449532401,1,1,0
25027171@N08,1879,24,1449629559,1449629634,9,2,75
25027171@N08,1879,27,1449606242,1449634227,53,2,27985
25027171@N08,1880,2,1449742280,1449742526,3,2,246
25027171@N08,1880,27,1449735733,1449750858,394,2,15125
25027171@N08,1881,25,1449869876,1449872761,9,2,2885
25027171@N08,1881,10,1449878703,1449881105,14,2,2402
25050086@N07,1882,7,1389249947,1389249947,1,4,0
25050086@N07,1882,3,1389256558,1389256558,1,4,0
25050086@N07,1882,23,1389260695,1389260695,1,4,0
25050086@N07,1882,14,1389258498,1389258498,1,4,0
25050086@N07,1883,9,1389384866,1389384866,1,1,0
25052208@N00,1884,25,1382079261,1382079261,1,1,0
25112704@N05,1885,14,1264304330,1264304330,1,1,0
25126729@N00,1886,9,1228694313,1228698168,2,2,3855
25126729@N00,1886,21,1228722621,1228722621,1,2,0
25126729@N00,1887,3,1228951037,1228951037,1,1,0
25126729@N00,1888,27,1228980008,1228980098,2,4,90
25126729@N00,1888,2,1228988048,1228988048,1,4,0
25126729@N00,1888,8,1228987614,1228987614,1,4,0
25126729@N00,1888,22,1228982301,1228982834,3,4,533
25126729@N00,1889,27,1276034134,1276034134,1,1,0
25126729@N00,1890,4,1276080918,1276082022,6,2,1104
25126729@N00,1890,17,1276086018,1276087170,8,2,1152
25126729@N00,1891,27,1276427144,1276427190,2,1,46
25126729@N00,1892,3,1307276912,1307276912,1,3,0
25126729@N00,1892,9,1307277647,1307277745,3,3,98
25126729@N00,1892,26,1307280786,1307280869,2,3,83
25126729@N00,1893,14,1307319719,1307319719,1,2,0
25126729@N00,1893,13,1307325149,1307325393,2,2,244
25126729@N00,1894,4,1307771078,1307771078,1,4,0
25126729@N00,1894,27,1307801497,1307801606,3,4,109
25126729@N00,1894,13,1307768515,1307768611,2,4,96
25126729@N00,1894,26,1307798488,1307799287,8,4,799
25143581@N00,1895,6,1385340304,1385340304,1,1,0
25152546@N04,1896,17,1441769688,1441769688,1,4,0
25152546@N04,1896,25,1441759702,1441759702,1,4,0
25152546@N04,1896,24,1441760909,1441760909,1,4,0
25152546@N04,1896,14,1441780174,1441780174,1,4,0
25166220@N02,1897,16,1195858987,1195891617,4,2,32630
25166220@N02,1897,17,1195877574,1195877787,4,2,213
25203548@N00,1898,20,1428835185,1428835185,1,1,0
25216059@N02,1899,21,1263532837,1263532837,1,1,0
25216419@N00,1900,16,1321265487,1321265487,1,1,0
25229032@N08,1901,27,1374732778,1374732778,1,1,0
25248468@N08,1902,13,1210836826,1210836837,2,2,11
25248468@N08,1902,15,1210836053,1210836201,3,2,148
25248468@N08,1903,15,1211114448,1211114504,3,1,56
25343363@N05,1904,27,1325474801,1325474801,1,1,0
25343363@N05,1905,27,1360277101,1360277101,1,2,0
25343363@N05,1905,10,1360281965,1360281965,1,2,0
25358394@N00,1906,19,1296445815,1296446445,2,1,630
25360342@N02,1907,2,1352544372,1352544372,1,1,0
25360342@N02,1908,3,1395571582,1395571582,1,6,0
25360342@N02,1908,7,1395556484,1395556484,1,6,0
25360342@N02,1908,16,1395554549,1395558562,2,6,4013
25360342@N02,1908,17,1395546071,1395548181,4,6,2110
25360342@N02,1908,27,1395534363,1395534363,1,6,0
25360342@N02,1908,20,1395537013,1395552340,2,6,15327
25360342@N02,1909,15,1395636833,1395636833,1,5,0
25360342@N02,1909,14,1395626806,1395626806,1,5,0
25360342@N02,1909,21,1395654249,1395654249,1,5,0
25360342@N02,1909,19,1395658611,1395658773,2,5,162
25360342@N02,1909,20,1395656744,1395656744,1,5,0
25360342@N02,1910,27,1395907289,1395907289,1,1,0
25360342@N02,1911,27,1408831987,1408831987,1,3,0
25360342@N02,1911,9,1408834972,1408834972,1,3,0
25360342@N02,1911,25,1408839470,1408839470,1,3,0
25360342@N02,1912,27,1454565729,1454566564,2,1,835
25360342@N02,1913,27,1454666709,1454676202,2,2,9493
25360342@N02,1913,21,1454669464,1454669464,1,2,0
25360342@N02,1914,27,1455160180,1455186606,2,6,26426
25360342@N02,1914,21,1455183297,1455183474,8,6,177
25360342@N02,1914,12,1455178412,1455178412,1,6,0
25360342@N02,1914,17,1455162866,1455164145,15,6,1279
25360342@N02,1914,24,1455179828,1455179828,1,6,0
25360342@N02,1914,13,1455178984,1455178984,1,6,0
25360342@N02,1915,27,1455231489,1455231489,1,3,0
25360342@N02,1915,9,1455226617,1455226748,6,3,131
25360342@N02,1915,15,1455228059,1455228263,2,3,204
25361579@N08,1916,4,1321225815,1321225815,1,1,0
25387061@N06,1917,25,1326773422,1326773422,1,2,0
25387061@N06,1917,14,1326760507,1326769606,2,2,9099
25387061@N06,1918,27,1327223656,1327223656,1,1,0
25418288@N02,1919,16,1207538437,1207538437,1,1,0
25435542@N08,1920,17,1367750335,1367753401,10,2,3066
25435542@N08,1920,13,1367743636,1367743780,9,2,144
25437583@N00,1921,27,1232934762,1232934762,1,1,0
25548984@N06,1922,27,1221673028,1221696604,9,2,23576
25548984@N06,1922,16,1221693556,1221693556,1,2,0
25548984@N06,1923,27,1222969136,1222969288,2,1,152
25548984@N06,1924,13,1225326260,1225326260,1,4,0
25548984@N06,1924,17,1225324178,1225324776,5,4,598
25548984@N06,1924,16,1225318467,1225320838,5,4,2371
25548984@N06,1924,9,1225310166,1225310166,1,4,0
25548984@N06,1925,2,1226259654,1226259654,1,1,0
25548984@N06,1926,27,1228782625,1228782625,1,2,0
25548984@N06,1926,16,1228787599,1228787599,1,2,0
25548984@N06,1927,14,1232480928,1232480928,1,3,0
25548984@N06,1927,16,1232478299,1232483414,3,3,5115
25548984@N06,1927,13,1232481159,1232481159,1,3,0
25548984@N06,1928,27,1232728259,1232728259,1,3,0
25548984@N06,1928,26,1232731614,1232732307,13,3,693
25548984@N06,1928,9,1232737821,1232737821,1,3,0
25548984@N06,1929,19,1233851484,1233851484,1,3,0
25548984@N06,1929,18,1233852285,1233852285,1,3,0
25548984@N06,1929,26,1233855091,1233855296,3,3,205
25548984@N06,1930,16,1234463325,1234463484,5,1,159
25555616@N02,1931,16,1317778228,1317802787,2,3,24559
25555616@N02,1931,27,1317776647,1317776647,1,3,0
25555616@N02,1931,14,1317809472,1317809472,1,3,0
25555616@N02,1932,16,1317897558,1317897558,1,1,0
25564364@N07,1933,16,1214910969,1214910969,2,1,0
25585962@N06,1934,20,1412556677,1412594703,3,12,38026
25585962@N06,1934,15,1412558598,1412593763,3,12,35165
25585962@N06,1934,16,1412553261,1412553261,1,12,0
25585962@N06,1934,19,1412557728,1412557767,2,12,39
25585962@N06,1934,26,1412557012,1412595028,3,12,38016
25585962@N06,1934,27,1412552970,1412595848,5,12,42878
25585962@N06,1934,21,1412553482,1412571620,4,12,18138
25585962@N06,1934,8,1412569098,1412569098,1,12,0
25585962@N06,1934,2,1412566146,1412592540,2,12,26394
25585962@N06,1934,17,1412556959,1412557162,2,12,203
25585962@N06,1934,1,1412593066,1412593066,1,12,0
25585962@N06,1934,18,1412557258,1412558320,2,12,1062
25595049@N08,1935,9,1240453901,1240453901,1,1,0
25601992@N00,1936,18,1413420455,1413420455,1,9,0
25601992@N00,1936,21,1413418333,1413418333,1,9,0
25601992@N00,1936,9,1413422394,1413435451,2,9,13057
25601992@N00,1936,26,1413439397,1413439397,1,9,0
25601992@N00,1936,15,1413435795,1413435795,1,9,0
25601992@N00,1936,22,1413418071,1413418074,2,9,3
25601992@N00,1936,3,1413427298,1413427302,2,9,4
25601992@N00,1936,10,1413432312,1413435223,26,9,2911
25601992@N00,1936,20,1413416935,1413418775,27,9,1840
25601992@N00,1937,27,1460360406,1460360406,1,4,0
25601992@N00,1937,19,1460335829,1460336124,9,4,295
25601992@N00,1937,3,1460333061,1460333061,1,4,0
25601992@N00,1937,14,1460347010,1460347010,1,4,0
25635719@N00,1938,16,1193378353,1193391973,12,4,13620
25635719@N00,1938,22,1193395095,1193395733,16,4,638
25635719@N00,1938,27,1193371641,1193372284,8,4,643
25635719@N00,1938,8,1193382862,1193383396,6,4,534
25651350@N06,1939,14,1220579380,1220588716,7,1,9336
25651350@N06,1940,21,1229833750,1229833750,1,3,0
25651350@N06,1940,9,1229834063,1229844994,5,3,10931
25651350@N06,1940,25,1229834118,1229834118,1,3,0
25651350@N06,1941,5,1244251192,1244264332,7,4,13140
25651350@N06,1941,27,1244264338,1244283378,5,4,19040
25651350@N06,1941,17,1244285909,1244285919,2,4,10
25651350@N06,1941,6,1244256450,1244256534,2,4,84
25651350@N06,1942,17,1252807338,1252807338,1,2,0
25651350@N06,1942,1,1252812455,1252812461,3,2,6
25651350@N06,1943,21,1307159285,1307159285,1,13,0
25651350@N06,1943,23,1307161020,1307161020,1,13,0
25651350@N06,1943,13,1307150368,1307151423,15,13,1055
25651350@N06,1943,16,1307154495,1307154520,2,13,25
25651350@N06,1943,14,1307154535,1307154546,2,13,11
25651350@N06,1943,5,1307146490,1307154862,12,13,8372
25651350@N06,1943,27,1307143805,1307143805,1,13,0
25651350@N06,1943,17,1307158248,1307158303,5,13,55
25651350@N06,1943,9,1307147669,1307148309,8,13,640
25651350@N06,1943,25,1307161104,1307161104,1,13,0
25651350@N06,1943,6,1307148211,1307148435,11,13,224
25651350@N06,1943,15,1307149084,1307154415,23,13,5331
25651350@N06,1943,4,1307144841,1307147313,4,13,2472
25651350@N06,1944,23,1338593365,1338595838,4,4,2473
25651350@N06,1944,20,1338597842,1338597903,2,4,61
25651350@N06,1944,17,1338599211,1338600421,7,4,1210
25651350@N06,1944,14,1338600791,1338601215,3,4,424
25698277@N06,1945,14,1374402330,1374402330,1,1,0
25698277@N06,1946,16,1375411777,1375411777,1,1,0
25703511@N06,1947,27,1241483589,1241483598,2,4,9
25703511@N06,1947,19,1241490897,1241490897,1,4,0
25703511@N06,1947,11,1241513916,1241513916,1,4,0
25703511@N06,1947,16,1241487393,1241488633,20,4,1240
25817217@N08,1948,10,1436425554,1436425554,1,1,0
25827417@N00,1949,21,1265083335,1265083335,1,1,0
25827417@N00,1950,4,1295522380,1295522380,1,1,0
25827417@N00,1951,4,1330855757,1330863013,12,1,7256
25827417@N00,1952,4,1330897952,1330897952,1,1,0
25827417@N00,1953,4,1330928004,1330941386,41,1,13382
25827417@N00,1954,4,1331153522,1331180837,144,1,27315
25827417@N00,1955,4,1331242444,1331248771,42,1,6327
25827417@N00,1956,4,1331290097,1331290097,1,1,0
25827417@N00,1957,21,1384399730,1384402328,2,1,2598
25827417@N00,1958,16,1430385145,1430387541,3,2,2396
25827417@N00,1958,21,1430346388,1430371984,4,2,25596
25827417@N00,1959,21,1430524365,1430544457,2,1,20092
25835520@N02,1960,27,1391157931,1391157931,1,1,0
25839240@N08,1961,7,1354237180,1354237180,1,10,0
25839240@N08,1961,9,1354247434,1354247434,1,10,0
25839240@N08,1961,25,1354244189,1354244325,6,10,136
25839240@N08,1961,10,1354236429,1354247131,3,10,10702
25839240@N08,1961,22,1354245998,1354245998,1,10,0
25839240@N08,1961,17,1354239150,1354239150,1,10,0
25839240@N08,1961,14,1354250784,1354259727,6,10,8943
25839240@N08,1961,2,1354248273,1354248281,2,10,8
25839240@N08,1961,23,1354243285,1354243285,1,10,0
25839240@N08,1961,15,1354240396,1354240495,4,10,99
25839240@N08,1962,27,1369097023,1369098224,11,2,1201
25839240@N08,1962,10,1369103881,1369104722,4,2,841
25846522@N00,1963,16,1360284808,1360284808,1,1,0
25846522@N00,1964,27,1360562151,1360562151,1,2,0
25846522@N00,1964,17,1360565324,1360565324,1,2,0
25854008@N00,1965,1,1352629095,1352629095,1,1,0
25854008@N00,1966,16,1352793856,1352793856,1,1,0
25854008@N00,1967,10,1352861250,1352861250,1,1,0
25858747@N02,1968,4,1284202740,1284202740,1,1,0
25865463@N00,1969,22,1400808467,1400808467,1,1,0
25865463@N00,1970,27,1400885584,1400885587,4,1,3
25868826@N05,1971,3,1286187046,1286187046,1,1,0
25905065@N00,1972,17,1336955134,1336955162,3,10,28
25905065@N00,1972,27,1336946705,1336957440,33,10,10735
25905065@N00,1972,18,1336955198,1336955489,7,10,291
25905065@N00,1972,4,1336957217,1336957217,1,10,0
25905065@N00,1972,24,1336959909,1336959909,1,10,0
25905065@N00,1972,19,1336955358,1336955358,1,10,0
25905065@N00,1972,14,1336955170,1336957150,3,10,1980
25905065@N00,1972,15,1336955546,1336955556,2,10,10
25905065@N00,1972,22,1336955187,1336955187,1,10,0
25905065@N00,1972,16,1336950431,1336950431,2,10,0
25905065@N00,1973,19,1363053669,1363053671,2,2,2
25905065@N00,1973,25,1363043521,1363044645,5,2,1124
25961474@N06,1974,27,1293165293,1293165293,1,1,0
25984179@N00,1975,19,1265853335,1265853335,1,1,0
26000176@N07,1976,25,1338182435,1338182498,2,1,63
26000176@N07,1977,8,1338242630,1338242698,2,1,68
26094090@N00,1978,22,1329562622,1329562622,1,1,0
26094090@N00,1979,14,1331773365,1331773365,1,1,0
26094090@N00,1980,15,1343214009,1343215031,2,1,1022
26094090@N00,1981,13,1352067907,1352067907,1,2,0
26094090@N00,1981,27,1352071452,1352071452,1,2,0
26094090@N00,1982,14,1355441381,1355441381,1,1,0
26116471@N03,1983,21,1428772391,1428772391,1,1,0
26143366@N00,1984,2,1205396175,1205396175,1,5,0
26143366@N00,1984,5,1205396233,1205396233,1,5,0
26143366@N00,1984,6,1205399107,1205399107,1,5,0
26143366@N00,1984,17,1205378242,1205381966,5,5,3724
26143366@N00,1984,22,1205367211,1205371930,3,5,4719
26153219@N00,1985,18,1309122376,1309122376,1,3,0
26153219@N00,1985,27,1309121382,1309121530,9,3,148
26153219@N00,1985,20,1309122271,1309122271,1,3,0
26176576@N07,1986,3,1444810168,1444810184,2,10,16
26176576@N07,1986,27,1444778799,1444823201,13,10,44402
26176576@N07,1986,13,1444801384,1444801639,14,10,255
26176576@N07,1986,7,1444787076,1444787084,3,10,8
26176576@N07,1986,17,1444780007,1444819148,6,10,39141
26176576@N07,1986,4,1444807309,1444807366,4,10,57
26176576@N07,1986,10,1444791552,1444791973,10,10,421
26176576@N07,1986,14,1444782097,1444782219,9,10,122
26176576@N07,1986,12,1444801054,1444801377,20,10,323
26176576@N07,1986,2,1444810464,1444810470,2,10,6
26176576@N07,1987,24,1444865710,1444866339,17,4,629
26176576@N07,1987,14,1444857077,1444862530,6,4,5453
26176576@N07,1987,25,1444865817,1444866022,15,4,205
26176576@N07,1987,16,1444862510,1444862523,2,4,13
26197615@N00,1988,2,1433804135,1433804135,1,1,0
26211887@N07,1989,27,1223606457,1223606457,1,1,0
26211887@N07,1990,9,1223973931,1223973951,2,2,20
26211887@N07,1990,17,1223979400,1223979400,1,2,0
26211887@N07,1991,16,1224106745,1224107057,2,4,312
26211887@N07,1991,9,1224107152,1224107254,2,4,102
26211887@N07,1991,27,1224105342,1224105342,1,4,0
26211887@N07,1991,14,1224106686,1224107220,2,4,534
26211887@N07,1992,19,1224213031,1224213031,1,8,0
26211887@N07,1992,24,1224222187,1224242027,4,8,19840
26211887@N07,1992,15,1224241604,1224241690,4,8,86
26211887@N07,1992,26,1224241850,1224241850,1,8,0
26211887@N07,1992,21,1224242054,1224242368,9,8,314
26211887@N07,1992,9,1224240840,1224240840,1,8,0
26211887@N07,1992,14,1224240993,1224241548,9,8,555
26211887@N07,1992,23,1224241868,1224241868,1,8,0
26211887@N07,1993,27,1224333777,1224333777,1,1,0
26211887@N07,1994,8,1224381188,1224381188,1,1,0
26236829@N00,1995,15,1354676426,1354676426,2,2,0
26236829@N00,1995,22,1354668800,1354668800,1,2,0
26247897@N03,1996,8,1338117040,1338117040,1,2,0
26247897@N03,1996,4,1338115443,1338115443,1,2,0
26284290@N05,1997,27,1189346400,1189346403,2,1,3
26284290@N05,1998,14,1189605600,1189605600,1,1,0
26284290@N05,1999,22,1220709600,1220709601,2,2,1
26284290@N05,1999,26,1220709602,1220709603,2,2,1
26284290@N05,2000,8,1220882400,1220882404,5,1,4
26284290@N05,2001,17,1221055200,1221055202,2,1,2
26284290@N05,2002,27,1221228000,1221228000,1,1,0
26284290@N05,2003,20,1253282401,1253282401,1,1,0
26284290@N05,2004,22,1284818400,1284818400,1,2,0
26284290@N05,2004,17,1284818401,1284818402,2,2,1
26284290@N05,2005,22,1284991201,1284991201,1,3,0
26284290@N05,2005,26,1284991203,1284991203,1,3,0
26284290@N05,2005,14,1284991200,1284991202,4,3,2
26284290@N05,2006,26,1285164001,1285164002,2,1,1
26284290@N05,2007,16,1285336800,1285336800,1,3,0
26284290@N05,2007,27,1285336800,1285336800,1,3,0
26284290@N05,2007,11,1285336801,1285336801,1,3,0
26284290@N05,2008,2,1305295200,1305295200,1,1,0
26284290@N05,2009,1,1305381600,1305381600,1,1,0
26284290@N05,2010,9,1321607399,1321607399,1,2,0
26284290@N05,2010,17,1321607406,1321607406,1,2,0
26284290@N05,2011,27,1328519536,1328519536,1,1,0
26291243@N00,2012,9,1331425926,1331425926,1,1,0
26342127@N00,2013,26,1264313465,1264313465,1,3,0
26342127@N00,2013,17,1264308124,1264308136,3,3,12
26342127@N00,2013,9,1264299897,1264303617,2,3,3720
26361782@N03,2014,27,1415883388,1415883388,1,2,0
26361782@N03,2014,14,1415858631,1415858631,1,2,0
26393454@N00,2015,17,1423015921,1423015921,1,2,0
26393454@N00,2015,26,1423024795,1423024795,1,2,0
26393454@N00,2016,13,1423205073,1423205073,1,2,0
26393454@N00,2016,12,1423205123,1423205123,1,2,0
26393454@N00,2017,7,1423274380,1423274409,3,3,29
26393454@N00,2017,23,1423286888,1423286891,2,3,3
26393454@N00,2017,8,1423283644,1423283644,1,3,0
26393795@N00,2018,8,1355463973,1355463973,1,1,0
26393795@N00,2019,9,1356311972,1356311972,1,1,0
26449190@N00,2020,6,1223108215,1223108215,1,3,0
26449190@N00,2020,3,1223109647,1223109647,1,3,0
26449190@N00,2020,27,1223117790,1223117790,1,3,0
26449984@N06,2021,1,1195041064,1195041064,1,2,0
26449984@N06,2021,16,1195040800,1195040800,1,2,0
26469338@N08,2022,9,1367115515,1367115515,1,3,0
26469338@N08,2022,27,1367106655,1367106655,1,3,0
26469338@N08,2022,16,1367139967,1367139967,1,3,0
26469338@N08,2023,6,1367216252,1367216252,1,2,0
26469338@N08,2023,27,1367200525,1367200525,1,2,0
26486487@N06,2024,5,1211342379,1211344309,11,6,1930
26486487@N06,2024,19,1211340962,1211340995,3,6,33
26486487@N06,2024,4,1211342575,1211342575,1,6,0
26486487@N06,2024,18,1211340762,1211341474,3,6,712
26486487@N06,2024,27,1211333689,1211344874,2,6,11185
26486487@N06,2024,22,1211339461,1211339839,3,6,378
26522673@N07,2025,2,1211550078,1211550078,1,2,0
26522673@N07,2025,16,1211550026,1211550026,1,2,0
26522673@N07,2026,20,1212286237,1212286237,1,2,0
26522673@N07,2026,25,1212286212,1212286232,5,2,20
26522673@N07,2027,22,1212480704,1212480704,1,1,0
26522673@N07,2028,16,1212837360,1212837360,1,3,0
26522673@N07,2028,22,1212821248,1212821248,1,3,0
26522673@N07,2028,25,1212821242,1212821242,1,3,0
26522673@N07,2029,20,1217931557,1217931557,1,2,0
26522673@N07,2029,22,1217931562,1217931562,1,2,0
26522673@N07,2030,16,1218114645,1218114645,1,1,0
26522673@N07,2031,1,1218184808,1218184808,1,1,0
26522673@N07,2032,17,1219047628,1219047628,1,1,0
26522673@N07,2033,1,1219407081,1219407081,1,1,0
26522673@N07,2034,25,1219631018,1219631018,1,1,0
26522673@N07,2035,2,1220699182,1220699182,1,1,0
26522673@N07,2036,17,1220964253,1220964257,2,1,4
26522673@N07,2037,15,1221121474,1221121474,1,2,0
26522673@N07,2037,13,1221121466,1221121466,1,2,0
26522673@N07,2038,17,1221179702,1221179702,1,1,0
26522673@N07,2039,3,1222484800,1222484800,1,1,0
26522673@N07,2040,14,1226389000,1226389000,1,1,0
26522673@N07,2041,12,1226468286,1226468286,1,1,0
26522673@N07,2042,16,1228815418,1228815418,1,1,0
26522673@N07,2043,25,1230710858,1230710858,1,1,0
26522673@N07,2044,3,1231999686,1231999686,1,2,0
26522673@N07,2044,2,1231999640,1231999640,1,2,0
26522673@N07,2045,16,1232279410,1232279410,1,1,0
26522673@N07,2046,24,1283160398,1283160398,1,8,0
26522673@N07,2046,25,1283161095,1283161438,5,8,343
26522673@N07,2046,1,1283169609,1283169609,1,8,0
26522673@N07,2046,21,1283162330,1283162330,1,8,0
26522673@N07,2046,5,1283170008,1283170068,2,8,60
26522673@N07,2046,2,1283167812,1283167812,1,8,0
26522673@N07,2046,27,1283170581,1283170581,1,8,0
26522673@N07,2046,16,1283170192,1283170192,1,8,0
26522673@N07,2047,24,1283493832,1283499836,2,14,6004
26522673@N07,2047,25,1283497753,1283498663,2,14,910
26522673@N07,2047,1,1283472407,1283472407,1,14,0
26522673@N07,2047,21,1283499476,1283499476,1,14,0
26522673@N07,2047,20,1283485730,1283489650,5,14,3920
26522673@N07,2047,18,1283493696,1283495123,2,14,1427
26522673@N07,2047,2,1283474647,1283474647,1,14,0
26522673@N07,2047,27,1283500478,1283500478,1,14,0
26522673@N07,2047,19,1283490240,1283490409,2,14,169
26522673@N07,2047,13,1283496141,1283496141,1,14,0
26522673@N07,2047,14,1283481219,1283482841,9,14,1622
26522673@N07,2047,16,1283478690,1283496917,2,14,18227
26522673@N07,2047,22,1283485925,1283493477,9,14,7552
26522673@N07,2047,15,1283479815,1283479815,1,14,0
26522673@N07,2048,24,1346305599,1346305720,2,8,121
26522673@N07,2048,25,1346299344,1346304196,6,8,4852
26522673@N07,2048,21,1346310007,1346310007,1,8,0
26522673@N07,2048,2,1346298458,1346298458,1,8,0
26522673@N07,2048,27,1346298178,1346298178,1,8,0
26522673@N07,2048,19,1346317417,1346317417,1,8,0
26522673@N07,2048,13,1346314527,1346315591,3,8,1064
26522673@N07,2048,26,1346302649,1346302649,1,8,0
26522673@N07,2049,25,1346569801,1346596883,2,9,27082
26522673@N07,2049,27,1346539880,1346563184,6,9,23304
26522673@N07,2049,9,1346572969,1346572994,2,9,25
26522673@N07,2049,17,1346595539,1346596338,2,9,799
26522673@N07,2049,13,1346574114,1346594550,2,9,20436
26522673@N07,2049,26,1346569250,1346569250,1,9,0
26522673@N07,2049,14,1346573399,1346573544,2,9,145
26522673@N07,2049,16,1346576073,1346576073,1,9,0
26522673@N07,2049,15,1346572348,1346572348,1,9,0
26522673@N07,2050,27,1346810752,1346812329,3,6,1577
26522673@N07,2050,16,1346823223,1346823223,1,6,0
26522673@N07,2050,1,1346816596,1346817035,2,6,439
26522673@N07,2050,3,1346818958,1346821116,2,6,2158
26522673@N07,2050,14,1346823090,1346823090,1,6,0
26522673@N07,2050,6,1346817321,1346817907,2,6,586
26522673@N07,2051,27,1382369339,1382369390,2,4,51
26522673@N07,2051,13,1382366820,1382366944,3,4,124
26522673@N07,2051,16,1382368419,1382368419,1,4,0
26522673@N07,2051,12,1382356725,1382356725,1,4,0
26522673@N07,2052,27,1382410248,1382453293,10,9,43045
26522673@N07,2052,22,1382426487,1382426487,1,9,0
26522673@N07,2052,14,1382451533,1382451533,1,9,0
26522673@N07,2052,13,1382418377,1382450223,2,9,31846
26522673@N07,2052,26,1382420411,1382424343,4,9,3932
26522673@N07,2052,16,1382442714,1382452538,4,9,9824
26522673@N07,2052,15,1382413606,1382413606,1,9,0
26522673@N07,2052,24,1382430351,1382430351,1,9,0
26522673@N07,2052,25,1382422862,1382422862,1,9,0
26522673@N07,2053,27,1382575641,1382575641,1,12,0
26522673@N07,2053,19,1382584187,1382584238,2,12,51
26522673@N07,2053,26,1382577736,1382578899,3,12,1163
26522673@N07,2053,22,1382584813,1382587086,4,12,2273
26522673@N07,2053,12,1382599408,1382599408,1,12,0
26522673@N07,2053,24,1382580539,1382580913,4,12,374
26522673@N07,2053,25,1382576699,1382576699,1,12,0
26522673@N07,2053,14,1382599149,1382600556,2,12,1407
26522673@N07,2053,13,1382600173,1382600173,1,12,0
26522673@N07,2053,20,1382582327,1382583263,3,12,936
26522673@N07,2053,6,1382598795,1382598795,1,12,0
26522673@N07,2053,9,1382596951,1382597100,4,12,149
26531284@N02,2054,16,1320223966,1320227387,2,3,3421
26531284@N02,2054,23,1320213487,1320213493,2,3,6
26531284@N02,2054,5,1320226286,1320226286,1,3,0
26531284@N02,2055,19,1320376851,1320377185,2,6,334
26531284@N02,2055,9,1320383299,1320383447,2,6,148
26531284@N02,2055,6,1320373489,1320373489,1,6,0
26531284@N02,2055,16,1320372968,1320373174,2,6,206
26531284@N02,2055,27,1320372551,1320372551,1,6,0
26531284@N02,2055,1,1320374430,1320374430,1,6,0
26531284@N02,2056,19,1352028878,1352028878,1,3,0
26531284@N02,2056,17,1352017752,1352028217,7,3,10465
26531284@N02,2056,5,1352026753,1352026900,3,3,147
26533304@N07,2057,25,1242536068,1242542216,9,8,6148
26533304@N07,2057,20,1242546379,1242547034,8,8,655
26533304@N07,2057,26,1242542112,1242542112,1,8,0
26533304@N07,2057,17,1242551283,1242551283,1,8,0
26533304@N07,2057,27,1242526888,1242527656,10,8,768
26533304@N07,2057,3,1242528802,1242528802,1,8,0
26533304@N07,2057,6,1242530527,1242530545,2,8,18
26533304@N07,2057,9,1242556030,1242556077,4,8,47
26536365@N00,2058,20,1386313999,1386313999,1,1,0
26544897@N04,2059,27,1197766346,1197791038,42,1,24692
26551005@N08,2060,25,1305876087,1305883694,3,3,7607
26551005@N08,2060,27,1305862195,1305886525,4,3,24330
26551005@N08,2060,16,1305862506,1305893909,22,3,31403
26551005@N08,2061,14,1308207777,1308207777,1,1,0
26551005@N08,2062,16,1326794766,1326794766,1,2,0
26551005@N08,2062,17,1326777853,1326777853,1,2,0
26559120@N06,2063,27,1391173200,1391173200,1,1,0
26560604@N02,2064,27,1201248849,1201249855,9,1,1006
26573031@N05,2065,15,1465607897,1465607897,1,4,0
26573031@N05,2065,18,1465609087,1465609087,1,4,0
26573031@N05,2065,17,1465625351,1465625351,1,4,0
26573031@N05,2065,2,1465630015,1465637151,2,4,7136
26573031@N05,2066,14,1465900523,1465900523,1,1,0
26573031@N05,2067,15,1466037375,1466037840,3,4,465
26573031@N05,2067,7,1466042394,1466042394,1,4,0
26573031@N05,2067,10,1466043272,1466043272,1,4,0
26573031@N05,2067,18,1466039147,1466039147,1,4,0
26603119@N00,2068,27,1366844474,1366868428,2,1,23954
26603119@N00,2069,14,1400032295,1400032295,1,1,0
26603119@N00,2070,27,1400187747,1400187747,1,3,0
26603119@N00,2070,2,1400191502,1400191502,1,3,0
26603119@N00,2070,4,1400188438,1400188438,1,3,0
26603119@N00,2071,1,1400302411,1400303310,2,1,899
26603119@N00,2072,3,1463091762,1463091762,1,2,0
26603119@N00,2072,27,1463087239,1463087239,1,2,0
26616207@N00,2073,27,1209084938,1209085034,2,1,96
26619856@N00,2074,1,1350971837,1350971837,1,1,0
26652894@N06,2075,16,1195337096,1195337096,1,1,0
26652894@N06,2076,14,1199484357,1199484357,1,1,0
26670433@N07,2077,7,1232854360,1232854360,1,5,0
26670433@N07,2077,21,1232860319,1232860319,1,5,0
26670433@N07,2077,16,1232830035,1232830550,3,5,515
26670433@N07,2077,4,1232849505,1232851758,3,5,2253
26670433@N07,2077,14,1232833102,1232835006,2,5,1904
26678134@N04,2078,27,1333061377,1333061377,1,12,0
26678134@N04,2078,21,1333073575,1333073575,1,12,0
26678134@N04,2078,2,1333062457,1333062457,1,12,0
26678134@N04,2078,24,1333068703,1333073925,2,12,5222
26678134@N04,2078,23,1333068671,1333068671,1,12,0
26678134@N04,2078,20,1333065606,1333065730,3,12,124
26678134@N04,2078,25,1333067839,1333074378,8,12,6539
26678134@N04,2078,19,1333065809,1333065809,1,12,0
26678134@N04,2078,4,1333063368,1333063407,4,12,39
26678134@N04,2078,17,1333074459,1333074459,1,12,0
26678134@N04,2078,22,1333064787,1333064787,1,12,0
26678134@N04,2078,18,1333065777,1333065777,1,12,0
26678134@N04,2079,27,1333260510,1333260510,1,4,0
26678134@N04,2079,6,1333271306,1333271315,2,4,9
26678134@N04,2079,26,1333277249,1333277249,1,4,0
26678134@N04,2079,9,1333271690,1333271690,1,4,0
26678134@N04,2080,17,1340009831,1340012489,2,3,2658
26678134@N04,2080,19,1340010581,1340010581,1,3,0
26678134@N04,2080,20,1340011162,1340011162,1,3,0
26678134@N04,2081,22,1340962446,1340962446,1,4,0
26678134@N04,2081,19,1340960132,1340960132,1,4,0
26678134@N04,2081,27,1340957510,1340957510,1,4,0
26678134@N04,2081,20,1340959732,1340959732,1,4,0
26678134@N04,2082,19,1349415014,1349422633,3,1,7619
26678134@N04,2083,19,1350017774,1350017774,1,1,0
26678134@N04,2084,27,1354854259,1354854259,1,1,0
26678134@N04,2085,17,1356948030,1356948030,1,4,0
26678134@N04,2085,16,1356960272,1356960272,2,4,0
26678134@N04,2085,14,1356946872,1356946876,3,4,4
26678134@N04,2085,10,1356953803,1356953992,2,4,189
26678134@N04,2086,24,1360121181,1360121181,1,6,0
26678134@N04,2086,19,1360117440,1360118643,4,6,1203
26678134@N04,2086,22,1360122873,1360122873,1,6,0
26678134@N04,2086,23,1360123072,1360123072,1,6,0
26678134@N04,2086,13,1360112488,1360113984,2,6,1496
26678134@N04,2086,10,1360114646,1360114908,3,6,262
26678134@N04,2087,19,1363328010,1363328010,1,1,0
26678134@N04,2088,9,1364039741,1364039741,1,2,0
26678134@N04,2088,3,1364040288,1364040288,1,2,0
26678134@N04,2089,19,1364626601,1364626601,1,1,0
26678134@N04,2090,23,1379830402,1379830402,1,1,0
26678134@N04,2091,1,1380260232,1380260232,1,1,0
26678134@N04,2092,22,1382685064,1382685093,2,1,29
26678134@N04,2093,17,1388239165,1388239165,1,2,0
26678134@N04,2093,16,1388239263,1388239508,3,2,245
26678134@N04,2094,17,1397034150,1397035243,2,4,1093
26678134@N04,2094,18,1397034164,1397035029,5,4,865
26678134@N04,2094,19,1397034465,1397034490,3,4,25
26678134@N04,2094,22,1397034263,1397034263,1,4,0
26678134@N04,2095,3,1397726796,1397726796,1,2,0
26678134@N04,2095,13,1397734181,1397734181,1,2,0
26678134@N04,2096,9,1399723794,1399723920,2,2,126
26678134@N04,2096,3,1399709514,1399709514,1,2,0
26678134@N04,2097,14,1401269329,1401269878,2,7,549
26678134@N04,2097,27,1401265852,1401265852,1,7,0
26678134@N04,2097,25,1401275499,1401275499,1,7,0
26678134@N04,2097,13,1401272080,1401272080,1,7,0
26678134@N04,2097,17,1401270873,1401270873,1,7,0
26678134@N04,2097,9,1401268685,1401269447,2,7,762
26678134@N04,2097,19,1401267449,1401271653,2,7,4204
26678134@N04,2098,19,1403176326,1403176326,1,1,0
26678134@N04,2099,23,1406456778,1406456778,1,4,0
26678134@N04,2099,18,1406452861,1406454457,3,4,1596
26678134@N04,2099,19,1406453807,1406453865,2,4,58
26678134@N04,2099,16,1406451922,1406452057,3,4,135
26678134@N04,2100,23,1408700499,1408700559,2,1,60
26678134@N04,2101,27,1411804883,1411804883,1,1,0
26678134@N04,2102,9,1412912666,1412912666,1,5,0
26678134@N04,2102,18,1412919769,1412920830,5,5,1061
26678134@N04,2102,1,1412915617,1412915617,1,5,0
26678134@N04,2102,26,1412918547,1412918631,2,5,84
26678134@N04,2102,17,1412911934,1412911934,2,5,0
26678134@N04,2103,15,1417261559,1417261559,1,1,0
26678134@N04,2104,27,1419066503,1419080935,2,2,14432
26678134@N04,2104,24,1419068396,1419068396,1,2,0
26678134@N04,2105,10,1419846714,1419846714,1,1,0
26678134@N04,2106,7,1420284164,1420284164,1,1,0
26678134@N04,2107,18,1422600297,1422600297,1,5,0
26678134@N04,2107,21,1422599720,1422599720,1,5,0
26678134@N04,2107,19,1422601000,1422601000,1,5,0
26678134@N04,2107,23,1422599637,1422599658,2,5,21
26678134@N04,2107,20,1422599828,1422599828,1,5,0
26678134@N04,2108,25,1423196772,1423196772,1,3,0
26678134@N04,2108,23,1423196426,1423196435,2,3,9
26678134@N04,2108,20,1423195256,1423195828,8,3,572
26678134@N04,2109,19,1425281706,1425281706,1,1,0
26678134@N04,2110,17,1426324659,1426324659,1,1,0
26678134@N04,2111,27,1426917454,1426917454,1,2,0
26678134@N04,2111,25,1426917966,1426917966,1,2,0
26678134@N04,2112,18,1427678532,1427683073,4,12,4541
26678134@N04,2112,24,1427672108,1427699497,3,12,27389
26678134@N04,2112,16,1427665532,1427696529,4,12,30997
26678134@N04,2112,15,1427665823,1427665823,1,12,0
26678134@N04,2112,27,1427665193,1427691600,2,12,26407
26678134@N04,2112,19,1427666142,1427682856,8,12,16714
26678134@N04,2112,26,1427665934,1427665988,2,12,54
26678134@N04,2112,20,1427666986,1427667276,4,12,290
26678134@N04,2112,17,1427696328,1427696328,1,12,0
26678134@N04,2112,10,1427676429,1427693404,2,12,16975
26678134@N04,2112,25,1427695893,1427699620,2,12,3727
26678134@N04,2112,8,1427676236,1427676236,1,12,0
26678134@N04,2113,24,1428046318,1428046318,1,7,0
26678134@N04,2113,21,1428046608,1428046608,1,7,0
26678134@N04,2113,16,1428050140,1428056773,2,7,6633
26678134@N04,2113,23,1428045350,1428045350,1,7,0
26678134@N04,2113,26,1428048076,1428048076,1,7,0
26678134@N04,2113,10,1428050864,1428050864,1,7,0
26678134@N04,2113,1,1428050463,1428050463,1,7,0
26678134@N04,2114,14,1428620628,1428620628,1,14,0
26678134@N04,2114,22,1428618528,1428625235,6,14,6707
26678134@N04,2114,16,1428618287,1428618287,1,14,0
26678134@N04,2114,27,1428618003,1428618003,1,14,0
26678134@N04,2114,23,1428625334,1428625334,1,14,0
26678134@N04,2114,19,1428619074,1428619371,6,14,297
26678134@N04,2114,26,1428625292,1428625756,3,14,464
26678134@N04,2114,20,1428619653,1428624933,3,14,5280
26678134@N04,2114,17,1428618446,1428618446,1,14,0
26678134@N04,2114,10,1428623710,1428623710,1,14,0
26678134@N04,2114,25,1428625461,1428625864,3,14,403
26678134@N04,2114,2,1428621216,1428621216,1,14,0
26678134@N04,2114,1,1428621559,1428623363,2,14,1804
26678134@N04,2114,9,1428620852,1428620852,1,14,0
26678134@N04,2115,19,1432166359,1432166359,1,3,0
26678134@N04,2115,20,1432167513,1432167513,1,3,0
26678134@N04,2115,27,1432175514,1432175514,1,3,0
26678134@N04,2116,14,1433385638,1433385638,1,1,0
26678134@N04,2117,24,1438224536,1438224536,1,8,0
26678134@N04,2117,27,1438228594,1438228594,1,8,0
26678134@N04,2117,5,1438218562,1438218562,1,8,0
26678134@N04,2117,13,1438221756,1438221834,3,8,78
26678134@N04,2117,17,1438221991,1438222033,2,8,42
26678134@N04,2117,4,1438218286,1438218286,1,8,0
26678134@N04,2117,10,1438221453,1438221453,1,8,0
26678134@N04,2117,9,1438226028,1438226028,1,8,0
26678134@N04,2118,24,1439510853,1439516777,4,12,5924
26678134@N04,2118,21,1439511155,1439511195,2,12,40
26678134@N04,2118,14,1439517423,1439517423,1,12,0
26678134@N04,2118,27,1439507133,1439507133,1,12,0
26678134@N04,2118,13,1439514094,1439514200,3,12,106
26678134@N04,2118,19,1439509402,1439509402,1,12,0
26678134@N04,2118,26,1439507626,1439510566,3,12,2940
26678134@N04,2118,17,1439507510,1439507659,3,12,149
26678134@N04,2118,12,1439514069,1439514069,1,12,0
26678134@N04,2118,22,1439510922,1439510970,3,12,48
26678134@N04,2118,25,1439511490,1439511490,1,12,0
26678134@N04,2118,9,1439517523,1439517523,1,12,0
26678134@N04,2119,6,1440724158,1440724158,1,1,0
26678134@N04,2120,24,1441933922,1441933922,1,5,0
26678134@N04,2120,19,1441931367,1441931962,4,5,595
26678134@N04,2120,27,1441927013,1441927013,1,5,0
26678134@N04,2120,13,1441929972,1441930012,3,5,40
26678134@N04,2120,4,1441927404,1441927404,1,5,0
26678134@N04,2121,19,1443138611,1443138611,1,1,0
26678134@N04,2122,22,1443317674,1443317674,1,4,0
26678134@N04,2122,25,1443315639,1443315639,1,4,0
26678134@N04,2122,19,1443321375,1443321375,1,4,0
26678134@N04,2122,27,1443310575,1443310575,1,4,0
26678134@N04,2123,18,1443832530,1443832530,1,2,0
26678134@N04,2123,4,1443834574,1443834574,1,2,0
26678134@N04,2124,10,1444348863,1444348863,1,5,0
26678134@N04,2124,18,1444351643,1444351643,1,5,0
26678134@N04,2124,15,1444349645,1444349768,2,5,123
26678134@N04,2124,27,1444353843,1444354017,4,5,174
26678134@N04,2124,20,1444342806,1444342870,2,5,64
26678134@N04,2125,7,1445386820,1445386820,1,3,0
26678134@N04,2125,22,1445380470,1445380470,1,3,0
26678134@N04,2125,18,1445388742,1445388742,1,3,0
26678134@N04,2126,10,1446334682,1446334682,1,6,0
26678134@N04,2126,2,1446333795,1446333795,1,6,0
26678134@N04,2126,3,1446346748,1446347152,3,6,404
26678134@N04,2126,24,1446338956,1446338956,1,6,0
26678134@N04,2126,19,1446331653,1446331653,1,6,0
26678134@N04,2126,4,1446333828,1446333828,1,6,0
26678134@N04,2127,19,1446769545,1446769545,1,2,0
26678134@N04,2127,27,1446777261,1446777261,1,2,0
26678134@N04,2128,1,1447240340,1447240340,1,3,0
26678134@N04,2128,6,1447236327,1447236327,1,3,0
26678134@N04,2128,16,1447234974,1447234974,1,3,0
26678134@N04,2129,19,1448615564,1448615564,1,3,0
26678134@N04,2129,27,1448624908,1448625072,2,3,164
26678134@N04,2129,13,1448623732,1448623732,1,3,0
26678134@N04,2130,16,1449291466,1449291466,1,2,0
26678134@N04,2130,27,1449291094,1449291242,4,2,148
26678134@N04,2131,16,1449921220,1449921220,1,2,0
26678134@N04,2131,27,1449921778,1449921820,3,2,42
26678134@N04,2132,4,1450474024,1450474024,1,7,0
26678134@N04,2132,16,1450485357,1450485357,1,7,0
26678134@N04,2132,27,1450473269,1450473655,5,7,386
26678134@N04,2132,19,1450480477,1450480477,1,7,0
26678134@N04,2132,13,1450478390,1450478390,1,7,0
26678134@N04,2132,24,1450483738,1450483882,2,7,144
26678134@N04,2132,1,1450474392,1450474392,1,7,0
26678134@N04,2133,27,1450913417,1450913474,3,3,57
26678134@N04,2133,3,1450919928,1450920025,2,3,97
26678134@N04,2133,24,1450915785,1450916319,3,3,534
26678134@N04,2134,27,1451203171,1451203182,2,2,11
26678134@N04,2134,24,1451205429,1451205429,1,2,0
26678134@N04,2135,17,1451362967,1451364057,26,2,1090
26678134@N04,2135,24,1451367144,1451367201,4,2,57
26678134@N04,2136,27,1451715550,1451732092,2,1,16542
26678134@N04,2137,21,1451899270,1451899270,1,5,0
26678134@N04,2137,27,1451899863,1451899897,2,5,34
26678134@N04,2137,23,1451896410,1451896410,1,5,0
26678134@N04,2137,22,1451891568,1451891568,1,5,0
26678134@N04,2137,3,1451897843,1451897843,1,5,0
26678134@N04,2138,18,1452042582,1452042582,1,7,0
26678134@N04,2138,26,1452040117,1452040117,1,7,0
26678134@N04,2138,17,1452038555,1452038607,2,7,52
26678134@N04,2138,10,1452033286,1452033286,1,7,0
26678134@N04,2138,22,1452043517,1452043517,1,7,0
26678134@N04,2138,25,1452039958,1452043814,2,7,3856
26678134@N04,2138,27,1452051070,1452051070,1,7,0
26678134@N04,2139,19,1452844610,1452844610,1,3,0
26678134@N04,2139,9,1452842613,1452842613,1,3,0
26678134@N04,2139,11,1452843433,1452843433,1,3,0
26678134@N04,2140,18,1452991841,1452991841,1,3,0
26678134@N04,2140,27,1453014464,1453014464,1,3,0
26678134@N04,2140,23,1452986174,1452986174,1,3,0
26678134@N04,2141,18,1453069607,1453069607,1,2,0
26678134@N04,2141,23,1453079711,1453079711,1,2,0
26678134@N04,2142,17,1455229198,1455229198,1,4,0
26678134@N04,2142,25,1455241357,1455241357,1,4,0
26678134@N04,2142,24,1455230636,1455231330,4,4,694
26678134@N04,2142,19,1455233633,1455235659,3,4,2026
26678134@N04,2143,2,1455315641,1455315641,1,4,0
26678134@N04,2143,18,1455322820,1455322820,1,4,0
26678134@N04,2143,11,1455318076,1455318076,1,4,0
26678134@N04,2143,27,1455318728,1455318728,1,4,0
26678134@N04,2144,10,1456007155,1456007155,1,10,0
26678134@N04,2144,17,1456007527,1456007527,1,10,0
26678134@N04,2144,22,1456007677,1456039977,2,10,32300
26678134@N04,2144,4,1456038699,1456038699,1,10,0
26678134@N04,2144,1,1456005697,1456005697,1,10,0
26678134@N04,2144,18,1456009283,1456014710,2,10,5427
26678134@N04,2144,14,1456007285,1456007285,1,10,0
26678134@N04,2144,13,1456007394,1456039647,5,10,32253
26678134@N04,2144,27,1456004750,1456004750,1,10,0
26678134@N04,2144,19,1456007881,1456009333,2,10,1452
26678134@N04,2145,27,1456465244,1456465244,1,1,0
26678134@N04,2146,27,1456610963,1456610963,1,1,0
26678134@N04,2147,22,1457830647,1457830647,1,5,0
26678134@N04,2147,9,1457831609,1457831609,1,5,0
26678134@N04,2147,16,1457843603,1457843603,1,5,0
26678134@N04,2147,13,1457843868,1457843868,1,5,0
26678134@N04,2147,27,1457834499,1457834499,1,5,0
26678134@N04,2148,1,1458339050,1458339050,1,2,0
26678134@N04,2148,16,1458342847,1458342847,1,2,0
26678134@N04,2149,10,1458423568,1458423568,1,3,0
26678134@N04,2149,15,1458427638,1458427638,1,3,0
26678134@N04,2149,16,1458423121,1458423121,1,3,0
26678134@N04,2150,14,1459666136,1459666136,1,2,0
26678134@N04,2150,17,1459664156,1459664156,1,2,0
26678134@N04,2151,13,1460076271,1460076271,1,1,0
26678134@N04,2152,11,1460160714,1460160714,1,2,0
26678134@N04,2152,15,1460156433,1460156465,2,2,32
26678134@N04,2153,18,1460274602,1460274602,1,1,0
26678134@N04,2154,7,1460801069,1460801069,1,1,0
26678134@N04,2155,19,1463299629,1463299629,1,1,0
26680632@N04,2156,1,1275716492,1275716492,1,2,0
26680632@N04,2156,21,1275700215,1275711205,2,2,10990
26754165@N08,2157,27,1290341931,1290341931,1,2,0
26754165@N08,2157,4,1290337926,1290337926,1,2,0
26824176@N00,2158,27,1203297079,1203297129,3,2,50
26824176@N00,2158,16,1203299401,1203299401,1,2,0
26859501@N00,2159,14,1269054129,1269054129,1,18,0
26859501@N00,2159,19,1269039671,1269053125,36,18,13454
26859501@N00,2159,1,1269058710,1269062101,5,18,3391
26859501@N00,2159,27,1269037868,1269075119,21,18,37251
26859501@N00,2159,17,1269044440,1269053998,10,18,9558
26859501@N00,2159,8,1269062590,1269062761,12,18,171
26859501@N00,2159,12,1269054328,1269056903,17,18,2575
26859501@N00,2159,11,1269062865,1269071316,2,18,8451
26859501@N00,2159,22,1269044126,1269053512,3,18,9386
26859501@N00,2159,15,1269054950,1269057412,16,18,2462
26859501@N00,2159,16,1269054088,1269054088,1,18,0
26859501@N00,2159,24,1269067639,1269069640,3,18,2001
26859501@N00,2159,20,1269040485,1269065636,10,18,25151
26859501@N00,2159,13,1269045661,1269056833,15,18,11172
26859501@N00,2159,9,1269057613,1269057773,3,18,160
26859501@N00,2159,21,1269065764,1269065769,2,18,5
26859501@N00,2159,18,1269045256,1269045797,4,18,541
26859501@N00,2159,26,1269044275,1269053748,4,18,9473
26859501@N00,2160,19,1281366774,1281366774,1,2,0
26859501@N00,2160,27,1281365936,1281365936,1,2,0
26874770@N06,2161,17,1188128849,1188128849,1,4,0
26874770@N06,2161,4,1188113919,1188123097,2,4,9178
26874770@N06,2161,1,1188136200,1188136200,1,4,0
26874770@N06,2161,27,1188095710,1188122809,3,4,27099
26874770@N06,2162,27,1191488945,1191488945,1,1,0
26874770@N06,2163,2,1191769029,1191769029,1,2,0
26874770@N06,2163,27,1191751616,1191773162,4,2,21546
26874770@N06,2164,27,1191826411,1191826441,4,1,30
26874770@N06,2165,16,1197359302,1197359302,1,2,0
26874770@N06,2165,3,1197379376,1197380010,2,2,634
26874770@N06,2166,18,1204261158,1204261158,1,2,0
26874770@N06,2166,27,1204255847,1204255847,1,2,0
26874770@N06,2167,27,1204941029,1204941029,1,1,0
26874770@N06,2168,13,1226643649,1226660806,13,17,17157
26874770@N06,2168,15,1226643875,1226643902,3,17,27
26874770@N06,2168,14,1226642371,1226652026,11,17,9655
26874770@N06,2168,25,1226642202,1226642264,2,17,62
26874770@N06,2168,2,1226645400,1226645400,1,17,0
26874770@N06,2168,16,1226648184,1226652795,11,17,4611
26874770@N06,2168,7,1226644647,1226644647,1,17,0
26874770@N06,2168,26,1226643321,1226643348,2,17,27
26874770@N06,2168,22,1226642346,1226642373,2,17,27
26874770@N06,2168,21,1226642611,1226642657,3,17,46
26874770@N06,2168,23,1226642357,1226642545,5,17,188
26874770@N06,2168,17,1226643302,1226643614,9,17,312
26874770@N06,2168,9,1226644417,1226644417,1,17,0
26874770@N06,2168,24,1226642503,1226642527,2,17,24
26874770@N06,2168,12,1226643855,1226655364,5,17,11509
26874770@N06,2168,19,1226642801,1226642869,2,17,68
26874770@N06,2168,3,1226649489,1226656951,3,17,7462
26874770@N06,2169,15,1226815152,1226818807,3,8,3655
26874770@N06,2169,25,1226814915,1226814915,1,8,0
26874770@N06,2169,16,1226815510,1226819321,2,8,3811
26874770@N06,2169,9,1226815225,1226815298,2,8,73
26874770@N06,2169,14,1226815260,1226819249,3,8,3989
26874770@N06,2169,21,1226819583,1226819755,2,8,172
26874770@N06,2169,17,1226815113,1226815113,1,8,0
26874770@N06,2169,12,1226815243,1226815243,1,8,0
26874770@N06,2170,27,1231538879,1231538879,1,1,0
26874770@N06,2171,16,1234775843,1234775843,1,1,0
26874770@N06,2172,23,1235971134,1235971911,2,13,777
26874770@N06,2172,9,1235952316,1235952940,5,13,624
26874770@N06,2172,8,1235963746,1235964021,6,13,275
26874770@N06,2172,24,1235972150,1235981583,2,13,9433
26874770@N06,2172,1,1235961178,1235961178,1,13,0
26874770@N06,2172,27,1235962274,1235962481,4,13,207
26874770@N06,2172,4,1235949941,1235961546,2,13,11605
26874770@N06,2172,13,1235965539,1235965539,1,13,0
26874770@N06,2172,15,1235955523,1235965347,6,13,9824
26874770@N06,2172,14,1235953671,1235958220,11,13,4549
26874770@N06,2172,2,1235952718,1235952718,1,13,0
26874770@N06,2172,16,1235978204,1235978204,1,13,0
26874770@N06,2172,12,1235956470,1235980862,8,13,24392
26874770@N06,2173,9,1245499897,1245499897,1,1,0
26874770@N06,2174,22,1251540380,1251540380,1,11,0
26874770@N06,2174,23,1251531848,1251533020,3,11,1172
26874770@N06,2174,17,1251526808,1251528865,3,11,2057
26874770@N06,2174,9,1251520557,1251520557,1,11,0
26874770@N06,2174,24,1251531538,1251534478,3,11,2940
26874770@N06,2174,27,1251500792,1251550371,2,11,49579
26874770@N06,2174,15,1251540640,1251540640,1,11,0
26874770@N06,2174,14,1251503347,1251503483,2,11,136
26874770@N06,2174,25,1251533536,1251533760,5,11,224
26874770@N06,2174,16,1251501215,1251530415,2,11,29200
26874770@N06,2174,26,1251533364,1251533364,1,11,0
26874770@N06,2175,2,1281267502,1281267502,1,1,0
26874770@N06,2176,9,1281395979,1281396513,4,4,534
26874770@N06,2176,16,1281395713,1281395713,1,4,0
26874770@N06,2176,14,1281396144,1281397175,2,4,1031
26874770@N06,2176,2,1281415811,1281415811,1,4,0
26874770@N06,2177,1,1281445446,1281445446,1,1,0
26874770@N06,2178,1,1281715263,1281715263,1,2,0
26874770@N06,2178,27,1281705510,1281705698,2,2,188
26874770@N06,2179,9,1281840516,1281840655,3,6,139
26874770@N06,2179,12,1281839953,1281840166,3,6,213
26874770@N06,2179,1,1281840734,1281841461,2,6,727
26874770@N06,2179,14,1281839384,1281839667,4,6,283
26874770@N06,2179,2,1281840991,1281841696,4,6,705
26874770@N06,2179,16,1281839442,1281839442,1,6,0
26888485@N08,2180,23,1371431215,1371431215,1,1,0
26893451@N02,2181,8,1360465762,1360465762,2,2,0
26893451@N02,2181,17,1360469561,1360469561,1,2,0
26897917@N02,2182,1,1422667407,1422667407,1,2,0
26897917@N02,2182,27,1422667411,1422667411,1,2,0
26913230@N03,2183,16,1248231794,1248264703,12,1,32909
27027561@N03,2184,27,1298604945,1298604945,1,1,0
27027561@N03,2185,27,1382537645,1382537645,1,3,0
27027561@N03,2185,16,1382549589,1382549589,1,3,0
27027561@N03,2185,2,1382541437,1382541437,1,3,0
27027561@N03,2186,16,1382853968,1382853968,1,3,0
27027561@N03,2186,13,1382848336,1382848336,1,3,0
27027561@N03,2186,2,1382854336,1382854336,1,3,0
27064297@N04,2187,21,1360408889,1360408889,1,1,0
27064629@N00,2188,10,1403224477,1403224556,3,4,79
27064629@N00,2188,14,1403217384,1403221401,7,4,4017
27064629@N00,2188,15,1403222575,1403222578,2,4,3
27064629@N00,2188,16,1403216576,1403216941,2,4,365
27064629@N00,2189,9,1403259840,1403259907,3,2,67
27064629@N00,2189,14,1403259087,1403259096,3,2,9
27178638@N00,2190,16,1359065621,1359081901,2,3,16280
27178638@N00,2190,27,1359098983,1359098983,1,3,0
27178638@N00,2190,1,1359077951,1359077951,1,3,0
27178638@N00,2191,20,1368609358,1368609358,1,2,0
27178638@N00,2191,16,1368614217,1368614217,1,2,0
27182886@N02,2192,7,1451423578,1451423578,1,3,0
27182886@N02,2192,3,1451425100,1451425100,1,3,0
27182886@N02,2192,25,1451423038,1451423038,1,3,0
27233089@N04,2193,19,1251768267,1251768267,1,1,0
27233089@N04,2194,4,1256611062,1256611062,1,1,0
27233089@N04,2195,27,1298608235,1298608235,1,4,0
27233089@N04,2195,11,1298622138,1298622138,1,4,0
27233089@N04,2195,17,1298629308,1298629467,2,4,159
27233089@N04,2195,16,1298631254,1298631435,2,4,181
27249103@N05,2196,16,1227005796,1227005796,1,1,0
27270108@N05,2197,27,1306543330,1306576256,22,1,32926
27270108@N05,2198,27,1307000504,1307011324,23,1,10820
27270108@N05,2199,27,1307072873,1307088877,14,1,16004
27270108@N05,2200,27,1307158320,1307167901,12,1,9581
27270108@N05,2201,22,1339407570,1339408454,3,1,884
27270108@N05,2202,17,1339478177,1339478361,2,1,184
27270108@N05,2203,17,1339564867,1339565066,4,2,199
27270108@N05,2203,19,1339553145,1339553163,2,2,18
27270108@N05,2204,17,1339823840,1339824092,14,2,252
27270108@N05,2204,22,1339808967,1339808967,1,2,0
27270108@N05,2205,17,1357013873,1357014354,19,1,481
27270108@N05,2206,9,1403265949,1403266240,4,1,291
27312248@N04,2207,2,1216123302,1216123308,3,4,6
27312248@N04,2207,27,1216133081,1216133082,2,4,1
27312248@N04,2207,20,1216133246,1216133246,1,4,0
27312248@N04,2207,17,1216133088,1216133090,2,4,2
27312709@N00,2208,15,1280643763,1280643763,1,1,0
27316914@N02,2209,23,1194348854,1194348854,1,1,0
27338137@N06,2210,27,1253835640,1253835640,1,1,0
27338137@N06,2211,14,1319068168,1319068168,1,2,0
27338137@N06,2211,27,1319065187,1319065187,1,2,0
27372897@N00,2212,27,1353025357,1353025371,2,1,14
27372897@N00,2213,27,1353265766,1353265766,1,1,0
27373375@N03,2214,27,1443958440,1443958453,2,1,13
27373375@N03,2215,27,1444139716,1444139716,1,1,0
27383466@N02,2216,16,1230654688,1230654888,3,1,200
27383466@N02,2217,16,1248161930,1248161930,1,1,0
27429042@N08,2218,17,1192534496,1192534496,1,1,0
27429042@N08,2219,14,1231290805,1231291695,4,8,890
27429042@N08,2219,20,1231280563,1231281671,2,8,1108
27429042@N08,2219,9,1231287750,1231287750,1,8,0
27429042@N08,2219,23,1231277963,1231278001,2,8,38
27429042@N08,2219,19,1231282192,1231282192,1,8,0
27429042@N08,2219,17,1231282011,1231282011,1,8,0
27429042@N08,2219,16,1231290893,1231290913,2,8,20
27429042@N08,2219,8,1231292481,1231292950,2,8,469
27429042@N08,2220,4,1231662302,1231662302,1,2,0
27429042@N08,2220,27,1231651461,1231651461,1,2,0
27429042@N08,2221,15,1264313718,1264313718,1,6,0
27429042@N08,2221,16,1264313882,1264313882,1,6,0
27429042@N08,2221,17,1264312415,1264312415,1,6,0
27429042@N08,2221,13,1264312046,1264312046,1,6,0
27429042@N08,2221,14,1264315226,1264315226,1,6,0
27429042@N08,2221,22,1264308549,1264308549,1,6,0
27429042@N08,2222,17,1267501751,1267501751,1,5,0
27429042@N08,2222,16,1267502273,1267502320,2,5,47
27429042@N08,2222,18,1267500287,1267500287,1,5,0
27429042@N08,2222,20,1267499751,1267499751,1,5,0
27429042@N08,2222,19,1267501092,1267501092,1,5,0
27429042@N08,2223,18,1268358817,1268358817,1,3,0
27429042@N08,2223,26,1268353941,1268353941,1,3,0
27429042@N08,2223,27,1268352509,1268352509,1,3,0
27429042@N08,2224,20,1272953691,1272953691,1,2,0
27429042@N08,2224,19,1272948638,1272948638,1,2,0
27429042@N08,2225,1,1273643835,1273643835,1,3,0
27429042@N08,2225,27,1273632029,1273632145,3,3,116
27429042@N08,2225,21,1273635611,1273635611,1,3,0
27429042@N08,2226,16,1274396542,1274396542,1,3,0
27429042@N08,2226,14,1274396866,1274397303,2,3,437
27429042@N08,2226,27,1274399854,1274399854,1,3,0
27429042@N08,2227,11,1292301952,1292301952,1,6,0
27429042@N08,2227,1,1292294594,1292294594,1,6,0
27429042@N08,2227,16,1292291107,1292292290,3,6,1183
27429042@N08,2227,2,1292294413,1292294413,1,6,0
27429042@N08,2227,14,1292292439,1292292491,2,6,52
27429042@N08,2227,9,1292292629,1292292629,1,6,0
27429042@N08,2228,13,1300769164,1300770075,3,4,911
27429042@N08,2228,9,1300795805,1300795805,1,4,0
27429042@N08,2228,19,1300769093,1300769093,1,4,0
27429042@N08,2228,21,1300760892,1300760892,1,4,0
27429042@N08,2229,14,1322092211,1322092211,1,1,0
27429042@N08,2230,21,1331105676,1331105676,1,7,0
27429042@N08,2230,23,1331075403,1331075403,1,7,0
27429042@N08,2230,26,1331075362,1331075362,1,7,0
27429042@N08,2230,27,1331103792,1331103792,1,7,0
27429042@N08,2230,1,1331095060,1331095060,1,7,0
27429042@N08,2230,18,1331077567,1331077567,1,7,0
27429042@N08,2230,2,1331085056,1331085056,1,7,0
27429042@N08,2231,8,1349321611,1349321611,1,1,0
27432207@N05,2232,25,1212800580,1212800580,1,1,0
27457334@N02,2233,27,1333634737,1333634737,1,2,0
27457334@N02,2233,16,1333631424,1333631424,1,2,0
27527078@N05,2234,1,1360479763,1360479763,1,8,0
27527078@N05,2234,3,1360481431,1360481733,5,8,302
27527078@N05,2234,16,1360469704,1360469944,8,8,240
27527078@N05,2234,14,1360457142,1360468369,14,8,11227
27527078@N05,2234,4,1360484217,1360484291,2,8,74
27527078@N05,2234,27,1360454240,1360455580,14,8,1340
27527078@N05,2234,6,1360465424,1360479755,5,8,14331
27527078@N05,2234,9,1360471281,1360471919,16,8,638
27527078@N05,2235,1,1360628473,1360628473,1,9,0
27527078@N05,2235,7,1360627474,1360627511,3,9,37
27527078@N05,2235,15,1360644724,1360646127,7,9,1403
27527078@N05,2235,19,1360640974,1360641014,7,9,40
27527078@N05,2235,23,1360636007,1360637485,10,9,1478
27527078@N05,2235,22,1360642967,1360642978,2,9,11
27527078@N05,2235,27,1360622268,1360622595,6,9,327
27527078@N05,2235,20,1360653389,1360654100,4,9,711
27527078@N05,2235,12,1360646191,1360646193,2,9,2
27527078@N05,2236,1,1360893418,1360893428,3,6,10
27527078@N05,2236,17,1360903264,1360903534,2,6,270
27527078@N05,2236,14,1360917333,1360917333,1,6,0
27527078@N05,2236,20,1360908267,1360908267,1,6,0
27527078@N05,2236,6,1360893441,1360893581,2,6,140
27527078@N05,2236,9,1360893458,1360893458,1,6,0
27528021@N06,2237,16,1413751530,1413807864,138,1,56334
27528021@N06,2238,16,1414011118,1414052175,130,1,41057
27539218@N06,2239,16,1210399888,1210399888,1,1,0
27539218@N06,2240,13,1216372475,1216372475,1,2,0
27539218@N06,2240,19,1216371889,1216372026,2,2,137
27539218@N06,2241,21,1216470112,1216470112,1,1,0
27539218@N06,2242,27,1221800707,1221801916,4,1,1209
27539218@N06,2243,27,1222061249,1222061506,2,1,257
27539218@N06,2244,16,1224749728,1224749728,1,1,0
27539218@N06,2245,9,1228633352,1228633352,1,1,0
27539218@N06,2246,16,1230036938,1230036938,1,1,0
27539218@N06,2247,27,1230444299,1230444299,1,2,0
27539218@N06,2247,3,1230452748,1230452748,1,2,0
27539218@N06,2248,22,1232000639,1232000737,4,4,98
27539218@N06,2248,12,1232002111,1232002384,3,4,273
27539218@N06,2248,24,1231996943,1231996943,1,4,0
27539218@N06,2248,20,1231998110,1231998260,5,4,150
27539218@N06,2249,21,1234666007,1234666007,1,3,0
27539218@N06,2249,27,1234655186,1234657800,4,3,2614
27539218@N06,2249,12,1234668045,1234668138,2,3,93
27539218@N06,2250,3,1244090674,1244090674,1,1,0
27539218@N06,2251,27,1245838743,1245838743,1,1,0
27539218@N06,2252,6,1248176616,1248176616,1,2,0
27539218@N06,2252,14,1248176612,1248176612,1,2,0
27539218@N06,2253,14,1260681447,1260681447,1,6,0
27539218@N06,2253,24,1260670525,1260670525,1,6,0
27539218@N06,2253,4,1260689267,1260692807,3,6,3540
27539218@N06,2253,9,1260688014,1260688014,1,6,0
27539218@N06,2253,21,1260671545,1260672262,4,6,717
27539218@N06,2253,27,1260667111,1260709142,2,6,42031
27539218@N06,2254,1,1261291483,1261292321,6,1,838
27557422@N08,2255,3,1212778010,1212778015,2,2,5
27557422@N08,2255,1,1212775123,1212775123,1,2,0
27618178@N08,2256,16,1351926991,1351931837,2,1,4846
27624680@N02,2257,16,1303636611,1303636611,1,1,0
27719489@N06,2258,12,1325388380,1325388380,2,1,0
27724919@N02,2259,27,1212727127,1212727127,1,1,0
27724919@N02,2260,27,1212886913,1212903710,3,1,16797
27724919@N02,2261,27,1213059639,1213068962,6,1,9323
27794725@N03,2262,16,1441875828,1441875828,1,1,0
27794725@N03,2263,13,1442543733,1442543733,1,1,0
27813472@N00,2264,27,1422232280,1422232462,5,4,182
27813472@N00,2264,22,1422241749,1422242057,2,4,308
27813472@N00,2264,16,1422229414,1422229414,1,4,0
27813472@N00,2264,19,1422241323,1422241323,1,4,0
27813472@N00,2265,27,1422329679,1422329679,1,4,0
27813472@N00,2265,23,1422314176,1422314176,1,4,0
27813472@N00,2265,24,1422327490,1422327490,1,4,0
27813472@N00,2265,16,1422320877,1422320877,1,4,0
27813472@N00,2266,26,1422570811,1422570811,1,2,0
27813472@N00,2266,17,1422570779,1422570779,1,2,0
27830299@N06,2267,8,1197007407,1197007407,1,2,0
27830299@N06,2267,19,1197012440,1197012440,1,2,0
27835170@N07,2268,16,1381017629,1381017629,1,1,0
27835170@N07,2269,10,1411804352,1411804352,1,1,0
27853624@N00,2270,2,1230190163,1230190163,1,1,0
27865886@N08,2271,11,1219488466,1219490097,4,1,1631
27874898@N00,2272,27,1349571243,1349594836,6,10,23593
27874898@N00,2272,20,1349582045,1349584532,9,10,2487
27874898@N00,2272,15,1349586346,1349586549,4,10,203
27874898@N00,2272,1,1349592669,1349592669,1,10,0
27874898@N00,2272,13,1349577106,1349577405,9,10,299
27874898@N00,2272,5,1349590996,1349590996,1,10,0
27874898@N00,2272,4,1349592637,1349592637,1,10,0
27874898@N00,2272,19,1349579103,1349584542,4,10,5439
27874898@N00,2272,2,1349592643,1349592643,1,10,0
27874898@N00,2272,21,1349582692,1349584085,12,10,1393
27874898@N00,2273,11,1350093344,1350094418,6,8,1074
27874898@N00,2273,20,1350124620,1350124620,1,8,0
27874898@N00,2273,1,1350096464,1350096521,3,8,57
27874898@N00,2273,3,1350099108,1350099108,1,8,0
27874898@N00,2273,5,1350096565,1350097379,2,8,814
27874898@N00,2273,19,1350088987,1350092895,3,8,3908
27874898@N00,2273,6,1350096627,1350096627,1,8,0
27874898@N00,2273,4,1350096530,1350096557,2,8,27
27874898@N00,2274,27,1367908887,1367910057,3,5,1170
27874898@N00,2274,20,1367900108,1367900108,1,5,0
27874898@N00,2274,1,1367913841,1367913852,2,5,11
27874898@N00,2274,6,1367903895,1367903895,1,5,0
27874898@N00,2274,2,1367913601,1367913601,1,5,0
27874898@N00,2275,10,1368090324,1368092090,28,7,1766
27874898@N00,2275,9,1368092431,1368092437,2,7,6
27874898@N00,2275,16,1368087780,1368087780,1,7,0
27874898@N00,2275,3,1368094058,1368094058,1,7,0
27874898@N00,2275,6,1368092518,1368092518,1,7,0
27874898@N00,2275,2,1368093481,1368093926,11,7,445
27874898@N00,2275,21,1368100263,1368100263,1,7,0
27874898@N00,2276,27,1378605253,1378638704,23,2,33451
27874898@N00,2276,2,1378635081,1378638390,6,2,3309
27874898@N00,2277,27,1378973893,1378973893,1,6,0
27874898@N00,2277,18,1378978338,1378978344,2,6,6
27874898@N00,2277,20,1378975823,1378978521,7,6,2698
27874898@N00,2277,1,1378981143,1378981219,4,6,76
27874898@N00,2277,5,1378980910,1378980910,1,6,0
27874898@N00,2277,6,1378981070,1378981070,1,6,0
27874898@N00,2278,27,1379139309,1379139334,2,3,25
27874898@N00,2278,20,1379136290,1379136298,2,3,8
27874898@N00,2278,21,1379132627,1379132627,1,3,0
27902479@N02,2279,21,1394677826,1394677826,1,3,0
27902479@N02,2279,4,1394666476,1394666476,1,3,0
27902479@N02,2279,18,1394672840,1394672840,1,3,0
27907946@N04,2280,16,1215842379,1215881802,11,1,39423
27914975@N06,2281,27,1379029381,1379029381,1,4,0
27914975@N06,2281,19,1379032554,1379032554,1,4,0
27914975@N06,2281,18,1379033213,1379033213,1,4,0
27914975@N06,2281,6,1379043280,1379043303,2,4,23
27934342@N00,2282,14,1326929372,1326933219,3,1,3847
27967379@N08,2283,21,1410316270,1410343586,6,10,27316
27967379@N08,2283,20,1410314686,1410322271,6,10,7585
27967379@N08,2283,22,1410314440,1410314440,1,10,0
27967379@N08,2283,3,1410329820,1410330179,5,10,359
27967379@N08,2283,9,1410325890,1410326042,2,10,152
27967379@N08,2283,1,1410333378,1410333384,2,10,6
27967379@N08,2283,17,1410345036,1410347943,3,10,2907
27967379@N08,2283,13,1410314037,1410314041,2,10,4
27967379@N08,2283,25,1410341451,1410341458,2,10,7
27967379@N08,2283,27,1410352764,1410352794,3,10,30
27976717@N05,2284,27,1220759838,1220759848,2,2,10
27976717@N05,2284,17,1220767188,1220767188,1,2,0
28004076@N04,2285,13,1399697288,1399697295,2,1,7
28019195@N07,2286,20,1418927668,1418927668,1,1,0
28031728@N02,2287,3,1267490049,1267490049,1,1,0
28031728@N02,2288,14,1267638494,1267638494,1,1,0
28031728@N02,2289,22,1267781903,1267781903,1,1,0
28031728@N02,2290,17,1268111903,1268111903,1,1,0
28031728@N02,2291,15,1268190551,1268190551,1,1,0
28031728@N02,2292,27,1268245989,1268245989,1,1,0
28031728@N02,2293,21,1268727988,1268727988,1,1,0
28031728@N02,2294,21,1268935332,1268935332,1,1,0
28031728@N02,2295,27,1269022832,1269022832,1,1,0
28031728@N02,2296,4,1270276547,1270276547,1,1,0
28031728@N02,2297,3,1270328053,1270328053,1,1,0
28057734@N03,2298,16,1313922312,1313922312,1,1,0
28057734@N03,2299,18,1316220220,1316220224,3,2,4
28057734@N03,2299,19,1316220227,1316220227,1,2,0
28065533@N00,2300,14,1356053221,1356053221,1,1,0
28069677@N00,2301,16,1223765002,1223765418,3,1,416
28069677@N00,2302,12,1223797978,1223797978,1,1,0
28069677@N00,2303,27,1224045293,1224045347,7,3,54
28069677@N00,2303,11,1224030999,1224030999,1,3,0
28069677@N00,2303,13,1224023935,1224023935,1,3,0
28069677@N00,2304,27,1224127455,1224127519,3,1,64
28083255@N00,2305,19,1416533064,1416533064,1,2,0
28083255@N00,2305,14,1416521208,1416521264,2,2,56
28083255@N00,2306,19,1443484723,1443484723,1,1,0
28083255@N00,2307,1,1443662428,1443662546,2,1,118
28113539@N07,2308,18,1222138425,1222138443,2,11,18
28113539@N07,2308,3,1222140940,1222140940,1,11,0
28113539@N07,2308,13,1222138603,1222139011,4,11,408
28113539@N07,2308,24,1222132049,1222132049,1,11,0
28113539@N07,2308,22,1222133653,1222135065,3,11,1412
28113539@N07,2308,16,1222130447,1222143329,4,11,12882
28113539@N07,2308,17,1222138764,1222138764,1,11,0
28113539@N07,2308,26,1222135163,1222135163,1,11,0
28113539@N07,2308,23,1222137063,1222137063,1,11,0
28113539@N07,2308,21,1222132218,1222138056,4,11,5838
28113539@N07,2308,27,1222130042,1222148919,8,11,18877
28132447@N00,2309,17,1292585656,1292585676,2,1,20
28163344@N08,2310,27,1446769088,1446769088,1,3,0
28163344@N08,2310,6,1446777698,1446777698,1,3,0
28163344@N08,2310,15,1446763413,1446763413,1,3,0
28203925@N08,2311,27,1344990673,1344990673,1,1,0
28215341@N07,2312,10,1424299536,1424299536,1,1,0
28223347@N00,2313,17,1298626882,1298630518,5,8,3636
28223347@N00,2313,4,1298630886,1298630886,1,8,0
28223347@N00,2313,26,1298628453,1298628453,1,8,0
28223347@N00,2313,22,1298630203,1298630203,1,8,0
28223347@N00,2313,19,1298628975,1298629355,3,8,380
28223347@N00,2313,14,1298627351,1298627643,3,8,292
28223347@N00,2313,20,1298628645,1298628804,2,8,159
28223347@N00,2313,16,1298627022,1298627022,1,8,0
28245557@N00,2314,21,1416971032,1416971032,1,3,0
28245557@N00,2314,15,1416951902,1416951902,1,3,0
28245557@N00,2314,27,1416961046,1416961046,1,3,0
28267103@N07,2315,9,1193272898,1193272898,1,1,0
28289318@N07,2316,27,1433193187,1433226277,70,1,33090
28289318@N07,2317,27,1433336164,1433339484,13,1,3320
28289318@N07,2318,27,1433457412,1433512790,70,1,55378
28305413@N07,2319,27,1390893442,1390893442,1,1,0
28311054@N03,2320,16,1197064660,1197064660,1,1,0
28311054@N03,2321,16,1197920570,1197929644,2,1,9074
28311054@N03,2322,16,1214853509,1214864689,7,1,11180
28312366@N08,2323,14,1387867997,1387867997,1,1,0
28416483@N03,2324,17,1342576495,1342576495,1,2,0
28416483@N03,2324,16,1342576718,1342576858,2,2,140
28416483@N03,2325,16,1342821758,1342821758,1,1,0
28416483@N03,2326,27,1342857873,1342858123,2,2,250
28416483@N03,2326,16,1342852889,1342852899,2,2,10
28416483@N03,2327,15,1343113755,1343113755,1,2,0
28416483@N03,2327,16,1343117884,1343117884,1,2,0
28450912@N02,2328,19,1220165579,1220165786,4,9,207
28450912@N02,2328,27,1220160485,1220167511,6,9,7026
28450912@N02,2328,4,1220160832,1220161110,4,9,278
28450912@N02,2328,16,1220162759,1220162759,2,9,0
28450912@N02,2328,22,1220165891,1220165898,4,9,7
28450912@N02,2328,13,1220166417,1220166417,2,9,0
28450912@N02,2328,25,1220187004,1220187004,1,9,0
28450912@N02,2328,15,1220166554,1220166554,2,9,0
28450912@N02,2328,17,1220162894,1220167108,8,9,4214
28450912@N02,2329,24,1235792196,1235799756,3,7,7560
28450912@N02,2329,26,1235791955,1235794300,2,7,2345
28450912@N02,2329,27,1235789097,1235824342,2,7,35245
28450912@N02,2329,16,1235822128,1235822128,1,7,0
28450912@N02,2329,22,1235798765,1235804080,3,7,5315
28450912@N02,2329,25,1235794506,1235794792,4,7,286
28450912@N02,2329,17,1235789372,1235789372,1,7,0
28450912@N02,2330,25,1238831021,1238839850,4,7,8829
28450912@N02,2330,21,1238849197,1238849526,2,7,329
28450912@N02,2330,24,1238831265,1238831265,1,7,0
28450912@N02,2330,23,1238848949,1238848949,1,7,0
28450912@N02,2330,19,1238832693,1238832693,1,7,0
28450912@N02,2330,27,1238830453,1238830511,3,7,58
28450912@N02,2330,18,1238832121,1238832121,1,7,0
28450912@N02,2331,22,1246788701,1246788701,1,1,0
28450912@N02,2332,16,1249892948,1249892948,1,14,0
28450912@N02,2332,13,1249892940,1249893084,2,14,144
28450912@N02,2332,25,1249892932,1249893092,7,14,160
28450912@N02,2332,15,1249892929,1249892929,1,14,0
28450912@N02,2332,21,1249892931,1249893215,9,14,284
28450912@N02,2332,24,1249892937,1249892939,2,14,2
28450912@N02,2332,9,1249892946,1249892946,1,14,0
28450912@N02,2332,1,1249892945,1249892945,1,14,0
28450912@N02,2332,19,1249893081,1249893081,1,14,0
28450912@N02,2332,26,1249892931,1249893078,4,14,147
28450912@N02,2332,27,1249892925,1249893070,6,14,145
28450912@N02,2332,20,1249892934,1249892936,2,14,2
28450912@N02,2332,18,1249892940,1249893080,6,14,140
28450912@N02,2332,22,1249892930,1249893217,6,14,287
28450912@N02,2333,27,1252041306,1252041306,1,1,0
28450912@N02,2334,27,1252243350,1252249324,3,1,5974
28450912@N02,2335,27,1260479650,1260479650,1,1,0
28450912@N02,2336,16,1260620889,1260621303,3,2,414
28450912@N02,2336,17,1260620477,1260620477,1,2,0
28450912@N02,2337,13,1263737952,1263737952,1,7,0
28450912@N02,2337,15,1263736147,1263736920,4,7,773
28450912@N02,2337,9,1263734581,1263734919,6,7,338
28450912@N02,2337,17,1263738781,1263738781,1,7,0
28450912@N02,2337,27,1263728346,1263730759,19,7,2413
28450912@N02,2337,6,1263732648,1263734042,4,7,1394
28450912@N02,2337,2,1263732386,1263732386,1,7,0
28450912@N02,2338,16,1274514872,1274516084,11,4,1212
28450912@N02,2338,17,1274515036,1274515109,2,4,73
28450912@N02,2338,14,1274516199,1274516554,4,4,355
28450912@N02,2338,18,1274517406,1274517406,1,4,0
28450912@N02,2339,17,1275136035,1275136035,1,3,0
28450912@N02,2339,26,1275135500,1275135724,2,3,224
28450912@N02,2339,27,1275132344,1275132740,2,3,396
28450912@N02,2340,3,1275225011,1275225011,1,11,0
28450912@N02,2340,13,1275227887,1275227887,1,11,0
28450912@N02,2340,9,1275225893,1275225893,1,11,0
28450912@N02,2340,27,1275223872,1275235902,10,11,12030
28450912@N02,2340,14,1275226862,1275226862,1,11,0
28450912@N02,2340,2,1275225179,1275225221,2,11,42
28450912@N02,2340,25,1275237303,1275237781,2,11,478
28450912@N02,2340,5,1275224894,1275224894,1,11,0
28450912@N02,2340,21,1275238541,1275238541,1,11,0
28450912@N02,2340,24,1275238331,1275238331,1,11,0
28450912@N02,2340,17,1275228371,1275228371,1,11,0
28450912@N02,2341,27,1323997657,1323998652,12,1,995
28450912@N02,2342,12,1324125163,1324125163,1,3,0
28450912@N02,2342,16,1324126286,1324126395,2,3,109
28450912@N02,2342,17,1324128009,1324128868,8,3,859
28450912@N02,2343,27,1388373256,1388373256,1,4,0
28450912@N02,2343,26,1388374396,1388374396,1,4,0
28450912@N02,2343,23,1388374532,1388374532,1,4,0
28450912@N02,2343,25,1388374222,1388374334,3,4,112
28450912@N02,2344,20,1400153974,1400153974,1,2,0
28450912@N02,2344,16,1400148102,1400148116,2,2,14
28450912@N02,2345,8,1400456518,1400456518,1,1,0
28450912@N02,2346,26,1416120462,1416120462,1,5,0
28450912@N02,2346,10,1416122234,1416122530,2,5,296
28450912@N02,2346,27,1416119490,1416144668,2,5,25178
28450912@N02,2346,18,1416120350,1416120350,1,5,0
28450912@N02,2346,17,1416120120,1416120566,2,5,446
28450912@N02,2347,18,1416185082,1416185082,1,2,0
28450912@N02,2347,17,1416184940,1416184940,1,2,0
28464553@N03,2348,27,1231637665,1231637919,3,7,254
28464553@N03,2348,14,1231657666,1231657666,1,7,0
28464553@N03,2348,24,1231646710,1231647359,5,7,649
28464553@N03,2348,16,1231637433,1231637433,1,7,0
28464553@N03,2348,13,1231651915,1231651915,1,7,0
28464553@N03,2348,18,1231650253,1231650294,2,7,41
28464553@N03,2348,25,1231644973,1231645096,3,7,123
28466131@N07,2349,16,1295062350,1295062350,1,1,0
28469514@N05,2350,16,1380883326,1380883442,2,1,116
28474359@N03,2351,27,1217364938,1217365585,3,1,647
28474359@N03,2352,16,1217565727,1217565795,2,1,68
28483202@N02,2353,14,1367728765,1367737419,2,1,8654
28495380@N05,2354,17,1431391776,1431391830,25,1,54
28495936@N03,2355,18,1292385120,1292385120,1,1,0
28495936@N03,2356,9,1294710649,1294710649,1,6,0
28495936@N03,2356,20,1294708924,1294709124,2,6,200
28495936@N03,2356,16,1294707713,1294707713,1,6,0
28495936@N03,2356,15,1294710429,1294710429,1,6,0
28495936@N03,2356,17,1294707921,1294710021,2,6,2100
28495936@N03,2356,3,1294713368,1294713368,1,6,0
28495936@N03,2357,10,1295743753,1295743753,1,2,0
28495936@N03,2357,19,1295743581,1295743581,1,2,0
28495936@N03,2358,10,1300061740,1300061879,4,2,139
28495936@N03,2358,8,1300061851,1300061851,1,2,0
28495936@N03,2359,11,1300750259,1300750259,1,4,0
28495936@N03,2359,25,1300750396,1300750396,1,4,0
28495936@N03,2359,23,1300750516,1300750516,1,4,0
28495936@N03,2359,6,1300750546,1300750546,1,4,0
28495936@N03,2360,10,1303087005,1303087005,1,1,0
28495936@N03,2361,10,1306274787,1306274787,1,1,0
28495936@N03,2362,10,1310595973,1310596039,2,1,66
28495936@N03,2363,7,1317509859,1317509859,1,2,0
28495936@N03,2363,14,1317509721,1317509721,1,2,0
28495936@N03,2364,6,1319339850,1319339850,1,1,0
28495936@N03,2365,26,1320831621,1320837431,2,3,5810
28495936@N03,2365,14,1320834919,1320834919,1,3,0
28495936@N03,2365,27,1320840852,1320840852,1,3,0
28495936@N03,2366,13,1322950429,1322950429,1,1,0
28495936@N03,2367,10,1323217047,1323217047,1,2,0
28495936@N03,2367,27,1323217167,1323217167,1,2,0
28495936@N03,2368,10,1328388792,1328388900,2,2,108
28495936@N03,2368,14,1328388853,1328388853,1,2,0
28495936@N03,2369,19,1329021000,1329021000,1,2,0
28495936@N03,2369,10,1329021000,1329021000,2,2,0
28495936@N03,2370,25,1330474703,1330474703,1,6,0
28495936@N03,2370,14,1330479064,1330479064,1,6,0
28495936@N03,2370,18,1330477415,1330477415,1,6,0
28495936@N03,2370,27,1330481653,1330481653,1,6,0
28495936@N03,2370,6,1330479292,1330479292,1,6,0
28495936@N03,2370,21,1330475264,1330475264,1,6,0
28495936@N03,2371,14,1331768824,1331768824,1,4,0
28495936@N03,2371,11,1331768669,1331768669,2,4,0
28495936@N03,2371,10,1331768451,1331768495,2,4,44
28495936@N03,2371,19,1331768819,1331768819,1,4,0
28495936@N03,2372,7,1333059083,1333059083,1,5,0
28495936@N03,2372,14,1333058769,1333059078,2,5,309
28495936@N03,2372,2,1333058729,1333058729,1,5,0
28495936@N03,2372,27,1333059060,1333059060,1,5,0
28495936@N03,2372,10,1333058600,1333058600,1,5,0
28495936@N03,2373,10,1341443002,1341443296,2,4,294
28495936@N03,2373,11,1341443306,1341443306,1,4,0
28495936@N03,2373,2,1341443559,1341443559,1,4,0
28495936@N03,2373,27,1341443074,1341443688,3,4,614
28495936@N03,2374,8,1343886665,1343886665,1,2,0
28495936@N03,2374,17,1343884960,1343884960,1,2,0
28495936@N03,2375,14,1344390192,1344390192,1,1,0
28495936@N03,2376,17,1348800718,1348800718,1,1,0
28495936@N03,2377,16,1348875700,1348875700,1,1,0
28495936@N03,2378,14,1349481410,1349481410,1,1,0
28495936@N03,2379,27,1354851686,1354851686,1,1,0
28495936@N03,2380,27,1355965539,1355965539,1,1,0
28519626@N07,2381,27,1325736185,1325736554,6,1,369
28527853@N00,2382,8,1335685424,1335685424,1,2,0
28527853@N00,2382,16,1335700125,1335700125,1,2,0
28527853@N00,2383,8,1354684084,1354684287,2,2,203
28527853@N00,2383,14,1354686656,1354692556,3,2,5900
28527853@N00,2384,10,1354732651,1354732651,1,4,0
28527853@N00,2384,3,1354745351,1354745351,1,4,0
28527853@N00,2384,14,1354732655,1354732655,1,4,0
28527853@N00,2384,16,1354743788,1354743788,1,4,0
28527853@N00,2385,10,1354867216,1354867216,1,1,0
28527853@N00,2386,27,1368230393,1368230393,1,2,0
28527853@N00,2386,16,1368215944,1368215944,1,2,0
28530387@N06,2387,1,1443249534,1443249534,1,1,0
28530387@N06,2388,3,1469849492,1469849492,1,2,0
28530387@N06,2388,2,1469852385,1469852385,1,2,0
28530387@N06,2389,27,1470310013,1470312941,2,1,2928
28555778@N00,2390,2,1363135498,1363136601,5,3,1103
28555778@N00,2390,7,1363127517,1363128526,8,3,1009
28555778@N00,2390,1,1363130245,1363130245,1,3,0
28558260@N04,2391,27,1295720283,1295720283,1,1,0
28572085@N03,2392,3,1216518091,1216518154,4,2,63
28572085@N03,2392,17,1216517058,1216517208,4,2,150
28572085@N03,2393,21,1216662365,1216662365,1,7,0
28572085@N03,2393,4,1216676977,1216676977,1,7,0
28572085@N03,2393,20,1216664817,1216664821,2,7,4
28572085@N03,2393,27,1216651935,1216651935,1,7,0
28572085@N03,2393,14,1216672483,1216674257,6,7,1774
28572085@N03,2393,16,1216682398,1216682452,6,7,54
28572085@N03,2393,24,1216639067,1216639067,1,7,0
28572085@N03,2394,23,1219069316,1219069316,1,6,0
28572085@N03,2394,14,1219069296,1219069323,20,6,27
28572085@N03,2394,3,1219069289,1219069294,4,6,5
28572085@N03,2394,13,1219069307,1219069308,2,6,1
28572085@N03,2394,11,1219069296,1219069296,1,6,0
28572085@N03,2394,27,1219069288,1219069314,6,6,26
28581468@N00,2395,27,1263945800,1263974866,101,1,29066
28582871@N04,2396,21,1253335916,1253335916,1,1,0
28598412@N04,2397,27,1251629831,1251629831,1,2,0
28598412@N04,2397,13,1251630192,1251646032,2,2,15840
28598412@N04,2398,13,1251675881,1251675881,1,1,0
28598412@N04,2399,13,1251846088,1251846088,1,1,0
28600633@N04,2400,25,1212715260,1212715260,1,1,0
28636569@N06,2401,18,1354280400,1354280400,2,3,0
28636569@N06,2401,14,1354280400,1354280400,1,3,0
28636569@N06,2401,27,1354280400,1354280400,2,3,0
28636569@N06,2402,9,1355534945,1355535100,2,4,155
28636569@N06,2402,4,1355531873,1355531873,1,4,0
28636569@N06,2402,16,1355536088,1355536252,2,4,164
28636569@N06,2402,6,1355535038,1355535038,1,4,0
28636569@N06,2403,9,1355637722,1355637722,1,2,0
28636569@N06,2403,27,1355638326,1355638326,1,2,0
28636569@N06,2404,27,1379285771,1379285897,4,1,126
28640739@N08,2405,16,1357868449,1357868449,1,1,0
28681548@N04,2406,6,1227991860,1227991860,1,3,0
28681548@N04,2406,15,1227991849,1227991849,1,3,0
28681548@N04,2406,14,1227991855,1227991906,7,3,51
28704523@N03,2407,12,1312360049,1312360049,1,1,0
28704523@N03,2408,9,1312935703,1312935703,1,1,0
28705786@N05,2409,27,1291795989,1291795989,1,1,0
28712708@N06,2410,22,1282781470,1282781470,1,3,0
28712708@N06,2410,27,1282777716,1282777831,2,3,115
28712708@N06,2410,19,1282782031,1282782124,3,3,93
28712708@N06,2411,21,1314536281,1314536281,1,3,0
28712708@N06,2411,27,1314513163,1314513163,1,3,0
28712708@N06,2411,9,1314533410,1314533410,1,3,0
28712708@N06,2412,27,1314755863,1314755863,1,1,0
28713051@N05,2413,27,1294774364,1294774364,1,1,0
28717442@N00,2414,9,1406454530,1406454530,1,1,0
28724781@N04,2415,12,1228988804,1228988804,1,11,0
28724781@N04,2415,14,1228954768,1228954768,1,11,0
28724781@N04,2415,1,1228985229,1228985229,1,11,0
28724781@N04,2415,26,1228980000,1228980000,1,11,0
28724781@N04,2415,27,1228940238,1228979725,18,11,39487
28724781@N04,2415,3,1228944889,1228944889,1,11,0
28724781@N04,2415,2,1228987228,1228987280,2,11,52
28724781@N04,2415,25,1228963960,1228969330,5,11,5370
28724781@N04,2415,24,1228967479,1228967479,1,11,0
28724781@N04,2415,9,1228988206,1228988491,2,11,285
28724781@N04,2415,17,1228990287,1228990318,2,11,31
28724781@N04,2416,14,1229206626,1229206626,1,4,0
28724781@N04,2416,15,1229207888,1229215646,3,4,7758
28724781@N04,2416,27,1229205275,1229205275,1,4,0
28724781@N04,2416,9,1229215618,1229215618,1,4,0
28724781@N04,2417,1,1231543384,1231548856,4,11,5472
28724781@N04,2417,22,1231572768,1231573144,6,11,376
28724781@N04,2417,16,1231553323,1231555227,2,11,1904
28724781@N04,2417,27,1231570296,1231570296,1,11,0
28724781@N04,2417,2,1231548469,1231548558,3,11,89
28724781@N04,2417,21,1231578145,1231578145,1,11,0
28724781@N04,2417,23,1231578245,1231578245,1,11,0
28724781@N04,2417,6,1231539309,1231578013,21,11,38704
28724781@N04,2417,5,1231548612,1231548612,1,11,0
28724781@N04,2417,24,1231578297,1231578297,1,11,0
28724781@N04,2417,17,1231581302,1231581329,2,11,27
28732514@N00,2418,26,1304807047,1304807047,1,1,0
28782167@N03,2419,17,1336909466,1336909466,1,1,0
28827568@N05,2420,27,1222492732,1222493230,2,1,498
28827568@N05,2421,26,1222742668,1222742668,1,2,0
28827568@N05,2421,14,1222749307,1222749319,2,2,12
28827568@N05,2422,27,1222858363,1222859571,5,1,1208
28827568@N05,2423,19,1289176959,1289176959,1,1,0
28835512@N07,2424,9,1302691743,1302693022,7,4,1279
28835512@N07,2424,16,1302685635,1302685635,1,4,0
28835512@N07,2424,14,1302686407,1302686407,1,4,0
28835512@N07,2424,27,1302684332,1302698910,2,4,14578
28836018@N02,2425,19,1305588774,1305592108,8,1,3334
28836018@N02,2426,27,1337259402,1337260576,5,1,1174
28836018@N02,2427,14,1358038240,1358038251,2,10,11
28836018@N02,2427,5,1358038054,1358038054,1,10,0
28836018@N02,2427,2,1358038085,1358038085,1,10,0
28836018@N02,2427,6,1358038149,1358038149,1,10,0
28836018@N02,2427,27,1358037866,1358037879,3,10,13
28836018@N02,2427,20,1358038714,1358038729,3,10,15
28836018@N02,2427,17,1358038354,1358038416,3,10,62
28836018@N02,2427,26,1358038423,1358038601,7,10,178
28836018@N02,2427,4,1358038017,1358038017,1,10,0
28836018@N02,2427,22,1358038616,1358038655,2,10,39
28869340@N00,2428,6,1310439112,1310439169,3,1,57
28869340@N00,2429,16,1310470127,1310470127,1,1,0
28900333@N08,2430,21,1381419159,1381419159,1,1,0
28900333@N08,2431,27,1381529829,1381529844,2,1,15
28941821@N02,2432,27,1197077342,1197077342,1,1,0
28941821@N02,2433,25,1197274666,1197274666,1,2,0
28941821@N02,2433,23,1197249678,1197251123,2,2,1445
28946471@N00,2434,23,1373932929,1373932929,1,3,0
28946471@N00,2434,27,1373931628,1373931628,1,3,0
28946471@N00,2434,14,1373944065,1373944065,1,3,0
28946471@N00,2435,13,1379311729,1379311729,1,2,0
28946471@N00,2435,16,1379315923,1379315923,1,2,0
28959709@N05,2436,2,1291940579,1291941441,7,1,862
28959709@N05,2437,14,1370045882,1370056841,3,1,10959
28971971@N00,2438,11,1195008189,1195008605,5,7,416
28971971@N00,2438,14,1195015230,1195016281,7,7,1051
28971971@N00,2438,27,1195034008,1195034008,1,7,0
28971971@N00,2438,17,1195035332,1195037416,6,7,2084
28971971@N00,2438,15,1195038903,1195038903,1,7,0
28971971@N00,2438,9,1195007189,1195014398,6,7,7209
28971971@N00,2438,4,1195003103,1195003103,1,7,0
28971971@N00,2439,8,1195179792,1195180784,4,3,992
28971971@N00,2439,15,1195175810,1195178939,2,3,3129
28971971@N00,2439,1,1195182505,1195182512,3,3,7
28971971@N00,2440,16,1195267060,1195267071,2,4,11
28971971@N00,2440,27,1195270910,1195271183,2,4,273
28971971@N00,2440,25,1195264803,1195264803,1,4,0
28971971@N00,2440,9,1195269507,1195269507,1,4,0
28971971@N00,2441,25,1264745546,1264745557,2,4,11
28971971@N00,2441,8,1264729664,1264732236,19,4,2572
28971971@N00,2441,2,1264728785,1264728785,1,4,0
28971971@N00,2441,9,1264732323,1264733049,3,4,726
28971971@N00,2442,20,1297413713,1297413713,1,2,0
28971971@N00,2442,14,1297418280,1297418304,4,2,24
28976420@N03,2443,15,1298366416,1298366416,1,5,0
28976420@N03,2443,2,1298375029,1298382359,6,5,7330
28976420@N03,2443,27,1298360283,1298361502,5,5,1219
28976420@N03,2443,14,1298361988,1298364638,3,5,2650
28976420@N03,2443,16,1298365339,1298365392,2,5,53
28977782@N00,2444,27,1191652660,1191662308,3,1,9648
28977782@N00,2445,27,1191708029,1191708573,5,1,544
28977782@N00,2446,12,1191745001,1191745001,1,1,0
28977782@N00,2447,22,1191982936,1191982985,2,4,49
28977782@N00,2447,24,1191982687,1191984757,5,4,2070
28977782@N00,2447,23,1191975070,1191982852,2,4,7782
28977782@N00,2447,27,1191968817,1191989160,4,4,20343
28977782@N00,2448,27,1192143440,1192143440,1,1,0
28977782@N00,2449,5,1324062073,1324062073,1,4,0
28977782@N00,2449,27,1324057052,1324057069,2,4,17
28977782@N00,2449,9,1324069454,1324069454,1,4,0
28977782@N00,2449,14,1324069593,1324069593,1,4,0
28977782@N00,2450,1,1324133607,1324133607,1,2,0
28977782@N00,2450,2,1324133030,1324133030,1,2,0
28977782@N00,2451,17,1324169912,1324169912,1,1,0
28977782@N00,2452,7,1324486916,1324486916,1,3,0
28977782@N00,2452,27,1324482804,1324482804,1,3,0
28977782@N00,2452,14,1324488803,1324488803,1,3,0
28977782@N00,2453,8,1334285402,1334285928,2,5,526
28977782@N00,2453,13,1334283742,1334283742,1,5,0
28977782@N00,2453,25,1334262626,1334264799,2,5,2173
28977782@N00,2453,21,1334261060,1334261060,1,5,0
28977782@N00,2453,24,1334264631,1334264631,1,5,0
28980024@N04,2454,18,1303092264,1303092264,1,1,0
29000027@N05,2455,16,1430309382,1430309533,2,1,151
29000027@N05,2456,27,1442744520,1442750904,5,1,6384
29000027@N05,2457,27,1451999974,1451999974,1,1,0
29000027@N05,2458,13,1455194944,1455194944,1,1,0
29000027@N05,2459,16,1459476853,1459481209,29,1,4356
29020490@N04,2460,17,1228197479,1228197479,1,1,0
29020490@N04,2461,18,1231488804,1231490358,2,1,1554
29020490@N04,2462,16,1231539364,1231539411,2,2,47
29020490@N04,2462,17,1231539971,1231539971,1,2,0
29057323@N07,2463,16,1207809134,1207809134,1,1,0
29075130@N00,2464,16,1307752639,1307752639,1,2,0
29075130@N00,2464,6,1307763352,1307763352,1,2,0
29108089@N04,2465,27,1385884676,1385884676,1,6,0
29108089@N04,2465,10,1385896882,1385898805,4,6,1923
29108089@N04,2465,2,1385899577,1385899577,1,6,0
29108089@N04,2465,5,1385899871,1385899871,1,6,0
29108089@N04,2465,15,1385894101,1385894101,1,6,0
29108089@N04,2465,4,1385900076,1385900331,3,6,255
29108089@N04,2466,27,1386025755,1386027738,2,4,1983
29108089@N04,2466,2,1386042509,1386042509,1,4,0
29108089@N04,2466,24,1386030577,1386031365,3,4,788
29108089@N04,2466,22,1386034704,1386035051,4,4,347
29108089@N04,2467,27,1386341640,1386341659,2,1,19
29108089@N04,2468,27,1386395656,1386395656,1,1,0
29129621@N05,2469,13,1246623229,1246623229,1,1,0
29129621@N05,2470,13,1269052835,1269052835,1,1,0
29129621@N05,2471,1,1291638738,1291639705,3,1,967
29129621@N05,2472,2,1317642734,1317642734,1,7,0
29129621@N05,2472,18,1317637061,1317637061,1,7,0
29129621@N05,2472,3,1317644906,1317644906,1,7,0
29129621@N05,2472,13,1317646499,1317646499,1,7,0
29129621@N05,2472,27,1317648206,1317648458,2,7,252
29129621@N05,2472,17,1317647626,1317647626,1,7,0
29129621@N05,2472,1,1317644041,1317644041,1,7,0
29129621@N05,2473,26,1327134956,1327134956,1,1,0
29129621@N05,2474,16,1348736186,1348736186,1,3,0
29129621@N05,2474,7,1348737482,1348737482,1,3,0
29129621@N05,2474,4,1348742528,1348742528,1,3,0
29129621@N05,2475,19,1348812696,1348812696,1,3,0
29129621@N05,2475,18,1348813828,1348814583,2,3,755
29129621@N05,2475,9,1348818047,1348818047,1,3,0
29129621@N05,2476,12,1348885655,1348885655,1,1,0
29129621@N05,2477,14,1352510283,1352511573,2,4,1290
29129621@N05,2477,9,1352510604,1352510604,1,4,0
29129621@N05,2477,1,1352508944,1352508944,1,4,0
29129621@N05,2477,10,1352510097,1352511298,2,4,1201
29129621@N05,2478,7,1358585193,1358585193,1,1,0
29129621@N05,2479,16,1365207381,1365207381,1,5,0
29129621@N05,2479,2,1365246756,1365246756,1,5,0
29129621@N05,2479,7,1365245627,1365245627,1,5,0
29129621@N05,2479,20,1365227897,1365227897,1,5,0
29129621@N05,2479,19,1365229422,1365229662,3,5,240
29129621@N05,2480,1,1379764414,1379764414,1,2,0
29129621@N05,2480,19,1379767733,1379767733,1,2,0
29129621@N05,2481,10,1382361817,1382361817,1,2,0
29129621@N05,2481,20,1382365526,1382365526,1,2,0
29129621@N05,2482,19,1410414576,1410414576,1,1,0
29129621@N05,2483,19,1423738403,1423738403,1,1,0
29129621@N05,2484,2,1439036882,1439036882,1,1,0
29158990@N02,2485,14,1310945032,1310945032,1,1,0
29168905@N00,2486,21,1313380249,1313380249,1,4,0
29168905@N00,2486,13,1313374921,1313401023,9,4,26102
29168905@N00,2486,18,1313402389,1313402436,5,4,47
29168905@N00,2486,12,1313374835,1313374845,2,4,10
29168905@N00,2487,17,1313663675,1313663681,2,3,6
29168905@N00,2487,14,1313649443,1313661455,14,3,12012
29168905@N00,2487,27,1313640187,1313640190,2,3,3
29196274@N02,2488,16,1201721423,1201721423,1,1,0
29196480@N02,2489,18,1216155493,1216158310,9,1,2817
29196480@N02,2490,18,1216326063,1216329001,9,1,2938
29196480@N02,2491,18,1216757322,1216760202,9,1,2880
29196480@N02,2492,27,1244249251,1244249869,2,1,618
29196480@N02,2493,27,1272685865,1272700028,10,1,14163
29198183@N00,2494,14,1303805367,1303805378,2,1,11
29225947@N00,2495,22,1380076021,1380077985,13,15,1964
29225947@N00,2495,19,1380074502,1380075573,10,15,1071
29225947@N00,2495,18,1380074974,1380074974,2,15,0
29225947@N00,2495,20,1380070949,1380077912,32,15,6963
29225947@N00,2495,2,1380082693,1380083848,13,15,1155
29225947@N00,2495,7,1380082370,1380082636,4,15,266
29225947@N00,2495,21,1380077576,1380077783,14,15,207
29225947@N00,2495,26,1380078095,1380078095,2,15,0
29225947@N00,2495,10,1380081711,1380081711,2,15,0
29225947@N00,2495,17,1380078193,1380078193,2,15,0
29225947@N00,2495,11,1380081854,1380081902,4,15,48
29225947@N00,2495,24,1380077377,1380077435,9,15,58
29225947@N00,2495,15,1380078611,1380081702,81,15,3091
29225947@N00,2495,25,1380077359,1380077359,2,15,0
29225947@N00,2495,27,1380096351,1380096351,2,15,0
29225947@N00,2496,17,1380362878,1380362878,1,1,0
29225947@N00,2497,14,1380511444,1380514136,6,3,2692
29225947@N00,2497,10,1380507713,1380511062,14,3,3349
29225947@N00,2497,17,1380506677,1380506896,4,3,219
29225947@N00,2498,22,1380580984,1380588827,2,7,7843
29225947@N00,2498,9,1380615032,1380615369,5,7,337
29225947@N00,2498,14,1380577000,1380577010,4,7,10
29225947@N00,2498,5,1380615531,1380615531,1,7,0
29225947@N00,2498,7,1380588877,1380614559,26,7,25682
29225947@N00,2498,17,1380580823,1380580827,2,7,4
29225947@N00,2498,15,1380579461,1380580532,10,7,1071
29225947@N00,2499,14,1380791257,1380791257,1,4,0
29225947@N00,2499,19,1380785971,1380785971,1,4,0
29225947@N00,2499,26,1380782384,1380782587,2,4,203
29225947@N00,2499,24,1380781404,1380781404,1,4,0
29232178@N03,2500,4,1268596361,1268596361,1,1,0
29232178@N03,2501,18,1410549667,1410549667,1,1,0
29232178@N03,2502,16,1412110373,1412110373,1,1,0
29232178@N03,2503,16,1436978382,1436978382,1,1,0
29259314@N04,2504,27,1285836681,1285836794,3,1,113
29259314@N04,2505,19,1286067099,1286069773,4,3,2674
29259314@N04,2505,18,1286067582,1286068348,7,3,766
29259314@N04,2505,27,1286064383,1286074790,3,3,10407
29259314@N04,2506,16,1412029027,1412029186,5,1,159
29259314@N04,2507,14,1412157780,1412157780,1,2,0
29259314@N04,2507,27,1412143825,1412143825,1,2,0
29259314@N04,2508,14,1412649290,1412649290,1,3,0
29259314@N04,2508,9,1412649298,1412649298,1,3,0
29259314@N04,2508,5,1412649298,1412649298,1,3,0
29337846@N02,2509,4,1299856717,1299856717,1,2,0
29337846@N02,2509,3,1299852421,1299852421,1,2,0
29352917@N00,2510,27,1255576064,1255583976,3,2,7912
29352917@N00,2510,18,1255578519,1255578519,1,2,0
29358051@N07,2511,21,1216944860,1216944860,1,6,0
29358051@N07,2511,22,1216946629,1216946629,1,6,0
29358051@N07,2511,15,1216965455,1216965455,1,6,0
29358051@N07,2511,24,1216943130,1216943174,3,6,44
29358051@N07,2511,14,1216965607,1216965607,1,6,0
29358051@N07,2511,26,1216948425,1216948720,2,6,295
29384095@N00,2512,16,1253718739,1253718926,3,1,187
29392290@N03,2513,27,1396729452,1396729452,1,1,0
29426902@N02,2514,16,1286926314,1286926314,1,1,0
29426902@N02,2515,5,1286959295,1286959295,1,1,0
29459675@N06,2516,27,1396220338,1396220338,1,1,0
29507514@N03,2517,16,1365309741,1365309741,1,1,0
29542859@N05,2518,16,1247091881,1247091881,1,1,0
29542859@N05,2519,14,1266373612,1266373612,1,2,0
29542859@N05,2519,27,1266377403,1266377403,1,2,0
29568026@N07,2520,27,1397180370,1397208779,9,4,28409
29568026@N07,2520,17,1397209731,1397209731,1,4,0
29568026@N07,2520,9,1397190813,1397193433,3,4,2620
29568026@N07,2520,16,1397181878,1397185492,4,4,3614
29568026@N07,2521,18,1397538812,1397538979,3,1,167
29568026@N07,2522,27,1397640171,1397642669,2,1,2498
29583624@N04,2523,18,1223113869,1223113869,1,3,0
29583624@N04,2523,27,1223102222,1223102917,6,3,695
29583624@N04,2523,13,1223115067,1223115067,1,3,0
29583624@N04,2524,12,1226664403,1226664403,1,1,0
29583624@N04,2525,14,1252735516,1252735516,1,1,0
29583624@N04,2526,16,1329538922,1329538922,1,2,0
29583624@N04,2526,27,1329536176,1329536176,1,2,0
29618911@N04,2527,13,1330063972,1330063972,1,2,0
29618911@N04,2527,25,1330064206,1330064206,1,2,0
29619840@N00,2528,15,1210059331,1210068816,2,21,9485
29619840@N00,2528,12,1210062145,1210062812,18,21,667
29619840@N00,2528,25,1210038276,1210038276,1,21,0
29619840@N00,2528,5,1210038784,1210039556,4,21,772
29619840@N00,2528,27,1210030292,1210075141,14,21,44849
29619840@N00,2528,23,1210034053,1210037649,3,21,3596
29619840@N00,2528,2,1210039045,1210067418,6,21,28373
29619840@N00,2528,1,1210038942,1210045990,3,21,7048
29619840@N00,2528,9,1210052890,1210058387,4,21,5497
29619840@N00,2528,11,1210055866,1210057304,16,21,1438
29619840@N00,2528,13,1210063274,1210064376,7,21,1102
29619840@N00,2528,4,1210038602,1210067817,9,21,29215
29619840@N00,2528,14,1210058892,1210059706,5,21,814
29619840@N00,2528,19,1210032273,1210032580,9,21,307
29619840@N00,2528,20,1210031660,1210035901,9,21,4241
29619840@N00,2528,24,1210036887,1210037301,5,21,414
29619840@N00,2528,17,1210064698,1210065733,17,21,1035
29619840@N00,2528,3,1210040861,1210047854,7,21,6993
29619840@N00,2528,8,1210055073,1210057475,19,21,2402
29619840@N00,2528,21,1210032805,1210034165,5,21,1360
29619840@N00,2528,16,1210051837,1210060460,9,21,8623
29648523@N05,2529,13,1258518261,1258518261,1,4,0
29648523@N05,2529,27,1258513975,1258514203,4,4,228
29648523@N05,2529,17,1258514650,1258514703,2,4,53
29648523@N05,2529,4,1258527438,1258527438,1,4,0
29648523@N05,2530,14,1448961466,1448961466,1,5,0
29648523@N05,2530,22,1448946705,1448946705,1,5,0
29648523@N05,2530,27,1448944178,1448945961,5,5,1783
29648523@N05,2530,17,1448950387,1448951060,3,5,673
29648523@N05,2530,13,1448949133,1448949133,1,5,0
29651901@N00,2531,14,1374392171,1374392171,1,1,0
29651901@N00,2532,23,1374900957,1374900957,1,1,0
29664314@N02,2533,14,1219398121,1219398121,1,1,0
29664314@N02,2534,14,1219569946,1219569946,1,1,0
29675024@N05,2535,12,1276041394,1276042131,5,12,737
29675024@N05,2535,4,1276040588,1276073752,2,12,33164
29675024@N05,2535,19,1276044301,1276044301,1,12,0
29675024@N05,2535,2,1276080999,1276080999,1,12,0
29675024@N05,2535,27,1276036329,1276038100,2,12,1771
29675024@N05,2535,1,1276039042,1276039042,1,12,0
29675024@N05,2535,22,1276044072,1276044072,1,12,0
29675024@N05,2535,9,1276040728,1276041147,2,12,419
29675024@N05,2535,24,1276081514,1276081514,1,12,0
29675024@N05,2535,21,1276045971,1276045971,1,12,0
29675024@N05,2535,20,1276043741,1276043741,1,12,0
29675024@N05,2535,13,1276042666,1276042666,1,12,0
29734611@N06,2536,25,1198498084,1198498084,1,1,0
29756928@N03,2537,19,1398901292,1398901292,1,2,0
29756928@N03,2537,23,1398907298,1398907298,1,2,0
29756928@N03,2538,9,1398943418,1398943418,1,1,0
29758442@N00,2539,16,1216882612,1216899146,4,1,16534
29775332@N00,2540,15,1383697846,1383698408,3,9,562
29775332@N00,2540,27,1383690402,1383690402,1,9,0
29775332@N00,2540,19,1383717800,1383717801,2,9,1
29775332@N00,2540,17,1383696364,1383727612,2,9,31248
29775332@N00,2540,8,1383700039,1383714538,4,9,14499
29775332@N00,2540,9,1383699195,1383699195,1,9,0
29775332@N00,2540,12,1383697955,1383697955,1,9,0
29775332@N00,2540,24,1383692739,1383692739,1,9,0
29775332@N00,2540,3,1383706497,1383706537,2,9,40
29775332@N00,2541,12,1383882222,1383882472,3,2,250
29775332@N00,2541,26,1383888944,1383888944,1,2,0
29807137@N03,2542,27,1221278169,1221278169,1,1,0
29807137@N03,2543,4,1221361077,1221361077,1,1,0
29833862@N00,2544,6,1441672810,1441674057,7,11,1247
29833862@N00,2544,15,1441680217,1441680217,1,11,0
29833862@N00,2544,16,1441684487,1441684500,2,11,13
29833862@N00,2544,13,1441680218,1441680237,3,11,19
29833862@N00,2544,26,1441691253,1441691254,2,11,1
29833862@N00,2544,1,1441674837,1441674837,1,11,0
29833862@N00,2544,8,1441697331,1441697331,1,11,0
29833862@N00,2544,4,1441671791,1441671791,1,11,0
29833862@N00,2544,11,1441697330,1441697330,1,11,0
29833862@N00,2544,9,1441676709,1441681841,7,11,5132
29833862@N00,2544,23,1441690782,1441691240,5,11,458
29838859@N08,2545,19,1433606594,1433606594,1,1,0
29845947@N00,2546,14,1278586013,1278586013,1,8,0
29845947@N00,2546,5,1278549105,1278549105,2,8,0
29845947@N00,2546,4,1278549315,1278549916,13,8,601
29845947@N00,2546,2,1278552299,1278578219,57,8,25920
29845947@N00,2546,7,1278578319,1278578319,1,8,0
29845947@N00,2546,1,1278552290,1278573906,3,8,21616
29845947@N00,2546,11,1278578432,1278585003,28,8,6571
29845947@N00,2546,9,1278585932,1278586042,4,8,110
29845947@N00,2547,14,1278839584,1278841674,18,5,2090
29845947@N00,2547,25,1278836586,1278839181,17,5,2595
29845947@N00,2547,11,1278817250,1278834095,35,5,16845
29845947@N00,2547,23,1278834485,1278836181,12,5,1696
29845947@N00,2547,8,1278816496,1278816552,4,5,56
29845947@N00,2548,14,1278894228,1278894254,3,1,26
29865634@N04,2549,4,1191660266,1191660266,1,1,0
29865634@N04,2550,22,1209791070,1209791070,1,2,0
29865634@N04,2550,13,1209794431,1209794431,1,2,0
29865634@N04,2551,26,1214564426,1214564426,1,2,0
29865634@N04,2551,1,1214561575,1214561575,2,2,0
29865634@N04,2552,14,1218847268,1218847268,1,2,0
29865634@N04,2552,9,1218849918,1218849966,2,2,48
29865634@N04,2553,27,1218941193,1218941193,1,1,0
29865634@N04,2554,26,1220003859,1220011841,2,3,7982
29865634@N04,2554,13,1220004853,1220004853,2,3,0
29865634@N04,2554,21,1220002423,1220002933,2,3,510
29865634@N04,2555,2,1221899272,1221899272,1,2,0
29865634@N04,2555,3,1221898716,1221898716,1,2,0
29865634@N04,2556,13,1222507149,1222507487,2,1,338
29865634@N04,2557,21,1223694213,1223694213,1,1,0
29865634@N04,2558,11,1226117133,1226117165,2,5,32
29865634@N04,2558,1,1226124172,1226125810,3,5,1638
29865634@N04,2558,27,1226128775,1226128964,2,5,189
29865634@N04,2558,9,1226119687,1226119687,1,5,0
29865634@N04,2558,15,1226120667,1226120667,1,5,0
29865634@N04,2559,4,1227450305,1227450305,1,2,0
29865634@N04,2559,13,1227451301,1227451301,1,2,0
29865634@N04,2560,14,1233382755,1233398738,3,6,15983
29865634@N04,2560,6,1233386725,1233386725,1,6,0
29865634@N04,2560,8,1233385646,1233385646,1,6,0
29865634@N04,2560,13,1233377433,1233395432,2,6,17999
29865634@N04,2560,21,1233396618,1233396618,1,6,0
29865634@N04,2560,9,1233383140,1233399654,3,6,16514
29865634@N04,2561,14,1235362465,1235362465,1,5,0
29865634@N04,2561,22,1235365728,1235367138,3,5,1410
29865634@N04,2561,25,1235368412,1235368657,2,5,245
29865634@N04,2561,13,1235365197,1235365197,1,5,0
29865634@N04,2561,27,1235355963,1235355963,1,5,0
29865634@N04,2562,22,1237526413,1237526413,1,9,0
29865634@N04,2562,14,1237521697,1237522050,5,9,353
29865634@N04,2562,21,1237527735,1237528358,5,9,623
29865634@N04,2562,8,1237510414,1237510697,4,9,283
29865634@N04,2562,27,1237509038,1237531086,2,9,22048
29865634@N04,2562,15,1237524319,1237524319,1,9,0
29865634@N04,2562,13,1237524862,1237525110,2,9,248
29865634@N04,2562,3,1237516686,1237516775,3,9,89
29865634@N04,2562,9,1237519722,1237519722,1,9,0
29865634@N04,2563,14,1242455906,1242456295,7,6,389
29865634@N04,2563,21,1242459982,1242459982,1,6,0
29865634@N04,2563,6,1242469840,1242469921,2,6,81
29865634@N04,2563,13,1242458502,1242458633,2,6,131
29865634@N04,2563,2,1242462676,1242467992,4,6,5316
29865634@N04,2563,9,1242468885,1242471492,3,6,2607
29865634@N04,2564,9,1243167993,1243168061,2,1,68
29865634@N04,2565,9,1243797635,1243798829,2,1,1194
29865634@N04,2566,15,1243842689,1243842846,14,3,157
29865634@N04,2566,27,1243848567,1243848567,1,3,0
29865634@N04,2566,9,1243843354,1243846944,15,3,3590
29865634@N04,2567,22,1245393677,1245394097,3,10,420
29865634@N04,2567,17,1245402801,1245420520,3,10,17719
29865634@N04,2567,21,1245396367,1245401574,5,10,5207
29865634@N04,2567,16,1245403275,1245419106,3,10,15831
29865634@N04,2567,13,1245394560,1245405640,10,10,11080
29865634@N04,2567,1,1245416128,1245416790,3,10,662
29865634@N04,2567,27,1245421794,1245422064,2,10,270
29865634@N04,2567,2,1245417462,1245417462,1,10,0
29865634@N04,2567,9,1245406779,1245406779,1,10,0
29865634@N04,2567,4,1245417998,1245417998,1,10,0
29865634@N04,2568,23,1247829470,1247829470,1,3,0
29865634@N04,2568,2,1247825732,1247825995,3,3,263
29865634@N04,2568,27,1247804103,1247831018,2,3,26915
29865634@N04,2569,14,1249475813,1249476084,3,2,271
29865634@N04,2569,27,1249477557,1249477557,1,2,0
29865634@N04,2570,24,1250305712,1250305712,1,1,0
29865634@N04,2571,27,1250375735,1250375881,3,1,146
29865634@N04,2572,14,1250431830,1250431830,1,1,0
29865634@N04,2573,15,1250506770,1250506770,1,2,0
29865634@N04,2573,13,1250507384,1250507810,2,2,426
29865634@N04,2574,14,1252151965,1252151965,1,1,0
29865634@N04,2575,27,1253953597,1253953815,2,3,218
29865634@N04,2575,9,1253954195,1253954206,2,3,11
29865634@N04,2575,13,1253955847,1253956585,4,3,738
29865634@N04,2576,1,1254568107,1254568107,1,7,0
29865634@N04,2576,9,1254571478,1254571637,2,7,159
29865634@N04,2576,14,1254576346,1254576346,1,7,0
29865634@N04,2576,8,1254570177,1254570177,1,7,0
29865634@N04,2576,16,1254576642,1254576761,2,7,119
29865634@N04,2576,17,1254573674,1254573674,1,7,0
29865634@N04,2576,13,1254575266,1254575266,1,7,0
29865634@N04,2577,27,1255259474,1255259474,1,4,0
29865634@N04,2577,15,1255270362,1255270362,1,4,0
29865634@N04,2577,22,1255265623,1255265623,1,4,0
29865634@N04,2577,6,1255271827,1255271827,1,4,0
29865634@N04,2578,27,1260004214,1260004214,1,1,0
29865634@N04,2579,23,1264303905,1264303905,1,7,0
29865634@N04,2579,27,1264317345,1264317345,1,7,0
29865634@N04,2579,21,1264303200,1264303531,2,7,331
29865634@N04,2579,15,1264305307,1264316641,2,7,11334
29865634@N04,2579,26,1264302619,1264302619,1,7,0
29865634@N04,2579,14,1264304629,1264316605,9,7,11976
29865634@N04,2579,13,1264309855,1264310285,4,7,430
29865634@N04,2580,5,1264921134,1264921134,1,1,0
29865634@N04,2581,4,1274342235,1274342235,1,3,0
29865634@N04,2581,21,1274347632,1274347632,1,3,0
29865634@N04,2581,14,1274341098,1274341098,1,3,0
29865634@N04,2582,13,1280488048,1280488048,1,3,0
29865634@N04,2582,27,1280498669,1280498669,1,3,0
29865634@N04,2582,9,1280484375,1280484375,1,3,0
29865634@N04,2583,4,1288917553,1288917553,1,1,0
29865634@N04,2584,4,1289050465,1289051787,3,7,1322
29865634@N04,2584,21,1289039071,1289048340,3,7,9269
29865634@N04,2584,16,1289049787,1289049787,1,7,0
29865634@N04,2584,27,1289055330,1289055330,1,7,0
29865634@N04,2584,2,1289051596,1289051596,1,7,0
29865634@N04,2584,1,1289051468,1289051468,1,7,0
29865634@N04,2584,20,1289052997,1289053054,2,7,57
29865634@N04,2585,26,1290240197,1290240197,1,1,0
29865634@N04,2586,13,1300024545,1300024545,1,1,0
29865634@N04,2587,13,1304141097,1304142363,5,1,1266
29865634@N04,2588,4,1305961333,1305970772,2,5,9439
29865634@N04,2588,13,1305968036,1305975315,4,5,7279
29865634@N04,2588,14,1305964448,1305964448,1,5,0
29865634@N04,2588,27,1305963272,1305963272,1,5,0
29865634@N04,2588,9,1305970050,1305971724,5,5,1674
29865634@N04,2589,25,1308319423,1308319423,1,5,0
29865634@N04,2589,14,1308324925,1308324925,1,5,0
29865634@N04,2589,23,1308320216,1308320216,2,5,0
29865634@N04,2589,9,1308323913,1308323913,1,5,0
29865634@N04,2589,20,1308320865,1308320865,1,5,0
29865634@N04,2590,26,1319182396,1319182396,1,4,0
29865634@N04,2590,16,1319190985,1319190985,1,4,0
29865634@N04,2590,21,1319181271,1319181271,1,4,0
29865634@N04,2590,13,1319183030,1319183030,1,4,0
29869245@N07,2591,24,1258860987,1258860987,1,1,0
29870124@N02,2592,27,1336193913,1336196151,22,1,2238
29875277@N02,2593,27,1389247832,1389248604,4,1,772
29882217@N06,2594,13,1353896455,1353896455,1,1,0
29896241@N06,2595,1,1220058222,1220058550,3,1,328
29896241@N06,2596,4,1220089334,1220089334,1,1,0
29913634@N06,2597,21,1368751020,1368762024,3,1,11004
29914374@N05,2598,16,1240969633,1240969633,1,1,0
29924665@N05,2599,14,1454620931,1454621865,10,7,934
29924665@N05,2599,8,1454623047,1454624592,5,7,1545
29924665@N05,2599,10,1454625156,1454625185,3,7,29
29924665@N05,2599,16,1454612400,1454670678,12,7,58278
29924665@N05,2599,11,1454622347,1454622347,1,7,0
29924665@N05,2599,17,1454666035,1454666035,1,7,0
29924665@N05,2599,9,1454627030,1454627038,2,7,8
29929764@N05,2600,16,1245773340,1245773340,1,1,0
29980560@N06,2601,27,1282096881,1282096881,1,2,0
29980560@N06,2601,19,1282092848,1282093002,2,2,154
29980560@N06,2602,20,1283054259,1283054259,1,1,0
30022156@N00,2603,14,1267317627,1267327439,28,1,9812
30022156@N00,2604,27,1315012529,1315030291,38,1,17762
30022156@N00,2605,27,1322182762,1322200567,14,1,17805
30030726@N05,2606,14,1437388187,1437388187,1,3,0
30030726@N05,2606,17,1437388332,1437388332,1,3,0
30030726@N05,2606,27,1437382660,1437388806,3,3,6146
30042168@N03,2607,7,1328425760,1328425766,2,4,6
30042168@N03,2607,4,1328430555,1328432769,2,4,2214
30042168@N03,2607,27,1328412166,1328412166,1,4,0
30042168@N03,2607,6,1328425813,1328425817,2,4,4
30042168@N03,2608,27,1328474405,1328474420,2,3,15
30042168@N03,2608,16,1328477814,1328479772,2,3,1958
30042168@N03,2608,14,1328477807,1328479780,6,3,1973
30042168@N03,2609,4,1328597374,1328597374,1,2,0
30042168@N03,2609,3,1328597380,1328597380,1,2,0
30042168@N03,2610,3,1328674228,1328676841,2,1,2613
30042168@N03,2611,26,1328829274,1328829274,1,8,0
30042168@N03,2611,16,1328871220,1328871220,1,8,0
30042168@N03,2611,15,1328833454,1328833473,6,8,19
30042168@N03,2611,23,1328831627,1328831687,4,8,60
30042168@N03,2611,4,1328857193,1328857193,1,8,0
30042168@N03,2611,2,1328835317,1328873175,9,8,37858
30042168@N03,2611,3,1328835309,1328836101,2,8,792
30042168@N03,2611,27,1328853407,1328854304,6,8,897
30042168@N03,2612,25,1328941392,1328941392,1,2,0
30042168@N03,2612,27,1328913350,1328913352,2,2,2
30042168@N03,2613,9,1329000617,1329000723,2,4,106
30042168@N03,2613,1,1329000190,1329000213,4,4,23
30042168@N03,2613,2,1329000052,1329000077,7,4,25
30042168@N03,2613,27,1328998469,1328998472,4,4,3
30052360@N08,2614,27,1341308980,1341335966,39,1,26986
30061875@N03,2615,16,1302696560,1302696560,1,2,0
30061875@N03,2615,9,1302696233,1302696238,3,2,5
30104263@N00,2616,3,1194253361,1194253361,1,1,0
30145793@N07,2617,14,1214129317,1214129317,1,1,0
30145793@N07,2618,18,1214448245,1214448245,1,1,0
30196619@N08,2619,17,1225371992,1225371992,1,1,0
30197109@N03,2620,26,1343638963,1343638963,1,1,0
30197109@N03,2621,25,1343782959,1343782959,1,1,0
30256684@N02,2622,2,1190168811,1190168811,1,7,0
30256684@N02,2622,17,1190168811,1190168811,1,7,0
30256684@N02,2622,3,1190168811,1190168811,1,7,0
30256684@N02,2622,27,1190168811,1190168811,2,7,0
30256684@N02,2622,20,1190168811,1190168811,1,7,0
30256684@N02,2622,19,1190168811,1190168811,1,7,0
30256684@N02,2622,21,1190168811,1190168811,1,7,0
30269754@N05,2623,20,1283679121,1283679121,1,2,0
30269754@N05,2623,21,1283675614,1283675724,2,2,110
30269754@N05,2624,27,1292574032,1292574032,1,2,0
30269754@N05,2624,17,1292581371,1292581371,1,2,0
30269754@N05,2625,25,1327731502,1327731756,3,9,254
30269754@N05,2625,23,1327732073,1327732195,2,9,122
30269754@N05,2625,26,1327734129,1327734260,4,9,131
30269754@N05,2625,27,1327730706,1327737015,4,9,6309
30269754@N05,2625,20,1327732554,1327732554,1,9,0
30269754@N05,2625,15,1327734937,1327734937,1,9,0
30269754@N05,2625,21,1327732483,1327732483,1,9,0
30269754@N05,2625,22,1327732638,1327732644,2,9,6
30269754@N05,2625,24,1327732298,1327732298,1,9,0
30269754@N05,2626,25,1408077923,1408078380,11,10,457
30269754@N05,2626,23,1408079619,1408079775,2,10,156
30269754@N05,2626,26,1408078427,1408078427,1,10,0
30269754@N05,2626,19,1408083746,1408085256,28,10,1510
30269754@N05,2626,9,1408083142,1408083160,2,10,18
30269754@N05,2626,15,1408077268,1408077397,6,10,129
30269754@N05,2626,10,1408076603,1408077019,7,10,416
30269754@N05,2626,20,1408067500,1408068020,17,10,520
30269754@N05,2626,22,1408079567,1408079951,2,10,384
30269754@N05,2626,24,1408078499,1408078509,3,10,10
30302460@N03,2627,27,1379504585,1379504585,1,1,0
30302460@N03,2628,27,1393159205,1393159205,1,1,0
30302460@N03,2629,27,1400853603,1400853603,1,1,0
30446909@N07,2630,1,1345697651,1345697651,1,1,0
30457574@N00,2631,4,1216062691,1216062691,1,1,0
30468514@N08,2632,27,1397435613,1397469645,3,7,34032
30468514@N08,2632,10,1397437344,1397437344,1,7,0
30468514@N08,2632,22,1397439563,1397439563,1,7,0
30468514@N08,2632,23,1397438861,1397438861,1,7,0
30468514@N08,2632,4,1397438547,1397438547,1,7,0
30468514@N08,2632,6,1397456175,1397456175,1,7,0
30468514@N08,2632,17,1397469173,1397469173,1,7,0
30468601@N00,2633,18,1324270374,1324270389,7,1,15
30468601@N00,2634,21,1324438164,1324438213,5,1,49
30485540@N03,2635,17,1244330603,1244330603,1,1,0
30485540@N03,2636,18,1244914946,1244914946,1,2,0
30485540@N03,2636,16,1244914852,1244915152,3,2,300
30485540@N03,2637,16,1247881249,1247881249,1,1,0
30493847@N04,2638,19,1317604691,1317604691,1,1,0
30498826@N00,2639,14,1291332826,1291341486,2,2,8660
30498826@N00,2639,16,1291330744,1291330790,2,2,46
30498826@N00,2640,26,1303030044,1303043213,28,1,13169
30498826@N00,2641,27,1303085942,1303101865,55,1,15923
30514233@N05,2642,16,1313831393,1313831393,1,1,0
30517481@N08,2643,7,1215152020,1215152020,1,1,0
30520769@N06,2644,2,1224391070,1224397008,7,1,5938
30535117@N06,2645,27,1449918682,1449923109,3,1,4427
30573133@N00,2646,9,1368610727,1368610727,1,3,0
30573133@N00,2646,13,1368611584,1368611584,1,3,0
30573133@N00,2646,19,1368612888,1368612888,1,3,0
30622023@N08,2647,27,1314855894,1314855894,1,2,0
30622023@N08,2647,21,1314876253,1314876253,1,2,0
30629351@N00,2648,17,1218172198,1218174605,23,8,2407
30629351@N00,2648,27,1218165107,1218197755,9,8,32648
30629351@N00,2648,12,1218209923,1218210516,8,8,593
30629351@N00,2648,9,1218167423,1218167975,6,8,552
30629351@N00,2648,2,1218202902,1218202902,1,8,0
30629351@N00,2648,14,1218177955,1218178643,6,8,688
30629351@N00,2648,8,1218168656,1218169520,4,8,864
30629351@N00,2648,4,1218198253,1218205215,5,8,6962
30629351@N00,2649,23,1218527244,1218527244,1,9,0
30629351@N00,2649,27,1218530352,1218530371,2,9,19
30629351@N00,2649,19,1218511456,1218528445,7,9,16989
30629351@N00,2649,25,1218516032,1218516430,4,9,398
30629351@N00,2649,20,1218522258,1218522258,1,9,0
30629351@N00,2649,24,1218521427,1218521865,12,9,438
30629351@N00,2649,26,1218508029,1218508029,1,9,0
30629351@N00,2649,18,1218517736,1218519525,5,9,1789
30629351@N00,2649,21,1218509725,1218509950,4,9,225
30631138@N00,2650,27,1289194301,1289194301,1,1,0
30650680@N02,2651,16,1276518756,1276518756,1,1,0
30650680@N02,2652,9,1434021355,1434021355,1,1,0
30651729@N05,2653,19,1389158750,1389158933,2,2,183
30651729@N05,2653,4,1389164797,1389164797,1,2,0
30701202@N03,2654,27,1434103301,1434103301,1,1,0
30707075@N08,2655,27,1444174946,1444174946,1,1,0
30708841@N05,2656,14,1328923776,1328923776,1,1,0
30738244@N07,2657,21,1201663616,1201663616,1,4,0
30738244@N07,2657,16,1201662584,1201662584,1,4,0
30738244@N07,2657,27,1201661042,1201661042,1,4,0
30738244@N07,2657,13,1201667001,1201667001,1,4,0
30738244@N07,2658,16,1202968001,1202968001,1,1,0
30738244@N07,2659,2,1203836805,1203836805,1,4,0
30738244@N07,2659,24,1203814206,1203814827,2,4,621
30738244@N07,2659,25,1203813963,1203813963,1,4,0
30738244@N07,2659,20,1203820811,1203820811,1,4,0
30738244@N07,2660,24,1206781292,1206781292,1,2,0
30738244@N07,2660,13,1206787535,1206787535,1,2,0
30738244@N07,2661,20,1209449668,1209449668,1,1,0
30738244@N07,2662,12,1216349926,1216349947,2,3,21
30738244@N07,2662,7,1216358667,1216358667,1,3,0
30738244@N07,2662,4,1216366841,1216366841,1,3,0
30738244@N07,2663,19,1218081333,1218081333,1,1,0
30738244@N07,2664,16,1218711837,1218716474,10,1,4637
30743089@N05,2665,16,1293086448,1293086448,1,4,0
30743089@N05,2665,4,1293066724,1293066724,1,4,0
30743089@N05,2665,24,1293070609,1293070817,3,4,208
30743089@N05,2665,14,1293086116,1293086116,1,4,0
30768270@N04,2666,17,1312028160,1312028160,1,1,0
30793917@N07,2667,22,1274261188,1274261999,3,1,811
30793917@N07,2668,24,1274578520,1274578520,1,1,0
30793917@N07,2669,22,1275115749,1275115749,1,1,0
30831872@N08,2670,27,1241255582,1241257143,4,2,1561
30831872@N08,2670,21,1241235430,1241235819,6,2,389
30831872@N08,2671,13,1241351790,1241351790,1,1,0
30831872@N08,2672,13,1241403706,1241403706,1,2,0
30831872@N08,2672,20,1241408848,1241408848,1,2,0
30831872@N08,2673,14,1241496858,1241496858,1,5,0
30831872@N08,2673,22,1241492286,1241492286,1,5,0
30831872@N08,2673,17,1241487091,1241487091,1,5,0
30831872@N08,2673,16,1241501399,1241501399,1,5,0
30831872@N08,2673,3,1241507286,1241507331,2,5,45
30831872@N08,2674,13,1241663792,1241665271,5,2,1479
30831872@N08,2674,21,1241659507,1241659544,2,2,37
30831872@N08,2675,3,1241863948,1241863948,1,5,0
30831872@N08,2675,5,1241864215,1241864215,1,5,0
30831872@N08,2675,13,1241849955,1241866853,3,5,16898
30831872@N08,2675,19,1241845908,1241846079,2,5,171
30831872@N08,2675,20,1241844166,1241858696,3,5,14530
30845032@N04,2676,23,1384384320,1384384320,1,1,0
30868771@N03,2677,27,1412849508,1412857854,5,1,8346
30891516@N08,2678,9,1305002360,1305002360,1,2,0
30891516@N08,2678,26,1305023248,1305023300,2,2,52
30891516@N08,2679,19,1305250592,1305250592,1,5,0
30891516@N08,2679,27,1305256095,1305266334,7,5,10239
30891516@N08,2679,17,1305250366,1305250448,2,5,82
30891516@N08,2679,25,1305244830,1305244830,1,5,0
30891516@N08,2679,14,1305277378,1305284706,10,5,7328
30954521@N08,2680,27,1229703290,1229703290,1,2,0
30954521@N08,2680,3,1229708224,1229708224,1,2,0
30954521@N08,2681,27,1230656727,1230656727,1,2,0
30954521@N08,2681,17,1230657850,1230657850,1,2,0
30960094@N04,2682,26,1262742727,1262742733,2,6,6
30960094@N04,2682,24,1262744331,1262744331,1,6,0
30960094@N04,2682,27,1262733679,1262750152,8,6,16473
30960094@N04,2682,16,1262755703,1262756019,2,6,316
30960094@N04,2682,4,1262751820,1262751820,1,6,0
30960094@N04,2682,17,1262742713,1262742713,1,6,0
31001191@N05,2683,27,1194681340,1194683203,4,1,1863
31006502@N04,2684,20,1370002377,1370002377,1,1,0
31006502@N04,2685,19,1406102668,1406102668,1,1,0
31006502@N04,2686,18,1420262315,1420262315,1,1,0
31028157@N07,2687,14,1241777266,1241777268,2,1,2
31115319@N00,2688,8,1394149042,1394149042,1,1,0
31120227@N02,2689,27,1305020950,1305020950,1,1,0
31149014@N00,2690,22,1329007654,1329007654,1,1,0
31181649@N00,2691,14,1294216136,1294216136,1,1,0
31188169@N04,2692,16,1332255447,1332255447,1,1,0
31188169@N04,2693,27,1336632865,1336632865,1,4,0
31188169@N04,2693,20,1336639688,1336640700,2,4,1012
31188169@N04,2693,16,1336636764,1336648130,4,4,11366
31188169@N04,2693,17,1336643080,1336643080,1,4,0
31188169@N04,2694,16,1336733160,1336733160,1,2,0
31188169@N04,2694,17,1336722639,1336722639,1,2,0
31223689@N00,2695,19,1222405387,1222405387,1,2,0
31223689@N00,2695,22,1222403499,1222403975,4,2,476
31281767@N04,2696,20,1348965017,1348965017,1,4,0
31281767@N04,2696,1,1348968682,1348968682,1,4,0
31281767@N04,2696,21,1348964799,1348964799,1,4,0
31281767@N04,2696,27,1348963749,1348977832,2,4,14083
31288648@N08,2697,16,1254046270,1254046576,9,1,306
31291728@N05,2698,9,1414997500,1415009094,2,1,11594
31291728@N05,2699,17,1415262537,1415263485,3,5,948
31291728@N05,2699,9,1415246236,1415272153,6,5,25917
31291728@N05,2699,14,1415276033,1415276033,1,5,0
31291728@N05,2699,27,1415240212,1415277120,2,5,36908
31291728@N05,2699,6,1415247314,1415247607,3,5,293
31291728@N05,2700,4,1430990921,1430990921,1,5,0
31291728@N05,2700,7,1430987661,1430987661,1,5,0
31291728@N05,2700,19,1430992892,1430992892,1,5,0
31291728@N05,2700,6,1430987682,1430987682,1,5,0
31291728@N05,2700,10,1430984801,1430984801,1,5,0
31291728@N05,2701,9,1431175681,1431179556,2,1,3875
31291728@N05,2702,7,1431231837,1431231837,1,3,0
31291728@N05,2702,14,1431228069,1431228114,2,3,45
31291728@N05,2702,23,1431224096,1431224546,4,3,450
31291728@N05,2703,27,1431302634,1431302634,1,6,0
31291728@N05,2703,15,1431312801,1431312801,2,6,0
31291728@N05,2703,3,1431308982,1431308982,1,6,0
31291728@N05,2703,17,1431302927,1431302927,1,6,0
31291728@N05,2703,10,1431312524,1431312524,1,6,0
31291728@N05,2703,9,1431311738,1431311738,1,6,0
31291728@N05,2704,26,1461551926,1461551926,1,1,0
31291728@N05,2705,10,1461763523,1461764199,4,2,676
31291728@N05,2705,14,1461765834,1461765834,1,2,0
31291728@N05,2706,23,1461806700,1461806816,5,1,116
31291728@N05,2707,27,1461912610,1461912610,1,2,0
31291728@N05,2707,14,1461896556,1461899922,3,2,3366
31291728@N05,2708,27,1461983952,1461983952,1,3,0
31291728@N05,2708,12,1461993088,1461993202,7,3,114
31291728@N05,2708,14,1461993001,1461993001,1,3,0
31295546@N04,2709,14,1307354760,1307354771,3,1,11
31331814@N04,2710,3,1376623240,1376623240,1,3,0
31331814@N04,2710,11,1376627600,1376627718,5,3,118
31331814@N04,2710,27,1376633074,1376633074,1,3,0
31348155@N03,2711,9,1325927096,1325927096,1,1,0
31348155@N03,2712,9,1326388290,1326388290,1,1,0
31360405@N06,2713,27,1284760152,1284760631,6,2,479
31360405@N06,2713,16,1284760579,1284760973,5,2,394
31360405@N06,2714,16,1285036752,1285052093,19,1,15341
31360405@N06,2715,16,1285153048,1285153048,1,1,0
31369133@N04,2716,16,1292061538,1292061538,1,1,0
31385681@N02,2717,8,1195600182,1195600182,1,1,0
31409566@N00,2718,3,1258083057,1258084655,2,2,1598
31409566@N00,2718,27,1258083024,1258100459,38,2,17435
31429098@N03,2719,3,1375605296,1375605296,1,1,0
31449648@N05,2720,10,1351908817,1351908817,1,1,0
31449648@N05,2721,27,1361772114,1361772114,1,1,0
31449648@N05,2722,6,1362268222,1362268222,1,1,0
31449648@N05,2723,6,1366193068,1366193068,1,1,0
31449648@N05,2724,17,1377592211,1377592211,1,1,0
31449648@N05,2725,3,1377656488,1377656488,1,1,0
31449648@N05,2726,6,1378685946,1378685946,1,1,0
31457177@N08,2727,6,1353509121,1353509121,1,1,0
31491939@N05,2728,21,1191843508,1191847293,46,1,3785
31491939@N05,2729,21,1220483361,1220503185,32,1,19824
31491939@N05,2730,21,1256978074,1256990985,98,1,12911
31491939@N05,2731,21,1262246576,1262261406,18,1,14830
31499593@N03,2732,16,1321956736,1321956736,1,1,0
31535569@N00,2733,9,1255389187,1255389817,3,3,630
31535569@N00,2733,27,1255406541,1255406964,11,3,423
31535569@N00,2733,16,1255387398,1255387398,1,3,0
31535569@N00,2734,6,1255481913,1255481983,3,2,70
31535569@N00,2734,1,1255485074,1255485245,3,2,171
31535569@N00,2735,9,1255570609,1255570623,3,3,14
31535569@N00,2735,3,1255562093,1255562093,1,3,0
31535569@N00,2735,2,1255562151,1255562159,3,3,8
31545574@N02,2736,19,1313898811,1313898811,1,1,0
31559075@N00,2737,26,1257733378,1257733378,1,3,0
31559075@N00,2737,27,1257716007,1257724269,7,3,8262
31559075@N00,2737,16,1257719155,1257720245,2,3,1090
31559075@N00,2738,27,1280040875,1280040875,1,1,0
31565537@N00,2739,16,1280965427,1280985571,19,1,20144
31565537@N00,2740,16,1281057470,1281087679,18,1,30209
31572810@N04,2741,2,1353823106,1353823106,1,1,0
31608675@N00,2742,16,1253273084,1253278445,4,1,5361
31616435@N04,2743,27,1311303434,1311311729,3,1,8295
31616435@N04,2744,27,1315633833,1315665715,9,1,31882
31646024@N00,2745,1,1192222645,1192222645,1,4,0
31646024@N00,2745,13,1192201922,1192202531,5,4,609
31646024@N00,2745,27,1192233610,1192233766,2,4,156
31646024@N00,2745,16,1192225551,1192226971,4,4,1420
31646024@N00,2746,21,1208501299,1208502665,4,6,1366
31646024@N00,2746,24,1208504213,1208505019,10,6,806
31646024@N00,2746,13,1208494847,1208496070,9,6,1223
31646024@N00,2746,27,1208486583,1208506055,19,6,19472
31646024@N00,2746,16,1208490011,1208494325,10,6,4314
31646024@N00,2746,14,1208490341,1208490341,1,6,0
31692641@N00,2747,14,1223463063,1223463076,2,5,13
31692641@N00,2747,9,1223463059,1223463069,2,5,10
31692641@N00,2747,2,1223463051,1223463051,1,5,0
31692641@N00,2747,27,1223463041,1223463041,1,5,0
31692641@N00,2747,16,1223463022,1223463034,3,5,12
31692641@N00,2748,2,1223698086,1223698086,1,1,0
31692641@N00,2749,15,1228426298,1228426298,1,9,0
31692641@N00,2749,1,1228440479,1228456807,2,9,16328
31692641@N00,2749,9,1228456803,1228456803,1,9,0
31692641@N00,2749,20,1228446926,1228446926,1,9,0
31692641@N00,2749,2,1228455005,1228455005,1,9,0
31692641@N00,2749,3,1228455003,1228456806,4,9,1803
31692641@N00,2749,14,1228455001,1228456802,5,9,1801
31692641@N00,2749,27,1228451920,1228455007,3,9,3087
31692641@N00,2749,4,1228456804,1228456804,1,9,0
31692641@N00,2750,11,1228741211,1228741215,5,2,4
31692641@N00,2750,27,1228741201,1228741210,10,2,9
31692641@N00,2751,5,1228815003,1228815005,3,12,2
31692641@N00,2751,4,1228779795,1228779795,1,12,0
31692641@N00,2751,17,1228802058,1228805557,11,12,3499
31692641@N00,2751,11,1228774853,1228774920,2,12,67
31692641@N00,2751,9,1228773990,1228774006,2,12,16
31692641@N00,2751,6,1228778337,1228785714,2,12,7377
31692641@N00,2751,12,1228810564,1228815007,5,12,4443
31692641@N00,2751,27,1228771432,1228771562,5,12,130
31692641@N00,2751,14,1228773372,1228775479,3,12,2107
31692641@N00,2751,8,1228815000,1228815000,1,12,0
31692641@N00,2751,2,1228779637,1228815002,10,12,35365
31692641@N00,2751,3,1228815008,1228815008,1,12,0
31692641@N00,2752,21,1228899600,1228899600,1,5,0
31692641@N00,2752,17,1228890129,1228899602,2,5,9473
31692641@N00,2752,26,1228899601,1228899601,1,5,0
31692641@N00,2752,9,1228889162,1228889289,2,5,127
31692641@N00,2752,23,1228881605,1228882575,2,5,970
31692641@N00,2753,13,1228953607,1228953607,1,7,0
31692641@N00,2753,27,1228953611,1228953612,2,7,1
31692641@N00,2753,21,1228953605,1228953606,2,7,1
31692641@N00,2753,18,1228951271,1228953608,7,7,2337
31692641@N00,2753,22,1228953609,1228953609,1,7,0
31692641@N00,2753,24,1228947736,1228948441,2,7,705
31692641@N00,2753,3,1228953604,1228953604,1,7,0
31692641@N00,2754,13,1317477602,1317477602,1,8,0
31692641@N00,2754,27,1317477600,1317477612,14,8,12
31692641@N00,2754,21,1317477631,1317477631,1,8,0
31692641@N00,2754,25,1317477632,1317477648,17,8,16
31692641@N00,2754,1,1317477628,1317477628,1,8,0
31692641@N00,2754,9,1317477601,1317477623,5,8,22
31692641@N00,2754,6,1317477624,1317477630,6,8,6
31692641@N00,2754,14,1317477614,1317477619,6,8,5
31692641@N00,2755,27,1317906018,1317906018,1,4,0
31692641@N00,2755,17,1317906016,1317906017,2,4,1
31692641@N00,2755,26,1317906007,1317906007,1,4,0
31692641@N00,2755,22,1317906008,1317906013,6,4,5
31692641@N00,2756,27,1317964191,1317992402,5,2,28211
31692641@N00,2756,9,1317991800,1317991816,2,2,16
31692641@N00,2757,21,1399780826,1399780826,1,9,0
31692641@N00,2757,15,1399780801,1399780801,1,9,0
31692641@N00,2757,11,1399780820,1399780822,3,9,2
31692641@N00,2757,23,1399780827,1399780827,1,9,0
31692641@N00,2757,6,1399780815,1399780819,5,9,4
31692641@N00,2757,27,1399780800,1399780804,5,9,4
31692641@N00,2757,8,1399780823,1399780825,3,9,2
31692641@N00,2757,3,1399780806,1399780814,8,9,8
31692641@N00,2757,25,1399780800,1399780828,2,9,28
31751836@N04,2758,8,1338119165,1338119165,1,3,0
31751836@N04,2758,13,1338113542,1338113542,1,3,0
31751836@N04,2758,14,1338119883,1338119883,1,3,0
31751836@N04,2759,19,1338151706,1338151706,1,1,0
31758040@N04,2760,16,1233632563,1233655826,5,1,23263
31758040@N04,2761,26,1233995473,1233995999,2,2,526
31758040@N04,2761,17,1233998144,1233998144,1,2,0
31772181@N00,2762,25,1394599849,1394599849,1,1,0
31846143@N08,2763,16,1238901515,1238901582,63,1,67
31856542@N04,2764,17,1247626674,1247626674,1,1,0
31864937@N00,2765,27,1344737882,1344737889,2,1,7
31911001@N00,2766,9,1414213395,1414213395,1,3,0
31911001@N00,2766,17,1414191329,1414191329,1,3,0
31911001@N00,2766,27,1414202022,1414202022,1,3,0
31911575@N00,2767,2,1266636763,1266636763,1,1,0
31912731@N08,2768,27,1225580763,1225580763,1,1,0
31924266@N02,2769,11,1272744899,1272744899,1,1,0
31924266@N02,2770,21,1272837145,1272837145,1,1,0
31924266@N02,2771,21,1282956242,1282956242,1,1,0
31924266@N02,2772,12,1304558556,1304558556,1,1,0
31937081@N07,2773,9,1422071445,1422071460,2,2,15
31937081@N07,2773,1,1422073951,1422073951,1,2,0
31953929@N08,2774,12,1292027970,1292027970,1,1,0
31953929@N08,2775,14,1297406010,1297406010,1,2,0
31953929@N08,2775,22,1297404618,1297404618,1,2,0
31953929@N08,2776,9,1304934654,1304934654,1,2,0
31953929@N08,2776,4,1304935188,1304935188,1,2,0
31953929@N08,2777,14,1321061851,1321061851,1,1,0
31957707@N08,2778,14,1388292422,1388292422,1,1,0
31957707@N08,2779,7,1419481320,1419481320,1,3,0
31957707@N08,2779,26,1419489384,1419489398,3,3,14
31957707@N08,2779,27,1419491769,1419492225,3,3,456
31957707@N08,2780,11,1419803589,1419803589,1,2,0
31957707@N08,2780,9,1419803803,1419804591,3,2,788
31962189@N04,2781,27,1400968125,1400968125,1,1,0
31962189@N04,2782,17,1401000902,1401000902,1,1,0
31964360@N00,2783,16,1420241154,1420241154,1,5,0
31964360@N00,2783,7,1420238791,1420243552,4,5,4761
31964360@N00,2783,14,1420277384,1420277384,1,5,0
31964360@N00,2783,15,1420250303,1420250303,1,5,0
31964360@N00,2783,6,1420238954,1420238954,1,5,0
31964360@N00,2784,24,1420410769,1420410770,2,5,1
31964360@N00,2784,17,1420414483,1420414483,1,5,0
31964360@N00,2784,22,1420418297,1420418297,1,5,0
31964360@N00,2784,27,1420437553,1420451766,2,5,14213
31964360@N00,2784,5,1420442803,1420442803,1,5,0
31979367@N00,2785,14,1270117258,1270117258,1,1,0
32018680@N06,2786,27,1217226629,1217226629,1,1,0
32018985@N00,2787,13,1455258604,1455258611,2,7,7
32018985@N00,2787,20,1455255268,1455255268,1,7,0
32018985@N00,2787,9,1455260613,1455260620,2,7,7
32018985@N00,2787,21,1455251717,1455255295,20,7,3578
32018985@N00,2787,27,1455241323,1455241323,1,7,0
32018985@N00,2787,14,1455246947,1455246947,1,7,0
32018985@N00,2787,17,1455242477,1455242477,1,7,0
32018985@N00,2788,23,1455421923,1455421923,1,6,0
32018985@N00,2788,27,1455416236,1455434551,9,6,18315
32018985@N00,2788,22,1455422762,1455422762,1,6,0
32018985@N00,2788,16,1455433702,1455433754,4,6,52
32018985@N00,2788,14,1455430960,1455431283,11,6,323
32018985@N00,2788,6,1455425234,1455425234,1,6,0
32028508@N05,2789,21,1418462029,1418462029,1,1,0
32046983@N08,2790,14,1447009403,1447009403,1,1,0
32077113@N00,2791,1,1269239192,1269239192,1,1,0
32077113@N00,2792,21,1269402532,1269403644,4,1,1112
32173292@N05,2793,16,1200191104,1200191104,1,1,0
32173292@N05,2794,16,1200358897,1200358897,1,1,0
32263245@N00,2795,9,1253271520,1253285839,14,1,14319
32263245@N00,2796,9,1283595767,1283606355,7,1,10588
32263245@N00,2797,17,1287744023,1287744023,1,3,0
32263245@N00,2797,5,1287738716,1287738716,1,3,0
32263245@N00,2797,27,1287735333,1287735333,1,3,0
32263245@N00,2798,1,1295749107,1295749107,1,1,0
32263245@N00,2799,5,1430452489,1430469671,7,1,17182
32274991@N03,2800,21,1371278612,1371278612,1,1,0
32279598@N02,2801,16,1407417610,1407417610,1,2,0
32279598@N02,2801,14,1407413522,1407413522,1,2,0
32284286@N00,2802,25,1338816135,1338816135,1,3,0
32284286@N00,2802,6,1338816219,1338816372,2,3,153
32284286@N00,2802,27,1338816446,1338816550,2,3,104
32288431@N08,2803,1,1317513946,1317513946,1,1,0
32288431@N08,2804,27,1409214602,1409214606,2,4,4
32288431@N08,2804,18,1409206424,1409207074,4,4,650
32288431@N08,2804,19,1409206446,1409206683,7,4,237
32288431@N08,2804,13,1409206559,1409206559,1,4,0
32288431@N08,2805,27,1409528725,1409528726,2,10,1
32288431@N08,2805,21,1409531884,1409531905,3,10,21
32288431@N08,2805,1,1409541561,1409541561,1,10,0
32288431@N08,2805,23,1409531609,1409532583,7,10,974
32288431@N08,2805,24,1409532427,1409532427,1,10,0
32288431@N08,2805,7,1409541101,1409541138,3,10,37
32288431@N08,2805,25,1409531284,1409532565,7,10,1281
32288431@N08,2805,26,1409531487,1409531494,3,10,7
32288431@N08,2805,10,1409539411,1409539556,6,10,145
32288431@N08,2805,8,1409541423,1409541433,4,10,10
32306742@N04,2806,16,1468887126,1468887126,1,4,0
32306742@N04,2806,2,1468887753,1468889801,2,4,2048
32306742@N04,2806,1,1468889857,1468889857,1,4,0
32306742@N04,2806,3,1468890591,1468890632,2,4,41
32306742@N04,2807,14,1468997817,1468997817,1,1,0
32359947@N00,2808,17,1244024273,1244024273,1,2,0
32359947@N00,2808,13,1244024505,1244024717,8,2,212
32363335@N00,2809,19,1400283940,1400283940,1,2,0
32363335@N00,2809,27,1400281334,1400281334,1,2,0
32370701@N02,2810,20,1292192826,1292192826,1,1,0
32392791@N00,2811,27,1270077094,1270122605,68,1,45511
32401942@N04,2812,4,1335176318,1335176462,2,1,144
32485654@N03,2813,5,1299851769,1299851769,1,1,0
32509269@N08,2814,27,1303183845,1303183845,1,4,0
32509269@N08,2814,16,1303183871,1303183871,1,4,0
32509269@N08,2814,18,1303183869,1303183869,1,4,0
32509269@N08,2814,14,1303183854,1303183854,1,4,0
32544079@N08,2815,21,1457662245,1457662245,1,2,0
32544079@N08,2815,22,1457669758,1457669758,1,2,0
32558000@N00,2816,12,1361691729,1361691729,1,1,0
32617425@N00,2817,27,1346984286,1346984329,6,1,43
32617425@N00,2818,27,1350117946,1350120859,137,1,2913
32617425@N00,2819,27,1352537847,1352540213,11,1,2366
32617425@N00,2820,17,1379387751,1379387790,5,3,39
32617425@N00,2820,27,1379384641,1379389707,10,3,5066
32617425@N00,2820,15,1379387791,1379388122,4,3,331
32617425@N00,2821,27,1404384073,1404384346,30,1,273
32617425@N00,2822,27,1436572959,1436573541,16,1,582
32644191@N07,2823,19,1254991731,1254991731,1,4,0
32644191@N07,2823,17,1254971849,1254971849,1,4,0
32644191@N07,2823,16,1255002591,1255002591,1,4,0
32644191@N07,2823,13,1254972118,1254972118,1,4,0
32730020@N08,2824,16,1294045720,1294046269,3,1,549
32735714@N07,2825,13,1280808628,1280840626,56,1,31998
32740711@N06,2826,16,1432903406,1432903406,1,2,0
32740711@N06,2826,14,1432903269,1432903269,1,2,0
32744581@N05,2827,16,1277285396,1277285641,2,1,245
32752574@N07,2828,22,1262264400,1262264400,1,1,0
32813984@N08,2829,4,1393099302,1393099302,1,1,0
32884264@N05,2830,26,1272091640,1272091640,1,1,0
32904352@N00,2831,21,1220443423,1220443423,1,1,0
32904352@N00,2832,7,1347185884,1347186526,3,1,642
32904352@N00,2833,19,1347362368,1347362368,1,3,0
32904352@N00,2833,21,1347359539,1347359539,2,3,0
32904352@N00,2833,20,1347354288,1347359325,6,3,5037
32904352@N00,2834,25,1347511989,1347512030,2,5,41
32904352@N00,2834,19,1347514647,1347517878,5,5,3231
32904352@N00,2834,17,1347509840,1347521352,16,5,11512
32904352@N00,2834,20,1347515560,1347515783,2,5,223
32904352@N00,2834,3,1347501680,1347501769,3,5,89
32904352@N00,2835,7,1347591434,1347591441,2,1,7
32939273@N02,2836,25,1369372422,1369372422,1,2,0
32939273@N02,2836,16,1369372706,1369416850,37,2,44144
32996060@N05,2837,27,1393098209,1393098282,69,1,73
33029321@N00,2838,16,1331482241,1331482491,13,2,250
33029321@N00,2838,9,1331492257,1331496010,5,2,3753
33029321@N00,2839,27,1331552024,1331552177,13,4,153
33029321@N00,2839,21,1331555325,1331555620,8,4,295
33029321@N00,2839,25,1331558043,1331561311,23,4,3268
33029321@N00,2839,22,1331554436,1331554538,17,4,102
33063488@N02,2840,27,1224625197,1224625197,1,1,0
33063488@N02,2841,27,1286440371,1286454203,2,2,13832
33063488@N02,2841,17,1286448864,1286448864,1,2,0
33063488@N02,2842,17,1301141332,1301141332,1,3,0
33063488@N02,2842,25,1301139486,1301139486,1,3,0
33063488@N02,2842,13,1301142370,1301142370,1,3,0
33063488@N02,2843,25,1301223882,1301223882,1,1,0
33121758@N04,2844,16,1317423600,1317423600,1,2,0
33121758@N04,2844,27,1317418315,1317418315,1,2,0
33121758@N04,2845,16,1321082763,1321082763,1,1,0
33121758@N04,2846,21,1325913303,1325913303,1,1,0
33121758@N04,2847,14,1328354498,1328354498,1,2,0
33121758@N04,2847,9,1328354872,1328354872,1,2,0
33121758@N04,2848,17,1329006628,1329006628,1,1,0
33121758@N04,2849,14,1334990061,1334990561,5,2,500
33121758@N04,2849,27,1334988976,1334988992,3,2,16
33121758@N04,2850,10,1350433235,1350433235,1,1,0
33121758@N04,2851,16,1352363349,1352377486,2,2,14137
33121758@N04,2851,14,1352376015,1352376015,1,2,0
33121758@N04,2852,14,1359795548,1359795548,1,2,0
33121758@N04,2852,24,1359769891,1359769891,1,2,0
33121758@N04,2853,27,1378513507,1378513507,1,1,0
33121758@N04,2854,24,1384502874,1384502874,1,1,0
33197996@N07,2855,14,1271459770,1271460933,7,1,1163
33197996@N07,2856,9,1271508179,1271508179,1,3,0
33197996@N07,2856,14,1271498776,1271508539,3,3,9763
33197996@N07,2856,16,1271510454,1271510454,1,3,0
33197996@N07,2857,14,1399665311,1399665311,1,1,0
33197996@N07,2858,14,1400783534,1400783534,1,1,0
33197996@N07,2859,21,1402482688,1402482688,1,1,0
33197996@N07,2860,19,1404855722,1404855722,1,1,0
33197996@N07,2861,16,1408052570,1408052570,1,1,0
33197996@N07,2862,27,1408101907,1408101907,1,1,0
33197996@N07,2863,14,1409036382,1409036382,1,1,0
33197996@N07,2864,25,1410377664,1410377664,1,1,0
33197996@N07,2865,27,1411681779,1411681779,1,1,0
33197996@N07,2866,4,1414616909,1414616909,1,1,0
33197996@N07,2867,8,1422912596,1422912596,1,1,0
33197996@N07,2868,16,1430118857,1430118857,1,1,0
33197996@N07,2869,14,1431646712,1431646712,1,1,0
33237989@N06,2870,2,1205451929,1205451929,1,1,0
33237989@N06,2871,9,1205483565,1205483565,1,3,0
33237989@N06,2871,20,1205486566,1205486566,1,3,0
33237989@N06,2871,4,1205492119,1205492119,1,3,0
33237989@N06,2872,19,1238036864,1238036864,1,12,0
33237989@N06,2872,16,1238021740,1238042745,6,12,21005
33237989@N06,2872,27,1238020669,1238021251,2,12,582
33237989@N06,2872,3,1238023456,1238023456,1,12,0
33237989@N06,2872,14,1238028255,1238032590,2,12,4335
33237989@N06,2872,9,1238027550,1238027990,3,12,440
33237989@N06,2872,17,1238041017,1238041017,1,12,0
33237989@N06,2872,2,1238025820,1238026701,4,12,881
33237989@N06,2872,22,1238049665,1238049665,1,12,0
33237989@N06,2872,4,1238021945,1238021945,1,12,0
33237989@N06,2872,13,1238033068,1238033906,3,12,838
33237989@N06,2872,21,1238037975,1238037975,1,12,0
33244915@N00,2873,12,1329014320,1329046112,6,7,31792
33244915@N00,2873,27,1329007848,1329045670,84,7,37822
33244915@N00,2873,4,1329033582,1329033590,2,7,8
33244915@N00,2873,5,1329033804,1329033804,1,7,0
33244915@N00,2873,9,1329018796,1329046316,10,7,27520
33244915@N00,2873,15,1329014376,1329046130,15,7,31754
33244915@N00,2873,2,1329023578,1329023582,2,7,4
33244915@N00,2874,6,1329076976,1329077312,18,6,336
33244915@N00,2874,3,1329077332,1329077458,7,6,126
33244915@N00,2874,4,1329077480,1329077584,6,6,104
33244915@N00,2874,5,1329077856,1329077964,7,6,108
33244915@N00,2874,2,1329077682,1329077842,10,6,160
33244915@N00,2874,9,1329076602,1329076952,19,6,350
33244915@N00,2875,21,1329353806,1329354138,12,7,332
33244915@N00,2875,25,1329358794,1329358806,2,7,12
33244915@N00,2875,15,1329353670,1329353742,4,7,72
33244915@N00,2875,9,1329353346,1329353656,17,7,310
33244915@N00,2875,20,1329353790,1329353790,1,7,0
33244915@N00,2875,22,1329353758,1329353774,2,7,16
33244915@N00,2875,14,1329353258,1329353330,5,7,72
33244915@N00,2876,15,1329393620,1329393660,3,10,40
33244915@N00,2876,25,1329392812,1329392862,3,10,50
33244915@N00,2876,26,1329392828,1329392828,1,10,0
33244915@N00,2876,21,1329393090,1329393106,2,10,16
33244915@N00,2876,22,1329393216,1329393378,8,10,162
33244915@N00,2876,18,1329393400,1329393400,1,10,0
33244915@N00,2876,17,1329393488,1329393776,11,10,288
33244915@N00,2876,13,1329393414,1329393474,5,10,60
33244915@N00,2876,20,1329393124,1329393200,5,10,76
33244915@N00,2876,24,1329393046,1329393068,2,10,22
33257765@N05,2877,26,1334033854,1334033854,1,3,0
33257765@N05,2877,27,1334050400,1334050400,1,3,0
33257765@N05,2877,16,1334037448,1334037448,1,3,0
33257765@N05,2878,16,1373948054,1373950712,3,1,2658
33272592@N00,2879,13,1380941792,1380941792,1,5,0
33272592@N00,2879,23,1380940151,1380973330,3,5,33179
33272592@N00,2879,20,1380937186,1380937186,1,5,0
33272592@N00,2879,16,1380941949,1380941949,1,5,0
33272592@N00,2879,6,1380946786,1380946786,1,5,0
33277678@N03,2880,15,1393175631,1393178118,12,5,2487
33277678@N03,2880,4,1393172325,1393172432,3,5,107
33277678@N03,2880,9,1393174940,1393174940,1,5,0
33277678@N03,2880,8,1393180891,1393183882,3,5,2991
33277678@N03,2880,10,1393173783,1393174710,5,5,927
33312419@N07,2881,22,1353909822,1353909822,1,1,0
33312419@N07,2882,22,1354120597,1354120597,1,1,0
33334548@N05,2883,14,1396166975,1396166975,1,1,0
33352249@N03,2884,1,1331765755,1331765755,1,8,0
33352249@N03,2884,9,1331774890,1331801461,3,8,26571
33352249@N03,2884,14,1331793739,1331793807,2,8,68
33352249@N03,2884,20,1331786944,1331786944,1,8,0
33352249@N03,2884,27,1331789442,1331789573,2,8,131
33352249@N03,2884,6,1331772325,1331772325,1,8,0
33352249@N03,2884,3,1331767376,1331767376,1,8,0
33352249@N03,2884,12,1331812759,1331812759,1,8,0
33360568@N05,2885,20,1389245382,1389245382,1,1,0
33404394@N00,2886,13,1462013299,1462013299,1,1,0
33433883@N02,2887,3,1355448244,1355448244,1,2,0
33433883@N02,2887,4,1355448005,1355448005,1,2,0
33441892@N00,2888,13,1381107261,1381135673,4,13,28412
33441892@N00,2888,14,1381104188,1381115407,18,13,11219
33441892@N00,2888,25,1381127837,1381127837,1,13,0
33441892@N00,2888,7,1381110073,1381112688,9,13,2615
33441892@N00,2888,24,1381129974,1381129974,1,13,0
33441892@N00,2888,15,1381106638,1381106948,3,13,310
33441892@N00,2888,27,1381101129,1381142310,2,13,41181
33441892@N00,2888,21,1381129554,1381136548,3,13,6994
33441892@N00,2888,2,1381121737,1381121745,2,13,8
33441892@N00,2888,8,1381113538,1381123073,6,13,9535
33441892@N00,2888,23,1381130715,1381131106,2,13,391
33441892@N00,2888,12,1381107029,1381107504,7,13,475
33441892@N00,2888,9,1381102793,1381103662,12,13,869
33462708@N06,2889,2,1272077641,1272077641,1,1,0
33479020@N04,2890,14,1263579808,1263579808,1,1,0
33479020@N04,2891,26,1285658607,1285658607,1,1,0
33479020@N04,2892,2,1285749093,1285749093,1,1,0
33479020@N04,2893,18,1285829908,1285829908,1,1,0
33479020@N04,2894,13,1288593238,1288593238,1,1,0
33479020@N04,2895,20,1294013826,1294013826,1,1,0
33479020@N04,2896,22,1295415043,1295415043,1,1,0
33479020@N04,2897,17,1296019823,1296019823,1,1,0
33479020@N04,2898,16,1297320118,1297320118,1,1,0
33479020@N04,2899,21,1298441651,1298441651,1,1,0
33479020@N04,2900,27,1299050139,1299050139,1,1,0
33479020@N04,2901,1,1299478849,1299478849,1,1,0
33479020@N04,2902,19,1300080393,1300080393,1,1,0
33479020@N04,2903,1,1300682613,1300682613,1,1,0
33479020@N04,2904,27,1301462340,1301462340,1,1,0
33479020@N04,2905,14,1301633601,1301633601,1,1,0
33479020@N04,2906,1,1302503003,1302503003,1,1,0
33479020@N04,2907,20,1303282983,1303282983,1,1,0
33479020@N04,2908,4,1303886824,1303886824,1,1,0
33479020@N04,2909,15,1304316947,1304316947,1,1,0
33479020@N04,2910,2,1304914421,1304914421,1,1,0
33479020@N04,2911,13,1306308548,1306308548,1,1,0
33479020@N04,2912,27,1307413219,1307413219,1,1,0
33479020@N04,2913,18,1312783658,1312783658,1,1,0
33479020@N04,2914,13,1314171396,1314171396,1,1,0
33479020@N04,2915,27,1315378100,1315378100,1,1,0
33479020@N04,2916,1,1315814288,1315814288,1,1,0
33494202@N04,2917,13,1252225221,1252225784,3,5,563
33494202@N04,2917,23,1252213770,1252214036,2,5,266
33494202@N04,2917,17,1252224759,1252225047,3,5,288
33494202@N04,2917,21,1252211313,1252212687,6,5,1374
33494202@N04,2917,27,1252209936,1252223974,15,5,14038
33494202@N04,2918,3,1252313936,1252313936,1,3,0
33494202@N04,2918,2,1252313749,1252313749,1,3,0
33494202@N04,2918,12,1252315116,1252315840,11,3,724
33494202@N04,2919,16,1252444390,1252450153,16,10,5763
33494202@N04,2919,15,1252451591,1252451591,1,10,0
33494202@N04,2919,24,1252484655,1252485132,3,10,477
33494202@N04,2919,21,1252488653,1252488653,1,10,0
33494202@N04,2919,8,1252480664,1252480664,1,10,0
33494202@N04,2919,9,1252454504,1252461620,6,10,7116
33494202@N04,2919,6,1252454995,1252458303,3,10,3308
33494202@N04,2919,27,1252443408,1252443466,2,10,58
33494202@N04,2919,11,1252462809,1252463083,4,10,274
33494202@N04,2919,14,1252448423,1252453955,9,10,5532
33494202@N04,2920,8,1252635782,1252635782,1,10,0
33494202@N04,2920,6,1252637320,1252637320,1,10,0
33494202@N04,2920,9,1252634207,1252634207,1,10,0
33494202@N04,2920,27,1252623947,1252625531,3,10,1584
33494202@N04,2920,3,1252638388,1252638388,1,10,0
33494202@N04,2920,1,1252639393,1252639393,1,10,0
33494202@N04,2920,2,1252639964,1252639964,1,10,0
33494202@N04,2920,16,1252630156,1252632938,2,10,2782
33494202@N04,2920,23,1252628174,1252628748,2,10,574
33494202@N04,2920,17,1252629607,1252629712,2,10,105
33507016@N05,2921,19,1214319424,1214319424,1,2,0
33507016@N05,2921,18,1214321620,1214321620,1,2,0
33507016@N05,2922,19,1385370726,1385370726,1,3,0
33507016@N05,2922,21,1385358929,1385358929,1,3,0
33507016@N05,2922,16,1385391644,1385391644,1,3,0
33507605@N03,2923,21,1249708603,1249709013,5,10,410
33507605@N03,2923,9,1249744017,1249748119,4,10,4102
33507605@N03,2923,12,1249717315,1249718322,6,10,1007
33507605@N03,2923,24,1249707593,1249708125,7,10,532
33507605@N03,2923,3,1249739321,1249739321,1,10,0
33507605@N03,2923,13,1249714440,1249714440,1,10,0
33507605@N03,2923,22,1249708326,1249714376,5,10,6050
33507605@N03,2923,16,1249743624,1249743624,1,10,0
33507605@N03,2923,25,1249709308,1249709400,3,10,92
33507605@N03,2923,20,1249713623,1249713654,2,10,31
33507605@N03,2924,9,1249832690,1249832690,1,3,0
33507605@N03,2924,21,1249829438,1249829438,1,3,0
33507605@N03,2924,16,1249827593,1249832403,4,3,4810
33507605@N03,2925,8,1250315303,1250315665,19,6,362
33507605@N03,2925,17,1250312307,1250321064,3,6,8757
33507605@N03,2925,27,1250311420,1250311813,3,6,393
33507605@N03,2925,3,1250314077,1250314077,1,6,0
33507605@N03,2925,16,1250312126,1250313196,3,6,1070
33507605@N03,2925,13,1250321753,1250321753,1,6,0
33507605@N03,2926,9,1250488853,1250488853,1,3,0
33507605@N03,2926,17,1250493010,1250493010,1,3,0
33507605@N03,2926,3,1250489030,1250490889,2,3,1859
33539876@N06,2927,16,1261547599,1261547599,1,1,0
33546659@N08,2928,27,1323584091,1323584091,1,6,0
33546659@N08,2928,20,1323579803,1323579803,1,6,0
33546659@N08,2928,13,1323585188,1323585188,1,6,0
33546659@N08,2928,14,1323606978,1323606978,1,6,0
33546659@N08,2928,25,1323612889,1323612889,1,6,0
33546659@N08,2928,19,1323581697,1323581697,1,6,0
33546659@N08,2929,22,1323917402,1323921557,2,3,4155
33546659@N08,2929,23,1323917728,1323917728,1,3,0
33546659@N08,2929,25,1323925936,1323925936,1,3,0
33546659@N08,2930,14,1323957311,1323967174,6,3,9863
33546659@N08,2930,19,1323965252,1323965252,1,3,0
33546659@N08,2930,16,1323958455,1323962413,2,3,3958
33563310@N06,2931,12,1349397577,1349397577,1,9,0
33563310@N06,2931,8,1349398955,1349398955,1,9,0
33563310@N06,2931,21,1349404279,1349404412,2,9,133
33563310@N06,2931,15,1349397024,1349397068,3,9,44
33563310@N06,2931,5,1349407550,1349407550,1,9,0
33563310@N06,2931,4,1349407483,1349407483,1,9,0
33563310@N06,2931,1,1349407752,1349407752,1,9,0
33563310@N06,2931,27,1349401696,1349402365,4,9,669
33563310@N06,2931,16,1349395861,1349395861,1,9,0
33563310@N06,2932,27,1357012734,1357012734,1,1,0
33563310@N06,2933,7,1357106804,1357106804,1,1,0
33572008@N03,2934,27,1419911125,1419931968,17,4,20843
33572008@N03,2934,14,1419923873,1419923917,2,4,44
33572008@N03,2934,17,1419924364,1419924549,2,4,185
33572008@N03,2934,16,1419924345,1419927111,7,4,2766
33572008@N03,2935,19,1420100165,1420100165,1,1,0
33598193@N03,2936,14,1358645043,1358645043,1,1,0
33598193@N03,2937,10,1358832990,1358832990,1,4,0
33598193@N03,2937,14,1358833008,1358833008,1,4,0
33598193@N03,2937,13,1358833122,1358833167,2,4,45
33598193@N03,2937,12,1358832826,1358832826,1,4,0
33598193@N03,2938,27,1367540997,1367540997,1,1,0
33598193@N03,2939,16,1383796366,1383796366,1,1,0
33598193@N03,2940,27,1389498060,1389525172,4,1,27112
33598193@N03,2941,27,1389673294,1389673857,2,2,563
33598193@N03,2941,10,1389673529,1389673711,2,2,182
33598193@N03,2942,27,1398679236,1398679236,1,2,0
33598193@N03,2942,23,1398679888,1398679888,1,2,0
33598193@N03,2943,6,1402201590,1402201590,1,1,0
33667899@N07,2944,26,1318403221,1318407632,2,2,4411
33667899@N07,2944,17,1318403098,1318403098,2,2,0
33667899@N07,2945,27,1318576866,1318577191,2,1,325
33667899@N07,2946,14,1318726857,1318726887,4,7,30
33667899@N07,2946,4,1318761485,1318761490,2,7,5
33667899@N07,2946,18,1318728241,1318730379,2,7,2138
33667899@N07,2946,16,1318730403,1318736315,11,7,5912
33667899@N07,2946,21,1318717902,1318769175,6,7,51273
33667899@N07,2946,24,1318726674,1318726674,1,7,0
33667899@N07,2946,27,1318755483,1318755483,1,7,0
33667899@N07,2947,17,1349852555,1349852565,2,1,10
33667899@N07,2948,14,1349993932,1349993943,3,5,11
33667899@N07,2948,9,1349992072,1349993200,6,5,1128
33667899@N07,2948,21,1350015883,1350019154,9,5,3271
33667899@N07,2948,24,1350000255,1350000255,1,5,0
33667899@N07,2948,6,1349991744,1349991744,1,5,0
33667899@N07,2949,18,1382177141,1382177141,1,1,0
33700145@N05,2950,16,1279009163,1279021096,2,5,11933
33700145@N05,2950,18,1278983176,1278984751,4,5,1575
33700145@N05,2950,6,1278990672,1278991299,2,5,627
33700145@N05,2950,5,1278987041,1278987271,2,5,230
33700145@N05,2950,27,1278982055,1279011235,2,5,29180
33704098@N00,2951,15,1389154684,1389154715,2,7,31
33704098@N00,2951,21,1389167842,1389167842,1,7,0
33704098@N00,2951,18,1389159073,1389161088,7,7,2015
33704098@N00,2951,13,1389157987,1389158734,2,7,747
33704098@N00,2951,27,1389150873,1389151502,3,7,629
33704098@N00,2951,19,1389161194,1389161194,1,7,0
33704098@N00,2951,12,1389154864,1389154864,1,7,0
33719077@N06,2952,14,1323580876,1323583292,4,1,2416
33719077@N06,2953,20,1390804744,1390804744,1,6,0
33719077@N06,2953,23,1390798098,1390798098,1,6,0
33719077@N06,2953,19,1390799093,1390799093,1,6,0
33719077@N06,2953,16,1390802383,1390802427,4,6,44
33719077@N06,2953,12,1390800352,1390800352,1,6,0
33719077@N06,2953,14,1390802263,1390802263,2,6,0
33725927@N00,2954,16,1299095771,1299095771,1,2,0
33725927@N00,2954,27,1299101924,1299101974,2,2,50
33754377@N03,2955,17,1395543358,1395543358,1,4,0
33754377@N03,2955,14,1395542421,1395542421,1,4,0
33754377@N03,2955,27,1395542463,1395542463,1,4,0
33754377@N03,2955,16,1395542436,1395542436,1,4,0
33786609@N02,2956,23,1437096590,1437096590,1,2,0
33786609@N02,2956,25,1437095381,1437095381,1,2,0
33786609@N02,2957,27,1437204999,1437204999,1,1,0
33822743@N08,2958,27,1230184438,1230185553,6,1,1115
33822743@N08,2959,27,1230316725,1230321296,2,3,4571
33822743@N08,2959,17,1230318510,1230318510,1,3,0
33822743@N08,2959,16,1230318761,1230318985,6,3,224
33822743@N08,2960,2,1244265212,1244265267,2,4,55
33822743@N08,2960,21,1244263663,1244281677,4,4,18014
33822743@N08,2960,18,1244273016,1244281584,40,4,8568
33822743@N08,2960,27,1244262362,1244285103,5,4,22741
33822743@N08,2961,27,1257748095,1257748137,3,2,42
33822743@N08,2961,24,1257745402,1257745446,4,2,44
33822743@N08,2962,27,1259205704,1259207636,3,1,1932
33822743@N08,2963,16,1275008026,1275008026,1,1,0
33822883@N06,2964,19,1218159473,1218159473,1,1,0
33824882@N07,2965,13,1398514122,1398514150,4,1,28
33878587@N06,2966,2,1230799602,1230799602,1,1,0
33878587@N06,2967,16,1230965332,1230965332,1,1,0
33879159@N06,2968,2,1332138952,1332138952,1,2,0
33879159@N06,2968,14,1332139062,1332139062,1,2,0
33890513@N06,2969,27,1385006031,1385006204,5,1,173
33912195@N05,2970,27,1305496338,1305496338,1,1,0
33929547@N03,2971,9,1430799275,1430799275,1,4,0
33929547@N03,2971,6,1430797921,1430797921,1,4,0
33929547@N03,2971,27,1430790083,1430790083,1,4,0
33929547@N03,2971,16,1430790862,1430821742,2,4,30880
33929547@N03,2972,14,1430988846,1430988846,1,2,0
33929547@N03,2972,27,1430995372,1430995372,1,2,0
33931717@N03,2973,14,1230257195,1230257195,1,1,0
33931717@N03,2974,14,1230334927,1230334927,1,1,0
33934966@N00,2975,27,1290053836,1290070377,4,6,16541
33934966@N00,2975,23,1290068037,1290068037,1,6,0
33934966@N00,2975,14,1290060496,1290062198,3,6,1702
33934966@N00,2975,12,1290059585,1290059585,1,6,0
33934966@N00,2975,13,1290066064,1290066064,1,6,0
33934966@N00,2975,25,1290069778,1290069778,1,6,0
33934966@N00,2976,15,1290418220,1290421192,2,3,2972
33934966@N00,2976,2,1290424394,1290424400,2,3,6
33934966@N00,2976,20,1290421766,1290423302,2,3,1536
33934966@N00,2977,21,1290605666,1290605700,2,4,34
33934966@N00,2977,27,1290617952,1290618918,3,4,966
33934966@N00,2977,23,1290607550,1290607822,3,4,272
33934966@N00,2977,4,1290615038,1290615038,1,4,0
33934966@N00,2978,14,1290873350,1290874012,9,4,662
33934966@N00,2978,8,1290865504,1290865504,1,4,0
33934966@N00,2978,26,1290869571,1290872104,10,4,2533
33934966@N00,2978,16,1290862466,1290862526,2,4,60
33934966@N00,2979,12,1291191816,1291191816,1,8,0
33934966@N00,2979,27,1291189801,1291189979,2,8,178
33934966@N00,2979,17,1291199539,1291199539,1,8,0
33934966@N00,2979,1,1291200422,1291200481,2,8,59
33934966@N00,2979,20,1291197971,1291198389,4,8,418
33934966@N00,2979,22,1291195516,1291195516,1,8,0
33934966@N00,2979,14,1291202577,1291204635,7,8,2058
33934966@N00,2979,26,1291194742,1291194742,1,8,0
33934966@N00,2980,27,1320231321,1320231398,2,5,77
33934966@N00,2980,17,1320231933,1320231933,1,5,0
33934966@N00,2980,4,1320241717,1320242843,4,5,1126
33934966@N00,2980,3,1320238341,1320238383,3,5,42
33934966@N00,2980,19,1320236299,1320237127,7,5,828
33934966@N00,2981,14,1320556054,1320556060,2,5,6
33934966@N00,2981,12,1320557502,1320557502,1,5,0
33934966@N00,2981,27,1320564070,1320564103,3,5,33
33934966@N00,2981,20,1320558783,1320558783,1,5,0
33934966@N00,2981,15,1320557356,1320557356,1,5,0
33934966@N00,2982,27,1320722468,1320722468,1,5,0
33934966@N00,2982,9,1320745133,1320745133,1,5,0
33934966@N00,2982,21,1320728739,1320737073,6,5,8334
33934966@N00,2982,20,1320723683,1320724108,2,5,425
33934966@N00,2982,16,1320747505,1320747505,1,5,0
33936522@N00,2983,27,1211779945,1211779945,1,1,0
33938510@N00,2984,22,1199250607,1199250607,1,1,0
33971415@N07,2985,16,1248680264,1248680264,1,4,0
33971415@N07,2985,27,1248680264,1248680264,2,4,0
33971415@N07,2985,24,1248680264,1248680264,1,4,0
33971415@N07,2985,14,1248683618,1248683618,1,4,0
34008756@N07,2986,16,1268657280,1268657280,1,1,0
34008756@N07,2987,18,1268797355,1268797355,1,1,0
34009864@N00,2988,16,1362379282,1362379282,1,1,0
34017702@N00,2989,6,1305768270,1305768270,1,1,0
34038355@N06,2990,17,1353042815,1353042815,1,1,0
34038355@N06,2991,25,1353094015,1353094015,1,2,0
34038355@N06,2991,17,1353094001,1353094027,2,2,26
34091054@N00,2992,8,1286768881,1286770485,4,4,1604
34091054@N00,2992,14,1286764459,1286764459,1,4,0
34091054@N00,2992,11,1286769565,1286769814,5,4,249
34091054@N00,2992,17,1286758006,1286758022,2,4,16
34104198@N06,2993,27,1350706127,1350706127,1,1,0
34104198@N06,2994,27,1391334018,1391334018,1,1,0
34153311@N05,2995,9,1318654177,1318654177,1,2,0
34153311@N05,2995,27,1318649814,1318649859,2,2,45
34153311@N05,2996,16,1318974834,1318975531,6,1,697
34153311@N05,2997,9,1319102221,1319102226,2,3,5
34153311@N05,2997,21,1319103421,1319103424,2,3,3
34153311@N05,2997,27,1319096555,1319096555,1,3,0
34153311@N05,2998,9,1361234490,1361244174,3,2,9684
34153311@N05,2998,27,1361229691,1361236783,2,2,7092
34153311@N05,2999,14,1361398649,1361405149,3,2,6500
34153311@N05,2999,9,1361403933,1361403933,1,2,0
34153311@N05,3000,9,1408234799,1408238091,6,2,3292
34153311@N05,3000,16,1408229090,1408231249,9,2,2159
34153311@N05,3001,9,1408325583,1408325583,1,1,0
34153311@N05,3002,17,1408580069,1408580084,5,3,15
34153311@N05,3002,15,1408578465,1408578472,3,3,7
34153311@N05,3002,14,1408589234,1408589235,2,3,1
34155736@N07,3003,27,1381270854,1381270854,1,1,0
34169073@N02,3004,16,1312486270,1312486270,1,1,0
34176066@N00,3005,27,1319444281,1319449139,51,1,4858
34176066@N00,3006,22,1319517030,1319517273,11,5,243
34176066@N00,3006,4,1319527420,1319527422,2,5,2
34176066@N00,3006,9,1319504884,1319505591,9,5,707
34176066@N00,3006,20,1319516960,1319517003,5,5,43
34176066@N00,3006,18,1319516940,1319516947,2,5,7
34176066@N00,3007,27,1319706638,1319709196,37,2,2558
34176066@N00,3007,4,1319711720,1319711955,13,2,235
34240084@N05,3008,19,1370600033,1370600033,1,1,0
34282503@N05,3009,26,1234839635,1234839636,2,1,1
34314282@N03,3010,27,1280274771,1280274771,1,3,0
34314282@N03,3010,9,1280285812,1280285812,1,3,0
34314282@N03,3010,19,1280275265,1280275432,2,3,167
34317816@N05,3011,16,1377988398,1377988634,2,2,236
34317816@N05,3011,27,1377987890,1377987890,1,2,0
34339642@N05,3012,27,1364432283,1364432705,3,1,422
34361471@N02,3013,20,1283340009,1283340009,1,1,0
34361916@N00,3014,13,1339494724,1339494724,1,1,0
34361916@N00,3015,27,1339647751,1339647751,1,2,0
34361916@N00,3015,9,1339636734,1339636734,1,2,0
34390084@N07,3016,16,1205257206,1205278262,21,1,21056
34390084@N07,3017,16,1238811404,1238812425,6,1,1021
34390084@N07,3018,16,1240737419,1240737933,3,1,514
34390084@N07,3019,18,1260693073,1260708786,4,3,15713
34390084@N07,3019,14,1260687814,1260688546,18,3,732
34390084@N07,3019,16,1260709900,1260710709,7,3,809
34407909@N07,3020,16,1201929825,1201929825,1,1,0
34429030@N00,3021,9,1305623243,1305623243,1,1,0
34482114@N07,3022,17,1398849876,1398849876,1,1,0
34538882@N00,3023,3,1307703058,1307703058,1,1,0
34544450@N05,3024,19,1359936406,1359936589,2,1,183
34544450@N05,3025,17,1360372269,1360372269,1,1,0
34544916@N07,3026,14,1356076095,1356076095,1,1,0
34600882@N05,3027,8,1360631140,1360631140,1,8,0
34600882@N05,3027,13,1360651642,1360651642,1,8,0
34600882@N05,3027,18,1360649711,1360650019,2,8,308
34600882@N05,3027,14,1360652879,1360652887,2,8,8
34600882@N05,3027,11,1360634922,1360639649,3,8,4727
34600882@N05,3027,17,1360648114,1360648754,2,8,640
34600882@N05,3027,3,1360644507,1360644507,1,8,0
34600882@N05,3027,27,1360629177,1360642101,4,8,12924
34600882@N05,3028,25,1360802304,1360802304,1,2,0
34600882@N05,3028,4,1360815599,1360815599,1,2,0
34606214@N00,3029,20,1324173265,1324173273,2,1,8
34612686@N08,3030,4,1427071703,1427071703,1,4,0
34612686@N08,3030,19,1427091976,1427093219,6,4,1243
34612686@N08,3030,13,1427088100,1427089276,5,4,1176
34612686@N08,3030,16,1427108247,1427108247,1,4,0
34695134@N00,3031,27,1198042542,1198043270,4,3,728
34695134@N00,3031,25,1198051202,1198057301,8,3,6099
34695134@N00,3031,3,1198046879,1198046969,2,3,90
34703628@N00,3032,17,1316319815,1316319815,1,5,0
34703628@N00,3032,16,1316332561,1316332561,1,5,0
34703628@N00,3032,19,1316313465,1316322602,2,5,9137
34703628@N00,3032,25,1316330534,1316330534,1,5,0
34703628@N00,3032,18,1316313220,1316313845,3,5,625
34703628@N00,3033,16,1317429105,1317468755,8,2,39650
34703628@N00,3033,27,1317428390,1317465653,5,2,37263
34703628@N00,3034,27,1319262394,1319262394,1,1,0
34703628@N00,3035,17,1331790992,1331790992,1,2,0
34703628@N00,3035,18,1331785627,1331785627,1,2,0
34727974@N05,3036,5,1291693217,1291693658,6,5,441
34727974@N05,3036,22,1291699923,1291699923,1,5,0
34727974@N05,3036,16,1291683722,1291683722,1,5,0
34727974@N05,3036,27,1291683572,1291683572,1,5,0
34727974@N05,3036,14,1291700222,1291700222,1,5,0
34737607@N00,3037,17,1234572777,1234572789,2,16,12
34737607@N00,3037,19,1234589827,1234589827,1,16,0
34737607@N00,3037,27,1234570453,1234611001,22,16,40548
34737607@N00,3037,18,1234582113,1234582113,1,16,0
34737607@N00,3037,26,1234573229,1234573341,4,16,112
34737607@N00,3037,15,1234583511,1234584688,6,16,1177
34737607@N00,3037,1,1234592028,1234592028,1,16,0
34737607@N00,3037,6,1234591958,1234597489,3,16,5531
34737607@N00,3037,14,1234594168,1234594203,2,16,35
34737607@N00,3037,5,1234591870,1234597171,3,16,5301
34737607@N00,3037,2,1234590769,1234591945,9,16,1176
34737607@N00,3037,9,1234587681,1234598542,3,16,10861
34737607@N00,3037,22,1234573436,1234573436,1,16,0
34737607@N00,3037,16,1234572684,1234596258,7,16,23574
34737607@N00,3037,4,1234592296,1234597026,7,16,4730
34737607@N00,3037,13,1234574591,1234582962,5,16,8371
34756241@N05,3038,18,1204609393,1204609393,1,1,0
34761987@N08,3039,17,1232327591,1232327591,1,1,0
34772702@N08,3040,27,1192690207,1192711589,230,1,21382
34772702@N08,3041,27,1206921885,1206932372,11,1,10487
34772702@N08,3042,27,1224789673,1224846832,189,1,57159
34772702@N08,3043,27,1236842266,1236845399,50,1,3133
34772702@N08,3044,27,1241335722,1241335736,27,1,14
34790448@N07,3045,27,1237644207,1237644358,2,1,151
34790448@N07,3046,27,1249618242,1249620881,10,1,2639
34790448@N07,3047,27,1251896941,1251896941,1,1,0
34790448@N07,3048,9,1253619297,1253624663,6,1,5366
34790448@N07,3049,27,1254883771,1254885102,48,1,1331
34790448@N07,3050,27,1256438714,1256439244,13,1,530
34790448@N07,3051,27,1257068790,1257068790,1,1,0
34790448@N07,3052,12,1257829558,1257829558,1,1,0
34790448@N07,3053,14,1266431698,1266431698,1,2,0
34790448@N07,3053,16,1266429556,1266429908,4,2,352
34790448@N07,3054,4,1267417693,1267417693,1,2,0
34790448@N07,3054,27,1267417017,1267417142,3,2,125
34790448@N07,3055,12,1269060145,1269061418,9,1,1273
34790448@N07,3056,12,1270285083,1270285191,5,1,108
34790448@N07,3057,17,1271046615,1271046652,3,2,37
34790448@N07,3057,25,1271048450,1271048937,3,2,487
34790448@N07,3058,4,1271650007,1271650999,21,2,992
34790448@N07,3058,16,1271638252,1271638865,2,2,613
34790448@N07,3059,8,1272865146,1272867032,9,1,1886
34790448@N07,3060,8,1272966039,1272967916,5,1,1877
34790448@N07,3061,22,1273141756,1273142770,22,1,1014
34790448@N07,3062,16,1273321668,1273322689,7,1,1021
34790448@N07,3063,22,1275744191,1275745156,20,1,965
34795150@N07,3064,9,1352507553,1352507553,1,2,0
34795150@N07,3064,27,1352502140,1352502140,1,2,0
34795150@N07,3065,16,1352539972,1352539972,1,1,0
34869921@N00,3066,6,1350111045,1350111045,1,1,0
34872729@N05,3067,17,1266549768,1266552130,5,2,2362
34872729@N05,3067,19,1266550713,1266551573,13,2,860
34898173@N05,3068,16,1255871933,1255871933,1,1,0
34898173@N05,3069,16,1256378965,1256378965,1,1,0
34932761@N06,3070,20,1244365460,1244365460,1,7,0
34932761@N06,3070,14,1244344077,1244377034,13,7,32957
34932761@N06,3070,5,1244352871,1244352871,1,7,0
34932761@N06,3070,27,1244377981,1244377981,1,7,0
34932761@N06,3070,25,1244337562,1244337597,4,7,35
34932761@N06,3070,15,1244360189,1244360189,1,7,0
34932761@N06,3070,23,1244337543,1244337555,3,7,12
34958003@N02,3071,21,1391472330,1391472330,1,1,0
34959558@N03,3072,27,1356136271,1356147265,2,1,10994
34959558@N03,3073,22,1412474112,1412474112,1,1,0
34959558@N03,3074,2,1412571287,1412571287,1,1,0
35030525630@N01,3075,1,1468924214,1468924214,1,1,0
35032613@N03,3076,8,1343536235,1343536235,1,1,0
35034347371@N01,3077,9,1449738713,1449742072,5,1,3359
35034348373@N01,3078,17,1364345039,1364345039,1,1,0
35034363370@N01,3079,24,1414727775,1414728075,2,21,300
35034363370@N01,3079,15,1414726354,1414726379,3,21,25
35034363370@N01,3079,19,1414733838,1414733838,1,21,0
35034363370@N01,3079,4,1414708983,1414715934,2,21,6951
35034363370@N01,3079,12,1414725609,1414726263,8,21,654
35034363370@N01,3079,13,1414723696,1414724587,3,21,891
35034363370@N01,3079,1,1414712232,1414712232,1,21,0
35034363370@N01,3079,9,1414718216,1414718324,4,21,108
35034363370@N01,3079,23,1414728309,1414728560,4,21,251
35034363370@N01,3079,6,1414707995,1414707995,1,21,0
35034363370@N01,3079,27,1414706611,1414738261,9,21,31650
35034363370@N01,3079,16,1414707182,1414735004,4,21,27822
35034363370@N01,3079,25,1414719567,1414730550,9,21,10983
35034363370@N01,3079,20,1414723122,1414723122,1,21,0
35034363370@N01,3079,2,1414708521,1414717427,8,21,8906
35034363370@N01,3079,7,1414717499,1414717502,2,21,3
35034363370@N01,3079,21,1414719762,1414727479,4,21,7717
35034363370@N01,3079,22,1414733632,1414733632,1,21,0
35034363370@N01,3079,18,1414733398,1414734648,4,21,1250
35034363370@N01,3079,14,1414707565,1414731625,6,21,24060
35034363370@N01,3079,5,1414715922,1414715922,1,21,0
35034364890@N01,3080,3,1194777858,1194777858,1,6,0
35034364890@N01,3080,6,1194779730,1194779756,4,6,26
35034364890@N01,3080,4,1194783034,1194783135,2,6,101
35034364890@N01,3080,26,1194754533,1194754533,1,6,0
35034364890@N01,3080,27,1194735299,1194783719,3,6,48420
35034364890@N01,3080,21,1194746018,1194746192,2,6,174
35034364890@N01,3081,27,1194824270,1194824270,1,3,0
35034364890@N01,3081,1,1194825317,1194825317,1,3,0
35034364890@N01,3081,5,1194826723,1194826723,1,3,0
35041397@N00,3082,21,1193012741,1193012741,1,2,0
35041397@N00,3082,16,1193008982,1193010339,5,2,1357
35067956@N08,3083,27,1436851568,1436852161,4,1,593
35071666@N00,3084,15,1352198471,1352198471,1,1,0
35082889@N05,3085,15,1415316588,1415317729,2,2,1141
35082889@N05,3085,17,1415320229,1415320229,1,2,0
35144236@N07,3086,16,1271016246,1271016246,1,1,0
35155400@N03,3087,21,1396867708,1396867708,1,1,0
35209467@N02,3088,26,1295658781,1295658781,1,1,0
35209467@N02,3089,27,1295742148,1295742148,1,1,0
35209467@N02,3090,16,1295771770,1295771770,1,1,0
35261894@N00,3091,4,1404269017,1404271149,10,8,2132
35261894@N00,3091,21,1404277345,1404277684,15,8,339
35261894@N00,3091,15,1404268566,1404268566,1,8,0
35261894@N00,3091,1,1404268030,1404268042,2,8,12
35261894@N00,3091,18,1404276383,1404276499,6,8,116
35261894@N00,3091,27,1404266789,1404267224,18,8,435
35261894@N00,3091,5,1404268948,1404268949,2,8,1
35261894@N00,3091,17,1404271417,1404271431,3,8,14
35356940@N00,3092,1,1368745801,1368745801,1,9,0
35356940@N00,3092,26,1368751330,1368781007,4,9,29677
35356940@N00,3092,27,1368742542,1368773946,3,9,31404
35356940@N00,3092,10,1368785811,1368786074,2,9,263
35356940@N00,3092,21,1368749505,1368749505,1,9,0
35356940@N00,3092,25,1368751419,1368751673,2,9,254
35356940@N00,3092,13,1368747505,1368781544,4,9,34039
35356940@N00,3092,20,1368749311,1368753724,2,9,4413
35356940@N00,3092,5,1368776873,1368776873,1,9,0
35356940@N00,3093,18,1393631931,1393632848,3,6,917
35356940@N00,3093,9,1393639733,1393639733,1,6,0
35356940@N00,3093,27,1393625632,1393629665,19,6,4033
35356940@N00,3093,22,1393634842,1393634842,1,6,0
35356940@N00,3093,19,1393631998,1393631998,1,6,0
35356940@N00,3093,17,1393630409,1393630409,1,6,0
35378947@N07,3094,27,1205232118,1205232118,1,3,0
35378947@N07,3094,5,1205232490,1205232490,1,3,0
35378947@N07,3094,16,1205232482,1205232482,1,3,0
35378947@N07,3095,1,1234418481,1234418481,1,5,0
35378947@N07,3095,3,1234419008,1234419932,28,5,924
35378947@N07,3095,20,1234411948,1234411961,2,5,13
35378947@N07,3095,2,1234414178,1234418401,6,5,4223
35378947@N07,3095,21,1234412773,1234412835,2,5,62
35378947@N07,3096,1,1260152479,1260162399,3,7,9920
35378947@N07,3096,3,1260164622,1260165600,8,7,978
35378947@N07,3096,20,1260166818,1260166845,2,7,27
35378947@N07,3096,14,1260159309,1260160303,2,7,994
35378947@N07,3096,17,1260166545,1260166545,1,7,0
35378947@N07,3096,25,1260153507,1260153507,1,7,0
35378947@N07,3096,27,1260158520,1260158520,1,7,0
35378947@N07,3097,1,1260257031,1260257031,1,7,0
35378947@N07,3097,17,1260271965,1260277313,4,7,5348
35378947@N07,3097,9,1260250149,1260250149,1,7,0
35378947@N07,3097,20,1260252048,1260265163,5,7,13115
35378947@N07,3097,12,1260250451,1260251367,11,7,916
35378947@N07,3097,16,1260249824,1260249852,3,7,28
35378947@N07,3097,27,1260247598,1260278150,8,7,30552
35378947@N07,3098,20,1281508552,1281508552,1,3,0
35378947@N07,3098,2,1281500140,1281515445,4,3,15305
35378947@N07,3098,1,1281500345,1281500345,1,3,0
35378947@N07,3099,27,1281649199,1281651915,8,1,2716
35378947@N07,3100,27,1281707880,1281708182,7,4,302
35378947@N07,3100,4,1281707625,1281707695,3,4,70
35378947@N07,3100,22,1281706056,1281706827,9,4,771
35378947@N07,3100,17,1281707330,1281707412,2,4,82
35378947@N07,3101,27,1284691761,1284717689,17,9,25928
35378947@N07,3101,3,1284698698,1284698698,1,9,0
35378947@N07,3101,26,1284708317,1284708317,1,9,0
35378947@N07,3101,16,1284692978,1284692978,1,9,0
35378947@N07,3101,8,1284695611,1284695761,10,9,150
35378947@N07,3101,9,1284703215,1284703215,1,9,0
35378947@N07,3101,19,1284693253,1284694852,6,9,1599
35378947@N07,3101,2,1284697317,1284697951,2,9,634
35378947@N07,3101,17,1284693130,1284693130,1,9,0
35378947@N07,3102,27,1285054515,1285054677,7,5,162
35378947@N07,3102,16,1285059570,1285067640,6,5,8070
35378947@N07,3102,9,1285063184,1285063283,2,5,99
35378947@N07,3102,17,1285056365,1285057550,5,5,1185
35378947@N07,3102,13,1285063997,1285064029,3,5,32
35378947@N07,3103,27,1304832877,1304832877,1,6,0
35378947@N07,3103,26,1304836250,1304839154,4,6,2904
35378947@N07,3103,14,1304844675,1304844675,1,6,0
35378947@N07,3103,2,1304854727,1304854727,1,6,0
35378947@N07,3103,17,1304836033,1304836033,1,6,0
35378947@N07,3103,15,1304841995,1304844752,2,6,2757
35378947@N07,3104,9,1304952715,1304952715,1,3,0
35378947@N07,3104,18,1304944993,1304944993,1,3,0
35378947@N07,3104,6,1304940015,1304940037,2,3,22
35378947@N07,3105,13,1305257193,1305257193,1,2,0
35378947@N07,3105,18,1305257146,1305257847,5,2,701
35378947@N07,3106,27,1305337231,1305337231,1,5,0
35378947@N07,3106,19,1305337667,1305337667,1,5,0
35378947@N07,3106,1,1305338420,1305338420,1,5,0
35378947@N07,3106,13,1305336541,1305336546,2,5,5
35378947@N07,3106,22,1305337623,1305337623,1,5,0
35378947@N07,3107,27,1305616911,1305617433,2,2,522
35378947@N07,3107,17,1305612199,1305612199,1,2,0
35378947@N07,3108,14,1328353903,1328353903,1,1,0
35378947@N07,3109,27,1328442735,1328442998,4,3,263
35378947@N07,3109,16,1328433498,1328441184,2,3,7686
35378947@N07,3109,13,1328435519,1328435574,4,3,55
35378947@N07,3110,1,1328770369,1328771395,7,8,1026
35378947@N07,3110,13,1328762595,1328762683,3,8,88
35378947@N07,3110,5,1328781051,1328781063,2,8,12
35378947@N07,3110,27,1328758328,1328782162,3,8,23834
35378947@N07,3110,4,1328767753,1328767780,2,8,27
35378947@N07,3110,22,1328764665,1328764682,2,8,17
35378947@N07,3110,14,1328761791,1328762188,7,8,397
35378947@N07,3110,16,1328758571,1328758571,1,8,0
35378947@N07,3111,1,1328846195,1328846195,1,2,0
35378947@N07,3111,2,1328842277,1328842277,1,2,0
35380796@N03,3112,16,1230728400,1230728400,1,5,0
35380796@N03,3112,21,1230728400,1230728400,1,5,0
35380796@N03,3112,2,1230728400,1230728400,1,5,0
35380796@N03,3112,17,1230728400,1230728400,2,5,0
35380796@N03,3112,22,1230728400,1230728400,2,5,0
35380796@N03,3113,12,1292311513,1292311578,2,11,65
35380796@N03,3113,20,1292327559,1292327559,1,11,0
35380796@N03,3113,19,1292305648,1292307040,3,11,1392
35380796@N03,3113,16,1292322830,1292323323,3,11,493
35380796@N03,3113,15,1292312864,1292312864,1,11,0
35380796@N03,3113,22,1292325641,1292330660,10,11,5019
35380796@N03,3113,21,1292304565,1292304799,3,11,234
35380796@N03,3113,27,1292329432,1292329564,5,11,132
35380796@N03,3113,2,1292321937,1292321966,2,11,29
35380796@N03,3113,24,1292303251,1292303670,2,11,419
35380796@N03,3113,14,1292316395,1292316579,2,11,184
35380796@N03,3114,12,1292487916,1292487916,1,9,0
35380796@N03,3114,13,1292485097,1292485097,1,9,0
35380796@N03,3114,22,1292499852,1292499936,2,9,84
35380796@N03,3114,14,1292486276,1292490171,2,9,3895
35380796@N03,3114,1,1292490389,1292504448,4,9,14059
35380796@N03,3114,9,1292489586,1292490031,2,9,445
35380796@N03,3114,24,1292483197,1292483197,1,9,0
35380796@N03,3114,16,1292494815,1292505492,13,9,10677
35380796@N03,3114,3,1292479949,1292503646,3,9,23697
35380796@N03,3115,12,1318493393,1318493393,1,7,0
35380796@N03,3115,13,1318487254,1318487794,4,7,540
35380796@N03,3115,22,1318491260,1318498029,6,7,6769
35380796@N03,3115,21,1318490128,1318490371,2,7,243
35380796@N03,3115,1,1318503426,1318503426,1,7,0
35380796@N03,3115,2,1318500067,1318500183,3,7,116
35380796@N03,3115,3,1318482782,1318482836,2,7,54
35380796@N03,3116,27,1318582804,1318583905,3,1,1101
35380796@N03,3117,12,1318739433,1318740426,4,11,993
35380796@N03,3117,20,1318720912,1318720920,2,11,8
35380796@N03,3117,19,1318742009,1318742009,1,11,0
35380796@N03,3117,26,1318725493,1318725493,1,11,0
35380796@N03,3117,15,1318731261,1318731261,1,11,0
35380796@N03,3117,21,1318720964,1318721118,3,11,154
35380796@N03,3117,23,1318722768,1318722768,1,11,0
35380796@N03,3117,1,1318726128,1318744741,4,11,18613
35380796@N03,3117,9,1318738662,1318738662,1,11,0
35380796@N03,3117,24,1318723422,1318723883,4,11,461
35380796@N03,3117,3,1318718531,1318743738,5,11,25207
35386099@N04,3118,27,1370098486,1370098486,1,1,0
35404547@N02,3119,16,1375317446,1375317446,1,3,0
35404547@N02,3119,13,1375323832,1375323832,1,3,0
35404547@N02,3119,27,1375314799,1375314950,2,3,151
35443533@N08,3120,16,1202941509,1202941509,1,1,0
35443533@N08,3121,16,1263205035,1263205035,1,1,0
35457947@N04,3122,17,1280037946,1280037946,1,1,0
35457947@N04,3123,25,1280361209,1280361209,1,2,0
35457947@N04,3123,18,1280363062,1280363062,1,2,0
35468140399@N01,3124,27,1332986832,1332986832,1,3,0
35468140399@N01,3124,10,1333001068,1333001068,1,3,0
35468140399@N01,3124,12,1332989565,1332989856,4,3,291
35468141333@N01,3125,16,1313622412,1313622769,2,5,357
35468141333@N01,3125,14,1313621777,1313639179,3,5,17402
35468141333@N01,3125,27,1313620903,1313620903,1,5,0
35468141333@N01,3125,18,1313653972,1313653972,1,5,0
35468141333@N01,3125,20,1313651144,1313651144,1,5,0
35470197@N08,3126,14,1452910503,1452911790,2,1,1287
35498711@N04,3127,13,1346037774,1346037774,1,2,0
35498711@N04,3127,1,1346041152,1346041152,1,2,0
35498711@N04,3128,16,1346731203,1346731203,1,5,0
35498711@N04,3128,20,1346731202,1346731202,1,5,0
35498711@N04,3128,27,1346731200,1346731200,1,5,0
35498711@N04,3128,21,1346731201,1346731201,1,5,0
35498711@N04,3128,19,1346752528,1346752528,1,5,0
35509457@N00,3129,2,1367551860,1367551868,2,3,8
35509457@N00,3129,10,1367545961,1367545961,1,3,0
35509457@N00,3129,4,1367553425,1367553425,1,3,0
35509457@N00,3130,9,1368327166,1368327166,1,1,0
35525807@N06,3131,17,1370673231,1370673231,1,1,0
35536869@N06,3132,16,1312262223,1312288825,17,1,26602
35536869@N06,3133,16,1312550009,1312552339,5,1,2330
35536869@N06,3134,16,1312622478,1312633773,13,1,11295
35547432@N07,3135,27,1364117897,1364117897,1,1,0
35570988@N08,3136,21,1345028702,1345028702,1,1,0
35570988@N08,3137,21,1345186123,1345186123,1,1,0
35570988@N08,3138,21,1345726958,1345726958,1,1,0
35570988@N08,3139,22,1347059406,1347059406,1,1,0
35570988@N08,3140,4,1347794135,1347794135,1,1,0
35581623@N04,3141,21,1368921799,1368921799,1,1,0
35581623@N04,3142,18,1371507859,1371507859,1,1,0
35602564@N00,3143,27,1439530041,1439530041,1,1,0
35617346@N02,3144,27,1375610709,1375619459,2,1,8750
35617346@N02,3145,27,1375665031,1375665031,1,2,0
35617346@N02,3145,20,1375668002,1375668002,1,2,0
35617346@N02,3146,20,1404033480,1404033480,1,3,0
35617346@N02,3146,14,1404014243,1404014243,1,3,0
35617346@N02,3146,3,1404008895,1404008895,1,3,0
35617346@N02,3147,8,1423799172,1423799172,1,1,0
35657441@N02,3148,16,1418625069,1418625069,1,4,0
35657441@N02,3148,27,1418600474,1418627779,2,4,27305
35657441@N02,3148,10,1418609078,1418609964,3,4,886
35657441@N02,3148,17,1418643181,1418643181,1,4,0
35665675@N04,3149,26,1197757200,1197757200,1,1,0
35721568@N00,3150,1,1221369676,1221369697,2,11,21
35721568@N00,3150,26,1221361207,1221361207,1,11,0
35721568@N00,3150,9,1221356008,1221356008,1,11,0
35721568@N00,3150,16,1221362414,1221362480,3,11,66
35721568@N00,3150,27,1221353344,1221353713,3,11,369
35721568@N00,3150,8,1221355109,1221355681,2,11,572
35721568@N00,3150,19,1221366607,1221366607,1,11,0
35721568@N00,3150,23,1221373990,1221374520,4,11,530
35721568@N00,3150,20,1221361085,1221365431,3,11,4346
35721568@N00,3150,18,1221359368,1221360013,4,11,645
35721568@N00,3150,22,1221364983,1221364983,1,11,0
35736481@N00,3151,15,1258328381,1258337100,4,8,8719
35736481@N00,3151,14,1258327023,1258360788,16,8,33765
35736481@N00,3151,22,1258338679,1258339107,4,8,428
35736481@N00,3151,17,1258326654,1258326654,1,8,0
35736481@N00,3151,27,1258321241,1258346565,4,8,25324
35736481@N00,3151,16,1258326763,1258326763,1,8,0
35736481@N00,3151,9,1258330551,1258360327,15,8,29776
35736481@N00,3151,20,1258339254,1258343865,5,8,4611
35736481@N00,3152,13,1258436975,1258437021,2,1,46
35736481@N00,3153,9,1258671846,1258678818,2,12,6972
35736481@N00,3153,14,1258699745,1258700643,8,12,898
35736481@N00,3153,16,1258661832,1258668051,45,12,6219
35736481@N00,3153,1,1258671064,1258671073,2,12,9
35736481@N00,3153,2,1258669303,1258669393,4,12,90
35736481@N00,3153,11,1258675499,1258675707,10,12,208
35736481@N00,3153,17,1258683018,1258683740,6,12,722
35736481@N00,3153,8,1258676435,1258677877,4,12,1442
35736481@N00,3153,22,1258690447,1258691654,5,12,1207
35736481@N00,3153,25,1258680747,1258682274,5,12,1527
35736481@N00,3153,26,1258680148,1258680556,4,12,408
35736481@N00,3153,20,1258687227,1258696668,3,12,9441
35736481@N00,3154,9,1296083559,1296083581,2,9,22
35736481@N00,3154,27,1296079755,1296080136,2,9,381
35736481@N00,3154,6,1296085217,1296085287,3,9,70
35736481@N00,3154,11,1296089141,1296089340,4,9,199
35736481@N00,3154,22,1296096615,1296097256,3,9,641
35736481@N00,3154,25,1296099110,1296099313,5,9,203
35736481@N00,3154,26,1296097695,1296102382,4,9,4687
35736481@N00,3154,14,1296080886,1296082274,6,9,1388
35736481@N00,3154,20,1296091571,1296092556,2,9,985
35736481@N00,3155,14,1296434901,1296436019,2,11,1118
35736481@N00,3155,9,1296429066,1296439674,14,11,10608
35736481@N00,3155,18,1296455297,1296455297,1,11,0
35736481@N00,3155,1,1296446216,1296447391,5,11,1175
35736481@N00,3155,19,1296458072,1296458072,1,11,0
35736481@N00,3155,17,1296434406,1296458527,3,11,24121
35736481@N00,3155,2,1296445356,1296445356,1,11,0
35736481@N00,3155,22,1296450829,1296450829,1,11,0
35736481@N00,3155,16,1296434567,1296434567,1,11,0
35736481@N00,3155,26,1296450913,1296450913,1,11,0
35736481@N00,3155,20,1296453152,1296453598,5,11,446
35736481@N00,3156,1,1296605044,1296605044,1,6,0
35736481@N00,3156,9,1296604776,1296607942,4,6,3166
35736481@N00,3156,19,1296603300,1296603368,2,6,68
35736481@N00,3156,22,1296612846,1296612846,1,6,0
35736481@N00,3156,25,1296618096,1296618096,1,6,0
35736481@N00,3156,20,1296614342,1296614876,2,6,534
35736481@N00,3157,25,1335775811,1335778769,2,1,2958
35758162@N00,3158,18,1194768167,1194768167,1,5,0
35758162@N00,3158,16,1194768138,1194768138,1,5,0
35758162@N00,3158,6,1194768143,1194768144,2,5,1
35758162@N00,3158,2,1194768147,1194768147,1,5,0
35758162@N00,3158,13,1194768152,1194768152,1,5,0
35816811@N04,3159,10,1379631788,1379631788,1,3,0
35816811@N04,3159,20,1379636244,1379636244,1,3,0
35816811@N04,3159,8,1379639283,1379639283,1,3,0
35816811@N04,3160,27,1388947357,1388947357,1,1,0
35816811@N04,3161,14,1389256006,1389256006,1,1,0
35825796@N00,3162,27,1194911845,1194945219,7,1,33374
35849644@N06,3163,17,1397177224,1397221874,32,1,44650
35849644@N06,3164,17,1397271049,1397271049,1,1,0
35853462@N00,3165,9,1231122492,1231122496,2,1,4
35853462@N00,3166,27,1231471174,1231471174,1,2,0
35853462@N00,3166,6,1231471131,1231471131,1,2,0
35853462@N00,3167,6,1283651155,1283651155,1,1,0
35853462@N00,3168,17,1283689429,1283689437,2,1,8
35853462@N00,3169,13,1283996263,1283996263,1,5,0
35853462@N00,3169,14,1283997518,1283997518,1,5,0
35853462@N00,3169,26,1284014008,1284014008,1,5,0
35853462@N00,3169,2,1284001099,1284001099,1,5,0
35853462@N00,3169,12,1283996331,1283996331,1,5,0
35853462@N00,3170,20,1388915900,1388915900,1,1,0
35853462@N00,3171,19,1389157171,1389157181,2,5,10
35853462@N00,3171,2,1389142023,1389154427,22,5,12404
35853462@N00,3171,13,1389146621,1389146949,11,5,328
35853462@N00,3171,1,1389142975,1389151225,3,5,8250
35853462@N00,3171,3,1389154401,1389154401,1,5,0
35853462@N00,3172,25,1389223569,1389224898,10,1,1329
35853462@N00,3173,6,1389342972,1389342972,1,3,0
35853462@N00,3173,17,1389344997,1389345005,6,3,8
35853462@N00,3173,13,1389344442,1389344447,4,3,5
35853462@N00,3174,21,1389399412,1389399412,1,8,0
35853462@N00,3174,6,1389394379,1389394379,1,8,0
35853462@N00,3174,13,1389398362,1389398362,1,8,0
35853462@N00,3174,10,1389396001,1389396001,1,8,0
35853462@N00,3174,2,1389394131,1389394201,4,8,70
35853462@N00,3174,26,1389400646,1389400646,2,8,0
35853462@N00,3174,4,1389393245,1389393245,1,8,0
35853462@N00,3174,25,1389400634,1389400994,4,8,360
35872939@N00,3175,4,1233472567,1233475863,9,8,3296
35872939@N00,3175,14,1233456532,1233456532,1,8,0
35872939@N00,3175,1,1233469259,1233469259,1,8,0
35872939@N00,3175,11,1233461758,1233466387,6,8,4629
35872939@N00,3175,26,1233458068,1233458653,13,8,585
35872939@N00,3175,21,1233482144,1233482144,1,8,0
35872939@N00,3175,8,1233461392,1233467360,5,8,5968
35872939@N00,3175,27,1233451152,1233452686,8,8,1534
35872939@N00,3176,12,1233806926,1233806926,1,3,0
35872939@N00,3176,14,1233808428,1233808428,1,3,0
35872939@N00,3176,17,1233816242,1233819298,3,3,3056
35872939@N00,3177,12,1267402763,1267403290,6,5,527
35872939@N00,3177,9,1267401915,1267401915,1,5,0
35872939@N00,3177,8,1267401573,1267401573,1,5,0
35872939@N00,3177,11,1267404275,1267408630,18,5,4355
35872939@N00,3177,27,1267400578,1267401182,2,5,604
35888901@N00,3178,14,1324986796,1324986796,1,2,0
35888901@N00,3178,16,1324987980,1324987980,1,2,0
35897523@N04,3179,4,1191281593,1191281593,1,1,0
35897523@N04,3180,17,1243387720,1243387720,1,5,0
35897523@N04,3180,4,1243382134,1243382134,1,5,0
35897523@N04,3180,27,1243381308,1243381308,1,5,0
35897523@N04,3180,14,1243387319,1243387319,1,5,0
35897523@N04,3180,23,1243387891,1243387891,1,5,0
35897523@N04,3181,21,1244941226,1244952696,4,2,11470
35897523@N04,3181,4,1244954243,1244954243,1,2,0
35897523@N04,3182,9,1251099881,1251099881,1,4,0
35897523@N04,3182,27,1251091812,1251091868,2,4,56
35897523@N04,3182,12,1251101074,1251101074,1,4,0
35897523@N04,3182,26,1251095418,1251095418,1,4,0
35897523@N04,3183,27,1251370977,1251372099,5,1,1122
35897523@N04,3184,27,1264625194,1264625194,1,1,0
35897523@N04,3185,19,1283820168,1283820168,1,1,0
35897523@N04,3186,9,1314239261,1314239261,1,1,0
35897523@N04,3187,4,1347361719,1347361719,1,1,0
35897587@N08,3188,14,1401857291,1401857291,1,1,0
35908912@N07,3189,27,1294965590,1294965590,1,1,0
35909485@N03,3190,2,1217494377,1217494377,1,3,0
35909485@N03,3190,16,1217494441,1217494441,1,3,0
35909485@N03,3190,1,1217502643,1217502643,1,3,0
35909485@N03,3191,16,1217813677,1217813677,1,1,0
35921741@N06,3192,2,1384132074,1384132074,1,1,0
35928519@N00,3193,27,1322943872,1322943872,1,1,0
35928519@N00,3194,27,1323064571,1323064571,1,1,0
35928519@N00,3195,16,1385939609,1385967938,3,1,28329
36004850@N02,3196,22,1259551594,1259551594,1,1,0
36004850@N02,3197,27,1259622134,1259624090,5,1,1956
36041393@N06,3198,21,1415669810,1415670021,2,1,211
36041393@N06,3199,14,1416113115,1416113115,1,10,0
36041393@N06,3199,9,1416095614,1416095730,3,10,116
36041393@N06,3199,22,1416100778,1416101370,3,10,592
36041393@N06,3199,27,1416093612,1416093621,2,10,9
36041393@N06,3199,25,1416110062,1416110099,2,10,37
36041393@N06,3199,8,1416114007,1416115612,2,10,1605
36041393@N06,3199,6,1416116871,1416116871,1,10,0
36041393@N06,3199,26,1416101381,1416109852,2,10,8471
36041393@N06,3199,19,1416099488,1416111491,2,10,12003
36041393@N06,3199,13,1416109612,1416112755,2,10,3143
36044387@N04,3200,27,1221531028,1221531028,1,1,0
36048845@N06,3201,17,1392537316,1392537341,2,1,25
36052779@N07,3202,27,1357082741,1357082804,3,2,63
36052779@N07,3202,25,1357084644,1357084644,1,2,0
36052779@N07,3203,14,1357114072,1357114072,1,1,0
36072072@N06,3204,7,1271208920,1271208920,1,1,0
36101699447@N01,3205,24,1357162354,1357162354,1,2,0
36101699447@N01,3205,25,1357163633,1357163633,1,2,0
36101699901@N01,3206,4,1224902951,1224903477,2,1,526
36101699901@N01,3207,4,1262344642,1262344642,1,1,0
36101699901@N01,3208,18,1277347943,1277347943,1,1,0
36101699901@N01,3209,22,1285390186,1285390186,1,1,0
36101699901@N01,3210,13,1340429842,1340429842,1,1,0
36112910@N02,3211,14,1380945170,1380945170,1,4,0
36112910@N02,3211,16,1380939831,1380939831,1,4,0
36112910@N02,3211,10,1380949810,1380949810,1,4,0
36112910@N02,3211,25,1380941265,1380941265,1,4,0
36168978@N00,3212,11,1292910302,1292910339,2,3,37
36168978@N00,3212,16,1292900484,1292910391,3,3,9907
36168978@N00,3212,12,1292901801,1292901818,2,3,17
36179078@N03,3213,16,1384140786,1384140786,1,2,0
36179078@N03,3213,14,1384140617,1384140617,1,2,0
36191363@N00,3214,9,1214736695,1214736695,1,1,0
36196989@N02,3215,17,1298012603,1298012603,1,2,0
36196989@N02,3215,10,1297986447,1297986447,1,2,0
36226805@N03,3216,26,1190605538,1190605538,1,2,0
36226805@N03,3216,27,1190599307,1190599307,1,2,0
36226805@N03,3217,19,1222051171,1222051634,2,1,463
36226805@N03,3218,18,1222318911,1222318911,1,3,0
36226805@N03,3218,27,1222303857,1222323101,3,3,19244
36226805@N03,3218,16,1222305118,1222305118,1,3,0
36226805@N03,3219,25,1240317161,1240317161,1,1,0
36226805@N03,3220,13,1245417523,1245417523,1,1,0
36226805@N03,3221,18,1253506230,1253506230,1,2,0
36226805@N03,3221,26,1253506211,1253506211,1,2,0
36226805@N03,3222,16,1253765845,1253765845,1,1,0
36226805@N03,3223,26,1284948023,1284948023,1,4,0
36226805@N03,3223,27,1284947673,1284947768,4,4,95
36226805@N03,3223,15,1284948760,1284948760,1,4,0
36226805@N03,3223,23,1284947775,1284947994,3,4,219
36226805@N03,3224,27,1285306671,1285307343,3,5,672
36226805@N03,3224,25,1285306454,1285306471,2,5,17
36226805@N03,3224,16,1285306074,1285306074,1,5,0
36226805@N03,3224,13,1285304138,1285304657,7,5,519
36226805@N03,3224,18,1285303995,1285303995,1,5,0
36226805@N03,3225,24,1316420481,1316421205,4,14,724
36226805@N03,3225,19,1316414257,1316414257,1,14,0
36226805@N03,3225,27,1316421601,1316422432,2,14,831
36226805@N03,3225,3,1316409205,1316409205,1,14,0
36226805@N03,3225,25,1316421469,1316421469,1,14,0
36226805@N03,3225,2,1316406887,1316406922,2,14,35
36226805@N03,3225,4,1316409226,1316409226,1,14,0
36226805@N03,3225,16,1316401544,1316401544,1,14,0
36226805@N03,3225,18,1316416927,1316417183,7,14,256
36226805@N03,3225,21,1316418752,1316418752,1,14,0
36226805@N03,3225,17,1316421430,1316421430,1,14,0
36226805@N03,3225,1,1316409811,1316409851,2,14,40
36226805@N03,3225,22,1316414665,1316419699,6,14,5034
36226805@N03,3225,23,1316419167,1316419185,2,14,18
36226805@N03,3226,24,1316753137,1316753137,1,14,0
36226805@N03,3226,27,1316742968,1316755305,15,14,12337
36226805@N03,3226,4,1316743906,1316744043,4,14,137
36226805@N03,3226,6,1316745600,1316745600,1,14,0
36226805@N03,3226,25,1316743614,1316754985,2,14,11371
36226805@N03,3226,2,1316744232,1316745679,3,14,1447
36226805@N03,3226,16,1316755112,1316755112,1,14,0
36226805@N03,3226,18,1316750176,1316750186,2,14,10
36226805@N03,3226,5,1316744176,1316744179,2,14,3
36226805@N03,3226,15,1316748250,1316748269,2,14,19
36226805@N03,3226,9,1316747923,1316748102,5,14,179
36226805@N03,3226,26,1316752832,1316752832,1,14,0
36226805@N03,3226,12,1316743303,1316749683,16,14,6380
36226805@N03,3226,13,1316750986,1316752470,13,14,1484
36226805@N03,3227,9,1347255116,1347255334,3,11,218
36226805@N03,3227,3,1347258350,1347259216,5,11,866
36226805@N03,3227,27,1347247414,1347263505,5,11,16091
36226805@N03,3227,4,1347259777,1347260096,3,11,319
36226805@N03,3227,16,1347247769,1347247769,1,11,0
36226805@N03,3227,18,1347251453,1347251801,5,11,348
36226805@N03,3227,2,1347257589,1347257792,2,11,203
36226805@N03,3227,17,1347247776,1347251754,3,11,3978
36226805@N03,3227,5,1347259937,1347260232,3,11,295
36226805@N03,3227,19,1347251160,1347262494,5,11,11334
36226805@N03,3227,22,1347248287,1347248287,1,11,0
36226805@N03,3228,13,1347366647,1347366647,1,4,0
36226805@N03,3228,18,1347367879,1347367879,1,4,0
36226805@N03,3228,19,1347368082,1347368082,1,4,0
36226805@N03,3228,22,1347363543,1347363915,3,4,372
36226805@N03,3229,10,1378641219,1378641265,2,1,46
36226805@N03,3230,14,1378709825,1378709825,1,15,0
36226805@N03,3230,3,1378708535,1378708535,1,15,0
36226805@N03,3230,2,1378708920,1378708920,1,15,0
36226805@N03,3230,9,1378699283,1378707106,4,15,7823
36226805@N03,3230,1,1378709141,1378709207,2,15,66
36226805@N03,3230,19,1378703937,1378704020,3,15,83
36226805@N03,3230,10,1378695561,1378699614,18,15,4053
36226805@N03,3230,23,1378706496,1378706496,1,15,0
36226805@N03,3230,18,1378702951,1378704127,2,15,1176
36226805@N03,3230,6,1378708929,1378708929,1,15,0
36226805@N03,3230,27,1378694671,1378710079,3,15,15408
36226805@N03,3230,4,1378707272,1378707272,1,15,0
36226805@N03,3230,22,1378704898,1378705361,5,15,463
36226805@N03,3230,17,1378702507,1378702507,1,15,0
36226805@N03,3230,16,1378707182,1378709844,3,15,2662
36226805@N03,3231,18,1378813456,1378813746,4,6,290
36226805@N03,3231,13,1378813923,1378814177,8,6,254
36226805@N03,3231,19,1378815758,1378815758,1,6,0
36226805@N03,3231,22,1378813246,1378813908,11,6,662
36226805@N03,3231,27,1378818850,1378818857,2,6,7
36226805@N03,3231,16,1378807760,1378809868,7,6,2108
36226805@N03,3232,4,1378984063,1378984575,3,1,512
36231632@N00,3233,27,1432162653,1432162653,1,1,0
36283124@N05,3234,5,1292045502,1292045502,1,4,0
36283124@N05,3234,27,1292028590,1292049719,4,4,21129
36283124@N05,3234,4,1292050882,1292050882,1,4,0
36283124@N05,3234,17,1292036949,1292044828,2,4,7879
36330825967@N01,3235,14,1259295597,1259295597,1,2,0
36330825967@N01,3235,27,1259311574,1259311574,1,2,0
36330825967@N01,3236,4,1427664368,1427688961,7,1,24593
36372149@N00,3237,17,1330063692,1330063692,1,2,0
36372149@N00,3237,23,1330061828,1330061828,1,2,0
36450627@N08,3238,14,1279433945,1279433945,1,2,0
36450627@N08,3238,9,1279434068,1279434068,1,2,0
36476564@N05,3239,27,1338250312,1338250312,1,1,0
36476564@N05,3240,27,1379479948,1379479948,1,1,0
36476564@N05,3241,14,1402446992,1402446992,1,2,0
36476564@N05,3241,23,1402469789,1402469789,1,2,0
36488332@N07,3242,3,1296971829,1296971829,1,3,0
36488332@N07,3242,4,1296973641,1296973699,3,3,58
36488332@N07,3242,11,1296970207,1296970213,2,3,6
36488502@N03,3243,12,1355100806,1355100867,2,1,61
36488502@N03,3244,17,1355382813,1355382813,1,1,0
36521965978@N01,3245,1,1288651127,1288651127,1,4,0
36521965978@N01,3245,23,1288691937,1288691937,1,4,0
36521965978@N01,3245,2,1288656443,1288656443,1,4,0
36521965978@N01,3245,16,1288669539,1288669539,1,4,0
36606366@N00,3246,20,1380266864,1380266864,1,3,0
36606366@N00,3246,16,1380273133,1380273133,1,3,0
36606366@N00,3246,27,1380268816,1380268816,1,3,0
36607954@N05,3247,17,1246946673,1246946708,2,2,35
36607954@N05,3247,21,1246946221,1246946446,2,2,225
36675073@N02,3248,16,1249886626,1249886626,1,2,0
36675073@N02,3248,9,1249888406,1249888406,1,2,0
36675073@N02,3249,8,1250226167,1250226167,1,1,0
36675073@N02,3250,4,1250739485,1250743393,2,2,3908
36675073@N02,3250,17,1250753524,1250753524,1,2,0
36679705@N05,3251,14,1322049148,1322049148,1,1,0
36694655@N08,3252,15,1402309683,1402309683,1,1,0
36694655@N08,3253,27,1402354200,1402354200,1,2,0
36694655@N08,3253,14,1402354180,1402354180,1,2,0
36694655@N08,3254,27,1402631816,1402631816,1,7,0
36694655@N08,3254,15,1402648640,1402648640,1,7,0
36694655@N08,3254,11,1402647100,1402647100,1,7,0
36694655@N08,3254,20,1402638525,1402638525,1,7,0
36694655@N08,3254,2,1402631753,1402631753,1,7,0
36694655@N08,3254,14,1402638503,1402647114,2,7,8611
36694655@N08,3254,23,1402647085,1402647085,1,7,0
36702908@N05,3255,8,1421630193,1421630193,1,10,0
36702908@N05,3255,11,1421631972,1421631972,1,10,0
36702908@N05,3255,9,1421662220,1421662277,3,10,57
36702908@N05,3255,3,1421622775,1421623065,2,10,290
36702908@N05,3255,27,1421617562,1421657802,9,10,40240
36702908@N05,3255,18,1421636464,1421636495,4,10,31
36702908@N05,3255,17,1421626252,1421626252,1,10,0
36702908@N05,3255,14,1421633956,1421633960,2,10,4
36702908@N05,3255,4,1421661436,1421661436,1,10,0
36702908@N05,3255,25,1421660507,1421660507,1,10,0
36702908@N05,3256,9,1421906764,1421908863,3,8,2099
36702908@N05,3256,27,1421914240,1421914756,9,8,516
36702908@N05,3256,12,1421893151,1421893665,7,8,514
36702908@N05,3256,18,1421882757,1421883772,5,8,1015
36702908@N05,3256,15,1421893124,1421893124,1,8,0
36702908@N05,3256,14,1421910063,1421910065,2,8,2
36702908@N05,3256,7,1421906770,1421906770,1,8,0
36702908@N05,3256,19,1421883646,1421883646,1,8,0
36702908@N05,3257,17,1422515374,1422515374,1,3,0
36702908@N05,3257,14,1422489399,1422492209,2,3,2810
36702908@N05,3257,8,1422501338,1422501338,1,3,0
36735086@N07,3258,27,1252020721,1252021005,5,4,284
36735086@N07,3258,6,1252024008,1252024042,2,4,34
36735086@N07,3258,11,1252024379,1252024407,2,4,28
36735086@N07,3258,2,1252022188,1252022330,2,4,142
36735086@N07,3259,27,1252236664,1252243400,7,3,6736
36735086@N07,3259,24,1252237358,1252237392,2,3,34
36735086@N07,3259,26,1252239522,1252239613,3,3,91
36753534@N02,3260,4,1307142354,1307142354,1,2,0
36753534@N02,3260,1,1307143923,1307143923,1,2,0
36771701@N00,3261,4,1200794029,1200809135,3,3,15106
36771701@N00,3261,1,1200804582,1200804582,1,3,0
36771701@N00,3261,16,1200791645,1200791645,1,3,0
36776510@N03,3262,19,1293507252,1293507252,1,3,0
36776510@N03,3262,15,1293501261,1293501261,1,3,0
36776510@N03,3262,18,1293507522,1293507522,1,3,0
36801190@N00,3263,11,1357257313,1357257313,1,3,0
36801190@N00,3263,13,1357257392,1357257392,1,3,0
36801190@N00,3263,16,1357257271,1357257271,1,3,0
36819642@N00,3264,27,1200001379,1200002135,3,3,756
36819642@N00,3264,14,1200002696,1200002696,1,3,0
36819642@N00,3264,26,1200005767,1200005772,2,3,5
36819642@N00,3265,17,1200085290,1200085290,1,8,0
36819642@N00,3265,21,1200112381,1200112381,1,8,0
36819642@N00,3265,20,1200085535,1200085535,1,8,0
36819642@N00,3265,6,1200084993,1200084993,1,8,0
36819642@N00,3265,22,1200085461,1200085499,2,8,38
36819642@N00,3265,4,1200084927,1200084927,1,8,0
36819642@N00,3265,14,1200085149,1200085195,3,8,46
36819642@N00,3265,26,1200085385,1200085385,1,8,0
36864630@N00,3266,16,1370301302,1370301302,1,1,0
36895960@N00,3267,3,1422674863,1422674863,1,1,0
36895960@N00,3268,27,1423191070,1423191070,1,1,0
36911028@N00,3269,16,1332395422,1332395422,1,2,0
36911028@N00,3269,22,1332371971,1332371971,1,2,0
36911028@N00,3270,9,1410511919,1410511919,1,2,0
36911028@N00,3270,26,1410515415,1410515415,1,2,0
36916766@N08,3271,27,1261297432,1261297607,3,2,175
36916766@N08,3271,9,1261303765,1261303765,1,2,0
36916766@N08,3272,6,1274824238,1274824238,1,1,0
36916766@N08,3273,27,1276329531,1276329553,3,5,22
36916766@N08,3273,13,1276329477,1276329477,1,5,0
36916766@N08,3273,19,1276329485,1276329494,2,5,9
36916766@N08,3273,25,1276329446,1276329446,1,5,0
36916766@N08,3273,20,1276329455,1276329506,2,5,51
36916766@N08,3274,27,1279381244,1279381244,1,4,0
36916766@N08,3274,6,1279381473,1279381473,1,4,0
36916766@N08,3274,9,1279381476,1279381476,1,4,0
36916766@N08,3274,14,1279381469,1279381488,4,4,19
36916766@N08,3275,9,1361649691,1361649691,1,1,0
37046031@N00,3276,20,1225839915,1225840184,3,2,269
37046031@N00,3276,19,1225841823,1225841872,2,2,49
37063827@N02,3277,17,1355704015,1355730795,14,20,26780
37063827@N02,3277,19,1355703213,1355703293,2,20,80
37063827@N02,3277,8,1355711956,1355732516,3,20,20560
37063827@N02,3277,1,1355711500,1355732085,4,20,20585
37063827@N02,3277,16,1355726854,1355733731,13,20,6877
37063827@N02,3277,9,1355724682,1355732905,3,20,8223
37063827@N02,3277,20,1355703393,1355734750,2,20,31357
37063827@N02,3277,4,1355709675,1355731328,3,20,21653
37063827@N02,3277,2,1355709832,1355731487,3,20,21655
37063827@N02,3277,25,1355714673,1355715136,5,20,463
37063827@N02,3277,22,1355703644,1355719767,17,20,16123
37063827@N02,3277,21,1355715628,1355734622,4,20,18994
37063827@N02,3277,12,1355714305,1355714305,1,20,0
37063827@N02,3277,11,1355713439,1355727433,2,20,13994
37063827@N02,3277,14,1355712629,1355728613,4,20,15984
37063827@N02,3277,10,1355712904,1355727196,12,20,14292
37063827@N02,3277,23,1355715325,1355734403,4,20,19078
37063827@N02,3277,27,1355702186,1355740593,10,20,38407
37063827@N02,3277,7,1355712345,1355712345,1,20,0
37063827@N02,3277,5,1355720451,1355720451,1,20,0
37084963@N08,3278,14,1393481191,1393481191,1,1,0
37088822@N00,3279,25,1237007408,1237007408,1,10,0
37088822@N00,3279,1,1237021276,1237021310,7,10,34
37088822@N00,3279,13,1236986895,1236995072,17,10,8177
37088822@N00,3279,22,1236994490,1236994490,1,10,0
37088822@N00,3279,14,1236986491,1236986496,2,10,5
37088822@N00,3279,18,1236994152,1236995514,24,10,1362
37088822@N00,3279,27,1237007954,1237008139,8,10,185
37088822@N00,3279,19,1236994658,1236994778,13,10,120
37088822@N00,3279,16,1236986365,1236986397,5,10,32
37088822@N00,3279,17,1236995524,1236997362,94,10,1838
37095876@N02,3280,1,1366425641,1366425641,1,2,0
37095876@N02,3280,20,1366423835,1366427973,2,2,4138
37097738@N02,3281,20,1444358885,1444360374,3,4,1489
37097738@N02,3281,7,1444355979,1444356088,4,4,109
37097738@N02,3281,9,1444354290,1444354445,5,4,155
37097738@N02,3281,6,1444353567,1444353567,1,4,0
37097738@N02,3282,27,1450066775,1450080343,10,4,13568
37097738@N02,3282,9,1450076557,1450076557,1,4,0
37097738@N02,3282,14,1450079835,1450079835,1,4,0
37097738@N02,3282,17,1450076917,1450076949,2,4,32
37159320@N00,3283,16,1188729307,1188735055,5,1,5748
37159320@N00,3284,22,1274686403,1274686403,1,1,0
37159320@N00,3285,14,1345780476,1345780476,1,4,0
37159320@N00,3285,27,1345766213,1345766213,1,4,0
37159320@N00,3285,2,1345781468,1345781468,1,4,0
37159320@N00,3285,4,1345795025,1345795025,1,4,0
37159320@N00,3286,10,1359868946,1359868946,1,2,0
37159320@N00,3286,27,1359866587,1359866587,1,2,0
37159320@N00,3287,1,1360124429,1360124429,1,3,0
37159320@N00,3287,14,1360129841,1360129841,1,3,0
37159320@N00,3287,9,1360129238,1360129238,1,3,0
37159320@N00,3288,20,1360195369,1360195369,1,2,0
37159320@N00,3288,22,1360196195,1360196392,3,2,197
37159320@N00,3289,22,1360496470,1360496470,1,1,0
37159320@N00,3290,27,1379147949,1379161928,2,2,13979
37159320@N00,3290,17,1379150797,1379150797,1,2,0
37159320@N00,3291,19,1379418821,1379418821,1,8,0
37159320@N00,3291,13,1379408281,1379424463,5,8,16182
37159320@N00,3291,12,1379408702,1379408702,1,8,0
37159320@N00,3291,16,1379423398,1379423772,3,8,374
37159320@N00,3291,1,1379422340,1379422340,1,8,0
37159320@N00,3291,17,1379412893,1379414150,8,8,1257
37159320@N00,3291,8,1379422604,1379422604,1,8,0
37159320@N00,3291,27,1379402318,1379402551,3,8,233
37182874@N04,3292,27,1259109535,1259109535,1,1,0
37186095@N08,3293,24,1305958030,1305958030,1,5,0
37186095@N08,3293,1,1305983475,1305983475,1,5,0
37186095@N08,3293,27,1305954927,1305954927,1,5,0
37186095@N08,3293,2,1305983667,1305983667,1,5,0
37186095@N08,3293,23,1305958009,1305958009,1,5,0
37186095@N08,3294,9,1306369031,1306372129,4,5,3098
37186095@N08,3294,27,1306366022,1306366064,2,5,42
37186095@N08,3294,14,1306366767,1306372046,3,5,5279
37186095@N08,3294,16,1306366359,1306366359,1,5,0
37186095@N08,3294,12,1306368265,1306368265,1,5,0
37186095@N08,3295,4,1317375208,1317375208,1,2,0
37186095@N08,3295,21,1317386217,1317386382,3,2,165
37186095@N08,3296,27,1317422597,1317422965,2,2,368
37186095@N08,3296,16,1317427041,1317429296,3,2,2255
37186095@N08,3297,19,1317606805,1317606805,1,9,0
37186095@N08,3297,27,1317593851,1317593904,2,9,53
37186095@N08,3297,17,1317601211,1317603139,2,9,1928
37186095@N08,3297,15,1317601910,1317601910,1,9,0
37186095@N08,3297,3,1317637669,1317638689,5,9,1020
37186095@N08,3297,13,1317599939,1317599939,2,9,0
37186095@N08,3297,14,1317597198,1317597198,1,9,0
37186095@N08,3297,11,1317612038,1317612038,1,9,0
37186095@N08,3297,16,1317633504,1317646472,2,9,12968
37186095@N08,3298,17,1330465453,1330467400,3,7,1947
37186095@N08,3298,13,1330465444,1330465668,3,7,224
37186095@N08,3298,27,1330455048,1330473097,3,7,18049
37186095@N08,3298,14,1330456379,1330456379,1,7,0
37186095@N08,3298,16,1330456349,1330465071,2,7,8722
37186095@N08,3298,20,1330469158,1330469158,1,7,0
37186095@N08,3298,26,1330469404,1330469404,1,7,0
37186095@N08,3299,16,1330511322,1330511322,1,3,0
37186095@N08,3299,21,1330514707,1330514707,1,3,0
37186095@N08,3299,4,1330511175,1330511175,1,3,0
37196072@N07,3300,16,1239195282,1239195282,1,1,0
37216383@N05,3301,19,1336198106,1336198106,1,1,0
37216383@N05,3302,20,1338032931,1338032931,1,1,0
37216383@N05,3303,10,1351027918,1351028665,3,1,747
37216383@N05,3304,17,1354742959,1354742959,1,1,0
37216383@N05,3305,10,1358388688,1358388688,1,1,0
37216383@N05,3306,16,1362962519,1362962519,2,1,0
37216383@N05,3307,20,1385344740,1385344740,1,1,0
37233792@N08,3308,21,1305424015,1305424015,1,1,0
37242378@N02,3309,4,1245397861,1245397861,1,1,0
37274056@N05,3310,2,1295316609,1295316609,1,9,0
37274056@N05,3310,3,1295317242,1295317242,1,9,0
37274056@N05,3310,9,1295315304,1295315310,4,9,6
37274056@N05,3310,27,1295310755,1295310755,1,9,0
37274056@N05,3310,6,1295315287,1295326303,5,9,11016
37274056@N05,3310,8,1295325334,1295325393,2,9,59
37274056@N05,3310,11,1295326701,1295326977,8,9,276
37274056@N05,3310,14,1295313391,1295314539,11,9,1148
37274056@N05,3310,25,1295321514,1295321526,4,9,12
37274056@N05,3311,9,1371206933,1371207506,9,9,573
37274056@N05,3311,1,1371179252,1371179254,2,9,2
37274056@N05,3311,20,1371196586,1371198805,2,9,2219
37274056@N05,3311,27,1371172446,1371172457,2,9,11
37274056@N05,3311,10,1371206494,1371206844,10,9,350
37274056@N05,3311,6,1371178695,1371207234,3,9,28539
37274056@N05,3311,15,1371202420,1371202441,3,9,21
37274056@N05,3311,14,1371203558,1371203558,1,9,0
37274056@N05,3311,16,1371203549,1371203549,1,9,0
37274056@N05,3312,27,1403135337,1403173536,87,1,38199
37276158@N05,3313,20,1407648485,1407648485,1,1,0
37276158@N05,3314,20,1408797086,1408797086,1,1,0
37276158@N05,3315,17,1408862732,1408862732,1,1,0
37287420@N08,3316,4,1357297127,1357297599,2,3,472
37287420@N08,3316,20,1357291586,1357292621,15,3,1035
37287420@N08,3316,14,1357285089,1357285089,1,3,0
37318322@N05,3317,14,1413440323,1413440323,1,1,0
37324769@N06,3318,2,1255664280,1255664510,13,9,230
37324769@N06,3318,16,1255653027,1255678454,13,9,25427
37324769@N06,3318,13,1255660876,1255660879,2,9,3
37324769@N06,3318,14,1255653866,1255674952,19,9,21086
37324769@N06,3318,26,1255660052,1255660052,1,9,0
37324769@N06,3318,17,1255660362,1255660362,1,9,0
37324769@N06,3318,4,1255662280,1255662302,4,9,22
37324769@N06,3318,22,1255657168,1255657657,5,9,489
37324769@N06,3318,27,1255651520,1255679786,63,9,28266
37387065@N05,3319,15,1445302841,1445302841,1,1,0
37457246@N07,3320,27,1292760697,1292760697,1,1,0
37504803@N00,3321,17,1198820492,1198820492,1,4,0
37504803@N00,3321,20,1198808614,1198808720,2,4,106
37504803@N00,3321,26,1198820010,1198820010,1,4,0
37504803@N00,3321,22,1198819879,1198819879,1,4,0
37515566@N00,3322,27,1443605377,1443611997,3,1,6620
37541950@N08,3323,14,1285715899,1285715899,1,1,0
37541950@N08,3324,17,1286111396,1286111396,2,3,0
37541950@N08,3324,14,1286108024,1286108155,4,3,131
37541950@N08,3324,9,1286098254,1286098254,2,3,0
37553034@N03,3325,19,1254357701,1254357701,1,1,0
37553034@N03,3326,16,1254396744,1254397265,4,3,521
37553034@N03,3326,3,1254397082,1254397109,2,3,27
37553034@N03,3326,4,1254401582,1254401582,1,3,0
37553034@N03,3327,19,1254446707,1254446707,1,1,0
37553034@N03,3328,4,1255737290,1255737290,1,1,0
37553034@N03,3329,4,1280140114,1280140114,1,1,0
37553034@N03,3330,1,1286398732,1286398732,1,5,0
37553034@N03,3330,17,1286408135,1286408135,1,5,0
37553034@N03,3330,18,1286428815,1286428815,1,5,0
37553034@N03,3330,20,1286411307,1286411307,1,5,0
37553034@N03,3330,16,1286403861,1286435235,3,5,31374
37553034@N03,3331,14,1286674660,1286674660,1,1,0
37553034@N03,3332,23,1294282213,1294282213,1,4,0
37553034@N03,3332,27,1294290624,1294291261,3,4,637
37553034@N03,3332,16,1294290717,1294290717,1,4,0
37553034@N03,3332,25,1294282559,1294282559,1,4,0
37553034@N03,3333,20,1305749997,1305749997,1,1,0
37553034@N03,3334,20,1307053749,1307053749,1,1,0
37553034@N03,3335,18,1307094230,1307094230,1,1,0
37553034@N03,3336,19,1313889462,1313892878,2,5,3416
37553034@N03,3336,21,1313888124,1313888124,1,5,0
37553034@N03,3336,17,1313892156,1313892156,1,5,0
37553034@N03,3336,18,1313891894,1313891894,1,5,0
37553034@N03,3336,16,1313887615,1313887615,1,5,0
37553034@N03,3337,25,1314064095,1314064095,1,1,0
37553034@N03,3338,16,1315564707,1315564707,1,1,0
37553034@N03,3339,21,1317245851,1317245851,1,1,0
37553034@N03,3340,13,1317361965,1317361965,1,3,0
37553034@N03,3340,17,1317366735,1317366756,2,3,21
37553034@N03,3340,26,1317367956,1317367956,1,3,0
37553034@N03,3341,2,1322282531,1322282531,1,1,0
37553034@N03,3342,21,1322609808,1322609808,1,1,0
37553034@N03,3343,16,1322649228,1322649228,1,2,0
37553034@N03,3343,26,1322640599,1322640599,1,2,0
37553034@N03,3344,10,1352332824,1352332824,1,1,0
37585370@N00,3345,27,1263440132,1263440132,1,1,0
37585370@N00,3346,1,1263477478,1263477478,1,2,0
37585370@N00,3346,26,1263479826,1263479826,1,2,0
37595844@N08,3347,22,1286946836,1286957754,2,5,10918
37595844@N08,3347,14,1286935167,1286964748,2,5,29581
37595844@N08,3347,26,1286958749,1286958749,1,5,0
37595844@N08,3347,16,1286932411,1286935272,3,5,2861
37595844@N08,3347,17,1286958269,1286958269,1,5,0
37599879@N06,3348,22,1420159975,1420160007,2,1,32
37599879@N06,3349,27,1452640571,1452640571,1,1,0
37606273@N07,3350,6,1360833779,1360833779,1,2,0
37606273@N07,3350,9,1360828598,1360828598,1,2,0
37620552@N06,3351,10,1367893718,1367893718,1,2,0
37620552@N06,3351,14,1367894079,1367894079,1,2,0
37642540@N04,3352,10,1240455276,1240455276,1,1,0
37642540@N04,3353,3,1380280988,1380280988,1,1,0
37657436@N04,3354,20,1262303763,1262303763,1,2,0
37657436@N04,3354,16,1262297259,1262297259,1,2,0
37657436@N04,3355,16,1310194000,1310194072,4,3,72
37657436@N04,3355,18,1310173515,1310173555,2,3,40
37657436@N04,3355,19,1310173713,1310173713,1,3,0
37657436@N04,3356,27,1450573831,1450573831,1,4,0
37657436@N04,3356,3,1450565476,1450565519,2,4,43
37657436@N04,3356,20,1450567042,1450568198,2,4,1156
37657436@N04,3356,15,1450570318,1450570318,1,4,0
37657436@N04,3357,16,1461792719,1461793137,2,1,418
37657436@N04,3358,16,1461829239,1461829239,1,1,0
37663070@N03,3359,17,1216540439,1216540439,1,2,0
37663070@N03,3359,9,1216544958,1216544958,1,2,0
37668708@N05,3360,21,1240456527,1240456527,1,1,0
37668708@N05,3361,17,1243579223,1243579223,1,1,0
37681283@N00,3362,16,1298274320,1298274320,1,1,0
37709784@N00,3363,27,1239239937,1239239955,2,2,18
37709784@N00,3363,17,1239244283,1239244301,2,2,18
37728727@N06,3364,14,1270079296,1270082084,8,1,2788
37728727@N06,3365,14,1270293687,1270293720,2,1,33
37729827@N05,3366,22,1337744567,1337744836,4,1,269
37747991@N02,3367,8,1240806964,1240806964,1,4,0
37747991@N02,3367,27,1240792825,1240796061,7,4,3236
37747991@N02,3367,16,1240826133,1240826133,1,4,0
37747991@N02,3367,14,1240826140,1240826140,1,4,0
37747991@N02,3368,20,1240880813,1240880882,7,2,69
37747991@N02,3368,18,1240885051,1240885136,6,2,85
37775700@N02,3369,16,1265466358,1265466358,1,3,0
37775700@N02,3369,27,1265480730,1265480730,1,3,0
37775700@N02,3369,17,1265478134,1265478134,1,3,0
37775700@N02,3370,27,1274464908,1274465633,2,3,725
37775700@N02,3370,16,1274469179,1274469179,1,3,0
37775700@N02,3370,1,1274460551,1274460551,1,3,0
37775700@N02,3371,13,1304093915,1304093915,1,2,0
37775700@N02,3371,25,1304099215,1304099215,1,2,0
37869753@N06,3372,17,1312775745,1312775745,1,7,0
37869753@N06,3372,23,1312772630,1312772630,1,7,0
37869753@N06,3372,16,1312781724,1312781724,1,7,0
37869753@N06,3372,14,1312781589,1312781589,1,7,0
37869753@N06,3372,27,1312755015,1312755284,2,7,269
37869753@N06,3372,2,1312756786,1312758457,2,7,1671
37869753@N06,3372,26,1312772792,1312772792,1,7,0
37869753@N06,3373,16,1376782026,1376783025,18,2,999
37869753@N06,3373,27,1376767451,1376798385,6,2,30934
37908196@N07,3374,15,1329517949,1329517949,1,1,0
37908196@N07,3375,23,1355270162,1355270162,1,1,0
37925025@N08,3376,12,1287217022,1287217022,1,6,0
37925025@N08,3376,27,1287207965,1287228587,3,6,20622
37925025@N08,3376,4,1287224383,1287224383,1,6,0
37925025@N08,3376,17,1287209434,1287209434,1,6,0
37925025@N08,3376,1,1287219285,1287219285,1,6,0
37925025@N08,3376,2,1287219152,1287219152,1,6,0
37996583874@N01,3377,6,1377765330,1377765412,2,2,82
37996583874@N01,3377,14,1377745392,1377745392,1,2,0
37996583874@N01,3378,11,1378038927,1378038927,1,1,0
37996603748@N01,3379,9,1418166129,1418166129,1,6,0
37996603748@N01,3379,10,1418166329,1418166329,1,6,0
37996603748@N01,3379,27,1418165172,1418165172,1,6,0
37996603748@N01,3379,17,1418185456,1418185456,1,6,0
37996603748@N01,3379,20,1418174733,1418174733,1,6,0
37996603748@N01,3379,6,1418169556,1418169556,1,6,0
37996654902@N01,3380,4,1355640054,1355640075,4,3,21
37996654902@N01,3380,27,1355633383,1355633383,1,3,0
37996654902@N01,3380,10,1355635819,1355635819,1,3,0
37996654902@N01,3381,25,1355825312,1355825328,2,1,16
37998051@N00,3382,23,1278399135,1278399135,1,2,0
37998051@N00,3382,27,1278392325,1278392985,2,2,660
37998051@N00,3383,26,1278654709,1278654709,1,1,0
37998051@N00,3384,19,1309947485,1309947596,2,5,111
37998051@N00,3384,21,1309961217,1309961217,1,5,0
37998051@N00,3384,20,1309952131,1309952131,1,5,0
37998051@N00,3384,16,1309965324,1309965324,1,5,0
37998051@N00,3384,25,1309943495,1309943495,1,5,0
37998051@N00,3385,27,1334483424,1334483424,1,1,0
37998051@N00,3386,14,1387774107,1387774107,1,4,0
37998051@N00,3386,8,1387775446,1387775446,1,4,0
37998051@N00,3386,16,1387770243,1387770243,1,4,0
37998051@N00,3386,20,1387784642,1387784805,2,4,163
38012205@N05,3387,22,1305626087,1305626087,1,1,0
38022350@N04,3388,16,1241643374,1241643747,2,2,373
38022350@N04,3388,14,1241643916,1241643916,1,2,0
38025203@N00,3389,14,1355474765,1355474765,1,1,0
38025203@N00,3390,27,1355533186,1355533186,1,1,0
38067879@N08,3391,17,1323561786,1323561786,1,3,0
38067879@N08,3391,19,1323567175,1323567175,1,3,0
38067879@N08,3391,3,1323550656,1323550656,1,3,0
38067879@N08,3392,8,1348310325,1348310325,1,2,0
38067879@N08,3392,21,1348300028,1348301928,2,2,1900
38067879@N08,3393,14,1348398429,1348398429,1,4,0
38067879@N08,3393,13,1348371099,1348371099,1,4,0
38067879@N08,3393,18,1348368113,1348368113,1,4,0
38067879@N08,3393,16,1348398059,1348398059,1,4,0
38067879@N08,3394,13,1348443967,1348443967,1,1,0
38067879@N08,3395,15,1348567263,1348567263,1,1,0
38067879@N08,3396,16,1348899640,1348899640,1,1,0
38067879@N08,3397,24,1348985083,1348985083,1,3,0
38067879@N08,3397,19,1348989126,1348989126,1,3,0
38067879@N08,3397,27,1348983078,1348983078,1,3,0
38067879@N08,3398,13,1349266819,1349266819,1,1,0
38067879@N08,3399,8,1349324924,1349324924,1,1,0
38067879@N08,3400,15,1349413894,1349413894,1,1,0
38067879@N08,3401,21,1349486441,1349486441,1,1,0
38067879@N08,3402,16,1349639166,1349639166,1,1,0
38067879@N08,3403,15,1349898650,1349898650,1,1,0
38067879@N08,3404,14,1368354429,1368354429,1,2,0
38067879@N08,3404,9,1368360986,1368360986,1,2,0
38067879@N08,3405,20,1368431376,1368431376,1,1,0
38067879@N08,3406,13,1386911630,1386911630,1,1,0
38067879@N08,3407,14,1411722213,1411722213,1,2,0
38067879@N08,3407,27,1411724611,1411724611,1,2,0
38067879@N08,3408,3,1449717002,1449717002,1,1,0
38084526@N06,3409,22,1229486819,1229486819,1,1,0
38084526@N06,3410,4,1230191959,1230191959,1,3,0
38084526@N06,3410,13,1230197339,1230197339,1,3,0
38084526@N06,3410,17,1230196833,1230196833,1,3,0
38084526@N06,3411,16,1230274765,1230274765,1,5,0
38084526@N06,3411,27,1230280602,1230280602,1,5,0
38084526@N06,3411,5,1230276469,1230276469,1,5,0
38084526@N06,3411,9,1230275763,1230275763,1,5,0
38084526@N06,3411,14,1230275607,1230275636,2,5,29
38084526@N06,3412,15,1240279528,1240279528,1,2,0
38084526@N06,3412,26,1240268877,1240268877,1,2,0
38084526@N06,3413,14,1240309158,1240309158,1,1,0
38084526@N06,3414,5,1241243744,1241243744,1,1,0
38084526@N06,3415,1,1315263345,1315263345,1,1,0
38088964@N00,3416,13,1330375478,1330375478,1,1,0
38088964@N00,3417,2,1330425479,1330425479,1,1,0
38102706@N05,3418,6,1240046818,1240064190,4,1,17372
38102706@N05,3419,18,1253946509,1253968822,11,14,22313
38102706@N05,3419,1,1253944963,1253945530,14,14,567
38102706@N05,3419,7,1253952965,1253953992,5,14,1027
38102706@N05,3419,26,1253948310,1253948310,1,14,0
38102706@N05,3419,2,1253944264,1253945792,27,14,1528
38102706@N05,3419,27,1253963416,1253963531,5,14,115
38102706@N05,3419,14,1253946206,1253970853,30,14,24647
38102706@N05,3419,8,1253954042,1253954268,3,14,226
38102706@N05,3419,9,1253945850,1253945963,3,14,113
38102706@N05,3419,5,1253944202,1253945279,2,14,1077
38102706@N05,3419,17,1253946461,1253956521,2,14,10060
38102706@N05,3419,21,1253947692,1253947887,7,14,195
38102706@N05,3419,23,1253946915,1253946915,1,14,0
38102706@N05,3419,6,1253945824,1253945824,1,14,0
38102706@N05,3420,14,1254632030,1254632073,2,5,43
38102706@N05,3420,27,1254646403,1254647048,13,5,645
38102706@N05,3420,23,1254633101,1254636710,3,5,3609
38102706@N05,3420,2,1254631739,1254631739,1,5,0
38102706@N05,3420,9,1254631742,1254632340,8,5,598
38102706@N05,3421,1,1255506299,1255506408,4,7,109
38102706@N05,3421,5,1255504665,1255506832,23,7,2167
38102706@N05,3421,7,1255506437,1255506476,5,7,39
38102706@N05,3421,6,1255504291,1255506223,2,7,1932
38102706@N05,3421,15,1255503145,1255503145,1,7,0
38102706@N05,3421,2,1255506115,1255506638,5,7,523
38102706@N05,3421,9,1255504255,1255504255,1,7,0
38102706@N05,3422,2,1255936997,1255938870,7,3,1873
38102706@N05,3422,1,1255938857,1255938860,2,3,3
38102706@N05,3422,11,1255933787,1255933932,3,3,145
38102706@N05,3423,27,1256963943,1256975181,14,6,11238
38102706@N05,3423,18,1256965025,1256969153,10,6,4128
38102706@N05,3423,2,1256973099,1256973726,5,6,627
38102706@N05,3423,1,1256973276,1256973289,2,6,13
38102706@N05,3423,26,1256968860,1256968917,3,6,57
38102706@N05,3423,4,1256973558,1256973581,3,6,23
38102706@N05,3424,27,1257485947,1257502199,10,9,16252
38102706@N05,3424,14,1257493329,1257493449,2,9,120
38102706@N05,3424,17,1257494820,1257494820,1,9,0
38102706@N05,3424,24,1257495082,1257495132,2,9,50
38102706@N05,3424,6,1257493224,1257493224,1,9,0
38102706@N05,3424,18,1257494686,1257495000,2,9,314
38102706@N05,3424,25,1257495067,1257495067,1,9,0
38102706@N05,3424,2,1257492288,1257492441,3,9,153
38102706@N05,3424,9,1257492669,1257492865,5,9,196
38102706@N05,3425,27,1257748111,1257748216,3,5,105
38102706@N05,3425,1,1257749449,1257749460,2,5,11
38102706@N05,3425,5,1257752608,1257752608,1,5,0
38102706@N05,3425,3,1257749299,1257749299,1,5,0
38102706@N05,3425,2,1257748965,1257749227,3,5,262
38102706@N05,3426,5,1258187574,1258187665,6,10,91
38102706@N05,3426,3,1258182010,1258182010,1,10,0
38102706@N05,3426,27,1258179012,1258181158,22,10,2146
38102706@N05,3426,21,1258197495,1258198197,2,10,702
38102706@N05,3426,2,1258179610,1258190412,2,10,10802
38102706@N05,3426,24,1258197457,1258197457,1,10,0
38102706@N05,3426,7,1258189907,1258189907,1,10,0
38102706@N05,3426,25,1258197192,1258197192,1,10,0
38102706@N05,3426,1,1258179697,1258182324,15,10,2627
38102706@N05,3426,9,1258190598,1258190598,1,10,0
38102706@N05,3427,2,1258702740,1258702740,1,1,0
38102706@N05,3428,27,1260072924,1260073330,7,6,406
38102706@N05,3428,17,1260076798,1260077191,5,6,393
38102706@N05,3428,22,1260075286,1260076417,15,6,1131
38102706@N05,3428,24,1260082271,1260083557,5,6,1286
38102706@N05,3428,18,1260076234,1260081340,11,6,5106
38102706@N05,3428,26,1260076602,1260076602,1,6,0
38102706@N05,3429,27,1260936064,1260936492,16,10,428
38102706@N05,3429,5,1260948514,1260948514,1,10,0
38102706@N05,3429,25,1260944792,1260944899,5,10,107
38102706@N05,3429,24,1260944984,1260944984,1,10,0
38102706@N05,3429,3,1260941047,1260948263,7,10,7216
38102706@N05,3429,23,1260944912,1260944912,1,10,0
38102706@N05,3429,2,1260941109,1260941637,3,10,528
38102706@N05,3429,1,1260947348,1260947434,2,10,86
38102706@N05,3429,17,1260944232,1260944566,5,10,334
38102706@N05,3429,26,1260944685,1260944689,2,10,4
38102706@N05,3430,18,1261103143,1261104347,8,10,1204
38102706@N05,3430,2,1261100501,1261100555,2,10,54
38102706@N05,3430,25,1261106708,1261106708,1,10,0
38102706@N05,3430,9,1261100755,1261100904,6,10,149
38102706@N05,3430,27,1261099356,1261108394,41,10,9038
38102706@N05,3430,14,1261100940,1261101803,13,10,863
38102706@N05,3430,5,1261100367,1261100515,10,10,148
38102706@N05,3430,17,1261102773,1261104626,8,10,1853
38102706@N05,3430,24,1261106799,1261107009,3,10,210
38102706@N05,3430,6,1261100639,1261100647,2,10,8
38102706@N05,3431,2,1262328724,1262328724,1,5,0
38102706@N05,3431,16,1262331759,1262331786,3,5,27
38102706@N05,3431,7,1262324483,1262328418,6,5,3935
38102706@N05,3431,27,1262323620,1262323754,7,5,134
38102706@N05,3431,3,1262330938,1262330938,1,5,0
38102706@N05,3432,27,1262437593,1262438238,5,3,645
38102706@N05,3432,17,1262429509,1262429633,2,3,124
38102706@N05,3432,21,1262433901,1262433959,4,3,58
38102706@N05,3433,25,1263013230,1263013281,3,5,51
38102706@N05,3433,26,1263013341,1263013661,13,5,320
38102706@N05,3433,27,1263009962,1263012010,28,5,2048
38102706@N05,3433,14,1263016373,1263019789,10,5,3416
38102706@N05,3433,17,1263013467,1263013691,2,5,224
38102706@N05,3434,27,1263639362,1263639362,1,1,0
38102706@N05,3435,18,1263737228,1263741065,17,13,3837
38102706@N05,3435,22,1263739238,1263739886,9,13,648
38102706@N05,3435,9,1263730341,1263730341,1,13,0
38102706@N05,3435,16,1263729971,1263736600,3,13,6629
38102706@N05,3435,26,1263740582,1263740596,2,13,14
38102706@N05,3435,2,1263696067,1263730709,17,13,34642
38102706@N05,3435,17,1263694041,1263741247,10,13,47206
38102706@N05,3435,6,1263730290,1263730299,2,13,9
38102706@N05,3435,27,1263693101,1263741456,7,13,48355
38102706@N05,3435,14,1263731996,1263736882,8,13,4886
38102706@N05,3435,5,1263699697,1263730914,2,13,31217
38102706@N05,3435,24,1263737686,1263738302,21,13,616
38102706@N05,3435,21,1263738461,1263738532,2,13,71
38102706@N05,3436,22,1263974005,1263974005,1,6,0
38102706@N05,3436,25,1263976776,1263976776,1,6,0
38102706@N05,3436,9,1263978848,1263978932,5,6,84
38102706@N05,3436,27,1263950768,1263981490,11,6,30722
38102706@N05,3436,17,1263969529,1263969544,4,6,15
38102706@N05,3436,6,1263969973,1263969993,2,6,20
38102706@N05,3437,18,1264208351,1264216706,23,14,8355
38102706@N05,3437,11,1264225184,1264225254,2,14,70
38102706@N05,3437,1,1264200969,1264224183,3,14,23214
38102706@N05,3437,2,1264201097,1264222846,23,14,21749
38102706@N05,3437,3,1264201621,1264201621,1,14,0
38102706@N05,3437,26,1264208632,1264212145,2,14,3513
38102706@N05,3437,4,1264200778,1264207167,2,14,6389
38102706@N05,3437,7,1264224459,1264224472,2,14,13
38102706@N05,3437,27,1264198443,1264247256,19,14,48813
38102706@N05,3437,14,1264217202,1264226465,5,14,9263
38102706@N05,3437,8,1264224580,1264225337,9,14,757
38102706@N05,3437,17,1264208315,1264214654,4,14,6339
38102706@N05,3437,24,1264241566,1264243716,13,14,2150
38102706@N05,3437,6,1264225607,1264225607,1,14,0
38102706@N05,3438,18,1264916447,1264925331,4,15,8884
38102706@N05,3438,22,1264918631,1264920397,13,15,1766
38102706@N05,3438,25,1264919851,1264919851,1,15,0
38102706@N05,3438,1,1264915657,1264924055,8,15,8398
38102706@N05,3438,9,1264916059,1264916123,2,15,64
38102706@N05,3438,26,1264918159,1264919815,2,15,1656
38102706@N05,3438,2,1264915763,1264925168,10,15,9405
38102706@N05,3438,4,1264915592,1264915592,1,15,0
38102706@N05,3438,27,1264909401,1264931934,21,15,22533
38102706@N05,3438,14,1264916196,1264916258,3,15,62
38102706@N05,3438,17,1264916353,1264920851,2,15,4498
38102706@N05,3438,7,1264922991,1264922991,1,15,0
38102706@N05,3438,6,1264915859,1264923706,4,15,7847
38102706@N05,3438,23,1264918239,1264919695,5,15,1456
38102706@N05,3438,24,1264920479,1264920479,1,15,0
38102706@N05,3439,18,1266016869,1266016869,1,7,0
38102706@N05,3439,26,1266015743,1266015773,2,7,30
38102706@N05,3439,17,1266017215,1266018184,11,7,969
38102706@N05,3439,27,1266011327,1266011730,11,7,403
38102706@N05,3439,14,1266018266,1266019190,2,7,924
38102706@N05,3439,24,1266014399,1266014399,1,7,0
38102706@N05,3439,21,1266015254,1266015254,1,7,0
38102706@N05,3440,2,1266065237,1266065237,1,1,0
38102706@N05,3441,25,1266648022,1266648022,1,1,0
38102706@N05,3442,27,1266730022,1266730723,4,1,701
38102706@N05,3443,27,1267242066,1267242339,3,6,273
38102706@N05,3443,25,1267242949,1267242949,1,6,0
38102706@N05,3443,3,1267263967,1267263967,1,6,0
38102706@N05,3443,2,1267265123,1267265123,1,6,0
38102706@N05,3443,23,1267243105,1267243105,1,6,0
38102706@N05,3443,26,1267260157,1267260157,1,6,0
38102706@N05,3444,27,1267343774,1267343774,1,7,0
38102706@N05,3444,7,1267331703,1267331703,1,7,0
38102706@N05,3444,8,1267337349,1267337486,2,7,137
38102706@N05,3444,18,1267341580,1267341612,5,7,32
38102706@N05,3444,2,1267332392,1267332810,4,7,418
38102706@N05,3444,22,1267334682,1267334682,1,7,0
38102706@N05,3444,20,1267334185,1267334185,1,7,0
38102706@N05,3445,27,1268192233,1268193395,4,6,1162
38102706@N05,3445,5,1268196384,1268196384,1,6,0
38102706@N05,3445,17,1268198450,1268198450,1,6,0
38102706@N05,3445,18,1268198805,1268201430,7,6,2625
38102706@N05,3445,2,1268204528,1268204528,1,6,0
38102706@N05,3445,26,1268198597,1268199263,2,6,666
38102706@N05,3446,14,1271071711,1271071966,4,1,255
38102706@N05,3447,27,1274759852,1274773183,3,4,13331
38102706@N05,3447,14,1274771718,1274771949,4,4,231
38102706@N05,3447,18,1274765786,1274765786,1,4,0
38102706@N05,3447,17,1274763640,1274763640,1,4,0
38102706@N05,3448,17,1275573600,1275573600,2,1,0
38102706@N05,3449,27,1275643210,1275643210,1,5,0
38102706@N05,3449,5,1275639716,1275639716,1,5,0
38102706@N05,3449,17,1275632851,1275660000,7,5,27149
38102706@N05,3449,18,1275637424,1275660000,2,5,22576
38102706@N05,3449,26,1275641971,1275641971,1,5,0
38102706@N05,3450,16,1275718001,1275718045,2,5,44
38102706@N05,3450,24,1275712742,1275712742,1,5,0
38102706@N05,3450,27,1275720272,1275720272,1,5,0
38102706@N05,3450,17,1275736265,1275737730,33,5,1465
38102706@N05,3450,18,1275712747,1275715383,27,5,2636
38102706@N05,3451,27,1277557537,1277558411,6,1,874
38102706@N05,3452,14,1277713832,1277713832,1,5,0
38102706@N05,3452,16,1277713841,1277713841,1,5,0
38102706@N05,3452,17,1277719259,1277719259,1,5,0
38102706@N05,3452,21,1277709937,1277713149,5,5,3212
38102706@N05,3452,18,1277713684,1277713708,3,5,24
38102706@N05,3453,2,1286432120,1286432120,1,2,0
38102706@N05,3453,18,1286430393,1286431462,8,2,1069
38102706@N05,3454,27,1286950301,1286956683,2,2,6382
38102706@N05,3454,7,1286948104,1286948104,1,2,0
38102706@N05,3455,17,1291089137,1291089137,1,3,0
38102706@N05,3455,27,1291085815,1291091147,5,3,5332
38102706@N05,3455,18,1291089728,1291089728,1,3,0
38102706@N05,3456,16,1298457804,1298458773,2,1,969
38102706@N05,3457,17,1299320184,1299320184,1,1,0
38102706@N05,3458,9,1299482273,1299482273,1,4,0
38102706@N05,3458,27,1299484131,1299484161,2,4,30
38102706@N05,3458,17,1299482931,1299482931,1,4,0
38102706@N05,3458,22,1299483519,1299483639,2,4,120
38102706@N05,3459,9,1299727674,1299727674,1,3,0
38102706@N05,3459,27,1299726189,1299726189,1,3,0
38102706@N05,3459,14,1299727256,1299728322,5,3,1066
38102706@N05,3460,16,1306664728,1306664728,1,1,0
38102706@N05,3461,2,1309698846,1309698846,1,1,0
38102706@N05,3462,1,1320912066,1320912585,2,2,519
38102706@N05,3462,13,1320914463,1320914463,1,2,0
38102706@N05,3463,14,1325367677,1325367677,1,1,0
38102706@N05,3464,4,1326264373,1326264373,1,1,0
38102706@N05,3465,1,1328361447,1328361447,1,1,0
38102706@N05,3466,14,1331732178,1331732178,1,3,0
38102706@N05,3466,21,1331731320,1331731432,2,3,112
38102706@N05,3466,1,1331731908,1331731908,1,3,0
38102706@N05,3467,8,1332681475,1332681475,1,1,0
38102706@N05,3468,21,1335345837,1335345837,1,7,0
38102706@N05,3468,18,1335346506,1335346575,4,7,69
38102706@N05,3468,27,1335345293,1335358134,3,7,12841
38102706@N05,3468,25,1335345459,1335351160,3,7,5701
38102706@N05,3468,9,1335347684,1335349019,3,7,1335
38102706@N05,3468,15,1335346221,1335347661,2,7,1440
38102706@N05,3468,26,1335345828,1335345828,1,7,0
38102706@N05,3469,4,1335692851,1335692851,1,3,0
38102706@N05,3469,23,1335697202,1335697216,2,3,14
38102706@N05,3469,26,1335696601,1335696601,1,3,0
38102706@N05,3470,9,1338619815,1338619815,1,4,0
38102706@N05,3470,27,1338619401,1338629432,3,4,10031
38102706@N05,3470,14,1338619934,1338627323,7,4,7389
38102706@N05,3470,22,1338621881,1338621889,2,4,8
38102706@N05,3471,11,1343285294,1343285321,5,8,27
38102706@N05,3471,9,1343284987,1343285547,4,8,560
38102706@N05,3471,8,1343285210,1343285421,9,8,211
38102706@N05,3471,5,1343285742,1343285742,1,8,0
38102706@N05,3471,15,1343284816,1343284816,1,8,0
38102706@N05,3471,14,1343284881,1343284941,3,8,60
38102706@N05,3471,7,1343285117,1343285164,2,8,47
38102706@N05,3471,6,1343285597,1343285597,1,8,0
38102706@N05,3472,13,1344855232,1344855232,1,2,0
38102706@N05,3472,9,1344854629,1344854629,1,2,0
38102706@N05,3473,1,1345014973,1345014973,1,8,0
38102706@N05,3473,17,1345014280,1345014347,4,8,67
38102706@N05,3473,9,1345014742,1345014742,1,8,0
38102706@N05,3473,26,1345014197,1345014197,1,8,0
38102706@N05,3473,4,1345015988,1345015988,1,8,0
38102706@N05,3473,27,1345016930,1345016930,1,8,0
38102706@N05,3473,3,1345015690,1345015747,2,8,57
38102706@N05,3473,2,1345014950,1345015646,4,8,696
38102706@N05,3474,2,1345894240,1345894240,1,1,0
38102706@N05,3475,1,1346215647,1346215647,1,1,0
38102706@N05,3476,16,1352277867,1352277867,1,3,0
38102706@N05,3476,22,1352276430,1352276430,1,3,0
38102706@N05,3476,27,1352272907,1352272907,1,3,0
38102706@N05,3477,10,1352886160,1352886160,1,1,0
38102706@N05,3478,27,1358580617,1358580617,1,1,0
38102706@N05,3479,13,1362389485,1362389485,1,3,0
38102706@N05,3479,3,1362381460,1362381460,1,3,0
38102706@N05,3479,2,1362382026,1362382026,1,3,0
38102706@N05,3480,27,1367810035,1367810035,1,5,0
38102706@N05,3480,22,1367806170,1367806170,1,5,0
38102706@N05,3480,17,1367806418,1367806418,1,5,0
38102706@N05,3480,24,1367805831,1367805831,1,5,0
38102706@N05,3480,1,1367808156,1367808156,1,5,0
38102706@N05,3481,27,1372043255,1372043255,1,1,0
38102706@N05,3482,27,1383087106,1383087106,1,2,0
38102706@N05,3482,11,1383089017,1383089441,4,2,424
38102706@N05,3483,1,1391068549,1391068549,1,1,0
38102706@N05,3484,16,1393591050,1393591050,1,1,0
38102706@N05,3485,27,1395716192,1395718569,37,1,2377
38102706@N05,3486,13,1396949213,1396949213,1,1,0
38102706@N05,3487,14,1402143119,1402143119,1,1,0
38102706@N05,3488,3,1402379507,1402379507,1,1,0
38102706@N05,3489,27,1424763298,1424763298,1,1,0
38102706@N05,3490,14,1426415265,1426415265,1,1,0
38102706@N05,3491,25,1426559525,1426559525,1,1,0
38102706@N05,3492,13,1429441527,1429441527,1,2,0
38102706@N05,3492,2,1429439661,1429439661,1,2,0
38189211@N05,3493,27,1400109681,1400109792,2,1,111
38189211@N05,3494,19,1400210124,1400210124,1,2,0
38189211@N05,3494,4,1400238851,1400238851,1,2,0
38189526@N02,3495,27,1241013600,1241013600,1,2,0
38189526@N02,3495,23,1241013602,1241013602,1,2,0
38194020@N00,3496,20,1219724148,1219724169,4,1,21
38235069@N00,3497,27,1450600690,1450600698,2,1,8
38235069@N00,3498,20,1450668583,1450668594,2,7,11
38235069@N00,3498,25,1450679865,1450680433,20,7,568
38235069@N00,3498,23,1450679227,1450679352,8,7,125
38235069@N00,3498,22,1450669815,1450670932,18,7,1117
38235069@N00,3498,19,1450671720,1450676320,14,7,4600
38235069@N00,3498,26,1450679858,1450679858,1,7,0
38235069@N00,3498,8,1450664378,1450664472,3,7,94
38235069@N00,3499,14,1450774867,1450774961,7,1,94
38235069@N00,3500,17,1451888717,1451888729,3,2,12
38235069@N00,3500,16,1451889058,1451889058,1,2,0
38251487@N03,3501,14,1388037262,1388037262,1,2,0
38251487@N03,3501,10,1388033092,1388033092,1,2,0
38255616@N06,3502,16,1349108630,1349108630,1,1,0
38257984@N04,3503,13,1337045442,1337045442,1,1,0
38278420@N00,3504,14,1342708383,1342708383,1,1,0
38332815@N00,3505,19,1263272517,1263274177,2,2,1660
38332815@N00,3505,27,1263253951,1263253951,1,2,0
38376245@N00,3506,3,1338424228,1338424228,1,2,0
38376245@N00,3506,27,1338436428,1338436428,1,2,0
38376245@N04,3507,17,1356990732,1356990732,1,1,0
38376245@N04,3508,15,1357532373,1357532373,1,1,0
38376245@N04,3509,4,1369557759,1369557759,1,1,0
38421387@N04,3510,14,1397186946,1397186946,1,3,0
38421387@N04,3510,16,1397198031,1397198035,2,3,4
38421387@N04,3510,9,1397202152,1397202152,1,3,0
38443862@N04,3511,16,1236502914,1236502914,1,1,0
38484710@N00,3512,17,1204781600,1204781600,1,3,0
38484710@N00,3512,20,1204783798,1204783798,1,3,0
38484710@N00,3512,27,1204781421,1204781421,1,3,0
38484710@N00,3513,5,1204872625,1204872625,1,7,0
38484710@N00,3513,20,1204868019,1204868019,1,7,0
38484710@N00,3513,1,1204870961,1204870961,1,7,0
38484710@N00,3513,16,1204859970,1204859970,1,7,0
38484710@N00,3513,3,1204871797,1204871797,1,7,0
38484710@N00,3513,18,1204866182,1204867006,3,7,824
38484710@N00,3513,4,1204872390,1204872578,3,7,188
38492497@N02,3514,21,1395442289,1395442289,1,1,0
38505413@N06,3515,27,1322372156,1322372156,1,1,0
38505413@N06,3516,14,1322570356,1322570356,1,1,0
38505413@N06,3517,4,1323844497,1323844497,1,1,0
38564190@N00,3518,27,1427272250,1427272250,1,1,0
38604142@N08,3519,4,1317866468,1317866468,1,1,0
38604142@N08,3520,4,1339644865,1339644865,1,1,0
38705054@N07,3521,27,1251356414,1251356414,1,1,0
38719482@N03,3522,17,1417644341,1417644341,1,1,0
38773853@N06,3523,22,1342961676,1342961676,1,1,0
38789043@N02,3524,19,1347083248,1347083268,2,4,20
38789043@N02,3524,7,1347071421,1347071834,2,4,413
38789043@N02,3524,8,1347071831,1347071831,1,4,0
38789043@N02,3524,24,1347083235,1347083235,1,4,0
38789043@N02,3525,17,1354420702,1354420702,1,1,0
38789043@N02,3526,3,1368941281,1368941293,2,8,12
38789043@N02,3526,21,1368930543,1368930566,4,8,23
38789043@N02,3526,6,1368943239,1368945117,5,8,1878
38789043@N02,3526,17,1368932205,1368936816,4,8,4611
38789043@N02,3526,26,1368936779,1368936779,1,8,0
38789043@N02,3526,18,1368919422,1368919428,5,8,6
38789043@N02,3526,20,1368918996,1368927837,25,8,8841
38789043@N02,3526,19,1368920245,1368920458,31,8,213
38794272@N04,3527,27,1321263222,1321276014,24,1,12792
38848642@N00,3528,17,1218192164,1218196699,8,1,4535
38848642@N00,3529,14,1255742985,1255746725,6,3,3740
38848642@N00,3529,4,1255761983,1255761983,1,3,0
38848642@N00,3529,27,1255742722,1255763386,15,3,20664
38848642@N00,3530,14,1256442279,1256442922,8,1,643
38848642@N00,3531,22,1275469409,1275469409,1,2,0
38848642@N00,3531,26,1275464213,1275464213,1,2,0
38848642@N00,3532,20,1281339136,1281339136,1,1,0
38848642@N00,3533,27,1408409969,1408409969,1,1,0
38879474@N04,3534,19,1259359179,1259359179,1,1,0
38879474@N04,3535,24,1318067953,1318067953,1,2,0
38879474@N04,3535,13,1318064280,1318064280,1,2,0
38879474@N04,3536,4,1351215096,1351215096,1,1,0
39015228@N04,3537,19,1432735200,1432735200,1,1,0
39024895@N00,3538,22,1309416897,1309416944,8,7,47
39024895@N00,3538,14,1309419526,1309419555,3,7,29
39024895@N00,3538,16,1309419342,1309419427,4,7,85
39024895@N00,3538,4,1309420077,1309425797,11,7,5720
39024895@N00,3538,20,1309416775,1309416850,5,7,75
39024895@N00,3538,5,1309420019,1309420041,3,7,22
39024895@N00,3538,15,1309419212,1309419314,12,7,102
39024895@N00,3539,17,1309503363,1309503365,2,3,2
39024895@N00,3539,16,1309503136,1309503173,5,3,37
39024895@N00,3539,18,1309503457,1309503610,4,3,153
39024895@N00,3540,25,1309555459,1309558151,16,1,2692
39052554@N00,3541,26,1396749784,1396749784,1,1,0
39073297@N04,3542,18,1426278618,1426278618,1,1,0
39078602@N04,3543,14,1464566891,1464566891,1,1,0
39078602@N04,3544,25,1464599371,1464600915,6,2,1544
39078602@N04,3544,14,1464596760,1464596760,1,2,0
39104390@N07,3545,22,1285308949,1285308994,2,1,45
39134511@N06,3546,27,1302231780,1302231780,1,2,0
39134511@N06,3546,4,1302236493,1302236493,1,2,0
39146060@N00,3547,2,1188100267,1188100736,2,10,469
39146060@N00,3547,1,1188098694,1188098694,1,10,0
39146060@N00,3547,16,1188082524,1188082642,4,10,118
39146060@N00,3547,21,1188101952,1188103950,2,10,1998
39146060@N00,3547,23,1188101772,1188101772,2,10,0
39146060@N00,3547,13,1188086044,1188086044,1,10,0
39146060@N00,3547,27,1188080542,1188080542,1,10,0
39146060@N00,3547,19,1188087666,1188089882,6,10,2216
39146060@N00,3547,17,1188092678,1188094162,2,10,1484
39146060@N00,3547,22,1188090762,1188090762,1,10,0
39146060@N00,3548,20,1190330706,1190330706,1,9,0
39146060@N00,3548,23,1190333420,1190333956,2,9,536
39146060@N00,3548,18,1190328696,1190328704,2,9,8
39146060@N00,3548,13,1190326678,1190327174,2,9,496
39146060@N00,3548,27,1190325530,1190342844,8,9,17314
39146060@N00,3548,4,1190342114,1190342240,3,9,126
39146060@N00,3548,19,1190329282,1190329282,2,9,0
39146060@N00,3548,26,1190335062,1190335272,3,9,210
39146060@N00,3548,15,1190335414,1190335414,1,9,0
39146060@N00,3549,1,1190540474,1190540474,1,2,0
39146060@N00,3549,3,1190540500,1190540500,1,2,0
39146060@N00,3550,18,1190686794,1190693284,2,7,6490
39146060@N00,3550,22,1190691082,1190691082,1,7,0
39146060@N00,3550,14,1190695200,1190695200,1,7,0
39146060@N00,3550,16,1190685140,1190698838,4,7,13698
39146060@N00,3550,15,1190695104,1190695120,2,7,16
39146060@N00,3550,19,1190688938,1190689826,3,7,888
39146060@N00,3550,27,1190684076,1190698990,4,7,14914
39146060@N00,3551,19,1190942532,1190942764,3,5,232
39146060@N00,3551,18,1190942514,1190942514,1,5,0
39146060@N00,3551,17,1190939910,1190942398,3,5,2488
39146060@N00,3551,13,1190942008,1190942008,1,5,0
39146060@N00,3551,27,1190939118,1190951604,4,5,12486
39146060@N00,3552,17,1191134588,1191146524,2,5,11936
39146060@N00,3552,18,1191136554,1191136814,2,5,260
39146060@N00,3552,13,1191135832,1191137052,7,5,1220
39146060@N00,3552,27,1191133998,1191150498,3,5,16500
39146060@N00,3552,16,1191141958,1191142940,2,5,982
39146060@N00,3553,13,1192266418,1192266494,4,5,76
39146060@N00,3553,2,1192266499,1192266502,2,5,3
39146060@N00,3553,27,1192266366,1192266474,4,5,108
39146060@N00,3553,26,1192266389,1192266389,1,5,0
39146060@N00,3553,1,1192266505,1192266531,6,5,26
39146060@N00,3554,20,1223111966,1223111966,1,11,0
39146060@N00,3554,18,1223111970,1223111970,1,11,0
39146060@N00,3554,14,1223126816,1223126816,1,11,0
39146060@N00,3554,9,1223111964,1223111964,1,11,0
39146060@N00,3554,3,1223111975,1223111977,2,11,2
39146060@N00,3554,2,1223111978,1223111979,2,11,1
39146060@N00,3554,13,1223111972,1223111972,1,11,0
39146060@N00,3554,27,1223111957,1223126810,2,11,14853
39146060@N00,3554,4,1223111974,1223126820,2,11,14846
39146060@N00,3554,26,1223111968,1223111968,1,11,0
39146060@N00,3554,1,1223111981,1223111985,4,11,4
39146060@N00,3555,19,1228819271,1228820131,4,5,860
39146060@N00,3555,12,1228816621,1228816621,1,5,0
39146060@N00,3555,1,1228812342,1228812342,1,5,0
39146060@N00,3555,13,1228816783,1228817805,12,5,1022
39146060@N00,3555,27,1228809515,1228809999,5,5,484
39146060@N00,3556,19,1229159247,1229160692,7,6,1445
39146060@N00,3556,3,1229174044,1229175074,6,6,1030
39146060@N00,3556,20,1229161078,1229161078,1,6,0
39146060@N00,3556,23,1229164724,1229164724,1,6,0
39146060@N00,3556,24,1229164053,1229164552,4,6,499
39146060@N00,3556,27,1229158330,1229158330,1,6,0
39146060@N00,3557,5,1229287805,1229287805,1,3,0
39146060@N00,3557,1,1229289430,1229289725,2,3,295
39146060@N00,3557,16,1229290144,1229290144,1,3,0
39146060@N00,3558,17,1255520142,1255522002,4,1,1860
39146060@N00,3559,17,1255565368,1255567784,6,1,2416
39146060@N00,3560,13,1262092455,1262092455,1,8,0
39146060@N00,3560,27,1262092390,1262092390,1,8,0
39146060@N00,3560,20,1262092404,1262092404,1,8,0
39146060@N00,3560,16,1262092449,1262092449,1,8,0
39146060@N00,3560,4,1262092424,1262092424,1,8,0
39146060@N00,3560,19,1262092398,1262092398,1,8,0
39146060@N00,3560,26,1262092422,1262092422,1,8,0
39146060@N00,3560,17,1262092460,1262092460,1,8,0
39146060@N00,3561,13,1311248884,1311248884,1,1,0
39146060@N00,3562,13,1311562808,1311562808,1,3,0
39146060@N00,3562,18,1311552475,1311552475,1,3,0
39146060@N00,3562,17,1311563288,1311563288,1,3,0
39156069@N03,3563,7,1451358383,1451359845,4,5,1462
39156069@N03,3563,6,1451356340,1451356340,1,5,0
39156069@N03,3563,8,1451361199,1451361199,1,5,0
39156069@N03,3563,15,1451364039,1451364122,4,5,83
39156069@N03,3563,9,1451375738,1451375738,1,5,0
39156069@N03,3564,17,1451468031,1451468031,1,2,0
39156069@N03,3564,27,1451467302,1451467302,1,2,0
39179826@N04,3565,27,1255436329,1255436329,1,3,0
39179826@N04,3565,15,1255434468,1255434468,1,3,0
39179826@N04,3565,4,1255433153,1255433153,1,3,0
39179826@N04,3566,17,1255481336,1255481336,1,2,0
39179826@N04,3566,18,1255472004,1255472007,2,2,3
39179826@N04,3567,16,1258343042,1258343042,1,1,0
39179826@N04,3568,14,1259707893,1259707893,1,1,0
39179826@N04,3569,13,1265155757,1265155757,1,1,0
39179826@N04,3570,21,1302588747,1302588747,1,1,0
39179826@N04,3571,14,1350757236,1350757236,1,1,0
39179826@N04,3572,13,1413839661,1413839661,1,1,0
39179826@N04,3573,16,1413951490,1413951490,1,1,0
39179826@N04,3574,2,1416986406,1416986406,1,1,0
39179826@N04,3575,13,1419408235,1419408235,1,1,0
39188842@N06,3576,11,1244276300,1244276300,1,2,0
39188842@N06,3576,16,1244276315,1244276315,1,2,0
39198272@N04,3577,8,1400384094,1400384094,1,2,0
39198272@N04,3577,3,1400370350,1400370350,1,2,0
39285097@N02,3578,27,1414711535,1414727379,9,2,15844
39285097@N02,3578,22,1414714100,1414714100,1,2,0
39312075@N06,3579,15,1279892257,1279892257,1,1,0
39312075@N06,3580,27,1319193139,1319193139,1,1,0
39333522@N03,3581,25,1355002557,1355002557,1,1,0
39360988@N05,3582,14,1274088517,1274088517,1,1,0
39360988@N05,3583,27,1300274199,1300274199,1,1,0
39360988@N05,3584,16,1300307928,1300310028,2,2,2100
39360988@N05,3584,27,1300309188,1300309188,1,2,0
39360988@N05,3585,21,1300435755,1300435755,1,1,0
39360988@N05,3586,27,1322772356,1322772356,1,1,0
39360988@N05,3587,15,1354401242,1354401242,1,1,0
39364877@N05,3588,1,1264982338,1264982338,1,1,0
39364877@N05,3589,27,1391064559,1391064559,1,1,0
39403274@N00,3590,4,1255471880,1255471905,2,1,25
39403274@N00,3591,27,1255780018,1255780018,1,1,0
39404976@N03,3592,23,1320533604,1320533604,1,1,0
39414936@N05,3593,27,1267157371,1267157371,1,1,0
39444366@N06,3594,27,1262134787,1262134787,1,2,0
39444366@N06,3594,9,1262134800,1262134800,1,2,0
39444366@N06,3595,27,1316864142,1316864142,1,1,0
39444366@N06,3596,13,1329132068,1329132068,1,1,0
39444366@N06,3597,27,1330500918,1330500918,1,1,0
39444366@N06,3598,15,1334374054,1334374054,1,2,0
39444366@N06,3598,9,1334374049,1334374049,1,2,0
39444366@N06,3599,10,1358037820,1358037820,1,1,0
39454436@N00,3600,6,1330888947,1330888947,1,3,0
39454436@N00,3600,15,1330888804,1330888804,1,3,0
39454436@N00,3600,16,1330888686,1330888686,1,3,0
39478938@N03,3601,5,1231379245,1231379245,1,2,0
39478938@N03,3601,2,1231379275,1231379275,1,2,0
39487324@N08,3602,18,1335222664,1335222664,1,1,0
39487324@N08,3603,16,1335260796,1335260796,1,1,0
39490385@N08,3604,24,1371507250,1371507250,1,2,0
39490385@N08,3604,1,1371530069,1371530069,1,2,0
39491066@N02,3605,27,1396836162,1396836162,1,1,0
39527581@N07,3606,21,1194555823,1194577238,2,1,21415
39530849@N02,3607,10,1246640784,1246640784,1,1,0
39607403@N04,3608,16,1195782738,1195782738,1,1,0
39648663@N07,3609,16,1326238520,1326238520,1,1,0
39707801@N00,3610,16,1195278421,1195278421,1,3,0
39707801@N00,3610,13,1195285008,1195285806,2,3,798
39707801@N00,3610,14,1195272369,1195283552,10,3,11183
39707801@N00,3611,22,1195341023,1195350239,5,1,9216
39707801@N00,3612,27,1195438194,1195439029,9,1,835
39707801@N00,3613,14,1196299249,1196299249,1,3,0
39707801@N00,3613,13,1196305574,1196305574,1,3,0
39707801@N00,3613,27,1196306961,1196306961,1,3,0
39769363@N06,3614,12,1296699908,1296699908,1,1,0
39864275@N02,3615,27,1417519330,1417519330,1,2,0
39864275@N02,3615,4,1417517040,1417517073,4,2,33
39893757@N00,3616,16,1314957158,1314957158,1,1,0
39893757@N00,3617,27,1409720437,1409720437,1,3,0
39893757@N00,3617,14,1409720446,1409720446,1,3,0
39893757@N00,3617,3,1409720302,1409720302,1,3,0
39894601@N00,3618,25,1198889310,1198891775,4,1,2465
39894601@N00,3619,27,1199152540,1199152540,1,2,0
39894601@N00,3619,21,1199153541,1199158353,5,2,4812
39909510@N07,3620,9,1232935672,1232935672,2,2,0
39909510@N07,3620,2,1232935677,1232935677,2,2,0
39909510@N07,3621,14,1233282138,1233282147,2,2,9
39909510@N07,3621,9,1233282101,1233282119,6,2,18
39925495@N00,3622,22,1260841543,1260841543,1,1,0
39925495@N00,3623,23,1260916640,1260916640,1,1,0
39925495@N00,3624,3,1356958800,1356958800,1,1,0
39953677@N06,3625,2,1348399876,1348399876,1,3,0
39953677@N06,3625,6,1348404790,1348404790,1,3,0
39953677@N06,3625,24,1348397506,1348397506,1,3,0
40021579@N00,3626,3,1375510887,1375510887,1,1,0
40041746@N00,3627,18,1382055637,1382057037,11,1,1400
40048950@N04,3628,19,1338106832,1338106832,1,1,0
40048950@N04,3629,27,1367894630,1367894630,1,1,0
40065817@N02,3630,27,1412311858,1412311858,1,1,0
40067478@N00,3631,7,1376638278,1376638278,1,1,0
40072693@N04,3632,5,1293228436,1293228436,1,4,0
40072693@N04,3632,4,1293228417,1293228417,1,4,0
40072693@N04,3632,1,1293231763,1293231763,1,4,0
40072693@N04,3632,27,1293227191,1293227191,1,4,0
40081977@N06,3633,27,1373503385,1373547347,14,3,43962
40081977@N06,3633,15,1373553487,1373553487,1,3,0
40081977@N06,3633,11,1373553308,1373553308,1,3,0
40081977@N06,3634,10,1373642889,1373642889,1,1,0
40089707@N00,3635,27,1219801673,1219801694,4,2,21
40089707@N00,3635,26,1219817403,1219817403,2,2,0
40165694@N03,3636,22,1360159311,1360159311,1,1,0
40170821@N06,3637,16,1188442313,1188442313,1,1,0
40170821@N06,3638,9,1249513134,1249513134,1,1,0
40170821@N06,3639,21,1345802580,1345802580,1,2,0
40170821@N06,3639,27,1345799420,1345814397,2,2,14977
40170821@N06,3640,22,1408698803,1408698803,1,2,0
40170821@N06,3640,20,1408698000,1408698000,1,2,0
40172365@N00,3641,26,1337820910,1337820910,1,1,0
40209760@N07,3642,16,1190806946,1190806946,1,1,0
40262057@N06,3643,3,1236739107,1236739107,1,11,0
40262057@N06,3643,6,1236738585,1236738585,1,11,0
40262057@N06,3643,1,1236726378,1236739366,5,11,12988
40262057@N06,3643,22,1236728609,1236733806,15,11,5197
40262057@N06,3643,12,1236743788,1236743788,1,11,0
40262057@N06,3643,16,1236727073,1236745101,5,11,18028
40262057@N06,3643,21,1236728849,1236730104,4,11,1255
40262057@N06,3643,13,1236727338,1236728263,9,11,925
40262057@N06,3643,9,1236743007,1236743007,1,11,0
40262057@N06,3643,27,1236725265,1236725270,2,11,5
40262057@N06,3643,2,1236736455,1236738691,8,11,2236
40262057@N06,3644,6,1236814286,1236814397,2,6,111
40262057@N06,3644,1,1236814627,1236814627,1,6,0
40262057@N06,3644,16,1236812751,1236812751,1,6,0
40262057@N06,3644,14,1236812697,1236812697,1,6,0
40262057@N06,3644,20,1236815616,1236815616,1,6,0
40262057@N06,3644,25,1236808398,1236808398,1,6,0
40262057@N06,3645,20,1236901764,1236901801,3,4,37
40262057@N06,3645,14,1236914048,1236914048,1,4,0
40262057@N06,3645,16,1236913449,1236914138,16,4,689
40262057@N06,3645,13,1236905477,1236905483,3,4,6
40262057@N06,3646,16,1354955893,1354965556,9,1,9663
40262057@N06,3647,16,1355049601,1355050026,13,1,425
40262057@N06,3648,17,1355097900,1355100096,2,2,2196
40262057@N06,3648,13,1355101587,1355101590,2,2,3
40279984@N00,3649,1,1395782709,1395782709,1,12,0
40279984@N00,3649,14,1395792064,1395808117,4,12,16053
40279984@N00,3649,6,1395782341,1395782341,1,12,0
40279984@N00,3649,15,1395802190,1395804525,3,12,2335
40279984@N00,3649,2,1395782231,1395784747,4,12,2516
40279984@N00,3649,26,1395806056,1395806056,1,12,0
40279984@N00,3649,17,1395789869,1395814428,9,12,24559
40279984@N00,3649,18,1395804722,1395804722,1,12,0
40279984@N00,3649,9,1395818389,1395818389,1,12,0
40279984@N00,3649,3,1395782828,1395782828,1,12,0
40279984@N00,3649,4,1395782275,1395800577,3,12,18302
40279984@N00,3649,16,1395807965,1395807965,1,12,0
40282793@N05,3650,27,1296175170,1296175170,1,1,0
40291653@N08,3651,16,1292495751,1292495751,1,1,0
40291653@N08,3652,27,1298767420,1298767420,1,1,0
40291653@N08,3653,1,1331510590,1331510590,1,1,0
40303166@N06,3654,4,1288092357,1288092357,1,3,0
40303166@N06,3654,13,1288074934,1288074934,1,3,0
40303166@N06,3654,22,1288071983,1288071983,1,3,0
40303166@N06,3655,16,1288600291,1288600934,10,12,643
40303166@N06,3655,20,1288606404,1288606404,1,12,0
40303166@N06,3655,14,1288604275,1288604384,2,12,109
40303166@N06,3655,4,1288601559,1288601559,1,12,0
40303166@N06,3655,25,1288609192,1288609192,1,12,0
40303166@N06,3655,9,1288604082,1288604082,1,12,0
40303166@N06,3655,1,1288602764,1288602764,1,12,0
40303166@N06,3655,15,1288604847,1288604866,2,12,19
40303166@N06,3655,17,1288605450,1288609691,2,12,4241
40303166@N06,3655,21,1288608718,1288608718,1,12,0
40303166@N06,3655,13,1288605145,1288605257,2,12,112
40303166@N06,3655,27,1288591999,1288611638,11,12,19639
40303166@N06,3656,15,1289215333,1289215333,1,4,0
40303166@N06,3656,17,1289210103,1289217504,6,4,7401
40303166@N06,3656,16,1289208135,1289209347,12,4,1212
40303166@N06,3656,27,1289207235,1289220290,5,4,13055
40303166@N06,3657,27,1289372721,1289373730,11,1,1009
40362134@N07,3658,17,1317428680,1317428680,1,8,0
40362134@N07,3658,9,1317437240,1317437240,1,8,0
40362134@N07,3658,25,1317432641,1317432641,1,8,0
40362134@N07,3658,16,1317437163,1317437195,2,8,32
40362134@N07,3658,27,1317424527,1317425478,3,8,951
40362134@N07,3658,24,1317431333,1317432701,2,8,1368
40362134@N07,3658,18,1317430123,1317430123,1,8,0
40362134@N07,3658,15,1317436988,1317437038,2,8,50
40362134@N07,3659,27,1403246305,1403254370,13,1,8065
40416743@N00,3660,16,1293448238,1293448238,1,1,0
40437944@N00,3661,27,1389383697,1389385572,2,1,1875
40437944@N00,3662,10,1389523415,1389523415,1,1,0
40472186@N08,3663,1,1261278329,1261278329,1,1,0
40472186@N08,3664,1,1261382471,1261382471,1,1,0
40472186@N08,3665,1,1261429635,1261436752,4,1,7117
40482053@N07,3666,14,1269632556,1269632556,1,1,0
40482053@N07,3667,27,1363218545,1363218545,1,1,0
40482053@N07,3668,27,1363248699,1363248699,1,1,0
40531740@N08,3669,17,1371178207,1371178207,1,1,0
40531740@N08,3670,5,1371297798,1371297798,1,2,0
40531740@N08,3670,4,1371298306,1371298306,1,2,0
40549771@N07,3671,16,1432565310,1432565310,1,1,0
40563308@N02,3672,15,1312577051,1312577051,1,1,0
40571088@N00,3673,13,1463712881,1463714534,8,9,1653
40571088@N00,3673,17,1463709756,1463720767,17,9,11011
40571088@N00,3673,1,1463717864,1463717953,2,9,89
40571088@N00,3673,15,1463707318,1463707701,5,9,383
40571088@N00,3673,12,1463708272,1463709158,23,9,886
40571088@N00,3673,26,1463739117,1463739631,5,9,514
40571088@N00,3673,20,1463739185,1463741697,6,9,2512
40571088@N00,3673,27,1463705652,1463746963,60,9,41311
40571088@N00,3673,23,1463738804,1463738842,3,9,38
40584328@N00,3674,19,1423359289,1423359289,1,1,0
40598203@N08,3675,1,1210697697,1210697843,2,1,146
40598203@N08,3676,15,1279931197,1279931197,1,1,0
40610681@N06,3677,1,1387166584,1387166584,1,7,0
40610681@N06,3677,9,1387177941,1387177941,1,7,0
40610681@N06,3677,8,1387166781,1387166781,1,7,0
40610681@N06,3677,14,1387169396,1387169396,1,7,0
40610681@N06,3677,20,1387171887,1387171887,1,7,0
40610681@N06,3677,4,1387166832,1387166832,1,7,0
40610681@N06,3677,2,1387176984,1387176984,1,7,0
40616636@N08,3678,6,1340885008,1340886068,40,3,1060
40616636@N08,3678,17,1340873533,1340879618,26,3,6085
40616636@N08,3678,27,1340881697,1340882221,9,3,524
40646519@N00,3679,7,1227662851,1227663625,7,13,774
40646519@N00,3679,6,1227662270,1227663959,7,13,1689
40646519@N00,3679,1,1227680364,1227680439,4,13,75
40646519@N00,3679,13,1227672513,1227672513,1,13,0
40646519@N00,3679,8,1227663027,1227663549,4,13,522
40646519@N00,3679,16,1227671003,1227671003,1,13,0
40646519@N00,3679,4,1227659228,1227694029,3,13,34801
40646519@N00,3679,11,1227663279,1227663476,11,13,197
40646519@N00,3679,18,1227671971,1227672289,5,13,318
40646519@N00,3679,27,1227658887,1227696167,3,13,37280
40646519@N00,3679,12,1227667606,1227692030,19,13,24424
40646519@N00,3679,15,1227677426,1227677825,3,13,399
40646519@N00,3679,14,1227666276,1227671206,11,13,4930
40646519@N00,3680,27,1259450862,1259451386,8,9,524
40646519@N00,3680,17,1259470209,1259470209,1,9,0
40646519@N00,3680,12,1259457375,1259458273,20,9,898
40646519@N00,3680,24,1259453663,1259454412,2,9,749
40646519@N00,3680,21,1259454554,1259455269,6,9,715
40646519@N00,3680,14,1259470797,1259470961,9,9,164
40646519@N00,3680,15,1259470487,1259470559,5,9,72
40646519@N00,3680,25,1259452018,1259452635,12,9,617
40646519@N00,3680,23,1259453178,1259453340,8,9,162
40646519@N00,3681,26,1320968725,1320968915,5,15,190
40646519@N00,3681,20,1320969349,1320969357,2,15,8
40646519@N00,3681,27,1320963113,1320975045,7,15,11932
40646519@N00,3681,9,1320966968,1320967080,8,15,112
40646519@N00,3681,17,1320968655,1320968655,1,15,0
40646519@N00,3681,12,1320965539,1320966415,15,15,876
40646519@N00,3681,13,1320967410,1320967599,6,15,189
40646519@N00,3681,14,1320963854,1320967122,9,15,3268
40646519@N00,3681,24,1320970860,1320970971,3,15,111
40646519@N00,3681,3,1320973662,1320973662,1,15,0
40646519@N00,3681,4,1320973546,1320974178,2,15,632
40646519@N00,3681,18,1320967357,1320967357,1,15,0
40646519@N00,3681,21,1320969567,1320970848,3,15,1281
40646519@N00,3681,15,1320967183,1320967203,2,15,20
40646519@N00,3681,16,1320963341,1320963397,5,15,56
40646519@N00,3682,26,1353027418,1353027418,1,21,0
40646519@N00,3682,5,1353043329,1353045821,2,21,2492
40646519@N00,3682,7,1353046070,1353047419,7,21,1349
40646519@N00,3682,27,1353014674,1353057813,11,21,43139
40646519@N00,3682,9,1353022048,1353057331,17,21,35283
40646519@N00,3682,2,1353036368,1353045804,22,21,9436
40646519@N00,3682,12,1353019741,1353020593,14,21,852
40646519@N00,3682,13,1353025121,1353025121,1,21,0
40646519@N00,3682,10,1353022409,1353056089,29,21,33680
40646519@N00,3682,17,1353024924,1353036783,4,21,11859
40646519@N00,3682,3,1353040592,1353043661,6,21,3069
40646519@N00,3682,1,1353041743,1353043607,4,21,1864
40646519@N00,3682,6,1353040888,1353043391,14,21,2503
40646519@N00,3682,4,1353035997,1353036064,3,21,67
40646519@N00,3682,11,1353046251,1353047285,9,21,1034
40646519@N00,3682,8,1353046391,1353047419,6,21,1028
40646519@N00,3682,21,1353033494,1353035413,6,21,1919
40646519@N00,3682,22,1353028503,1353028503,1,21,0
40646519@N00,3682,14,1353019360,1353056950,21,21,37590
40646519@N00,3682,15,1353019595,1353024911,4,21,5316
40646519@N00,3682,16,1353015289,1353037410,41,21,22121
40646519@N00,3683,3,1416815602,1416815602,1,15,0
40646519@N00,3683,26,1416790214,1416790214,1,15,0
40646519@N00,3683,7,1416814005,1416819794,7,15,5789
40646519@N00,3683,9,1416789562,1416824181,7,15,34619
40646519@N00,3683,13,1416800175,1416802129,7,15,1954
40646519@N00,3683,19,1416791570,1416794518,8,15,2948
40646519@N00,3683,17,1416790205,1416809029,3,15,18824
40646519@N00,3683,15,1416789873,1416799878,5,15,10005
40646519@N00,3683,20,1416806500,1416808307,5,15,1807
40646519@N00,3683,1,1416784824,1416816571,5,15,31747
40646519@N00,3683,4,1416782289,1416782485,2,15,196
40646519@N00,3683,27,1416781537,1416825288,11,15,43751
40646519@N00,3683,22,1416790421,1416795299,5,15,4878
40646519@N00,3683,14,1416789778,1416823906,34,15,34128
40646519@N00,3683,16,1416809452,1416809532,3,15,80
40696376@N03,3684,6,1293800400,1293800400,1,1,0
40709591@N07,3685,27,1257871559,1257871559,1,2,0
40709591@N07,3685,20,1257875415,1257875415,1,2,0
40709591@N07,3686,16,1258192421,1258192421,1,2,0
40709591@N07,3686,1,1258163939,1258163939,1,2,0
40718771@N00,3687,20,1446079582,1446079582,1,1,0
40722759@N02,3688,27,1383001088,1383001088,1,2,0
40722759@N02,3688,18,1383023141,1383023141,1,2,0
40732565660@N01,3689,17,1188808674,1188808674,1,3,0
40732565660@N01,3689,11,1188818932,1188818932,1,3,0
40732565660@N01,3689,9,1188814128,1188814148,2,3,20
40732565660@N01,3690,27,1201849477,1201849479,2,2,2
40732565660@N01,3690,4,1201853439,1201853439,1,2,0
40732565660@N01,3691,22,1202002921,1202002921,1,3,0
40732565660@N01,3691,27,1202001023,1202005808,3,3,4785
40732565660@N01,3691,21,1202003781,1202003791,2,3,10
40745887@N05,3692,26,1284339003,1284339003,1,2,0
40745887@N05,3692,3,1284354617,1284355237,3,2,620
40802704@N05,3693,27,1274320778,1274322171,3,2,1393
40802704@N05,3693,16,1274322304,1274345980,16,2,23676
40827705@N04,3694,9,1207635198,1207635198,1,1,0
40833298@N02,3695,27,1255554031,1255559238,3,5,5207
40833298@N02,3695,8,1255571168,1255571168,1,5,0
40833298@N02,3695,14,1255575919,1255575919,1,5,0
40833298@N02,3695,18,1255591652,1255591652,1,5,0
40833298@N02,3695,12,1255578307,1255578308,2,5,1
40835857@N00,3696,16,1386855215,1386855215,1,1,0
40899173@N05,3697,16,1262023702,1262023702,1,1,0
40901879@N07,3698,17,1315486055,1315486055,1,1,0
40908775@N04,3699,3,1248789602,1248789602,1,2,0
40908775@N04,3699,16,1248789616,1248789616,1,2,0
40937461@N02,3700,22,1329544884,1329544956,2,9,72
40937461@N02,3700,27,1329524551,1329527249,6,9,2698
40937461@N02,3700,1,1329527099,1329527099,1,9,0
40937461@N02,3700,16,1329550892,1329565106,2,9,14214
40937461@N02,3700,17,1329547218,1329547218,1,9,0
40937461@N02,3700,9,1329541699,1329541699,1,9,0
40937461@N02,3700,18,1329547053,1329547053,1,9,0
40937461@N02,3700,14,1329535182,1329537057,2,9,1875
40937461@N02,3700,11,1329526784,1329526784,1,9,0
40937461@N02,3701,26,1329722698,1329722698,1,6,0
40937461@N02,3701,21,1329726108,1329726108,1,6,0
40937461@N02,3701,16,1329728322,1329728322,1,6,0
40937461@N02,3701,22,1329722994,1329723057,2,6,63
40937461@N02,3701,4,1329728518,1329728518,1,6,0
40937461@N02,3701,18,1329721038,1329721038,1,6,0
40979501@N04,3702,25,1307324086,1307326612,2,1,2526
41013533@N04,3703,12,1428299877,1428300207,3,2,330
41013533@N04,3703,14,1428298725,1428298725,1,2,0
41013533@N04,3704,27,1428418006,1428418006,1,2,0
41013533@N04,3704,21,1428391927,1428391927,1,2,0
41101678@N00,3705,14,1397616853,1397616853,1,1,0
41117712@N05,3706,8,1361826970,1361829221,2,7,2251
41117712@N05,3706,13,1361842410,1361842410,1,7,0
41117712@N05,3706,4,1361871224,1361871224,1,7,0
41117712@N05,3706,22,1361841649,1361841649,1,7,0
41117712@N05,3706,6,1361871577,1361871577,1,7,0
41117712@N05,3706,2,1361871379,1361871379,1,7,0
41117712@N05,3706,27,1361820359,1361859817,2,7,39458
41126359@N00,3707,18,1277949733,1277949733,1,2,0
41126359@N00,3707,1,1277945859,1277945859,1,2,0
41126359@N00,3708,2,1278077489,1278077489,1,2,0
41126359@N00,3708,16,1278061932,1278061932,1,2,0
41126359@N00,3709,17,1278159696,1278159696,1,2,0
41126359@N00,3709,16,1278155663,1278155663,1,2,0
41126359@N00,3710,3,1278749279,1278749279,1,2,0
41126359@N00,3710,19,1278754666,1278754666,1,2,0
41126359@N00,3711,14,1279363865,1279363865,1,1,0
41126359@N00,3712,14,1280923370,1280923370,1,1,0
41126359@N00,3713,9,1281005166,1281005166,1,1,0
41126359@N00,3714,16,1281101055,1281101055,1,1,0
41126359@N00,3715,14,1283853105,1283853105,1,1,0
41126359@N00,3716,9,1295827713,1295827713,1,2,0
41126359@N00,3716,12,1295827483,1295827483,1,2,0
41126359@N00,3717,13,1295874866,1295874866,1,2,0
41126359@N00,3717,14,1295860835,1295860835,1,2,0
41126359@N00,3718,16,1312448736,1312448736,1,1,0
41126359@N00,3719,27,1322904625,1322904625,1,2,0
41126359@N00,3719,25,1322915908,1322915908,1,2,0
41126359@N00,3720,17,1329377270,1329377270,1,1,0
41126359@N00,3721,18,1329805326,1329805326,1,2,0
41126359@N00,3721,27,1329808503,1329808503,1,2,0
41126359@N00,3722,8,1339840950,1339840950,1,1,0
41126359@N00,3723,16,1341318971,1341318971,1,1,0
41126359@N00,3724,14,1346546615,1346546615,1,2,0
41126359@N00,3724,9,1346546700,1346546700,1,2,0
41126359@N00,3725,10,1350103326,1350103326,1,1,0
41126359@N00,3726,2,1363945729,1363945729,1,1,0
41134616@N00,3727,12,1225062609,1225062609,1,10,0
41134616@N00,3727,20,1225065012,1225065051,2,10,39
41134616@N00,3727,14,1225081691,1225091292,2,10,9601
41134616@N00,3727,27,1225059198,1225108628,3,10,49430
41134616@N00,3727,25,1225074019,1225074019,1,10,0
41134616@N00,3727,19,1225064181,1225067381,2,10,3200
41134616@N00,3727,24,1225075606,1225075606,1,10,0
41134616@N00,3727,13,1225060623,1225061492,2,10,869
41134616@N00,3727,16,1225076765,1225106416,9,10,29651
41134616@N00,3727,21,1225068470,1225068470,1,10,0
41134616@N00,3728,11,1225442670,1225442670,1,3,0
41134616@N00,3728,9,1225443866,1225443866,1,3,0
41134616@N00,3728,27,1225437226,1225439590,5,3,2364
41138825@N00,3729,14,1452842717,1452842717,1,9,0
41138825@N00,3729,4,1452840467,1452840467,1,9,0
41138825@N00,3729,19,1452849769,1452849769,1,9,0
41138825@N00,3729,15,1452846724,1452846724,1,9,0
41138825@N00,3729,3,1452842462,1452842462,1,9,0
41138825@N00,3729,27,1452840114,1452840114,1,9,0
41138825@N00,3729,17,1452854849,1452854849,1,9,0
41138825@N00,3729,2,1452841633,1452841633,1,9,0
41138825@N00,3729,5,1452842714,1452842714,1,9,0
41164738@N00,3730,15,1373785899,1373785899,1,1,0
41164738@N00,3731,15,1373883396,1373883410,2,1,14
41164738@N00,3732,15,1374262828,1374262828,1,1,0
41164738@N00,3733,15,1374324422,1374330140,9,1,5718
41164738@N00,3734,15,1374399519,1374420200,2,1,20681
41164738@N00,3735,15,1374811401,1374847774,12,1,36373
41180631@N06,3736,27,1227839252,1227839941,2,2,689
41180631@N06,3736,16,1227842991,1227842991,1,2,0
41185854@N07,3737,16,1325302720,1325302720,1,1,0
41197583@N00,3738,22,1250232610,1250233278,3,3,668
41197583@N00,3738,6,1250237292,1250237666,3,3,374
41197583@N00,3738,27,1250228165,1250228165,1,3,0
41197583@N00,3739,18,1250545276,1250547150,4,4,1874
41197583@N00,3739,17,1250559640,1250559640,1,4,0
41197583@N00,3739,22,1250546140,1250559896,2,4,13756
41197583@N00,3739,23,1250582192,1250582192,1,4,0
41211080@N02,3740,4,1336602847,1336602847,1,1,0
41236077@N02,3741,16,1291034204,1291034204,1,1,0
41236077@N02,3742,2,1326536132,1326536132,1,2,0
41236077@N02,3742,14,1326513557,1326534103,5,2,20546
41277655@N07,3743,7,1399200916,1399200916,1,2,0
41277655@N07,3743,14,1399170586,1399173657,8,2,3071
41287315@N06,3744,27,1335660522,1335660522,1,1,0
41294893@N05,3745,16,1252884006,1252920137,15,1,36131
41294893@N05,3746,16,1252966785,1253013855,47,1,47070
41294893@N05,3747,16,1253057017,1253077823,9,1,20806
41294893@N05,3748,16,1253147727,1253166406,27,1,18679
41294893@N05,3749,16,1253233693,1253276101,54,1,42408
41299606@N00,3750,14,1425100465,1425100465,1,1,0
41330913@N04,3751,27,1351473201,1351473285,3,1,84
41362237@N00,3752,16,1232743728,1232743845,6,3,117
41362237@N00,3752,18,1232756313,1232758264,21,3,1951
41362237@N00,3752,19,1232756518,1232757100,22,3,582
41396402@N03,3753,26,1396325089,1396325089,1,5,0
41396402@N03,3753,14,1396318027,1396318027,1,5,0
41396402@N03,3753,2,1396339075,1396339145,2,5,70
41396402@N03,3753,3,1396338745,1396338745,1,5,0
41396402@N03,3753,22,1396325118,1396325686,5,5,568
41407408@N00,3754,14,1281475497,1281475497,1,1,0
41407408@N00,3755,1,1306462973,1306462973,1,4,0
41407408@N00,3755,27,1306463705,1306463705,1,4,0
41407408@N00,3755,19,1306463177,1306464180,2,4,1003
41407408@N00,3755,17,1306463837,1306463837,1,4,0
41407408@N00,3756,5,1420189115,1420189115,1,1,0
41407408@N00,3757,27,1421826185,1421826185,1,2,0
41407408@N00,3757,17,1421826982,1421827093,3,2,111
41407408@N00,3758,15,1422309948,1422309948,1,1,0
41427544@N00,3759,16,1297756707,1297756707,1,1,0
41518442@N02,3760,16,1250746067,1250746133,2,1,66
41545932@N02,3761,12,1357108927,1357108927,1,2,0
41545932@N02,3761,9,1357104943,1357104943,1,2,0
41545932@N02,3762,16,1357164560,1357164560,1,1,0
41545932@N02,3763,16,1357277230,1357277230,1,2,0
41545932@N02,3763,1,1357264969,1357264969,1,2,0
41545932@N02,3764,14,1357453903,1357453903,1,1,0
41566089@N04,3765,14,1433297351,1433297351,1,1,0
41597043@N00,3766,14,1385329197,1385329245,3,2,48
41597043@N00,3766,27,1385327617,1385327617,1,2,0
41610763@N04,3767,27,1315411237,1315411237,1,3,0
41610763@N04,3767,17,1315388794,1315388794,1,3,0
41610763@N04,3767,9,1315408412,1315408412,1,3,0
41610763@N04,3768,17,1326949940,1326949940,1,2,0
41610763@N04,3768,18,1326941401,1326941401,1,2,0
41624223@N08,3769,27,1338343544,1338371412,8,5,27868
41624223@N08,3769,4,1338373700,1338373718,2,5,18
41624223@N08,3769,25,1338355718,1338355925,3,5,207
41624223@N08,3769,20,1338357764,1338358328,2,5,564
41624223@N08,3769,14,1338363670,1338367424,3,5,3754
41644332@N07,3770,16,1263339033,1263367892,4,1,28859
41644332@N07,3771,16,1263539541,1263546468,3,1,6927
41661621@N00,3772,4,1215138641,1215159780,5,11,21139
41661621@N00,3772,20,1215163444,1215163444,1,11,0
41661621@N00,3772,15,1215131392,1215131734,5,11,342
41661621@N00,3772,6,1215160460,1215160460,1,11,0
41661621@N00,3772,27,1215139623,1215139717,4,11,94
41661621@N00,3772,8,1215136481,1215136481,1,11,0
41661621@N00,3772,18,1215163160,1215165312,8,11,2152
41661621@N00,3772,9,1215127512,1215172642,21,11,45130
41661621@N00,3772,22,1215161817,1215162685,10,11,868
41661621@N00,3772,11,1215136940,1215136940,1,11,0
41661621@N00,3772,3,1215159622,1215159688,3,11,66
41661621@N00,3773,17,1240617147,1240617364,8,10,217
41661621@N00,3773,15,1240623062,1240623902,7,10,840
41661621@N00,3773,27,1240613575,1240663700,15,10,50125
41661621@N00,3773,9,1240630083,1240630083,1,10,0
41661621@N00,3773,16,1240618057,1240622705,7,10,4648
41661621@N00,3773,21,1240627323,1240627773,5,10,450
41661621@N00,3773,23,1240616490,1240616490,1,10,0
41661621@N00,3773,24,1240616006,1240616023,3,10,17
41661621@N00,3773,14,1240622834,1240657465,7,10,34631
41661621@N00,3773,22,1240625548,1240625600,4,10,52
41661621@N00,3774,27,1240718230,1240718230,1,1,0
41661621@N00,3775,20,1392168043,1392171676,3,15,3633
41661621@N00,3775,15,1392160328,1392161851,19,15,1523
41661621@N00,3775,10,1392174332,1392174479,3,15,147
41661621@N00,3775,6,1392184235,1392184235,1,15,0
41661621@N00,3775,2,1392177489,1392181801,7,15,4312
41661621@N00,3775,18,1392168471,1392170664,8,15,2193
41661621@N00,3775,3,1392180704,1392182501,6,15,1797
41661621@N00,3775,9,1392173415,1392173415,1,15,0
41661621@N00,3775,16,1392186602,1392186602,1,15,0
41661621@N00,3775,23,1392166695,1392166736,4,15,41
41661621@N00,3775,14,1392158678,1392174600,9,15,15922
41661621@N00,3775,4,1392178320,1392179540,2,15,1220
41661621@N00,3775,22,1392164927,1392167691,17,15,2764
41661621@N00,3775,19,1392162919,1392169969,7,15,7050
41661621@N00,3775,25,1392167217,1392167476,5,15,259
41662207@N05,3776,2,1393582198,1393582401,2,2,203
41662207@N05,3776,8,1393584250,1393584250,1,2,0
41662207@N05,3777,14,1400851851,1400853364,2,1,1513
41662207@N05,3778,16,1428744526,1428744526,1,1,0
41663556@N00,3779,4,1354843665,1354843665,1,5,0
41663556@N00,3779,6,1354844692,1354844692,1,5,0
41663556@N00,3779,14,1354856359,1354867930,9,5,11571
41663556@N00,3779,7,1354845091,1354845091,1,5,0
41663556@N00,3779,27,1354842538,1354842538,1,5,0
41689886@N02,3780,27,1347500749,1347500749,1,3,0
41689886@N02,3780,9,1347511919,1347511919,1,3,0
41689886@N02,3780,14,1347510031,1347510031,1,3,0
41693381@N00,3781,16,1212919014,1212919014,1,1,0
41693381@N00,3782,1,1292106178,1292106178,1,1,0
41693381@N00,3783,16,1292241242,1292241242,1,1,0
41693381@N00,3784,13,1337478212,1337478212,1,2,0
41693381@N00,3784,27,1337485744,1337485744,1,2,0
41693381@N00,3785,13,1337523661,1337523661,1,1,0
41693381@N00,3786,2,1337845355,1337845956,2,3,601
41693381@N00,3786,17,1337852392,1337852392,1,3,0
41693381@N00,3786,4,1337847722,1337847722,1,3,0
41693381@N00,3787,27,1365752042,1365752042,1,1,0
41693381@N00,3788,27,1365846910,1365854928,2,1,8018
41693381@N00,3789,14,1404265277,1404265277,1,1,0
41693381@N00,3790,14,1406286701,1406286701,1,1,0
41693381@N00,3791,27,1415009210,1415009210,1,1,0
41693381@N00,3792,13,1424503426,1424503426,1,1,0
41693381@N00,3793,27,1430554683,1430554683,1,2,0
41693381@N00,3793,9,1430556631,1430556886,2,2,255
41693381@N00,3794,20,1432459339,1432459339,1,1,0
41693381@N00,3795,19,1434529220,1434529220,1,1,0
41693381@N00,3796,10,1442133806,1442133838,2,2,32
41693381@N00,3796,17,1442133447,1442134179,2,2,732
41695711@N00,3797,16,1191289076,1191289076,1,1,0
41709523@N07,3798,14,1415087771,1415087771,1,1,0
41781975@N00,3799,9,1229211380,1229215427,3,1,4047
41781975@N00,3800,10,1253353867,1253353867,1,2,0
41781975@N00,3800,17,1253354100,1253354100,1,2,0
41864324@N02,3801,4,1225955151,1225955151,1,1,0
41872770@N05,3802,7,1255671273,1255671273,1,1,0
41872770@N05,3803,24,1260504371,1260504371,1,2,0
41872770@N05,3803,21,1260499739,1260499739,1,2,0
41872770@N05,3804,22,1260622345,1260622345,1,1,0
41872770@N05,3805,27,1266163305,1266163305,1,4,0
41872770@N05,3805,22,1266115876,1266115876,1,4,0
41872770@N05,3805,1,1266153329,1266153329,1,4,0
41872770@N05,3805,5,1266143363,1266143363,1,4,0
41872770@N05,3806,26,1268970340,1268970340,1,1,0
41878212@N00,3807,13,1394840433,1394840433,1,1,0
41881070@N08,3808,21,1284662489,1284662525,2,3,36
41881070@N08,3808,16,1284654483,1284679276,14,3,24793
41881070@N08,3808,27,1284653000,1284653000,1,3,0
41881070@N08,3809,16,1284862107,1284862107,1,2,0
41881070@N08,3809,27,1284859130,1284859130,1,2,0
41881070@N08,3810,16,1284929236,1284929236,1,1,0
41881070@N08,3811,16,1285026069,1285032558,5,1,6489
41894164051@N01,3812,16,1366700839,1366700839,1,1,0
41894165897@N01,3813,4,1356591573,1356591573,1,4,0
41894165897@N01,3813,13,1356558590,1356558600,2,4,10
41894165897@N01,3813,27,1356584426,1356584426,1,4,0
41894165897@N01,3813,17,1356591882,1356591882,1,4,0
41894166078@N01,3814,9,1292449759,1292449759,1,1,0
41894185936@N01,3815,17,1381890104,1381890104,1,1,0
41894194820@N01,3816,17,1370872803,1370872803,1,1,0
41894194820@N01,3817,17,1371011210,1371011210,1,1,0
41903519@N07,3818,22,1379585821,1379585821,1,3,0
41903519@N07,3818,8,1379580608,1379580608,1,3,0
41903519@N07,3818,16,1379573907,1379573907,1,3,0
41919930@N03,3819,22,1258345521,1258360192,4,1,14671
41919930@N03,3820,22,1269229299,1269238941,2,1,9642
41934700@N05,3821,16,1360384464,1360384464,1,3,0
41934700@N05,3821,21,1360388098,1360388098,1,3,0
41934700@N05,3821,13,1360385416,1360385858,2,3,442
41967511@N00,3822,27,1244036708,1244036708,1,1,0
41967511@N00,3823,27,1244191010,1244191021,2,1,11
41976006@N02,3824,16,1306323555,1306323555,1,1,0
42085328@N07,3825,16,1268031600,1268031600,1,1,0
42118699@N08,3826,20,1210189156,1210189156,1,1,0
42118699@N08,3827,25,1210294783,1210294783,1,1,0
42118699@N08,3828,24,1254611068,1254611068,1,6,0
42118699@N08,3828,16,1254615403,1254615403,1,6,0
42118699@N08,3828,3,1254597725,1254597725,1,6,0
42118699@N08,3828,20,1254594590,1254594590,1,6,0
42118699@N08,3828,26,1254594324,1254594329,2,6,5
42118699@N08,3828,18,1254600830,1254600830,1,6,0
42118699@N08,3829,24,1257885544,1257885544,1,3,0
42118699@N08,3829,20,1257880934,1257880934,1,3,0
42118699@N08,3829,19,1257883047,1257883440,2,3,393
42118699@N08,3830,9,1286390152,1286390152,1,6,0
42118699@N08,3830,21,1286394360,1286394360,1,6,0
42118699@N08,3830,27,1286387988,1286387988,1,6,0
42118699@N08,3830,15,1286389107,1286389107,1,6,0
42118699@N08,3830,20,1286392741,1286392741,1,6,0
42118699@N08,3830,16,1286388451,1286388451,1,6,0
42118699@N08,3831,1,1286700233,1286700233,1,1,0
42118699@N08,3832,15,1286995816,1286995816,1,1,0
42118699@N08,3833,19,1351113798,1351113798,1,2,0
42118699@N08,3833,15,1351102701,1351102701,1,2,0
42118699@N08,3834,10,1367458898,1367459977,6,1,1079
42118699@N08,3835,9,1368513433,1368520625,2,3,7192
42118699@N08,3835,14,1368513065,1368514631,2,3,1566
42118699@N08,3835,10,1368516535,1368516535,1,3,0
42118699@N08,3836,15,1368645877,1368646146,2,3,269
42118699@N08,3836,14,1368650412,1368650412,1,3,0
42118699@N08,3836,10,1368648787,1368648787,1,3,0
42118699@N08,3837,15,1368776278,1368776530,2,2,252
42118699@N08,3837,1,1368771032,1368771033,2,2,1
42118699@N08,3838,9,1429860790,1429861231,2,1,441
42118699@N08,3839,10,1430030573,1430030573,1,1,0
42118699@N08,3840,8,1430097489,1430097489,1,2,0
42118699@N08,3840,9,1430094783,1430094783,1,2,0
42118699@N08,3841,16,1460357673,1460357673,1,1,0
42118699@N08,3842,14,1460638703,1460644345,2,1,5642
42151752@N05,3843,9,1417052754,1417052754,1,3,0
42151752@N05,3843,4,1417053573,1417053573,1,3,0
42151752@N05,3843,15,1417052564,1417052564,1,3,0
42151752@N05,3844,19,1417153121,1417153121,1,4,0
42151752@N05,3844,8,1417149485,1417149729,2,4,244
42151752@N05,3844,7,1417146095,1417146095,1,4,0
42151752@N05,3844,2,1417140424,1417140424,1,4,0
42201001@N07,3845,2,1287008454,1287008454,1,1,0
42218330@N03,3846,4,1343645412,1343645419,2,1,7
42299049@N06,3847,14,1453813200,1453813200,1,1,0
42320709@N06,3848,16,1454033287,1454055818,2,1,22531
42327762@N03,3849,16,1257995941,1258013642,2,2,17701
42327762@N03,3849,27,1258013762,1258014444,2,2,682
42327762@N03,3850,27,1286332934,1286357554,33,1,24620
42344249@N02,3851,9,1217160338,1217160338,1,2,0
42344249@N02,3851,25,1217132879,1217132901,2,2,22
42398872@N03,3852,14,1325913765,1325913765,1,6,0
42398872@N03,3852,23,1325900888,1325900888,1,6,0
42398872@N03,3852,19,1325898434,1325898434,1,6,0
42398872@N03,3852,1,1325908780,1325908780,1,6,0
42398872@N03,3852,4,1325903522,1325903522,1,6,0
42398872@N03,3852,6,1325908954,1325908954,1,6,0
42399173@N05,3853,22,1345458525,1345458951,9,5,426
42399173@N05,3853,27,1345430885,1345433053,3,5,2168
42399173@N05,3853,8,1345444177,1345444244,2,5,67
42399173@N05,3853,14,1345452159,1345452159,1,5,0
42399173@N05,3853,9,1345443753,1345443778,4,5,25
42399173@N05,3854,9,1345609169,1345609169,1,1,0
42399173@N05,3855,6,1386661758,1386661760,2,6,2
42399173@N05,3855,23,1386646403,1386651001,2,6,4598
42399173@N05,3855,24,1386647088,1386647088,1,6,0
42399173@N05,3855,27,1386642347,1386677597,11,6,35250
42399173@N05,3855,4,1386662309,1386662309,1,6,0
42399173@N05,3855,9,1386658223,1386658235,2,6,12
42399173@N05,3856,7,1386985726,1386985833,2,3,107
42399173@N05,3856,16,1386985240,1386985240,1,3,0
42399173@N05,3856,27,1386983862,1387008568,2,3,24706
42416044@N04,3857,21,1291760751,1291764738,4,8,3987
42416044@N04,3857,13,1291770334,1291783839,3,8,13505
42416044@N04,3857,20,1291768513,1291768513,1,8,0
42416044@N04,3857,23,1291763592,1291764484,2,8,892
42416044@N04,3857,27,1291759363,1291759363,1,8,0
42416044@N04,3857,17,1291769084,1291769084,1,8,0
42416044@N04,3857,18,1291765993,1291766529,4,8,536
42416044@N04,3857,16,1291776401,1291776401,1,8,0
42419824@N03,3858,20,1383524014,1383570651,123,1,46637
42431443@N08,3859,15,1313219822,1313219822,1,1,0
42438292@N07,3860,21,1290847206,1290847206,1,1,0
42438292@N07,3861,16,1290929617,1290929617,1,1,0
42440817@N02,3862,16,1335694313,1335694313,1,1,0
42486569@N00,3863,4,1300008095,1300011203,3,3,3108
42486569@N00,3863,5,1300008425,1300008459,3,3,34
42486569@N00,3863,18,1300019759,1300019759,1,3,0
42486569@N00,3864,27,1300132435,1300133216,13,7,781
42486569@N00,3864,20,1300148345,1300148345,1,7,0
42486569@N00,3864,14,1300151953,1300151953,1,7,0
42486569@N00,3864,24,1300138413,1300138426,3,7,13
42486569@N00,3864,5,1300183211,1300183211,1,7,0
42486569@N00,3864,6,1300154638,1300154725,2,7,87
42486569@N00,3864,15,1300150972,1300150972,1,7,0
42486569@N00,3865,13,1300405756,1300409600,47,6,3844
42486569@N00,3865,22,1300404969,1300404977,2,6,8
42486569@N00,3865,20,1300404885,1300404897,2,6,12
42486569@N00,3865,12,1300414689,1300414827,6,6,138
42486569@N00,3865,18,1300409170,1300409197,2,6,27
42486569@N00,3865,17,1300405560,1300405738,11,6,178
42491939@N00,3866,9,1228960913,1228970960,2,2,10047
42491939@N00,3866,25,1228970967,1228970967,1,2,0
42491939@N00,3867,27,1347832611,1347839721,9,1,7110
42491939@N00,3868,21,1348272130,1348273575,22,4,1445
42491939@N00,3868,22,1348270588,1348271111,6,4,523
42491939@N00,3868,24,1348271977,1348272078,3,4,101
42491939@N00,3868,27,1348266384,1348267118,6,4,734
42504117@N06,3869,27,1356651503,1356651503,1,2,0
42504117@N06,3869,25,1356668139,1356668139,1,2,0
42508926@N03,3870,27,1328825205,1328837192,3,1,11987
42508926@N03,3871,22,1329266826,1329270848,3,4,4022
42508926@N03,3871,1,1329277808,1329291684,8,4,13876
42508926@N03,3871,27,1329262271,1329262296,3,4,25
42508926@N03,3871,21,1329265871,1329265880,2,4,9
42508926@N03,3872,27,1329378001,1329380509,23,2,2508
42508926@N03,3872,21,1329364527,1329364541,2,2,14
42508926@N03,3873,27,1330601988,1330601988,1,1,0
42533701@N00,3874,27,1215403889,1215403927,3,1,38
42539010@N02,3875,27,1428280873,1428280875,4,8,2
42539010@N02,3875,20,1428287323,1428287368,4,8,45
42539010@N02,3875,19,1428288235,1428289010,2,8,775
42539010@N02,3875,21,1428285336,1428290503,3,8,5167
42539010@N02,3875,23,1428283376,1428285340,10,8,1964
42539010@N02,3875,18,1428287680,1428288416,3,8,736
42539010@N02,3875,17,1428296873,1428297131,17,8,258
42539010@N02,3875,25,1428282121,1428283237,8,8,1116
42580834@N08,3876,17,1256381001,1256381001,1,2,0
42580834@N08,3876,27,1256372401,1256372401,1,2,0
42580834@N08,3877,16,1256550664,1256551984,3,5,1320
42580834@N08,3877,9,1256548458,1256553443,2,5,4985
42580834@N08,3877,2,1256553693,1256553693,1,5,0
42580834@N08,3877,3,1256553904,1256554147,2,5,243
42580834@N08,3877,27,1256547211,1256547211,1,5,0
42580834@N08,3878,22,1256621778,1256622772,6,8,994
42580834@N08,3878,8,1256641646,1256641646,1,8,0
42580834@N08,3878,25,1256620323,1256620323,1,8,0
42580834@N08,3878,23,1256620842,1256620842,1,8,0
42580834@N08,3878,13,1256643115,1256644323,3,8,1208
42580834@N08,3878,21,1256646097,1256646097,1,8,0
42580834@N08,3878,24,1256619795,1256619795,1,8,0
42580834@N08,3878,27,1256616448,1256616824,6,8,376
42580834@N08,3879,7,1256857696,1256857696,1,8,0
42580834@N08,3879,11,1256858402,1256858572,4,8,170
42580834@N08,3879,19,1256864737,1256864737,1,8,0
42580834@N08,3879,9,1256859823,1256859823,1,8,0
42580834@N08,3879,4,1256861827,1256861827,1,8,0
42580834@N08,3879,16,1256892159,1256892159,1,8,0
42580834@N08,3879,20,1256864737,1256864737,3,8,0
42580834@N08,3879,3,1256861587,1256861587,1,8,0
42580834@N08,3880,27,1256938901,1256939576,2,1,675
42580834@N08,3881,27,1350015244,1350015739,2,3,495
42580834@N08,3881,10,1350017119,1350018644,3,3,1525
42580834@N08,3881,14,1350021163,1350021163,1,3,0
42580834@N08,3882,11,1350347502,1350349156,2,8,1654
42580834@N08,3882,27,1350359497,1350359576,2,8,79
42580834@N08,3882,4,1350357554,1350357642,2,8,88
42580834@N08,3882,21,1350339820,1350339820,1,8,0
42580834@N08,3882,19,1350360376,1350360376,1,8,0
42580834@N08,3882,17,1350373679,1350373679,1,8,0
42580834@N08,3882,12,1350345554,1350345554,1,8,0
42580834@N08,3882,13,1350345318,1350345318,1,8,0
42580834@N08,3883,21,1350615321,1350615321,1,5,0
42580834@N08,3883,25,1350615614,1350615614,1,5,0
42580834@N08,3883,22,1350607689,1350607689,1,5,0
42580834@N08,3883,12,1350617023,1350617023,1,5,0
42580834@N08,3883,16,1350618080,1350618080,1,5,0
42614577@N03,3884,26,1335661629,1335661629,1,7,0
42614577@N03,3884,14,1335660167,1335660167,2,7,0
42614577@N03,3884,9,1335659498,1335660045,11,7,547
42614577@N03,3884,4,1335656059,1335656072,3,7,13
42614577@N03,3884,24,1335666751,1335666751,1,7,0
42614577@N03,3884,27,1335651872,1335652146,3,7,274
42614577@N03,3884,6,1335659936,1335659939,2,7,3
42614577@N03,3885,27,1366110957,1366110997,32,1,40
42688661@N06,3886,27,1442122454,1442132927,2,2,10473
42688661@N06,3886,3,1442124854,1442124854,1,2,0
42688661@N06,3887,27,1442307471,1442326627,4,1,19156
42688661@N06,3888,6,1442455565,1442455565,1,4,0
42688661@N06,3888,4,1442455463,1442455909,2,4,446
42688661@N06,3888,1,1442455598,1442455756,2,4,158
42688661@N06,3888,2,1442455407,1442455988,3,4,581
42688661@N06,3889,27,1442613567,1442613836,2,2,269
42688661@N06,3889,14,1442616015,1442616015,1,2,0
42695644@N04,3890,4,1262053616,1262053616,1,1,0
42728140@N00,3891,6,1229678269,1229678269,1,1,0
42755016@N02,3892,4,1404776447,1404776447,1,2,0
42755016@N02,3892,10,1404776978,1404776978,1,2,0
42786185@N06,3893,17,1336968040,1336968986,2,1,946
42786185@N06,3894,16,1367151008,1367151492,4,2,484
42786185@N06,3894,27,1367155236,1367155236,1,2,0
42786185@N06,3895,18,1399021490,1399021490,1,1,0
42787199@N08,3896,16,1386147196,1386153420,3,1,6224
42815122@N02,3897,27,1347147079,1347147079,1,3,0
42815122@N02,3897,4,1347183011,1347183011,1,3,0
42815122@N02,3897,19,1347165484,1347165484,1,3,0
42832231@N00,3898,14,1309664885,1309664885,1,1,0
42848911@N05,3899,19,1298629211,1298629211,1,2,0
42848911@N05,3899,24,1298627586,1298627586,1,2,0
42852007@N07,3900,21,1303032377,1303032377,1,1,0
42852007@N07,3901,27,1323079090,1323079090,1,1,0
42895575@N00,3902,17,1283253117,1283253117,1,1,0
42912996@N00,3903,27,1379626746,1379671725,5,6,44979
42912996@N00,3903,11,1379636025,1379636025,1,6,0
42912996@N00,3903,10,1379634757,1379634757,1,6,0
42912996@N00,3903,13,1379635176,1379635176,1,6,0
42912996@N00,3903,2,1379655359,1379655359,1,6,0
42912996@N00,3903,16,1379633552,1379633552,1,6,0
42912996@N00,3904,10,1380171915,1380171915,1,2,0
42912996@N00,3904,27,1380145686,1380173742,2,2,28056
42925588@N00,3905,27,1333404811,1333404811,1,2,0
42925588@N00,3905,8,1333406777,1333406777,1,2,0
42930817@N06,3906,21,1252722201,1252722201,1,1,0
42930817@N06,3907,4,1253237329,1253237336,2,1,7
42930817@N06,3908,2,1253408736,1253408736,1,2,0
42930817@N06,3908,27,1253404317,1253404434,3,2,117
42960193@N04,3909,27,1309791821,1309792565,6,1,744
42995562@N00,3910,14,1230945532,1230945532,1,1,0
43038803@N00,3911,26,1192430589,1192430602,2,3,13
43038803@N00,3911,2,1192430628,1192430628,1,3,0
43038803@N00,3911,12,1192430617,1192430617,1,3,0
43038803@N00,3912,9,1192507534,1192507534,1,4,0
43038803@N00,3912,27,1192506925,1192508251,6,4,1326
43038803@N00,3912,4,1192508082,1192508082,1,4,0
43038803@N00,3912,20,1192507918,1192507918,1,4,0
43074401@N07,3913,26,1386814356,1386814356,1,1,0
43082306@N00,3914,4,1195291327,1195291327,1,1,0
43082306@N00,3915,27,1211693563,1211693684,4,1,121
43082306@N00,3916,27,1213421433,1213421657,2,1,224
43082306@N00,3917,27,1215235963,1215235963,1,1,0
43082306@N00,3918,27,1216445777,1216446009,3,1,232
43082306@N00,3919,16,1217132301,1217132428,2,2,127
43082306@N00,3919,27,1217136992,1217136992,1,2,0
43082306@N00,3920,22,1222433648,1222433648,1,2,0
43082306@N00,3920,13,1222433619,1222433619,1,2,0
43082306@N00,3921,27,1223098617,1223098617,1,1,0
43082306@N00,3922,27,1223785726,1223786062,2,1,336
43082306@N00,3923,21,1224914077,1224914077,1,1,0
43082306@N00,3924,22,1225518090,1225518090,1,1,0
43082306@N00,3925,16,1226136552,1226136552,1,2,0
43082306@N00,3925,27,1226122952,1226122952,1,2,0
43082306@N00,3926,1,1227350888,1227350888,1,2,0
43082306@N00,3926,27,1227358032,1227358032,1,2,0
43082306@N00,3927,27,1227840179,1227874706,2,2,34527
43082306@N00,3927,9,1227864500,1227864500,1,2,0
43082306@N00,3928,16,1229756286,1229756286,1,2,0
43082306@N00,3928,3,1229758603,1229758603,1,2,0
43082306@N00,3929,5,1231584559,1231584559,1,1,0
43082306@N00,3930,4,1232785943,1232785943,2,1,0
43082306@N00,3931,5,1233373308,1233373308,1,2,0
43082306@N00,3931,27,1233376804,1233389321,4,2,12517
43082306@N00,3932,13,1234746977,1234746977,1,5,0
43082306@N00,3932,19,1234746403,1234746403,1,5,0
43082306@N00,3932,25,1234759647,1234759647,1,5,0
43082306@N00,3932,17,1234745675,1234745675,1,5,0
43082306@N00,3932,15,1234749345,1234749345,1,5,0
43082306@N00,3933,27,1235192442,1235192442,1,5,0
43082306@N00,3933,5,1235181131,1235181131,1,5,0
43082306@N00,3933,12,1235183875,1235183952,2,5,77
43082306@N00,3933,14,1235182189,1235182189,1,5,0
43082306@N00,3933,2,1235181755,1235181755,1,5,0
43082306@N00,3934,23,1235798550,1235798550,1,2,0
43082306@N00,3934,27,1235795557,1235796201,6,2,644
43082306@N00,3935,27,1241928388,1241928615,5,1,227
43082306@N00,3936,21,1243140069,1243140069,1,1,0
43082306@N00,3937,21,1243191213,1243191213,1,1,0
43082306@N00,3938,21,1243223398,1243223443,2,1,45
43082306@N00,3939,25,1246011905,1246011905,1,8,0
43082306@N00,3939,21,1246011136,1246011145,2,8,9
43082306@N00,3939,26,1246011767,1246011767,1,8,0
43082306@N00,3939,17,1246009346,1246009346,1,8,0
43082306@N00,3939,4,1246008456,1246008456,1,8,0
43082306@N00,3939,23,1246010044,1246010044,1,8,0
43082306@N00,3939,13,1246009319,1246009319,1,8,0
43082306@N00,3939,27,1246012214,1246018183,3,8,5969
43082306@N00,3940,12,1246157560,1246157560,1,2,0
43082306@N00,3940,17,1246171950,1246172090,2,2,140
43082306@N00,3941,21,1248331526,1248331526,1,2,0
43082306@N00,3941,23,1248331967,1248331967,1,2,0
43082306@N00,3942,12,1250138560,1250138560,1,1,0
43082306@N00,3943,27,1251082692,1251082692,1,1,0
43082306@N00,3944,21,1252032616,1252032616,1,1,0
43082306@N00,3945,21,1254618221,1254618221,1,3,0
43082306@N00,3945,27,1254608866,1254608866,1,3,0
43082306@N00,3945,19,1254610507,1254613185,2,3,2678
43082306@N00,3946,4,1255753267,1255753267,1,2,0
43082306@N00,3946,27,1255746978,1255746978,1,2,0
43082306@N00,3947,17,1256948690,1256948690,1,2,0
43082306@N00,3947,19,1256949079,1256949079,1,2,0
43082306@N00,3948,12,1257574868,1257574868,1,2,0
43082306@N00,3948,21,1257575656,1257575656,1,2,0
43082306@N00,3949,27,1261803424,1261803499,2,1,75
43082306@N00,3950,20,1263683331,1263683331,1,3,0
43082306@N00,3950,22,1263683902,1263683902,1,3,0
43082306@N00,3950,27,1263700605,1263700605,1,3,0
43082306@N00,3951,4,1265430436,1265430436,1,1,0
43082306@N00,3952,27,1266639351,1266639351,1,1,0
43082306@N00,3953,27,1267325019,1267325019,1,1,0
43082306@N00,3954,2,1267873589,1267874010,2,1,421
43082306@N00,3955,27,1270357051,1270357051,1,1,0
43082306@N00,3956,21,1270878061,1270878061,1,1,0
43082306@N00,3957,27,1273320314,1273320489,2,1,175
43082306@N00,3958,4,1273895621,1273895621,1,1,0
43082306@N00,3959,27,1275221398,1275221398,1,1,0
43082306@N00,3960,27,1275743291,1275744127,2,1,836
43082306@N00,3961,27,1278736705,1278736705,1,1,0
43082306@N00,3962,17,1280480751,1280480751,1,1,0
43082306@N00,3963,18,1282372899,1282372899,1,2,0
43082306@N00,3963,4,1282369110,1282370972,2,2,1862
43082306@N00,3964,27,1284789061,1284814750,3,2,25689
43082306@N00,3964,1,1284787108,1284787108,1,2,0
43082306@N00,3965,22,1286106248,1286106248,1,1,0
43082306@N00,3966,4,1287816523,1287816523,1,1,0
43082306@N00,3967,5,1291446222,1291446222,1,2,0
43082306@N00,3967,27,1291457988,1291460652,2,2,2664
43082306@N00,3968,27,1291896605,1291896605,1,1,0
43082306@N00,3969,13,1295753499,1295753625,3,1,126
43082306@N00,3970,27,1296902969,1296902969,1,1,0
43082306@N00,3971,16,1300438210,1300438210,1,1,0
43082306@N00,3972,27,1302412825,1302412940,2,1,115
43082306@N00,3973,3,1303557655,1303557655,1,3,0
43082306@N00,3973,13,1303547391,1303547391,1,3,0
43082306@N00,3973,16,1303554245,1303554245,1,3,0
43082306@N00,3974,21,1306567905,1306567905,1,1,0
43082306@N00,3975,21,1307109815,1307109815,1,3,0
43082306@N00,3975,26,1307112766,1307112766,1,3,0
43082306@N00,3975,20,1307111754,1307111754,1,3,0
43082306@N00,3976,9,1308449766,1308449766,1,6,0
43082306@N00,3976,22,1308445835,1308445835,1,6,0
43082306@N00,3976,4,1308455342,1308455342,1,6,0
43082306@N00,3976,17,1308446042,1308446042,1,6,0
43082306@N00,3976,19,1308456877,1308456877,1,6,0
43082306@N00,3976,27,1308456086,1308456086,1,6,0
43082306@N00,3977,19,1309664258,1309665059,2,3,801
43082306@N00,3977,18,1309665461,1309665461,1,3,0
43082306@N00,3977,20,1309663484,1309663484,1,3,0
43082306@N00,3978,4,1310879231,1310879231,1,1,0
43082306@N00,3979,3,1313208682,1313208682,1,1,0
43082306@N00,3980,16,1313768921,1313768921,1,1,0
43082306@N00,3981,27,1315051736,1315051736,1,1,0
43082306@N00,3982,3,1317179247,1317179247,1,1,0
43082306@N00,3983,27,1319190183,1319190183,1,2,0
43082306@N00,3983,22,1319197251,1319197251,1,2,0
43082306@N00,3984,27,1320508393,1320508393,1,3,0
43082306@N00,3984,21,1320504532,1320505034,2,3,502
43082306@N00,3984,26,1320501247,1320501247,1,3,0
43082306@N00,3985,16,1323642498,1323642846,6,1,348
43082306@N00,3986,22,1325227613,1325228294,11,1,681
43082306@N00,3987,17,1330456781,1330456781,1,1,0
43082306@N00,3988,8,1331544438,1331544438,1,1,0
43082306@N00,3989,13,1333536576,1333536576,1,1,0
43082306@N00,3990,8,1333864856,1333864856,1,3,0
43082306@N00,3990,9,1333876570,1333876570,1,3,0
43082306@N00,3990,17,1333869395,1333869395,1,3,0
43082306@N00,3991,27,1336215883,1336216341,2,2,458
43082306@N00,3991,12,1336209194,1336209227,2,2,33
43082306@N00,3992,18,1340789788,1340789788,1,1,0
43082306@N00,3993,26,1344047691,1344047691,1,2,0
43082306@N00,3993,17,1344047467,1344047467,1,2,0
43082306@N00,3994,8,1345211372,1345211372,1,1,0
43082306@N00,3995,26,1347626682,1347626683,2,1,1
43082306@N00,3996,27,1348375109,1348375109,1,1,0
43082306@N00,3997,10,1350088294,1350093328,2,1,5034
43082306@N00,3998,10,1350294710,1350294710,1,2,0
43082306@N00,3998,2,1350302498,1350302498,1,2,0
43082306@N00,3999,10,1353218610,1353218610,1,1,0
43082306@N00,4000,27,1354014148,1354018125,2,1,3977
43082306@N00,4001,10,1354329807,1354329807,1,1,0
43082306@N00,4002,27,1365854637,1365854637,1,1,0
43082306@N00,4003,20,1381579747,1381579747,1,1,0
43082306@N00,4004,15,1384515571,1384515571,1,2,0
43082306@N00,4004,27,1384508440,1384508440,1,2,0
43082306@N00,4005,15,1391856655,1391856655,1,1,0
43082306@N00,4006,10,1399104668,1399104668,1,1,0
43082306@N00,4007,10,1400996851,1400996857,2,1,6
43082306@N00,4008,27,1413538973,1413538989,2,1,16
43082306@N00,4009,16,1415009081,1415009081,1,1,0
43082306@N00,4010,27,1417694459,1417694973,2,1,514
43082306@N00,4011,13,1420952569,1420952569,1,1,0
43082306@N00,4012,13,1435904532,1435904740,2,1,208
43082306@N00,4013,27,1445186709,1445186709,1,1,0
43082306@N00,4014,27,1449312283,1449312283,1,1,0
43082306@N00,4015,27,1449571642,1449576719,3,1,5077
43108539@N03,4016,27,1278694366,1278694366,1,2,0
43108539@N03,4016,17,1278671709,1278671709,1,2,0
43108539@N03,4017,20,1279032703,1279032736,3,2,33
43108539@N03,4017,18,1279038769,1279039541,3,2,772
43108539@N03,4018,19,1279096394,1279096394,1,1,0
43122711@N02,4019,27,1272186636,1272186795,6,2,159
43122711@N02,4019,17,1272167075,1272167166,3,2,91
43122711@N02,4020,9,1272253534,1272253563,2,6,29
43122711@N02,4020,17,1272266584,1272266584,1,6,0
43122711@N02,4020,8,1272289034,1272289129,3,6,95
43122711@N02,4020,18,1272259758,1272260633,13,6,875
43122711@N02,4020,6,1272288344,1272288344,1,6,0
43122711@N02,4020,7,1272288465,1272288573,4,6,108
43122711@N02,4021,18,1272692656,1272692656,1,1,0
43122711@N02,4022,14,1307139410,1307139410,1,5,0
43122711@N02,4022,2,1307152016,1307152016,1,5,0
43122711@N02,4022,6,1307147845,1307147990,3,5,145
43122711@N02,4022,1,1307152280,1307152280,1,5,0
43122711@N02,4022,25,1307165664,1307165664,1,5,0
43122711@N02,4023,4,1307354166,1307354166,1,3,0
43122711@N02,4023,6,1307357732,1307357732,1,3,0
43122711@N02,4023,27,1307353322,1307353322,1,3,0
43186161@N04,4024,11,1254454348,1254454794,24,5,446
43186161@N04,4024,17,1254445319,1254445319,1,5,0
43186161@N04,4024,7,1254453396,1254453455,2,5,59
43186161@N04,4024,27,1254443406,1254465842,41,5,22436
43186161@N04,4024,8,1254453521,1254453882,14,5,361
43244835@N00,4025,6,1354358780,1354358780,1,1,0
43244835@N00,4026,17,1354496315,1354496718,3,3,403
43244835@N00,4026,16,1354518173,1354518173,1,3,0
43244835@N00,4026,15,1354520151,1354520151,1,3,0
43245053@N00,4027,16,1331362220,1331362220,1,1,0
43245053@N00,4028,13,1331442578,1331442607,2,1,29
43245053@N00,4029,16,1331898281,1331898281,1,1,0
43245053@N00,4030,13,1332758247,1332758247,1,4,0
43245053@N00,4030,27,1332758210,1332758210,1,4,0
43245053@N00,4030,16,1332756683,1332756696,2,4,13
43245053@N00,4030,1,1332756641,1332756641,1,4,0
43245053@N00,4031,13,1346851475,1346851475,1,3,0
43245053@N00,4031,22,1346851763,1346851763,1,3,0
43245053@N00,4031,16,1346851526,1346851526,1,3,0
43245053@N00,4032,27,1355009573,1355009573,1,2,0
43245053@N00,4032,14,1355015688,1355015688,1,2,0
43245053@N00,4033,26,1356530333,1356530333,1,1,0
43245053@N00,4034,13,1381107559,1381108468,2,1,909
43245053@N00,4035,9,1414881582,1414881596,2,1,14
43245053@N00,4036,16,1414913556,1414914592,2,1,1036
43266053@N00,4037,2,1278218965,1278218965,1,1,0
43266097@N03,4038,27,1456609211,1456611445,4,1,2234
43266097@N03,4039,27,1459308429,1459308445,18,1,16
43297700@N00,4040,17,1321953036,1321953036,1,1,0
43358741@N00,4041,14,1400992236,1401000946,2,2,8710
43358741@N00,4041,19,1400985550,1400985550,1,2,0
43391619@N06,4042,9,1195697083,1195697083,1,1,0
43391619@N06,4043,3,1252180894,1252181828,3,1,934
43391619@N06,4044,3,1258795834,1258795834,1,3,0
43391619@N06,4044,18,1258802140,1258802140,1,3,0
43391619@N06,4044,9,1258801435,1258801435,1,3,0
43391619@N06,4045,3,1266125755,1266125755,1,2,0
43391619@N06,4045,17,1266123396,1266123396,1,2,0
43391619@N06,4046,6,1269684165,1269684165,1,1,0
43391619@N06,4047,17,1275276936,1275277086,2,2,150
43391619@N06,4047,5,1275277427,1275277427,1,2,0
43391619@N06,4048,27,1278470802,1278470802,1,1,0
43391619@N06,4049,2,1283633390,1283633390,1,1,0
43391619@N06,4050,17,1283666773,1283666773,1,2,0
43391619@N06,4050,2,1283682649,1283682649,1,2,0
43391619@N06,4051,27,1293183554,1293183554,1,1,0
43391619@N06,4052,26,1293243739,1293243739,1,1,0
43391619@N06,4053,17,1296768940,1296768940,1,1,0
43441796@N06,4054,4,1325814018,1325814018,1,1,0
43511960@N08,4055,27,1334539705,1334539705,1,1,0
43535605@N00,4056,22,1360646343,1360646343,1,2,0
43535605@N00,4056,11,1360639272,1360639272,1,2,0
43545301@N03,4057,18,1331802652,1331802652,1,1,0
43549138@N00,4058,18,1229322641,1229322641,1,1,0
43549138@N00,4059,17,1231464809,1231464809,1,1,0
43549138@N00,4060,16,1254694615,1254694615,1,1,0
43608757@N08,4061,17,1455944945,1455945564,7,3,619
43608757@N08,4061,16,1455941502,1455942100,3,3,598
43608757@N08,4061,4,1455935056,1455935056,1,3,0
43612819@N03,4062,15,1188606476,1188606476,1,1,0
43612819@N03,4063,17,1268363840,1268363840,1,1,0
43612819@N03,4064,27,1337411422,1337411422,1,1,0
43612819@N03,4065,17,1337942570,1337942570,1,2,0
43612819@N03,4065,27,1337935627,1337939145,2,2,3518
43612819@N03,4066,25,1345258409,1345258409,1,1,0
43612819@N03,4067,22,1353319053,1353319053,1,1,0
43612819@N03,4068,26,1380331717,1380331717,1,1,0
43612819@N03,4069,25,1408227118,1408227118,1,1,0
43636216@N00,4070,4,1228777066,1228777066,1,3,0
43636216@N00,4070,9,1228782472,1228782472,1,3,0
43636216@N00,4070,27,1228775269,1228775269,1,3,0
43642153@N04,4071,10,1412210983,1412210983,1,8,0
43642153@N04,4071,1,1412229548,1412231216,2,8,1668
43642153@N04,4071,8,1412208976,1412208976,1,8,0
43642153@N04,4071,16,1412208323,1412208323,1,8,0
43642153@N04,4071,13,1412214495,1412214495,1,8,0
43642153@N04,4071,27,1412206043,1412207069,4,8,1026
43642153@N04,4071,22,1412236503,1412236503,1,8,0
43642153@N04,4071,2,1412225354,1412225354,1,8,0
43642153@N04,4072,20,1412569948,1412569948,1,6,0
43642153@N04,4072,7,1412548740,1412581161,2,6,32421
43642153@N04,4072,25,1412566901,1412566901,1,6,0
43642153@N04,4072,9,1412559324,1412574927,3,6,15603
43642153@N04,4072,17,1412568678,1412568678,1,6,0
43642153@N04,4072,14,1412555486,1412582453,4,6,26967
43643415@N07,4073,27,1293714128,1293714128,1,1,0
43649575@N03,4074,14,1398937663,1398937663,1,1,0
43652558@N00,4075,12,1462426221,1462426221,1,3,0
43652558@N00,4075,16,1462420319,1462420319,1,3,0
43652558@N00,4075,15,1462425156,1462425156,1,3,0
43652558@N00,4076,2,1462685710,1462685710,1,3,0
43652558@N00,4076,27,1462683337,1462683726,2,3,389
43652558@N00,4076,5,1462685151,1462685151,1,3,0
43652558@N00,4077,27,1463662617,1463662617,1,1,0
43652558@N00,4078,14,1463910375,1463913266,2,4,2891
43652558@N00,4078,12,1463913604,1463913645,2,4,41
43652558@N00,4078,16,1463910056,1463910091,2,4,35
43652558@N00,4078,10,1463911308,1463911942,2,4,634
43667163@N00,4079,12,1256367502,1256369546,4,12,2044
43667163@N00,4079,23,1256375406,1256375473,2,12,67
43667163@N00,4079,11,1256383993,1256383993,1,12,0
43667163@N00,4079,25,1256374534,1256381009,3,12,6475
43667163@N00,4079,13,1256371522,1256371522,1,12,0
43667163@N00,4079,20,1256384943,1256385214,2,12,271
43667163@N00,4079,2,1256365529,1256365553,2,12,24
43667163@N00,4079,17,1256384132,1256388860,3,12,4728
43667163@N00,4079,5,1256357786,1256358831,2,12,1045
43667163@N00,4079,22,1256386257,1256387361,6,12,1104
43667163@N00,4079,26,1256382407,1256382621,3,12,214
43667163@N00,4079,6,1256362299,1256362299,1,12,0
43676934@N06,4080,27,1253682300,1253682300,1,1,0
43679955@N05,4081,6,1261797310,1261797310,1,1,0
43681824@N00,4082,5,1212797646,1212799639,3,13,1993
43681824@N00,4082,22,1212812629,1212812634,2,13,5
43681824@N00,4082,12,1212815386,1212817238,6,13,1852
43681824@N00,4082,9,1212803764,1212804455,2,13,691
43681824@N00,4082,19,1212811198,1212811957,10,13,759
43681824@N00,4082,15,1212813421,1212813505,3,13,84
43681824@N00,4082,20,1212804720,1212810046,6,13,5326
43681824@N00,4082,4,1212796995,1212797050,3,13,55
43681824@N00,4082,27,1212796566,1212819904,10,13,23338
43681824@N00,4082,1,1212803205,1212803215,2,13,10
43681824@N00,4082,6,1212799664,1212800520,5,13,856
43681824@N00,4082,25,1212817761,1212817876,2,13,115
43681824@N00,4082,2,1212801705,1212801743,3,13,38
43681824@N00,4083,20,1232709875,1232709875,1,1,0
43700437@N06,4084,19,1362996361,1362996361,1,1,0
43700437@N06,4085,13,1364328258,1364328258,1,2,0
43700437@N06,4085,23,1364327926,1364327926,1,2,0
43700437@N06,4086,27,1368339865,1368339865,1,1,0
43700437@N06,4087,13,1371328213,1371328213,1,1,0
43700437@N06,4088,22,1373076643,1373076643,1,2,0
43700437@N06,4088,27,1373076455,1373076455,1,2,0
43700437@N06,4089,15,1376098643,1376098643,1,4,0
43700437@N06,4089,26,1376090724,1376090724,1,4,0
43700437@N06,4089,25,1376093827,1376093844,2,4,17
43700437@N06,4089,14,1376107389,1376107389,1,4,0
43700437@N06,4090,27,1392501337,1392501337,1,1,0
43700437@N06,4091,13,1393024571,1393024571,1,3,0
43700437@N06,4091,10,1393024886,1393024886,1,3,0
43700437@N06,4091,22,1393023428,1393023428,1,3,0
43700437@N06,4092,13,1394277109,1394277112,2,2,3
43700437@N06,4092,15,1394277145,1394277145,1,2,0
43700437@N06,4093,16,1401436442,1401436478,3,3,36
43700437@N06,4093,10,1401446748,1401446748,1,3,0
43700437@N06,4093,9,1401449585,1401449585,1,3,0
43700437@N06,4094,17,1402100259,1402100259,1,2,0
43700437@N06,4094,22,1402112460,1402112460,1,2,0
43700437@N06,4095,13,1405669509,1405669509,1,1,0
43700437@N06,4096,17,1420957179,1420957179,1,1,0
43700437@N06,4097,18,1440814605,1440814605,1,1,0
43808803@N00,4098,14,1462265964,1462265964,1,7,0
43808803@N00,4098,9,1462232927,1462232927,1,7,0
43808803@N00,4098,27,1462232401,1462232401,1,7,0
43808803@N00,4098,15,1462240840,1462242169,2,7,1329
43808803@N00,4098,20,1462237859,1462237897,2,7,38
43808803@N00,4098,26,1462253733,1462253733,1,7,0
43808803@N00,4098,25,1462262600,1462262600,1,7,0
43808803@N00,4099,22,1462421748,1462421748,1,2,0
43808803@N00,4099,27,1462429883,1462430289,3,2,406
43808803@N00,4100,27,1462757237,1462757237,1,1,0
43808803@N00,4101,15,1463012039,1463012039,1,1,0
43882213@N00,4102,2,1261469229,1261478879,6,12,9650
43882213@N00,4102,21,1261448523,1261448523,1,12,0
43882213@N00,4102,18,1261440925,1261453340,4,12,12415
43882213@N00,4102,17,1261440181,1261451906,2,12,11725
43882213@N00,4102,7,1261462110,1261469666,14,12,7556
43882213@N00,4102,24,1261443578,1261447505,7,12,3927
43882213@N00,4102,22,1261441097,1261443102,8,12,2005
43882213@N00,4102,1,1261476788,1261477328,2,12,540
43882213@N00,4102,14,1261456913,1261459900,5,12,2987
43882213@N00,4102,26,1261440786,1261450817,6,12,10031
43882213@N00,4102,27,1261438445,1261481721,7,12,43276
43882213@N00,4102,8,1261463369,1261464724,3,12,1355
43906182@N04,4103,18,1269587369,1269587401,2,2,32
43906182@N04,4103,27,1269587332,1269587332,1,2,0
43906182@N04,4104,18,1269814551,1269814551,1,1,0
43906182@N04,4105,18,1270074448,1270074448,1,1,0
43928881@N00,4106,27,1275301972,1275302531,2,1,559
43998338@N07,4107,16,1262323208,1262344776,2,1,21568
44022769@N00,4108,9,1344732642,1344732642,1,2,0
44022769@N00,4108,1,1344732579,1344732579,1,2,0
44023757@N04,4109,16,1321957597,1321966647,69,2,9050
44023757@N04,4109,27,1321957228,1321968590,8,2,11362
44023757@N04,4110,16,1352083216,1352104204,16,2,20988
44023757@N04,4110,27,1352089188,1352089188,1,2,0
44023757@N04,4111,11,1365306192,1365306718,9,2,526
44023757@N04,4111,9,1365306956,1365309479,43,2,2523
44033839@N05,4112,17,1288994415,1288994415,1,3,0
44033839@N05,4112,27,1288994416,1288994425,6,3,9
44033839@N05,4112,26,1288994414,1288994414,1,3,0
44082489@N00,4113,27,1230588994,1230605060,21,3,16066
44082489@N00,4113,13,1230597266,1230597327,2,3,61
44082489@N00,4113,16,1230589210,1230589210,1,3,0
44082489@N00,4114,16,1230638366,1230641888,6,4,3522
44082489@N00,4114,22,1230647028,1230647028,1,4,0
44082489@N00,4114,20,1230645494,1230645688,2,4,194
44082489@N00,4114,12,1230642516,1230642710,4,4,194
44082489@N00,4115,27,1261181012,1261181012,1,2,0
44082489@N00,4115,20,1261186558,1261186558,1,2,0
44082489@N00,4116,8,1395681214,1395681214,1,3,0
44082489@N00,4116,20,1395688079,1395688079,1,3,0
44082489@N00,4116,27,1395673334,1395718416,40,3,45082
44082489@N00,4117,27,1395929165,1395929165,1,2,0
44082489@N00,4117,23,1395928556,1395928556,1,2,0
44085687@N06,4118,22,1292689921,1292689921,1,1,0
44124305550@N01,4119,21,1189383939,1189384484,2,7,545
44124305550@N01,4119,2,1189387925,1189387925,1,7,0
44124305550@N01,4119,3,1189380177,1189380177,1,7,0
44124305550@N01,4119,4,1189378428,1189388159,4,7,9731
44124305550@N01,4119,1,1189387714,1189387714,1,7,0
44124305550@N01,4119,17,1189380497,1189380497,1,7,0
44124305550@N01,4119,27,1189377125,1189377270,2,7,145
44124305550@N01,4120,14,1189417733,1189417733,1,1,0
44124305550@N01,4121,21,1189770019,1189770019,1,1,0
44124305550@N01,4122,4,1189853044,1189853044,1,3,0
44124305550@N01,4122,13,1189846981,1189847099,2,3,118
44124305550@N01,4122,2,1189851083,1189851083,1,3,0
44124341154@N01,4123,1,1353195496,1353195496,1,9,0
44124341154@N01,4123,27,1353213634,1353213634,1,9,0
44124341154@N01,4123,7,1353195529,1353195537,2,9,8
44124341154@N01,4123,12,1353200513,1353200513,1,9,0
44124341154@N01,4123,15,1353200476,1353200476,1,9,0
44124341154@N01,4123,4,1353192047,1353192049,2,9,2
44124341154@N01,4123,20,1353208944,1353208963,3,9,19
44124341154@N01,4123,2,1353195458,1353195458,1,9,0
44124341154@N01,4123,6,1353195099,1353195648,6,9,549
44124341154@N01,4124,14,1353583690,1353583692,2,2,2
44124341154@N01,4124,12,1353583113,1353583113,1,2,0
44124341154@N01,4125,4,1353666278,1353666278,1,3,0
44124341154@N01,4125,27,1353663475,1353663475,1,3,0
44124341154@N01,4125,3,1353670095,1353670442,3,3,347
44124364198@N01,4126,25,1420493831,1420493831,1,2,0
44124364198@N01,4126,14,1420514025,1420514025,1,2,0
44124367235@N01,4127,6,1364764581,1364764581,1,2,0
44124367235@N01,4127,27,1364761722,1364761722,1,2,0
44124372331@N01,4128,13,1217193146,1217193146,1,2,0
44124372331@N01,4128,27,1217192103,1217192103,1,2,0
44124372331@N01,4129,16,1217330448,1217330448,1,3,0
44124372331@N01,4129,15,1217331335,1217331335,1,3,0
44124372331@N01,4129,14,1217330107,1217330800,8,3,693
44124372331@N01,4130,14,1217375167,1217379603,13,4,4436
44124372331@N01,4130,12,1217387810,1217388426,2,4,616
44124372331@N01,4130,17,1217396183,1217396183,1,4,0
44124372331@N01,4130,16,1217393383,1217395169,2,4,1786
44124377471@N01,4131,23,1306357833,1306357833,1,1,0
44124395373@N01,4132,27,1353542146,1353542146,1,5,0
44124395373@N01,4132,19,1353558593,1353558593,1,5,0
44124395373@N01,4132,25,1353555970,1353555970,1,5,0
44124395373@N01,4132,26,1353543560,1353543879,4,5,319
44124395373@N01,4132,22,1353543277,1353543277,1,5,0
44124395373@N01,4133,9,1353662592,1353662592,1,1,0
44124401501@N01,4134,27,1336809581,1336812488,8,1,2907
44124401501@N01,4135,1,1349009627,1349009627,1,2,0
44124401501@N01,4135,17,1349004690,1349005460,21,2,770
44124401501@N01,4136,5,1359873665,1359873665,1,1,0
44124401501@N01,4137,14,1360830341,1360832743,3,1,2402
44124401501@N01,4138,3,1384177951,1384177951,1,2,0
44124401501@N01,4138,2,1384178768,1384178832,2,2,64
44124401501@N01,4139,15,1385815971,1385816742,4,11,771
44124401501@N01,4139,17,1385813753,1385813886,8,11,133
44124401501@N01,4139,22,1385810079,1385812964,19,11,2885
44124401501@N01,4139,26,1385810190,1385810432,5,11,242
44124401501@N01,4139,6,1385817795,1385817813,2,11,18
44124401501@N01,4139,13,1385814788,1385815958,4,11,1170
44124401501@N01,4139,14,1385816917,1385817422,5,11,505
44124401501@N01,4139,27,1385806970,1385807949,6,11,979
44124401501@N01,4139,18,1385814049,1385814093,5,11,44
44124401501@N01,4139,9,1385817138,1385817688,8,11,550
44124401501@N01,4139,23,1385810684,1385811649,6,11,965
44124426205@N01,4140,27,1271738598,1271738598,1,1,0
44124426205@N01,4141,13,1352763539,1352763539,1,2,0
44124426205@N01,4141,14,1352770120,1352770120,1,2,0
44124426205@N01,4142,27,1352894621,1352894621,1,1,0
44124426205@N01,4143,13,1352957511,1352957511,1,1,0
44124426205@N01,4144,6,1385861491,1385861491,1,9,0
44124426205@N01,4144,21,1385870793,1385870793,1,9,0
44124426205@N01,4144,13,1385858685,1385858685,1,9,0
44124426205@N01,4144,16,1385887143,1385887143,1,9,0
44124426205@N01,4144,19,1385876414,1385876414,1,9,0
44124426205@N01,4144,17,1385866247,1385866247,1,9,0
44124426205@N01,4144,14,1385893126,1385893126,1,9,0
44124426205@N01,4144,24,1385851126,1385851126,1,9,0
44124426205@N01,4144,8,1385874461,1385874461,1,9,0
44124426205@N01,4145,16,1386153595,1386153595,1,1,0
44124426205@N01,4146,19,1386222515,1386222515,1,1,0
44124426205@N01,4147,13,1386292073,1386292772,2,4,699
44124426205@N01,4147,16,1386288194,1386288194,1,4,0
44124426205@N01,4147,26,1386294869,1386294869,1,4,0
44124426205@N01,4147,27,1386287137,1386287137,1,4,0
44124426205@N01,4148,13,1386385469,1386385469,1,2,0
44124426205@N01,4148,18,1386388016,1386388016,1,2,0
44124426205@N01,4149,10,1411350928,1411351647,2,1,719
44124426205@N01,4150,18,1411721210,1411721210,1,2,0
44124426205@N01,4150,27,1411719116,1411719116,1,2,0
44124427374@N01,4151,4,1201923543,1201923543,1,1,0
44124427374@N01,4152,27,1202024487,1202024487,1,1,0
44124427374@N01,4153,6,1202443249,1202443249,1,3,0
44124427374@N01,4153,2,1202454816,1202454816,1,3,0
44124427374@N01,4153,18,1202446772,1202448645,6,3,1873
44124427374@N01,4154,12,1202509680,1202510091,5,3,411
44124427374@N01,4154,2,1202522195,1202522195,1,3,0
44124427374@N01,4154,18,1202525670,1202526456,3,3,786
44124427374@N01,4155,12,1349137434,1349137572,4,3,138
44124427374@N01,4155,15,1349137367,1349137476,3,3,109
44124427374@N01,4155,13,1349137759,1349137759,1,3,0
44124427374@N01,4156,2,1415237009,1415238450,2,2,1441
44124427374@N01,4156,5,1415237137,1415237137,1,2,0
44124427374@N01,4157,2,1415576717,1415576717,1,2,0
44124427374@N01,4157,17,1415588565,1415588565,1,2,0
44124427374@N01,4158,21,1415667604,1415667604,1,2,0
44124427374@N01,4158,23,1415669408,1415669408,1,2,0
44124461706@N01,4159,12,1413454128,1413454128,1,2,0
44124461706@N01,4159,27,1413447140,1413447140,1,2,0
44124461706@N01,4160,24,1413686331,1413686413,3,3,82
44124461706@N01,4160,10,1413684480,1413684793,2,3,313
44124461706@N01,4160,3,1413692452,1413695181,3,3,2729
44124473586@N01,4161,14,1412296329,1412296329,1,1,0
44124478562@N01,4162,14,1317173815,1317174438,4,1,623
44124478562@N01,4163,27,1317203467,1317204585,4,1,1118
44125563@N00,4164,27,1301862175,1301862175,1,1,0
44125563@N00,4165,12,1301912012,1301912012,1,1,0
44164246@N00,4166,7,1250375554,1250375554,1,1,0
44164246@N00,4167,14,1267661492,1267661492,1,1,0
44164246@N00,4168,14,1293069160,1293070609,2,3,1449
44164246@N00,4168,23,1293065992,1293067052,3,3,1060
44164246@N00,4168,21,1293067107,1293068044,3,3,937
44164246@N00,4169,22,1327044463,1327044583,8,2,120
44164246@N00,4169,14,1327061813,1327061877,5,2,64
44178635@N08,4170,4,1256772407,1256772407,1,1,0
44225280@N00,4171,27,1192254929,1192254989,2,1,60
44275181@N00,4172,15,1425737389,1425737389,1,3,0
44275181@N00,4172,21,1425718042,1425718042,1,3,0
44275181@N00,4172,22,1425726338,1425726338,1,3,0
44275181@N00,4173,19,1442642759,1442642759,1,1,0
44275181@N00,4174,21,1450948471,1450948471,1,1,0
44307313@N04,4175,14,1310271173,1310289596,37,1,18423
44318907@N08,4176,20,1286102968,1286102968,1,3,0
44318907@N08,4176,4,1286101743,1286101743,1,3,0
44318907@N08,4176,14,1286110307,1286110307,1,3,0
44318907@N08,4177,27,1286409377,1286409377,1,4,0
44318907@N08,4177,17,1286408893,1286409753,3,4,860
44318907@N08,4177,26,1286408557,1286408557,1,4,0
44318907@N08,4177,4,1286389564,1286389564,1,4,0
44318907@N08,4178,19,1286546806,1286546806,1,1,0
44318907@N08,4179,20,1286707283,1286707283,1,2,0
44318907@N08,4179,13,1286706905,1286706905,1,2,0
44318907@N08,4180,16,1296630055,1296630629,5,1,574
44318907@N08,4181,16,1296960118,1296964532,2,2,4414
44318907@N08,4181,13,1296946937,1296946937,1,2,0
44318907@N08,4182,17,1305498152,1305498160,2,1,8
44318907@N08,4183,27,1305756950,1305756950,1,1,0
44318907@N08,4184,16,1305844574,1305844574,1,1,0
44318907@N08,4185,4,1306794271,1306794271,1,1,0
44318907@N08,4186,4,1307396806,1307396806,1,2,0
44318907@N08,4186,22,1307396799,1307396799,1,2,0
44318907@N08,4187,18,1309905156,1309905156,1,1,0
44318907@N08,4188,18,1317437248,1317459948,2,3,22700
44318907@N08,4188,13,1317437432,1317437432,1,3,0
44318907@N08,4188,27,1317461205,1317461205,1,3,0
44318907@N08,4189,20,1317685161,1317685161,1,4,0
44318907@N08,4189,13,1317671257,1317671321,2,4,64
44318907@N08,4189,21,1317682903,1317682903,1,4,0
44318907@N08,4189,1,1317677786,1317677786,1,4,0
44318907@N08,4190,13,1317894449,1317894728,2,4,279
44318907@N08,4190,21,1317871150,1317892095,2,4,20945
44318907@N08,4190,17,1317887473,1317887473,1,4,0
44318907@N08,4190,23,1317891516,1317891516,1,4,0
44318907@N08,4191,14,1329052234,1329052466,2,7,232
44318907@N08,4191,20,1329049775,1329049775,1,7,0
44318907@N08,4191,21,1329048205,1329048520,3,7,315
44318907@N08,4191,23,1329047921,1329047921,1,7,0
44318907@N08,4191,18,1329050882,1329050882,1,7,0
44318907@N08,4191,4,1329052926,1329052926,1,7,0
44318907@N08,4191,16,1329052083,1329052083,1,7,0
44318907@N08,4192,27,1329218028,1329218143,2,6,115
44318907@N08,4192,4,1329215623,1329215623,1,6,0
44318907@N08,4192,9,1329211555,1329211555,1,6,0
44318907@N08,4192,5,1329215367,1329215367,1,6,0
44318907@N08,4192,16,1329211884,1329212387,4,6,503
44318907@N08,4192,2,1329215309,1329215309,1,6,0
44318907@N08,4193,18,1329388873,1329388873,1,3,0
44318907@N08,4193,4,1329392508,1329392508,1,3,0
44318907@N08,4193,21,1329387099,1329387304,2,3,205
44318907@N08,4194,9,1347491646,1347491646,1,1,0
44318907@N08,4195,14,1361621875,1361622324,2,5,449
44318907@N08,4195,10,1361620681,1361620681,1,5,0
44318907@N08,4195,26,1361590074,1361590074,1,5,0
44318907@N08,4195,12,1361621506,1361621506,1,5,0
44318907@N08,4195,16,1361616845,1361616845,1,5,0
44318907@N08,4196,14,1361872508,1361874660,3,5,2152
44318907@N08,4196,13,1361870808,1361870808,1,5,0
44318907@N08,4196,27,1361877153,1361877153,1,5,0
44318907@N08,4196,10,1361872986,1361872986,1,5,0
44318907@N08,4196,12,1361849496,1361849496,1,5,0
44318907@N08,4197,14,1361963836,1361963836,1,3,0
44318907@N08,4197,9,1361962169,1361962169,1,3,0
44318907@N08,4197,22,1361958161,1361958161,1,3,0
44318907@N08,4198,14,1362029525,1362029525,1,4,0
44318907@N08,4198,12,1362030460,1362030460,1,4,0
44318907@N08,4198,17,1362027126,1362027126,1,4,0
44318907@N08,4198,16,1362031027,1362031815,2,4,788
44318907@N08,4199,21,1371902119,1371902119,1,5,0
44318907@N08,4199,23,1371902868,1371902868,1,5,0
44318907@N08,4199,15,1371903735,1371903735,1,5,0
44318907@N08,4199,4,1371904721,1371904721,1,5,0
44318907@N08,4199,20,1371901258,1371901258,1,5,0
44318907@N08,4200,21,1371964939,1371964939,1,1,0
44337661@N07,4201,17,1337921698,1337921698,1,6,0
44337661@N07,4201,27,1337943895,1337945035,10,6,1140
44337661@N07,4201,15,1337922904,1337922904,2,6,0
44337661@N07,4201,13,1337922884,1337922884,1,6,0
44337661@N07,4201,9,1337925730,1337925730,1,6,0
44337661@N07,4201,12,1337921711,1337921711,1,6,0
44375167@N00,4202,9,1324939188,1324939188,1,1,0
44437814@N00,4203,16,1319341395,1319341395,1,1,0
44437814@N00,4204,27,1440897760,1440897760,1,1,0
44458225@N00,4205,4,1325349615,1325349615,1,2,0
44458225@N00,4205,9,1325351366,1325351366,1,2,0
44458225@N00,4206,27,1338694553,1338694553,1,1,0
44458225@N00,4207,4,1343738183,1343738183,1,1,0
44490358@N04,4208,5,1192434816,1192434816,1,3,0
44490358@N04,4208,3,1192434340,1192434340,1,3,0
44490358@N04,4208,13,1192425996,1192426596,2,3,600
44490358@N04,4209,21,1308243329,1308243329,1,1,0
44490358@N04,4210,13,1312888664,1312888664,1,2,0
44490358@N04,4210,12,1312888234,1312888234,1,2,0
44490358@N04,4211,27,1315033777,1315033777,1,1,0
44490358@N04,4212,17,1315629143,1315629261,2,3,118
44490358@N04,4212,27,1315628130,1315628235,8,3,105
44490358@N04,4212,26,1315629284,1315629466,4,3,182
44490358@N04,4213,25,1322133300,1322134549,6,3,1249
44490358@N04,4213,17,1322135317,1322135422,3,3,105
44490358@N04,4213,26,1322133645,1322133675,2,3,30
44490358@N04,4214,23,1329340438,1329341235,2,8,797
44490358@N04,4214,3,1329348456,1329348759,2,8,303
44490358@N04,4214,4,1329351376,1329351376,1,8,0
44490358@N04,4214,9,1329346090,1329346769,2,8,679
44490358@N04,4214,24,1329341307,1329341307,1,8,0
44490358@N04,4214,14,1329343067,1329345320,4,8,2253
44490358@N04,4214,2,1329349669,1329350274,2,8,605
44490358@N04,4214,22,1329340751,1329340751,1,8,0
44510773@N08,4215,16,1314514325,1314514325,1,1,0
44510773@N08,4216,24,1355264153,1355264153,1,5,0
44510773@N08,4216,9,1355265157,1355265157,1,5,0
44510773@N08,4216,14,1355264443,1355265809,2,5,1366
44510773@N08,4216,2,1355264787,1355264787,1,5,0
44510773@N08,4216,18,1355263579,1355263579,1,5,0
44510773@N08,4217,14,1355424274,1355424274,1,3,0
44510773@N08,4217,6,1355425899,1355425919,2,3,20
44510773@N08,4217,16,1355433497,1355433497,1,3,0
44510773@N08,4218,27,1441111697,1441111697,1,1,0
44510773@N08,4219,17,1441333891,1441333891,1,1,0
44603553@N03,4220,16,1352623124,1352640846,5,1,17722
44633742@N02,4221,10,1278755236,1278755236,1,4,0
44633742@N02,4221,27,1278745871,1278745871,1,4,0
44633742@N02,4221,3,1278767258,1278767258,1,4,0
44633742@N02,4221,11,1278753970,1278753970,1,4,0
44649244@N00,4222,27,1193403837,1193404226,4,1,389
44679044@N07,4223,27,1368227568,1368227568,1,1,0
44684173@N00,4224,25,1311155846,1311155846,1,10,0
44684173@N00,4224,26,1311157260,1311160640,6,10,3380
44684173@N00,4224,15,1311135608,1311135608,1,10,0
44684173@N00,4224,2,1311145004,1311145075,4,10,71
44684173@N00,4224,20,1311154148,1311177402,2,10,23254
44684173@N00,4224,14,1311126133,1311136901,5,10,10768
44684173@N00,4224,3,1311141725,1311149580,9,10,7855
44684173@N00,4224,9,1311146564,1311167000,5,10,20436
44684173@N00,4224,19,1311133432,1311133432,1,10,0
44684173@N00,4224,17,1311163908,1311163908,1,10,0
44718928@N00,4225,4,1427796253,1427796253,1,1,0
44813763@N07,4226,6,1425255483,1425255483,1,2,0
44813763@N07,4226,2,1425277106,1425277330,2,2,224
44813763@N07,4227,27,1425535627,1425535627,1,2,0
44813763@N07,4227,14,1425523733,1425539013,6,2,15280
44816688@N00,4228,12,1410768383,1410768423,2,1,40
44816688@N00,4229,11,1430980398,1430980522,3,3,124
44816688@N00,4229,15,1430980548,1430980548,1,3,0
44816688@N00,4229,9,1430980201,1430980333,4,3,132
44816688@N00,4230,9,1432078204,1432078204,1,2,0
44816688@N00,4230,8,1432078289,1432078289,1,2,0
44816688@N00,4231,14,1439381757,1439381890,4,1,133
44816688@N00,4232,27,1454918751,1454918751,1,1,0
44861310@N03,4233,27,1349581750,1349581969,2,1,219
44867875@N00,4234,18,1353663230,1353663264,3,4,34
44867875@N00,4234,14,1353663176,1353663295,3,4,119
44867875@N00,4234,27,1353663326,1353663326,1,4,0
44867875@N00,4234,6,1353663203,1353663310,2,4,107
44867875@N00,4235,11,1353924972,1353924972,1,1,0
44867875@N00,4236,16,1385431950,1385431950,1,3,0
44867875@N00,4236,14,1385431531,1385431531,1,3,0
44867875@N00,4236,22,1385432672,1385432672,2,3,0
44888545@N00,4237,10,1356467756,1356467756,1,4,0
44888545@N00,4237,27,1356466004,1356466004,1,4,0
44888545@N00,4237,9,1356467909,1356467909,1,4,0
44888545@N00,4237,25,1356467842,1356467842,1,4,0
44888545@N00,4238,23,1419571668,1419571668,1,1,0
44914784@N04,4239,27,1260149892,1260149892,1,1,0
44948268@N02,4240,16,1327970722,1327971614,10,1,892
44948268@N02,4241,16,1328869871,1328869871,1,1,0
44948268@N02,4242,10,1399344552,1399344552,1,2,0
44948268@N02,4242,16,1399345570,1399345570,1,2,0
44948268@N02,4243,21,1399858331,1399858331,1,2,0
44948268@N02,4243,17,1399868671,1399868671,1,2,0
44948268@N02,4244,10,1399981025,1399981025,1,3,0
44948268@N02,4244,9,1399977446,1399977446,1,3,0
44948268@N02,4244,20,1399984536,1399984536,1,3,0
44948268@N02,4245,14,1400203988,1400203988,1,2,0
44948268@N02,4245,9,1400206756,1400206756,1,2,0
44948268@N02,4246,2,1422706715,1422706715,1,1,0
44948268@N02,4247,19,1423025858,1423025858,1,1,0
44957651@N00,4248,27,1320214686,1320214686,1,1,0
44978333@N06,4249,16,1293696352,1293699152,2,2,2800
44978333@N06,4249,14,1293686077,1293698807,2,2,12730
45023772@N03,4250,27,1361235802,1361235802,1,1,0
45032460@N06,4251,7,1380675957,1380676161,3,12,204
45032460@N06,4251,10,1380674641,1380674666,2,12,25
45032460@N06,4251,8,1380676144,1380676144,1,12,0
45032460@N06,4251,4,1380685968,1380685968,1,12,0
45032460@N06,4251,3,1380669296,1380669322,2,12,26
45032460@N06,4251,27,1380688287,1380703110,6,12,14823
45032460@N06,4251,23,1380707745,1380707745,1,12,0
45032460@N06,4251,22,1380709168,1380710031,7,12,863
45032460@N06,4251,6,1380672847,1380672847,1,12,0
45032460@N06,4251,20,1380703974,1380703974,1,12,0
45032460@N06,4251,17,1380703654,1380703654,1,12,0
45032460@N06,4251,9,1380673615,1380674115,6,12,500
45032460@N06,4252,13,1380866222,1380866222,1,10,0
45032460@N06,4252,17,1380849516,1380855304,8,10,5788
45032460@N06,4252,4,1380859038,1380862383,6,10,3345
45032460@N06,4252,16,1380862581,1380869157,11,10,6576
45032460@N06,4252,22,1380848469,1380848487,4,10,18
45032460@N06,4252,23,1380868383,1380868392,2,10,9
45032460@N06,4252,15,1380865432,1380865432,1,10,0
45032460@N06,4252,12,1380865418,1380865418,1,10,0
45032460@N06,4252,18,1380850986,1380852097,4,10,1111
45032460@N06,4252,26,1380849245,1380854715,3,10,5470
45032460@N06,4253,14,1380975903,1380975903,1,5,0
45032460@N06,4253,24,1380996816,1380996816,1,5,0
45032460@N06,4253,27,1380965075,1380965075,1,5,0
45032460@N06,4253,10,1380970451,1380975483,6,5,5032
45032460@N06,4253,9,1380969692,1380969841,2,5,149
45033503@N06,4254,13,1285628988,1285633009,2,1,4021
45033503@N06,4255,23,1285662138,1285662138,1,1,0
45033503@N06,4256,14,1290059720,1290059720,1,2,0
45033503@N06,4256,27,1290088007,1290088007,1,2,0
45033503@N06,4257,21,1290208980,1290208980,1,3,0
45033503@N06,4257,27,1290219571,1290219571,1,3,0
45033503@N06,4257,19,1290210834,1290210834,1,3,0
45033503@N06,4258,21,1305761804,1305761804,1,1,0
45033503@N06,4259,22,1307102637,1307102637,1,1,0
45033503@N06,4260,17,1307264144,1307264144,1,3,0
45033503@N06,4260,4,1307286302,1307286302,1,3,0
45033503@N06,4260,2,1307275727,1307275727,1,3,0
45033503@N06,4261,17,1315989007,1315989007,1,1,0
45067258@N00,4262,27,1318770770,1318770961,3,2,191
45067258@N00,4262,2,1318769621,1318769621,1,2,0
45067258@N00,4263,27,1339459293,1339459740,4,1,447
45067258@N00,4264,27,1339645785,1339652049,3,2,6264
45067258@N00,4264,21,1339647189,1339647189,1,2,0
45067258@N00,4265,27,1339823031,1339823043,2,3,12
45067258@N00,4265,11,1339824972,1339825824,12,3,852
45067258@N00,4265,8,1339825189,1339825352,3,3,163
45067258@N00,4266,17,1339891732,1339891737,2,1,5
45067258@N00,4267,27,1354748468,1354748468,1,1,0
45067258@N00,4268,27,1354791206,1354791206,1,1,0
45067258@N00,4269,27,1370235482,1370239242,37,1,3760
45067258@N00,4270,7,1383991909,1383991912,2,7,3
45067258@N00,4270,24,1383997811,1383998562,3,7,751
45067258@N00,4270,17,1383993277,1383996133,4,7,2856
45067258@N00,4270,19,1384001135,1384001147,3,7,12
45067258@N00,4270,26,1384002671,1384002671,1,7,0
45067258@N00,4270,23,1383997534,1383997534,1,7,0
45067258@N00,4270,18,1384001124,1384001124,1,7,0
45067258@N00,4271,6,1432239703,1432239825,3,2,122
45067258@N00,4271,27,1432237875,1432238124,8,2,249
45067258@N00,4272,17,1432291698,1432293998,23,3,2300
45067258@N00,4272,27,1432298223,1432298223,1,3,0
45067258@N00,4272,15,1432290239,1432290256,3,3,17
45067258@N00,4273,7,1432388973,1432389242,7,5,269
45067258@N00,4273,8,1432390376,1432390555,2,5,179
45067258@N00,4273,9,1432381890,1432392318,3,5,10428
45067258@N00,4273,14,1432397476,1432397510,2,5,34
45067258@N00,4273,15,1432394238,1432394238,1,5,0
45067258@N00,4274,10,1432809810,1432809863,4,7,53
45067258@N00,4274,26,1432791592,1432791592,1,7,0
45067258@N00,4274,18,1432807287,1432807287,1,7,0
45067258@N00,4274,11,1432809751,1432809751,1,7,0
45067258@N00,4274,21,1432792322,1432792322,1,7,0
45067258@N00,4274,20,1432793015,1432793093,4,7,78
45067258@N00,4274,15,1432808590,1432808590,1,7,0
45072542@N00,4275,21,1317274156,1317274160,2,3,4
45072542@N00,4275,27,1317269967,1317274829,7,3,4862
45072542@N00,4275,22,1317271665,1317273051,13,3,1386
45072542@N00,4276,5,1317432396,1317432975,16,8,579
45072542@N00,4276,6,1317433762,1317433762,1,8,0
45072542@N00,4276,17,1317426176,1317427138,24,8,962
45072542@N00,4276,4,1317433331,1317433331,1,8,0
45072542@N00,4276,2,1317433048,1317435033,8,8,1985
45072542@N00,4276,13,1317428190,1317429015,37,8,825
45072542@N00,4276,27,1317424667,1317425326,3,8,659
45072542@N00,4276,14,1317430995,1317431943,7,8,948
45072542@N00,4277,5,1317899040,1317899448,3,9,408
45072542@N00,4277,17,1317892474,1317893649,46,9,1175
45072542@N00,4277,4,1317898130,1317898819,3,9,689
45072542@N00,4277,16,1317894439,1317894443,2,9,4
45072542@N00,4277,21,1317889871,1317890723,10,9,852
45072542@N00,4277,14,1317893902,1317900336,30,9,6434
45072542@N00,4277,18,1317891084,1317893776,49,9,2692
45072542@N00,4277,27,1317889137,1317904193,9,9,15056
45072542@N00,4277,22,1317890919,1317890919,1,9,0
45083310@N06,4278,14,1353822773,1353822773,1,2,0
45083310@N06,4278,27,1353822723,1353822723,1,2,0
45083310@N06,4279,27,1357932665,1357932665,1,1,0
45083310@N06,4280,16,1358060711,1358060711,1,6,0
45083310@N06,4280,10,1358047223,1358047223,1,6,0
45083310@N06,4280,15,1358044461,1358044567,4,6,106
45083310@N06,4280,17,1358050802,1358050808,2,6,6
45083310@N06,4280,12,1358044680,1358044956,6,6,276
45083310@N06,4280,7,1358037552,1358037562,2,6,10
45088079@N00,4281,19,1315129745,1315129745,1,1,0
45088079@N00,4282,21,1315461069,1315461069,1,1,0
45130440@N03,4283,16,1368269016,1368269016,1,1,0
45130440@N03,4284,16,1368303038,1368303038,1,1,0
45130440@N03,4285,16,1368423536,1368423536,1,1,0
45151724@N00,4286,2,1443146538,1443146538,1,1,0
45182247@N06,4287,27,1384856928,1384856928,1,2,0
45182247@N06,4287,16,1384864667,1384864667,1,2,0
45188796@N06,4288,25,1281019046,1281019046,1,1,0
45194801@N03,4289,27,1300706998,1300706998,1,1,0
45212148@N07,4290,4,1326849955,1326850073,7,3,118
45212148@N07,4290,27,1326844059,1326849755,21,3,5696
45212148@N07,4290,3,1326850265,1326855419,9,3,5154
45264491@N00,4291,12,1347708478,1347708478,1,3,0
45264491@N00,4291,14,1347707452,1347707802,2,3,350
45264491@N00,4291,17,1347709422,1347709422,1,3,0
45264491@N00,4292,10,1351912608,1351912608,1,1,0
45265244@N07,4293,13,1305795480,1305795480,1,1,0
45297761@N02,4294,22,1229137733,1229141761,3,1,4028
45297761@N02,4295,22,1229201817,1229206722,10,1,4905
45297761@N02,4296,22,1229291340,1229311219,6,1,19879
45297761@N02,4297,22,1229376310,1229376310,1,1,0
45297761@N02,4298,22,1229458225,1229475246,4,1,17021
45313042@N08,4299,27,1286247424,1286247947,5,2,523
45313042@N08,4299,7,1286249614,1286249614,1,2,0
45313042@N08,4300,14,1323240750,1323240750,1,5,0
45313042@N08,4300,1,1323242368,1323242368,1,5,0
45313042@N08,4300,17,1323245748,1323245748,1,5,0
45313042@N08,4300,27,1323239737,1323240059,4,5,322
45313042@N08,4300,16,1323240662,1323240662,1,5,0
45409135@N00,4301,16,1431316041,1431316041,1,1,0
45504464@N00,4302,12,1207102635,1207118550,25,1,15915
45504464@N00,4303,12,1207174501,1207192402,40,1,17901
45504464@N00,4304,12,1207271624,1207291606,30,1,19982
45504464@N00,4305,12,1207436371,1207454959,30,1,18588
45514084@N03,4306,26,1275355467,1275355467,1,1,0
45537774@N02,4307,16,1312174747,1312174747,1,1,0
45561435@N00,4308,19,1295084400,1295084400,1,2,0
45561435@N00,4308,14,1295089240,1295089300,2,2,60
45561435@N00,4309,27,1295186108,1295186108,2,1,0
45561435@N00,4310,1,1295236108,1295239807,6,7,3699
45561435@N00,4310,16,1295243237,1295243237,1,7,0
45561435@N00,4310,17,1295243319,1295243351,4,7,32
45561435@N00,4310,19,1295231708,1295231708,1,7,0
45561435@N00,4310,14,1295243114,1295243221,5,7,107
45561435@N00,4310,9,1295243104,1295243104,1,7,0
45561435@N00,4310,27,1295244041,1295244175,4,7,134
45561435@N00,4311,20,1426498566,1426498566,1,2,0
45561435@N00,4311,27,1426507907,1426507952,2,2,45
45561435@N00,4312,1,1426759311,1426759311,1,7,0
45561435@N00,4312,4,1426762786,1426762786,1,7,0
45561435@N00,4312,3,1426758807,1426759193,2,7,386
45561435@N00,4312,2,1426757048,1426759261,2,7,2213
45561435@N00,4312,14,1426760073,1426760140,3,7,67
45561435@N00,4312,9,1426759899,1426759958,2,7,59
45561435@N00,4312,27,1426766370,1426766370,1,7,0
45571875@N06,4313,3,1266643669,1266643669,1,1,0
45571875@N06,4314,4,1326795022,1326800141,3,1,5119
45571875@N06,4315,11,1349755013,1349755013,1,4,0
45571875@N06,4315,27,1349751374,1349751374,1,4,0
45571875@N06,4315,9,1349752954,1349752954,1,4,0
45571875@N06,4315,14,1349752801,1349753963,6,4,1162
45571875@N06,4316,10,1350002708,1350004845,2,2,2137
45571875@N06,4316,9,1350002602,1350002602,1,2,0
45571875@N06,4317,14,1351137418,1351137418,1,2,0
45571875@N06,4317,9,1351137329,1351137329,1,2,0
45571875@N06,4318,22,1353499852,1353499852,1,5,0
45571875@N06,4318,26,1353499669,1353500119,3,5,450
45571875@N06,4318,16,1353504385,1353504385,1,5,0
45571875@N06,4318,7,1353503680,1353503680,1,5,0
45571875@N06,4318,27,1353507085,1353507342,2,5,257
45571875@N06,4319,9,1359526002,1359526002,1,4,0
45571875@N06,4319,19,1359522796,1359522796,1,4,0
45571875@N06,4319,10,1359531758,1359531758,1,4,0
45571875@N06,4319,20,1359522693,1359522693,1,4,0
45571875@N06,4320,9,1360145200,1360145200,1,2,0
45571875@N06,4320,14,1360145474,1360145474,1,2,0
45571875@N06,4321,7,1369420068,1369420068,1,1,0
45571875@N06,4322,10,1386599797,1386599797,1,1,0
45571875@N06,4323,27,1387853036,1387853036,1,1,0
45571875@N06,4324,3,1401199330,1401199330,1,1,0
45571875@N06,4325,27,1401255190,1401255190,1,1,0
45571875@N06,4326,22,1407301757,1407301943,2,2,186
45571875@N06,4326,14,1407305975,1407305975,1,2,0
45577837@N02,4327,16,1279735895,1279735895,1,2,0
45577837@N02,4327,4,1279730773,1279730773,1,2,0
45577837@N02,4328,24,1310397300,1310397300,1,1,0
45577837@N02,4329,23,1347364879,1347364879,1,1,0
45583433@N00,4330,23,1287205281,1287205281,1,5,0
45583433@N00,4330,14,1287216861,1287216861,1,5,0
45583433@N00,4330,22,1287203247,1287203247,1,5,0
45583433@N00,4330,18,1287201581,1287201581,1,5,0
45583433@N00,4330,21,1287210466,1287210466,1,5,0
45596886@N00,4331,16,1255901269,1255901269,1,2,0
45596886@N00,4331,14,1255904500,1255904500,1,2,0
45614589@N02,4332,27,1225503308,1225522280,7,1,18972
45614589@N02,4333,27,1226277219,1226280647,2,1,3428
45614589@N02,4334,27,1289086874,1289098234,3,1,11360
45614589@N02,4335,27,1290037913,1290047292,3,1,9379
45614589@N02,4336,27,1320531344,1320538297,4,1,6953
45614589@N02,4337,27,1320825778,1320836319,6,1,10541
45614589@N02,4338,27,1321569573,1321570889,2,1,1316
45614589@N02,4339,27,1351997705,1351997705,1,1,0
45614589@N02,4340,27,1352896496,1352896496,1,1,0
45618467@N03,4341,18,1260927258,1260927292,3,1,34
45621944@N00,4342,16,1260963653,1260963653,1,1,0
45632083@N00,4343,14,1411285720,1411285720,1,1,0
45632083@N00,4344,14,1412588351,1412588597,4,2,246
45632083@N00,4344,9,1412588960,1412589033,2,2,73
45653662@N06,4345,27,1271899798,1271900221,2,1,423
45676151@N08,4346,16,1226302624,1226302624,1,1,0
45681479@N04,4347,2,1298680763,1298681592,3,3,829
45681479@N04,4347,4,1298679809,1298680691,4,3,882
45681479@N04,4347,27,1298679185,1298679310,4,3,125
45681479@N04,4348,21,1298738833,1298738875,2,14,42
45681479@N04,4348,22,1298744825,1298744825,1,14,0
45681479@N04,4348,17,1298730294,1298761957,24,14,31663
45681479@N04,4348,9,1298726317,1298763372,10,14,37055
45681479@N04,4348,3,1298749055,1298750097,2,14,1042
45681479@N04,4348,26,1298723275,1298733923,6,14,10648
45681479@N04,4348,18,1298723044,1298751418,3,14,28374
45681479@N04,4348,24,1298735565,1298739265,4,14,3700
45681479@N04,4348,20,1298724451,1298724757,2,14,306
45681479@N04,4348,2,1298724866,1298726307,4,14,1441
45681479@N04,4348,25,1298750169,1298750916,2,14,747
45681479@N04,4348,4,1298766970,1298766970,1,14,0
45681479@N04,4348,27,1298722611,1298746693,4,14,24082
45681479@N04,4348,19,1298754098,1298757662,6,14,3564
45716980@N00,4349,22,1327463751,1327463755,2,14,4
45716980@N00,4349,18,1327464713,1327465823,3,14,1110
45716980@N00,4349,3,1327449641,1327449641,1,14,0
45716980@N00,4349,26,1327444349,1327444349,2,14,0
45716980@N00,4349,1,1327448899,1327448899,1,14,0
45716980@N00,4349,6,1327448356,1327449138,2,14,782
45716980@N00,4349,9,1327446456,1327447496,4,14,1040
45716980@N00,4349,17,1327444480,1327453480,5,14,9000
45716980@N00,4349,4,1327452178,1327479437,2,14,27259
45716980@N00,4349,24,1327444780,1327454814,3,14,10034
45716980@N00,4349,25,1327443103,1327479668,39,14,36565
45716980@N00,4349,16,1327453151,1327453151,1,14,0
45716980@N00,4349,27,1327441421,1327450049,13,14,8628
45716980@N00,4349,20,1327464160,1327464239,3,14,79
45716980@N00,4350,19,1362031553,1362031708,8,10,155
45716980@N00,4350,9,1362033935,1362034002,3,10,67
45716980@N00,4350,25,1362028784,1362029287,6,10,503
45716980@N00,4350,18,1362030864,1362032157,18,10,1293
45716980@N00,4350,16,1362027008,1362027008,1,10,0
45716980@N00,4350,14,1362032866,1362032866,1,10,0
45716980@N00,4350,27,1362028163,1362028163,1,10,0
45716980@N00,4350,26,1362028771,1362028771,1,10,0
45716980@N00,4350,10,1362033048,1362033546,3,10,498
45716980@N00,4350,22,1362031356,1362031356,1,10,0
45716980@N00,4351,16,1362091320,1362091320,1,1,0
45716980@N00,4352,16,1362179629,1362179629,1,2,0
45716980@N00,4352,14,1362176679,1362176679,1,2,0
45718773@N00,4353,16,1234704617,1234704617,1,1,0
45730150@N02,4354,16,1307955630,1307955630,1,1,0
45749280@N00,4355,4,1303942892,1303942892,1,11,0
45749280@N00,4355,2,1303943016,1303943016,1,11,0
45749280@N00,4355,19,1303949654,1303958468,3,11,8814
45749280@N00,4355,18,1303958215,1303958950,3,11,735
45749280@N00,4355,3,1303965078,1303965078,1,11,0
45749280@N00,4355,27,1303942114,1303942114,1,11,0
45749280@N00,4355,24,1303945753,1303946022,2,11,269
45749280@N00,4355,1,1303943167,1303943194,2,11,27
45749280@N00,4355,17,1303967112,1303967253,2,11,141
45749280@N00,4355,12,1303952985,1303953138,3,11,153
45749280@N00,4355,13,1303950910,1303951883,5,11,973
45749280@N00,4356,27,1304299033,1304299341,4,1,308
45749280@N00,4357,13,1304340479,1304341427,2,2,948
45749280@N00,4357,18,1304340351,1304340351,1,2,0
45749280@N00,4358,22,1413006797,1413006797,1,8,0
45749280@N00,4358,3,1412998596,1412998601,2,8,5
45749280@N00,4358,13,1413003251,1413003251,1,8,0
45749280@N00,4358,19,1413020911,1413024532,3,8,3621
45749280@N00,4358,17,1413027629,1413027629,1,8,0
45749280@N00,4358,18,1413023310,1413024651,4,8,1341
45749280@N00,4358,16,1413045446,1413046018,2,8,572
45749280@N00,4358,14,1413030155,1413045855,2,8,15700
45749280@N00,4359,27,1413731104,1413731920,3,2,816
45749280@N00,4359,13,1413727035,1413727542,5,2,507
45756179@N03,4360,21,1315981088,1315981088,1,9,0
45756179@N03,4360,14,1315979564,1315979564,1,9,0
45756179@N03,4360,26,1315980124,1315980124,1,9,0
45756179@N03,4360,16,1315979649,1315995003,2,9,15354
45756179@N03,4360,23,1315988620,1316004824,2,9,16204
45756179@N03,4360,13,1315993737,1315994627,3,9,890
45756179@N03,4360,27,1316012837,1316017235,5,9,4398
45756179@N03,4360,24,1316003430,1316003430,1,9,0
45756179@N03,4360,19,1315983302,1315991113,2,9,7811
45769608@N00,4361,9,1219805471,1219806401,2,1,930
45771081@N02,4362,16,1390343006,1390343006,1,1,0
45777165@N00,4363,27,1248181151,1248181151,1,2,0
45777165@N00,4363,14,1248175520,1248175520,1,2,0
45842774@N00,4364,16,1221959569,1221959569,1,2,0
45842774@N00,4364,8,1221961857,1221961857,2,2,0
45842774@N00,4365,20,1223347368,1223347368,1,1,0
45842774@N00,4366,27,1237943580,1237943580,1,1,0
45842774@N00,4367,16,1249217517,1249217517,1,2,0
45842774@N00,4367,14,1249216951,1249216951,1,2,0
45842774@N00,4368,18,1249359146,1249359146,1,4,0
45842774@N00,4368,14,1249380139,1249380148,2,4,9
45842774@N00,4368,17,1249359904,1249360075,2,4,171
45842774@N00,4368,15,1249360091,1249360198,2,4,107
45842803@N00,4369,16,1254529068,1254529068,1,5,0
45842803@N00,4369,19,1254525512,1254525512,1,5,0
45842803@N00,4369,24,1254530988,1254530993,2,5,5
45842803@N00,4369,25,1254524627,1254525046,5,5,419
45842803@N00,4369,17,1254528846,1254528846,1,5,0
45848087@N03,4370,15,1455517449,1455517449,1,1,0
45886439@N06,4371,16,1301723062,1301723062,1,1,0
45906008@N00,4372,27,1340578975,1340598451,16,1,19476
45913899@N02,4373,7,1354343263,1354343263,1,1,0
45936897@N07,4374,17,1292563717,1292563778,2,9,61
45936897@N07,4374,7,1292575974,1292576003,4,9,29
45936897@N07,4374,18,1292570335,1292570335,1,9,0
45936897@N07,4374,14,1292558671,1292560632,5,9,1961
45936897@N07,4374,21,1292566199,1292566199,1,9,0
45936897@N07,4374,1,1292575932,1292576018,3,9,86
45936897@N07,4374,3,1292577643,1292577684,2,9,41
45936897@N07,4374,22,1292563926,1292563926,1,9,0
45936897@N07,4374,27,1292557413,1292590048,5,9,32635
45959609@N00,4375,20,1343899311,1343899311,1,2,0
45959609@N00,4375,6,1343910500,1343910500,1,2,0
45959609@N00,4376,3,1368222339,1368224348,2,2,2009
45959609@N00,4376,1,1368224538,1368229995,2,2,5457
45959609@N00,4377,27,1368323543,1368323543,1,2,0
45959609@N00,4377,10,1368323359,1368323359,1,2,0
45959609@N00,4378,10,1374205421,1374205421,1,2,0
45959609@N00,4378,27,1374222323,1374222323,1,2,0
45959609@N00,4379,27,1393668054,1393668054,1,1,0
45959609@N00,4380,20,1407557109,1407557109,1,1,0
45959609@N00,4381,10,1429309651,1429309651,1,2,0
45959609@N00,4381,20,1429315303,1429315303,1,2,0
45968077@N02,4382,8,1350183134,1350183134,1,6,0
45968077@N02,4382,11,1350183149,1350183171,3,6,22
45968077@N02,4382,12,1350177323,1350177323,1,6,0
45968077@N02,4382,14,1350174329,1350174329,1,6,0
45968077@N02,4382,10,1350178184,1350179979,8,6,1795
45968077@N02,4382,27,1350172997,1350172997,1,6,0
46023761@N08,4383,16,1307787742,1307794364,25,3,6622
46023761@N08,4383,27,1307785931,1307796747,12,3,10816
46023761@N08,4383,4,1307787945,1307788819,6,3,874
46023761@N08,4384,16,1308224973,1308228301,17,2,3328
46023761@N08,4384,12,1308215152,1308215797,21,2,645
46027550@N00,4385,21,1236651278,1236651278,1,2,0
46027550@N00,4385,3,1236669810,1236669810,1,2,0
46027550@N00,4386,1,1236903769,1236903769,1,1,0
46050386@N03,4387,13,1242693624,1242697907,7,11,4283
46050386@N03,4387,20,1242687257,1242689259,20,11,2002
46050386@N03,4387,12,1242700501,1242701207,11,11,706
46050386@N03,4387,24,1242690856,1242690897,2,11,41
46050386@N03,4387,21,1242689382,1242690222,3,11,840
46050386@N03,4387,22,1242692867,1242692867,1,11,0
46050386@N03,4387,27,1242686608,1242686608,1,11,0
46050386@N03,4387,18,1242697565,1242697565,1,11,0
46050386@N03,4387,17,1242703181,1242703181,1,11,0
46050386@N03,4387,16,1242699855,1242699855,1,11,0
46050386@N03,4387,19,1242687325,1242687809,2,11,484
46050386@N03,4388,27,1242876446,1242876446,1,2,0
46050386@N03,4388,2,1242877054,1242877054,1,2,0
46050386@N03,4389,12,1242976255,1242976255,1,7,0
46050386@N03,4389,13,1242977174,1242977174,1,7,0
46050386@N03,4389,21,1242980829,1242980829,1,7,0
46050386@N03,4389,22,1242977555,1242978736,4,7,1181
46050386@N03,4389,20,1242979493,1242980293,7,7,800
46050386@N03,4389,26,1242977566,1242978638,5,7,1072
46050386@N03,4389,16,1242974625,1242974625,1,7,0
46050386@N03,4390,20,1262864791,1262864791,1,2,0
46050386@N03,4390,8,1262864767,1262864771,2,2,4
46050386@N03,4391,1,1280800791,1280800799,3,1,8
46083863@N06,4392,22,1319332213,1319332213,1,1,0
46108419@N00,4393,17,1257028762,1257031485,5,12,2723
46108419@N00,4393,16,1257027424,1257047265,10,12,19841
46108419@N00,4393,12,1257036687,1257036687,1,12,0
46108419@N00,4393,20,1257028951,1257028951,1,12,0
46108419@N00,4393,8,1257038435,1257044857,29,12,6422
46108419@N00,4393,26,1257029059,1257032893,14,12,3834
46108419@N00,4393,13,1257035581,1257036489,3,12,908
46108419@N00,4393,24,1257030031,1257030931,8,12,900
46108419@N00,4393,14,1257036888,1257038275,5,12,1387
46108419@N00,4393,18,1257028942,1257034279,11,12,5337
46108419@N00,4393,22,1257029223,1257029972,8,12,749
46108419@N00,4393,2,1257041098,1257041098,1,12,0
46108419@N00,4394,16,1452400924,1452400924,1,1,0
46229761@N02,4395,6,1307303373,1307303373,1,1,0
46229761@N02,4396,16,1307648494,1307648494,1,1,0
46272979@N08,4397,3,1293016472,1293016472,1,2,0
46272979@N08,4397,12,1293017969,1293017969,1,2,0
46328592@N00,4398,15,1267936455,1267942401,6,5,5946
46328592@N00,4398,21,1267924215,1267925112,2,5,897
46328592@N00,4398,27,1267921794,1267921794,1,5,0
46328592@N00,4398,26,1267930298,1267930677,4,5,379
46328592@N00,4398,19,1267928664,1267929402,6,5,738
46328592@N00,4399,21,1268960268,1268960268,1,1,0
46334439@N04,4400,16,1262939727,1262939746,2,1,19
46360199@N06,4401,27,1408231401,1408231401,1,1,0
46364076@N02,4402,16,1258746114,1258746172,3,1,58
46364076@N02,4403,16,1284879829,1284879966,32,1,137
46401409@N00,4404,27,1467176766,1467177264,4,1,498
46401409@N00,4405,14,1467206117,1467206372,2,1,255
46419214@N06,4406,8,1212398481,1212398481,1,1,0
46419214@N06,4407,16,1293444079,1293444079,1,1,0
46453719@N00,4408,2,1205706990,1205706990,1,6,0
46453719@N00,4408,11,1205709139,1205709139,1,6,0
46453719@N00,4408,21,1205713549,1205713549,1,6,0
46453719@N00,4408,20,1205698309,1205698309,1,6,0
46453719@N00,4408,1,1205730163,1205730163,1,6,0
46453719@N00,4408,15,1205709762,1205709821,2,6,59
46453719@N00,4409,18,1205922008,1205922008,1,1,0
46453719@N00,4410,25,1206053966,1206053966,1,1,0
46453719@N00,4411,13,1230615884,1230617534,2,1,1650
46514221@N03,4412,18,1392939817,1392939817,1,1,0
46592338@N04,4413,26,1274096921,1274096921,1,1,0
46602694@N00,4414,15,1294787375,1294787375,1,1,0
46602694@N00,4415,21,1317541505,1317541505,1,1,0
46602694@N00,4416,27,1317677077,1317677077,1,1,0
46602694@N00,4417,9,1355181081,1355181081,1,3,0
46602694@N00,4417,27,1355190823,1355190823,1,3,0
46602694@N00,4417,14,1355178010,1355178010,1,3,0
46602694@N00,4418,14,1355621437,1355621437,1,2,0
46602694@N00,4418,13,1355629571,1355629571,1,2,0
46602694@N00,4419,27,1357894375,1357894375,1,7,0
46602694@N00,4419,2,1357874981,1357874981,1,7,0
46602694@N00,4419,18,1357857678,1357859197,2,7,1519
46602694@N00,4419,17,1357853805,1357853805,1,7,0
46602694@N00,4419,15,1357853709,1357853709,1,7,0
46602694@N00,4419,1,1357876020,1357876020,1,7,0
46602694@N00,4419,14,1357852282,1357853104,2,7,822
46602694@N00,4420,21,1372307269,1372307269,1,1,0
46602694@N00,4421,8,1372486552,1372486552,1,1,0
46602694@N00,4422,16,1372554449,1372554449,1,1,0
46602694@N00,4423,21,1389505449,1389505449,1,2,0
46602694@N00,4423,16,1389502007,1389502007,1,2,0
46602694@N00,4424,14,1394411122,1394411122,1,1,0
46602694@N00,4425,17,1414812476,1414812476,1,1,0
46602694@N00,4426,27,1415362783,1415362783,1,2,0
46602694@N00,4426,20,1415361057,1415361057,1,2,0
46623443@N00,4427,27,1392468400,1392468400,1,2,0
46623443@N00,4427,24,1392439934,1392439934,1,2,0
46649528@N04,4428,27,1285328675,1285328795,2,1,120
46649528@N04,4429,27,1348565279,1348565279,1,1,0
46659210@N07,4430,13,1305770620,1305770620,1,1,0
46671006@N00,4431,1,1253407771,1253407771,1,2,0
46671006@N00,4431,27,1253404464,1253406908,6,2,2444
46724048@N00,4432,12,1294554976,1294555008,2,4,32
46724048@N00,4432,22,1294561266,1294561266,1,4,0
46724048@N00,4432,19,1294543366,1294543366,1,4,0
46724048@N00,4432,14,1294552477,1294552477,1,4,0
46724048@N00,4433,13,1295326873,1295326873,1,3,0
46724048@N00,4433,27,1295326253,1295335771,2,3,9518
46724048@N00,4433,16,1295326661,1295326661,1,3,0
46724048@N00,4434,4,1325988188,1325988188,1,1,0
46738052@N00,4435,21,1429576349,1429576349,1,2,0
46738052@N00,4435,23,1429576130,1429576130,1,2,0
46772713@N04,4436,16,1388056996,1388056996,1,1,0
46814333@N00,4437,4,1190960597,1190960597,1,1,0
46818794@N00,4438,5,1282530656,1282531093,17,1,437
46818794@N00,4439,5,1287726326,1287726326,1,1,0
46818794@N00,4440,21,1289979334,1289979544,2,1,210
46866350@N00,4441,3,1293837656,1293837705,3,9,49
46866350@N00,4441,9,1293840332,1293840524,2,9,192
46866350@N00,4441,27,1293836033,1293859758,3,9,23725
46866350@N00,4441,26,1293848372,1293848372,1,9,0
46866350@N00,4441,20,1293844999,1293844999,1,9,0
46866350@N00,4441,12,1293840126,1293840950,4,9,824
46866350@N00,4441,25,1293848482,1293848482,1,9,0
46866350@N00,4441,2,1293854827,1293854827,1,9,0
46866350@N00,4441,14,1293858755,1293858755,1,9,0
46879553@N00,4442,16,1210993073,1210993075,2,1,2
46993544@N00,4443,21,1419372557,1419372557,1,2,0
46993544@N00,4443,2,1419367477,1419367477,1,2,0
47003653@N00,4444,8,1396942992,1396942992,1,7,0
47003653@N00,4444,14,1396953395,1396953395,1,7,0
47003653@N00,4444,17,1396950641,1396950652,2,7,11
47003653@N00,4444,27,1396912822,1396955839,24,7,43017
47003653@N00,4444,12,1396916854,1396952666,2,7,35812
47003653@N00,4444,15,1396917103,1396952909,4,7,35806
47003653@N00,4444,13,1396951126,1396951134,2,7,8
47064447@N00,4445,6,1351332755,1351332755,1,2,0
47064447@N00,4445,27,1351332213,1351340105,4,2,7892
47087576@N00,4446,12,1212889240,1212889240,1,2,0
47087576@N00,4446,26,1212903620,1212917388,3,2,13768
47087576@N00,4447,4,1213152010,1213152010,1,3,0
47087576@N00,4447,14,1213181900,1213181900,1,3,0
47087576@N00,4447,26,1213153554,1213154760,2,3,1206
47125846@N08,4448,27,1268463888,1268464112,2,3,224
47125846@N08,4448,21,1268469052,1268469052,1,3,0
47125846@N08,4448,22,1268467902,1268467902,1,3,0
47125846@N08,4449,14,1273144300,1273144300,1,3,0
47125846@N08,4449,12,1273143717,1273143864,4,3,147
47125846@N08,4449,3,1273145859,1273145859,1,3,0
47125846@N08,4450,17,1280035116,1280035116,1,1,0
47125846@N08,4451,27,1282978258,1282979518,3,5,1260
47125846@N08,4451,13,1282986037,1282986037,1,5,0
47125846@N08,4451,5,1282987626,1282987626,1,5,0
47125846@N08,4451,16,1282987483,1282987483,1,5,0
47125846@N08,4451,4,1282998419,1282998419,1,5,0
47125846@N08,4452,24,1291876758,1291876803,2,6,45
47125846@N08,4452,21,1291875620,1291875882,2,6,262
47125846@N08,4452,18,1291872294,1291874200,2,6,1906
47125846@N08,4452,12,1291867056,1291867276,3,6,220
47125846@N08,4452,22,1291872769,1291872769,1,6,0
47125846@N08,4452,13,1291870074,1291871787,3,6,1713
47125846@N08,4453,14,1293715660,1293716276,2,2,616
47125846@N08,4453,9,1293714912,1293717518,2,2,2606
47125846@N08,4454,26,1294482449,1294482449,1,2,0
47125846@N08,4454,14,1294477410,1294477410,1,2,0
47125846@N08,4455,19,1295675480,1295675480,1,4,0
47125846@N08,4455,18,1295673059,1295675036,3,4,1977
47125846@N08,4455,25,1295670237,1295670237,1,4,0
47125846@N08,4455,21,1295672487,1295672487,1,4,0
47125846@N08,4456,19,1299198241,1299198241,1,5,0
47125846@N08,4456,20,1299194021,1299194021,1,5,0
47125846@N08,4456,21,1299196088,1299196133,2,5,45
47125846@N08,4456,17,1299192353,1299192353,1,5,0
47125846@N08,4456,15,1299203726,1299203726,1,5,0
47125846@N08,4457,3,1301217520,1301217520,1,2,0
47125846@N08,4457,23,1301223847,1301223847,1,2,0
47125846@N08,4458,18,1302173692,1302173692,1,4,0
47125846@N08,4458,13,1302167079,1302176121,6,4,9042
47125846@N08,4458,14,1302171030,1302171030,1,4,0
47125846@N08,4458,15,1302171773,1302171773,1,4,0
47125846@N08,4459,12,1304146832,1304146832,1,6,0
47125846@N08,4459,13,1304144428,1304145483,5,6,1055
47125846@N08,4459,23,1304141345,1304141345,1,6,0
47125846@N08,4459,24,1304139400,1304139813,2,6,413
47125846@N08,4459,27,1304130680,1304130680,1,6,0
47125846@N08,4459,9,1304149233,1304150631,3,6,1398
47125846@N08,4460,4,1305712167,1305714895,4,2,2728
47125846@N08,4460,5,1305714696,1305714696,1,2,0
47125846@N08,4461,4,1306573165,1306573503,2,4,338
47125846@N08,4461,15,1306585095,1306585095,1,4,0
47125846@N08,4461,26,1306576199,1306576199,1,4,0
47125846@N08,4461,13,1306575619,1306575632,2,4,13
47125846@N08,4462,20,1307107269,1307107269,1,2,0
47125846@N08,4462,26,1307099149,1307108975,3,2,9826
47125846@N08,4463,22,1309696537,1309696709,2,1,172
47125846@N08,4464,16,1313229930,1313229930,1,1,0
47125846@N08,4465,17,1315992205,1315992654,2,1,449
47125846@N08,4466,26,1317474334,1317474334,1,4,0
47125846@N08,4466,19,1317455657,1317459632,3,4,3975
47125846@N08,4466,2,1317478488,1317478488,1,4,0
47125846@N08,4466,15,1317475509,1317475509,1,4,0
47125846@N08,4467,26,1317546677,1317546677,1,3,0
47125846@N08,4467,17,1317544320,1317544320,1,3,0
47125846@N08,4467,13,1317557917,1317558336,5,3,419
47125846@N08,4468,23,1317640781,1317640930,2,2,149
47125846@N08,4468,27,1317644204,1317644204,1,2,0
47125846@N08,4469,6,1317804602,1317804602,1,2,0
47125846@N08,4469,17,1317803525,1317803525,1,2,0
47125846@N08,4470,17,1319287427,1319287427,1,1,0
47125846@N08,4471,21,1324633279,1324633279,1,1,0
47125846@N08,4472,4,1327820874,1327820874,1,1,0
47125846@N08,4473,3,1328355984,1328355984,1,2,0
47125846@N08,4473,4,1328353934,1328353934,1,2,0
47125846@N08,4474,6,1328518192,1328518192,1,1,0
47125846@N08,4475,17,1330460482,1330461028,2,4,546
47125846@N08,4475,24,1330461687,1330461687,1,4,0
47125846@N08,4475,16,1330456862,1330456862,1,4,0
47125846@N08,4475,26,1330462045,1330462045,1,4,0
47125846@N08,4476,21,1330773348,1330773348,1,1,0
47125846@N08,4477,8,1331538060,1331547768,6,1,9708
47125846@N08,4478,13,1333245666,1333245666,1,2,0
47125846@N08,4478,24,1333243460,1333249478,2,2,6018
47125846@N08,4479,22,1333863057,1333863057,1,1,0
47125846@N08,4480,27,1336212654,1336212654,1,1,0
47125846@N08,4481,2,1337253103,1337253103,1,1,0
47125846@N08,4482,4,1338197633,1338197633,1,1,0
47125846@N08,4483,2,1339845394,1339845394,1,1,0
47125846@N08,4484,3,1341296929,1341296929,1,1,0
47125846@N08,4485,20,1348996078,1348996078,1,4,0
47125846@N08,4485,22,1349007758,1349007758,1,4,0
47125846@N08,4485,27,1348968660,1349012894,7,4,44234
47125846@N08,4485,13,1349009988,1349010106,3,4,118
47125846@N08,4486,10,1350184720,1350184720,1,1,0
47125846@N08,4487,10,1351980021,1351980310,3,2,289
47125846@N08,4487,12,1351989377,1351989377,1,2,0
47125846@N08,4488,10,1354368192,1354368192,1,1,0
47125846@N08,4489,27,1354786686,1354787464,4,1,778
47125846@N08,4490,27,1356843832,1356843832,1,1,0
47125846@N08,4491,4,1359807819,1359807819,1,1,0
47125846@N08,4492,13,1363506878,1363506878,1,1,0
47125846@N08,4493,4,1373190414,1373190414,1,1,0
47125846@N08,4494,10,1373711310,1373712060,4,1,750
47125846@N08,4495,27,1378615201,1378615201,1,2,0
47125846@N08,4495,3,1378622403,1378622467,3,2,64
47125846@N08,4496,14,1379589142,1379589142,1,1,0
47125846@N08,4497,21,1381569698,1381569698,1,3,0
47125846@N08,4497,3,1381574302,1381574302,1,3,0
47125846@N08,4497,9,1381566321,1381566321,1,3,0
47125846@N08,4498,4,1383399046,1383399046,1,2,0
47125846@N08,4498,27,1383376970,1383376970,1,2,0
47125846@N08,4499,27,1386237571,1386244997,3,1,7426
47125846@N08,4500,13,1387627216,1387627216,1,1,0
47125846@N08,4501,10,1391861976,1391861976,1,1,0
47125846@N08,4502,16,1392627504,1392627504,1,5,0
47125846@N08,4502,10,1392630115,1392630983,2,5,868
47125846@N08,4502,22,1392620570,1392620570,1,5,0
47125846@N08,4502,17,1392627104,1392627104,1,5,0
47125846@N08,4502,14,1392635468,1392635468,1,5,0
47136771@N03,4503,17,1346499151,1346499482,2,2,331
47136771@N03,4503,27,1346502275,1346505537,16,2,3262
47136771@N03,4504,4,1347094656,1347095805,2,1,1149
47136771@N03,4505,27,1347421760,1347421837,2,3,77
47136771@N03,4505,4,1347429226,1347429226,2,3,0
47136771@N03,4505,20,1347417646,1347417646,1,3,0
47136771@N03,4506,27,1347536843,1347536843,1,1,0
47136771@N03,4507,8,1347582244,1347582244,1,2,0
47136771@N03,4507,9,1347581404,1347581404,1,2,0
47189760@N05,4508,16,1359215632,1359215808,3,2,176
47189760@N05,4508,9,1359215548,1359215548,1,2,0
47189760@N05,4509,9,1359539102,1359539246,3,5,144
47189760@N05,4509,8,1359539308,1359539388,3,5,80
47189760@N05,4509,10,1359536997,1359538971,6,5,1974
47189760@N05,4509,27,1359536921,1359536921,1,5,0
47189760@N05,4509,1,1359529260,1359529260,1,5,0
47223527@N05,4510,27,1412312075,1412312075,1,1,0
47340152@N06,4511,23,1352714658,1352714658,1,1,0
47343648@N04,4512,5,1271141627,1271141627,1,2,0
47343648@N04,4512,27,1271152501,1271152501,1,2,0
47363316@N08,4513,9,1330058225,1330058225,1,2,0
47363316@N08,4513,27,1330046891,1330046891,1,2,0
47365658@N00,4514,6,1278682590,1278682590,1,1,0
47373126@N03,4515,16,1292740236,1292740236,1,1,0
47391741@N04,4516,27,1310097121,1310097350,2,1,229
47423151@N06,4517,16,1318324484,1318324484,1,4,0
47423151@N06,4517,3,1318295723,1318295723,1,4,0
47423151@N06,4517,13,1318324532,1318335253,2,4,10721
47423151@N06,4517,14,1318319344,1318319344,1,4,0
47423151@N06,4518,27,1318370238,1318370238,1,1,0
47423151@N06,4519,14,1321347747,1321347747,1,1,0
47423151@N06,4520,27,1368864895,1368864895,1,1,0
47423151@N06,4521,19,1380778224,1380778224,1,1,0
47423151@N06,4522,16,1381155408,1381155408,1,1,0
47423151@N06,4523,25,1399632843,1399632843,1,2,0
47423151@N06,4523,15,1399618074,1399618074,1,2,0
47423151@N06,4524,14,1415507052,1415507052,1,1,0
47473683@N06,4525,4,1265792943,1265792943,1,1,0
47522010@N03,4526,16,1302086516,1302086516,1,1,0
47522010@N03,4527,25,1316769260,1316769260,1,1,0
47567986@N00,4528,17,1303348054,1303362544,5,1,14490
47580197@N07,4529,4,1279309891,1279361975,176,2,52084
47580197@N07,4529,22,1279361985,1279365017,58,2,3032
47580197@N07,4530,22,1279401403,1279453225,100,1,51822
47580197@N07,4531,22,1279489673,1279491931,9,2,2258
47580197@N07,4531,21,1279497263,1279497263,1,2,0
47597914@N00,4532,4,1298517675,1298518068,3,6,393
47597914@N00,4532,25,1298492902,1298511004,3,6,18102
47597914@N00,4532,9,1298521929,1298532305,3,6,10376
47597914@N00,4532,1,1298516127,1298516127,1,6,0
47597914@N00,4532,18,1298503228,1298503228,1,6,0
47597914@N00,4532,2,1298515124,1298515269,2,6,145
47606840@N00,4533,16,1379894231,1379894324,2,4,93
47606840@N00,4533,18,1379893049,1379893080,2,4,31
47606840@N00,4533,3,1379894716,1379894716,1,4,0
47606840@N00,4533,15,1379890290,1379890290,1,4,0
47615165@N04,4534,7,1357878251,1357878251,1,5,0
47615165@N04,4534,8,1357878332,1357878332,1,5,0
47615165@N04,4534,14,1357872430,1357873027,4,5,597
47615165@N04,4534,16,1357870096,1357883710,11,5,13614
47615165@N04,4534,10,1357872812,1357893843,15,5,21031
47615165@N04,4535,17,1358016091,1358016091,1,2,0
47615165@N04,4535,16,1358015942,1358022426,26,2,6484
47615165@N04,4536,27,1358066845,1358067049,5,1,204
47615165@N04,4537,10,1358212366,1358212366,1,4,0
47615165@N04,4537,27,1358200467,1358200512,3,4,45
47615165@N04,4537,17,1358212327,1358212327,1,4,0
47615165@N04,4537,16,1358215706,1358217946,12,4,2240
47705525@N06,4538,3,1304670241,1304670241,1,3,0
47705525@N06,4538,4,1304670208,1304670295,2,3,87
47705525@N06,4538,16,1304670178,1304670178,1,3,0
47705525@N06,4539,4,1306240194,1306240194,1,2,0
47705525@N06,4539,16,1306240136,1306240136,1,2,0
47705525@N06,4540,16,1306315910,1306316224,3,1,314
47705525@N06,4541,27,1307077002,1307077042,2,2,40
47705525@N06,4541,16,1307073952,1307077139,3,2,3187
47705525@N06,4542,27,1308285043,1308285073,4,2,30
47705525@N06,4542,14,1308285056,1308285062,2,2,6
47705525@N06,4543,27,1308375224,1308402384,34,1,27160
47705525@N06,4544,27,1313044046,1313044061,4,1,15
47705525@N06,4545,14,1440839652,1440839652,1,1,0
47722545@N00,4546,23,1355654410,1355654410,1,1,0
47743387@N07,4547,14,1416284005,1416284005,1,1,0
47762796@N03,4548,2,1274687060,1274687060,1,2,0
47762796@N03,4548,16,1274686970,1274686970,1,2,0
47785122@N06,4549,16,1346632447,1346632447,1,1,0
47785122@N06,4550,16,1354400160,1354400160,1,1,0
47785122@N06,4551,3,1363909370,1363909370,1,2,0
47785122@N06,4551,27,1363910006,1363910006,1,2,0
47785122@N06,4552,1,1367716178,1367716178,1,1,0
47785122@N06,4553,27,1372765252,1372767548,3,1,2296
47785122@N06,4554,19,1378890616,1378890616,1,1,0
47785122@N06,4555,3,1381570706,1381570706,1,2,0
47785122@N06,4555,27,1381569024,1381569024,1,2,0
47785122@N06,4556,27,1393131762,1393131762,1,1,0
47845995@N00,4557,15,1338787654,1338787654,1,3,0
47845995@N00,4557,27,1338807066,1338807890,2,3,824
47845995@N00,4557,17,1338776806,1338776806,1,3,0
47861479@N02,4558,14,1355632984,1355632984,1,2,0
47861479@N02,4558,10,1355607433,1355607433,1,2,0
47861479@N02,4559,27,1355949456,1355949456,1,1,0
47861479@N02,4560,20,1381445421,1381446187,3,1,766
47861479@N02,4561,27,1381478397,1381493873,3,1,15476
47861479@N02,4562,13,1381710326,1381710523,3,2,197
47861479@N02,4562,20,1381719677,1381719677,1,2,0
47861479@N02,4563,14,1403513114,1403513114,1,1,0
47861479@N02,4564,27,1403697490,1403697490,1,1,0
47861479@N02,4565,14,1409284332,1409284332,1,3,0
47861479@N02,4565,27,1409281553,1409281634,2,3,81
47861479@N02,4565,20,1409288449,1409288449,1,3,0
47861479@N02,4566,10,1418529795,1418529795,1,4,0
47861479@N02,4566,27,1418549360,1418549360,1,4,0
47861479@N02,4566,16,1418534247,1418538073,5,4,3826
47861479@N02,4566,1,1418527871,1418527871,1,4,0
47861479@N02,4567,27,1418802318,1418802318,1,1,0
47861479@N02,4568,27,1419031191,1419033676,5,1,2485
47861479@N02,4569,8,1432459499,1432459499,1,1,0
47861479@N02,4570,19,1432890470,1432890470,1,1,0
47918842@N00,4571,16,1332888720,1332888720,1,1,0
47918842@N00,4572,14,1332919065,1332919065,1,1,0
47918842@N00,4573,4,1332977644,1332977644,1,1,0
47943464@N06,4574,27,1318326737,1318326737,1,1,0
47953780@N07,4575,2,1400044458,1400044458,1,2,0
47953780@N07,4575,27,1400030866,1400030866,1,2,0
48075944@N06,4576,17,1274584568,1274584568,1,1,0
48105777@N00,4577,18,1275456621,1275456621,1,2,0
48105777@N00,4577,27,1275442628,1275442628,1,2,0
48105777@N00,4578,10,1370051455,1370063766,5,1,12311
48105777@N00,4579,27,1370168293,1370168293,1,3,0
48105777@N00,4579,19,1370169132,1370169132,1,3,0
48105777@N00,4579,17,1370168521,1370168528,2,3,7
48105777@N00,4580,20,1370250043,1370250043,1,1,0
48144132@N06,4581,16,1268962982,1268962982,1,1,0
48152295@N00,4582,27,1377957600,1377957600,1,1,0
48257423@N02,4583,23,1300529050,1300529050,1,1,0
48271781@N00,4584,14,1275704865,1275704865,1,10,0
48271781@N00,4584,16,1275734630,1275734630,1,10,0
48271781@N00,4584,1,1275696668,1275696668,1,10,0
48271781@N00,4584,5,1275701532,1275701532,1,10,0
48271781@N00,4584,7,1275703845,1275703845,1,10,0
48271781@N00,4584,9,1275700673,1275704186,5,10,3513
48271781@N00,4584,2,1275701504,1275701504,1,10,0
48271781@N00,4584,17,1275734705,1275737635,12,10,2930
48271781@N00,4584,19,1275710434,1275710562,4,10,128
48271781@N00,4584,3,1275699639,1275699639,1,10,0
48271781@N00,4585,27,1345344535,1345344690,2,1,155
48275668@N02,4586,21,1340314524,1340314524,1,1,0
48275668@N02,4587,14,1340493291,1340493291,1,1,0
48275668@N02,4588,9,1347162443,1347162443,1,5,0
48275668@N02,4588,10,1347120825,1347120825,1,5,0
48275668@N02,4588,15,1347116672,1347116672,1,5,0
48275668@N02,4588,27,1347100839,1347126476,2,5,25637
48275668@N02,4588,14,1347154174,1347154257,2,5,83
48275668@N02,4589,26,1347286434,1347286434,1,4,0
48275668@N02,4589,17,1347303284,1347303284,1,4,0
48275668@N02,4589,23,1347285611,1347285611,1,4,0
48275668@N02,4589,12,1347293324,1347293656,3,4,332
48275668@N02,4590,14,1350310986,1350310986,1,3,0
48275668@N02,4590,9,1350310871,1350310871,1,3,0
48275668@N02,4590,16,1350310734,1350311528,2,3,794
48275668@N02,4591,17,1350392935,1350392935,1,5,0
48275668@N02,4591,27,1350394279,1350394279,1,5,0
48275668@N02,4591,12,1350394504,1350394504,1,5,0
48275668@N02,4591,20,1350392563,1350393241,2,5,678
48275668@N02,4591,18,1350393138,1350393138,1,5,0
48275668@N02,4592,3,1350535689,1350535689,1,5,0
48275668@N02,4592,16,1350535871,1350535871,1,5,0
48275668@N02,4592,27,1350533654,1350535202,6,5,1548
48275668@N02,4592,6,1350532619,1350532619,1,5,0
48275668@N02,4592,7,1350533125,1350533125,1,5,0
48275668@N02,4593,27,1350632362,1350633471,3,1,1109
48275668@N02,4594,23,1359360557,1359360557,1,1,0
48275668@N02,4595,27,1363510087,1363510087,1,1,0
48275668@N02,4596,5,1363669475,1363669475,1,1,0
48275668@N02,4597,16,1374307081,1374307081,1,1,0
48275668@N02,4598,20,1410344705,1410344705,1,2,0
48275668@N02,4598,26,1410341994,1410341994,1,2,0
48275668@N02,4599,17,1418789532,1418789532,1,1,0
48275668@N02,4600,17,1425762896,1425762896,1,1,0
48275668@N02,4601,25,1450234748,1450234748,1,1,0
48275668@N02,4602,19,1457394277,1457394277,1,1,0
48275668@N02,4603,13,1457520739,1457520739,1,1,0
48275668@N02,4604,25,1468971546,1468971546,1,1,0
48275668@N02,4605,4,1469156307,1469156307,1,1,0
48279300@N00,4606,21,1444968497,1444968497,1,1,0
48279300@N00,4607,3,1445119292,1445119292,1,1,0
48311919@N00,4608,18,1367108711,1367108711,1,1,0
48311919@N00,4609,20,1415672654,1415672744,4,12,90
48311919@N00,4609,14,1415675082,1415676154,21,12,1072
48311919@N00,4609,24,1415669911,1415673873,17,12,3962
48311919@N00,4609,16,1415672181,1415672197,3,12,16
48311919@N00,4609,13,1415668918,1415678465,9,12,9547
48311919@N00,4609,1,1415677628,1415677628,1,12,0
48311919@N00,4609,18,1415669281,1415678902,4,12,9621
48311919@N00,4609,21,1415672883,1415672974,6,12,91
48311919@N00,4609,19,1415678936,1415679217,13,12,281
48311919@N00,4609,26,1415669221,1415669314,5,12,93
48311919@N00,4609,17,1415669119,1415678771,10,12,9652
48311919@N00,4609,27,1415681085,1415681789,11,12,704
48311919@N00,4610,14,1418453608,1418458196,14,3,4588
48311919@N00,4610,27,1418461123,1418461913,9,3,790
48311919@N00,4610,16,1418458723,1418460582,12,3,1859
48311919@N00,4611,27,1423368622,1423385354,6,4,16732
48311919@N00,4611,21,1423369072,1423369461,8,4,389
48311919@N00,4611,1,1423371004,1423373766,5,4,2762
48311919@N00,4611,14,1423375483,1423384951,40,4,9468
48311919@N00,4612,27,1423713811,1423713811,1,1,0
48311919@N00,4613,27,1426300931,1426300942,2,3,11
48311919@N00,4613,17,1426293073,1426296981,25,3,3908
48311919@N00,4613,16,1426290378,1426300939,191,3,10561
48311919@N00,4614,27,1430803848,1430805975,83,2,2127
48311919@N00,4614,17,1430806862,1430824592,40,2,17730
48311919@N00,4615,20,1440818305,1440818387,7,3,82
48311919@N00,4615,14,1440807422,1440815484,31,3,8062
48311919@N00,4615,9,1440808391,1440808391,1,3,0
48427787@N00,4616,14,1320361677,1320361677,1,4,0
48427787@N00,4616,12,1320361684,1320361720,4,4,36
48427787@N00,4616,21,1320365146,1320365150,2,4,4
48427787@N00,4616,4,1320359155,1320359192,2,4,37
48427787@N00,4617,16,1320487979,1320487979,1,8,0
48427787@N00,4617,14,1320487796,1320487962,2,8,166
48427787@N00,4617,21,1320484681,1320484687,2,8,6
48427787@N00,4617,27,1320480961,1320481530,12,8,569
48427787@N00,4617,12,1320486607,1320486607,1,8,0
48427787@N00,4617,18,1320486127,1320486163,2,8,36
48427787@N00,4617,17,1320481993,1320481993,1,8,0
48427787@N00,4617,13,1320486354,1320487505,2,8,1151
48427787@N00,4618,25,1320624091,1320625919,3,3,1828
48427787@N00,4618,27,1320618187,1320628245,7,3,10058
48427787@N00,4618,4,1320620141,1320620204,2,3,63
48481127@N08,4619,16,1356924051,1356937842,3,3,13791
48481127@N08,4619,14,1356933994,1356933994,1,3,0
48481127@N08,4619,1,1356905962,1356905962,1,3,0
48481127@N08,4620,20,1372553473,1372553473,1,2,0
48481127@N08,4620,15,1372546023,1372546023,1,2,0
48494440@N04,4621,16,1253489092,1253489092,1,1,0
48494440@N04,4622,27,1322974987,1322974987,1,1,0
48513718@N02,4623,2,1221954900,1221954900,1,1,0
48513718@N02,4624,6,1253403430,1253403430,1,1,0
48513718@N02,4625,27,1253834829,1253846830,2,1,12001
48513718@N02,4626,6,1269082371,1269082371,1,1,0
48600084713@N01,4627,16,1314234768,1314234768,1,2,0
48600084713@N01,4627,14,1314234765,1314234765,1,2,0
48600084713@N01,4628,4,1314360770,1314360770,1,1,0
48600084713@N01,4629,9,1314601278,1314601341,3,1,63
48600084713@N01,4630,6,1314761980,1314761980,1,1,0
48600084713@N01,4631,14,1351851193,1351851193,1,1,0
48600085633@N01,4632,22,1204320187,1204322788,25,1,2601
48603464@N05,4633,8,1458172481,1458172481,1,2,0
48603464@N05,4633,27,1458160825,1458174643,4,2,13818
48624550@N00,4634,6,1328319462,1328319478,8,6,16
48624550@N00,4634,7,1328317862,1328317862,1,6,0
48624550@N00,4634,27,1328307674,1328334479,6,6,26805
48624550@N00,4634,1,1328317831,1328317846,11,6,15
48624550@N00,4634,3,1328310387,1328312887,10,6,2500
48624550@N00,4634,2,1328312888,1328312888,1,6,0
48658532@N06,4635,7,1352509653,1352516122,3,2,6469
48658532@N06,4635,8,1352510244,1352518555,2,2,8311
48699368@N08,4636,27,1304317472,1304317620,3,1,148
48763139@N00,4637,26,1199925378,1199925378,1,1,0
48763139@N00,4638,1,1262927197,1262927197,1,1,0
48763139@N00,4639,4,1294717019,1294717019,1,1,0
48826873@N08,4640,27,1321821663,1321822060,2,1,397
48826873@N08,4641,8,1328450053,1328450053,1,1,0
48826873@N08,4642,19,1329699063,1329699063,1,4,0
48826873@N08,4642,13,1329693945,1329693945,1,4,0
48826873@N08,4642,18,1329697996,1329697996,1,4,0
48826873@N08,4642,1,1329688108,1329688729,2,4,621
48826873@N08,4643,3,1335512399,1335512399,1,4,0
48826873@N08,4643,7,1335515715,1335515955,2,4,240
48826873@N08,4643,4,1335511151,1335511151,1,4,0
48826873@N08,4643,13,1335519057,1335519057,1,4,0
48826873@N08,4644,18,1335575918,1335575918,1,1,0
48826873@N08,4645,27,1344715600,1344715600,1,1,0
48826873@N08,4646,2,1350521949,1350521949,1,1,0
48826873@N08,4647,2,1411776088,1411776088,1,1,0
48826873@N08,4648,26,1414035879,1414035879,2,1,0
48826873@N08,4649,5,1421810279,1421810279,1,2,0
48826873@N08,4649,4,1421825146,1421825146,1,2,0
48826873@N08,4650,27,1438298901,1438298901,1,1,0
48826873@N08,4651,13,1456384432,1456384432,1,1,0
48826873@N08,4652,15,1457420837,1457420837,1,1,0
48826873@N08,4653,17,1465376151,1465376151,1,1,0
48842746@N04,4654,27,1277409932,1277409932,1,1,0
48861861@N08,4655,18,1403757011,1403757011,1,8,0
48861861@N08,4655,17,1403764503,1403764503,1,8,0
48861861@N08,4655,26,1403767426,1403767426,1,8,0
48861861@N08,4655,4,1403748202,1403748202,1,8,0
48861861@N08,4655,15,1403759970,1403759970,1,8,0
48861861@N08,4655,22,1403770011,1403770011,1,8,0
48861861@N08,4655,1,1403770159,1403770159,1,8,0
48861861@N08,4655,2,1403761528,1403761528,1,8,0
48861861@N08,4656,16,1426213309,1426213309,1,1,0
48861861@N08,4657,25,1427103760,1427103760,1,1,0
48861861@N08,4658,16,1427686148,1427686148,1,1,0
48861861@N08,4659,21,1428143694,1428143694,1,1,0
48861861@N08,4660,6,1429086592,1429086592,1,1,0
48861861@N08,4661,1,1430015734,1430015734,1,1,0
48861861@N08,4662,17,1432219525,1432219525,1,1,0
48861861@N08,4663,7,1434677228,1434677228,1,1,0
48861861@N08,4664,19,1434875967,1434875967,1,1,0
48861861@N08,4665,20,1437088317,1437088317,1,1,0
48861861@N08,4666,13,1437205236,1437205236,1,1,0
48861861@N08,4667,14,1438375442,1438375442,1,1,0
48861861@N08,4668,4,1438736779,1438736779,1,1,0
48861861@N08,4669,2,1438921534,1438921534,1,1,0
48861861@N08,4670,24,1440560035,1440560035,1,1,0
48861861@N08,4671,7,1441006807,1441006807,1,1,0
48861861@N08,4672,27,1441532566,1441532566,1,1,0
48861861@N08,4673,3,1441622675,1441622675,1,1,0
48861861@N08,4674,27,1441688209,1441688209,1,1,0
48861861@N08,4675,14,1441857100,1441857100,1,1,0
48861861@N08,4676,9,1441960665,1441960665,1,1,0
48861861@N08,4677,3,1442205496,1442205496,1,1,0
48861861@N08,4678,20,1443409152,1443409152,1,1,0
48861861@N08,4679,16,1444525799,1444525799,1,1,0
48861861@N08,4680,25,1445140342,1445140342,1,1,0
48861861@N08,4681,4,1445299406,1445299406,1,1,0
48861861@N08,4682,23,1449026567,1449026567,1,1,0
48861861@N08,4683,12,1449456673,1449456673,1,1,0
48861861@N08,4684,6,1450417774,1450417774,1,1,0
48861861@N08,4685,10,1453334626,1453334626,1,1,0
48861861@N08,4686,21,1453961575,1453961575,1,1,0
48861861@N08,4687,27,1454728609,1454728609,1,1,0
48861861@N08,4688,26,1454812423,1454812423,1,1,0
48861861@N08,4689,6,1454896604,1454896604,1,1,0
48861861@N08,4690,9,1455665997,1455665997,1,1,0
48861861@N08,4691,9,1456710562,1456710562,1,1,0
48861861@N08,4692,8,1457069781,1457069781,1,1,0
48861861@N08,4693,20,1457227926,1457227926,1,1,0
48861861@N08,4694,27,1457314497,1457314497,1,1,0
48861861@N08,4695,6,1460250439,1460250439,1,1,0
48861861@N08,4696,5,1461544548,1461544548,1,1,0
48861861@N08,4697,19,1462155129,1462155129,1,1,0
48861861@N08,4698,6,1464581701,1464581701,1,1,0
48861861@N08,4699,5,1464784456,1464784456,1,1,0
48889050018@N01,4700,14,1296713150,1296713150,1,4,0
48889050018@N01,4700,11,1296712081,1296712081,1,4,0
48889050018@N01,4700,2,1296714468,1296714468,1,4,0
48889050018@N01,4700,9,1296713667,1296715993,2,4,2326
48889050018@N01,4701,25,1296871185,1296871185,1,3,0
48889050018@N01,4701,27,1296861544,1296861544,1,3,0
48889050018@N01,4701,2,1296888237,1296888237,1,3,0
48889052497@N01,4702,4,1311584719,1311584754,3,1,35
48889052497@N01,4703,27,1311633038,1311633038,1,2,0
48889052497@N01,4703,14,1311634837,1311639676,5,2,4839
48889052497@N01,4704,27,1311762923,1311763104,5,6,181
48889052497@N01,4704,13,1311765180,1311765886,5,6,706
48889052497@N01,4704,15,1311764723,1311765537,2,6,814
48889052497@N01,4704,12,1311765018,1311765528,8,6,510
48889052497@N01,4704,14,1311764188,1311764188,1,6,0
48889052497@N01,4704,9,1311765995,1311765995,1,6,0
48889052497@N01,4705,22,1344733442,1344734214,6,5,772
48889052497@N01,4705,13,1344739468,1344739468,1,5,0
48889052497@N01,4705,15,1344739146,1344739146,1,5,0
48889052497@N01,4705,25,1344730660,1344730660,1,5,0
48889052497@N01,4705,23,1344731338,1344732631,4,5,1293
48889052497@N01,4706,15,1344770832,1344770832,1,1,0
48889052497@N01,4707,17,1344910600,1344910600,1,4,0
48889052497@N01,4707,18,1344914922,1344914922,1,4,0
48889052497@N01,4707,4,1344920664,1344920664,1,4,0
48889052497@N01,4707,8,1344918231,1344919036,3,4,805
48889052497@N01,4708,9,1344990268,1344990798,6,8,530
48889052497@N01,4708,22,1344997007,1344997007,1,8,0
48889052497@N01,4708,24,1344998914,1344998914,1,8,0
48889052497@N01,4708,23,1344995304,1344999966,8,8,4662
48889052497@N01,4708,15,1344991264,1344991474,4,8,210
48889052497@N01,4708,16,1344992382,1344992528,2,8,146
48889052497@N01,4708,14,1344990840,1344990840,1,8,0
48889052497@N01,4708,21,1344994263,1344995457,4,8,1194
48889052497@N01,4709,27,1345072382,1345072405,3,3,23
48889052497@N01,4709,16,1345073424,1345073424,1,3,0
48889052497@N01,4709,12,1345080412,1345080530,2,3,118
48889052497@N01,4710,16,1376891302,1376891534,4,3,232
48889052497@N01,4710,22,1376901170,1376901174,2,3,4
48889052497@N01,4710,27,1376892650,1376892650,1,3,0
48889052497@N01,4711,22,1377149042,1377150892,22,1,1850
48889052497@N01,4712,9,1377224514,1377224514,1,1,0
48889119686@N01,4713,27,1352363693,1352363693,1,1,0
48889119704@N01,4714,22,1273403431,1273403732,5,2,301
48889119704@N01,4714,17,1273397827,1273398134,3,2,307
48890186@N05,4715,16,1278072758,1278072758,1,1,0
48891180@N00,4716,26,1229889130,1229889130,1,1,0
48891180@N00,4717,9,1230244430,1230244430,1,3,0
48891180@N00,4717,27,1230236361,1230236361,1,3,0
48891180@N00,4717,16,1230244663,1230245580,3,3,917
48891180@N00,4718,27,1230312703,1230320241,2,1,7538
48900696@N04,4719,27,1404378363,1404378363,1,1,0
48904826@N06,4720,22,1257818672,1257818672,1,1,0
48922012@N08,4721,27,1283263200,1283263200,4,1,0
48922012@N08,4722,27,1283509148,1283511923,2,1,2775
48922012@N08,4723,27,1283555729,1283598328,23,1,42599
48938973@N07,4724,4,1379304831,1379304831,1,1,0
48938973@N07,4725,16,1379644223,1379644223,1,1,0
48954567@N02,4726,14,1324459202,1324462497,32,1,3295
48980448@N05,4727,4,1263972176,1263972176,1,1,0
48989603@N06,4728,25,1297591671,1297591671,1,3,0
48989603@N06,4728,23,1297562753,1297591951,2,3,29198
48989603@N06,4728,26,1297591364,1297591364,1,3,0
49014295@N06,4729,4,1397101421,1397128275,11,10,26854
49014295@N06,4729,13,1397109592,1397109592,1,10,0
49014295@N06,4729,21,1397104340,1397104340,1,10,0
49014295@N06,4729,1,1397101222,1397101222,1,10,0
49014295@N06,4729,10,1397096787,1397130250,2,10,33463
49014295@N06,4729,14,1397095920,1397095920,1,10,0
49014295@N06,4729,27,1397133241,1397133241,1,10,0
49014295@N06,4729,5,1397097624,1397097624,1,10,0
49014295@N06,4729,16,1397090899,1397090899,1,10,0
49014295@N06,4729,17,1397090518,1397109064,2,10,18546
49027661@N03,4730,6,1400044981,1400044981,1,8,0
49027661@N03,4730,17,1400030414,1400030425,2,8,11
49027661@N03,4730,2,1400044652,1400044697,3,8,45
49027661@N03,4730,4,1400040340,1400040340,1,8,0
49027661@N03,4730,5,1400044743,1400044743,1,8,0
49027661@N03,4730,27,1400026177,1400026187,4,8,10
49027661@N03,4730,20,1400052534,1400052534,1,8,0
49027661@N03,4730,23,1400028474,1400028474,1,8,0
49027661@N03,4731,3,1400869404,1400869404,1,5,0
49027661@N03,4731,26,1400869702,1400869702,1,5,0
49027661@N03,4731,22,1400869401,1400869702,2,5,301
49027661@N03,4731,19,1400869407,1400869413,4,5,6
49027661@N03,4731,27,1400869910,1400869910,1,5,0
49032331@N05,4732,22,1339997110,1339997382,10,3,272
49032331@N05,4732,25,1339982514,1339982984,2,3,470
49032331@N05,4732,17,1339986649,1339986707,2,3,58
49032331@N05,4733,20,1347648018,1347648018,1,2,0
49032331@N05,4733,13,1347637762,1347637762,1,2,0
49032331@N05,4734,2,1348148883,1348148883,1,4,0
49032331@N05,4734,1,1348178772,1348178772,1,4,0
49032331@N05,4734,3,1348150173,1348150173,1,4,0
49032331@N05,4734,16,1348145985,1348145985,1,4,0
49032331@N05,4735,25,1348567126,1348567126,1,4,0
49032331@N05,4735,18,1348555835,1348555835,1,4,0
49032331@N05,4735,21,1348564516,1348564516,1,4,0
49032331@N05,4735,27,1348552252,1348552252,1,4,0
49032331@N05,4736,25,1353972382,1353972693,22,2,311
49032331@N05,4736,24,1353972311,1353972713,11,2,402
49032331@N05,4737,22,1354444382,1354444382,1,2,0
49032331@N05,4737,17,1354444109,1354444113,4,2,4
49039096@N04,4738,27,1388696602,1388696906,19,1,304
49052221@N00,4739,27,1366937511,1366937511,1,1,0
49052221@N00,4740,20,1367023934,1367023934,1,2,0
49052221@N00,4740,16,1367033398,1367033398,1,2,0
49052221@N00,4741,6,1367119056,1367119056,1,1,0
49075539@N06,4742,17,1298160092,1298184949,4,7,24857
49075539@N06,4742,20,1298168652,1298176010,4,7,7358
49075539@N06,4742,26,1298167900,1298168342,3,7,442
49075539@N06,4742,16,1298159733,1298195308,13,7,35575
49075539@N06,4742,19,1298160675,1298161403,2,7,728
49075539@N06,4742,1,1298182021,1298182021,1,7,0
49075539@N06,4742,15,1298167485,1298167485,1,7,0
49103297@N04,4743,6,1408001290,1408001443,7,7,153
49103297@N04,4743,3,1407984428,1407998193,11,7,13765
49103297@N04,4743,4,1407984702,1408009500,9,7,24798
49103297@N04,4743,5,1407992901,1408001409,2,7,8508
49103297@N04,4743,13,1407982589,1407982589,1,7,0
49103297@N04,4743,9,1407985674,1407985674,1,7,0
49103297@N04,4743,27,1407976185,1408017664,10,7,41479
49109678@N04,4744,27,1251457885,1251457885,1,3,0
49109678@N04,4744,21,1251445280,1251445280,1,3,0
49109678@N04,4744,4,1251441130,1251441130,1,3,0
49109678@N04,4745,16,1277611485,1277611485,1,15,0
49109678@N04,4745,6,1277608451,1277608451,1,15,0
49109678@N04,4745,27,1277620569,1277620569,1,15,0
49109678@N04,4745,21,1277616097,1277616097,1,15,0
49109678@N04,4745,5,1277603813,1277608434,2,15,4621
49109678@N04,4745,4,1277607553,1277607553,1,15,0
49109678@N04,4745,17,1277609361,1277609361,1,15,0
49109678@N04,4745,12,1277610232,1277611147,3,15,915
49109678@N04,4745,24,1277616584,1277616584,1,15,0
49109678@N04,4745,15,1277609693,1277609693,1,15,0
49109678@N04,4745,20,1277616289,1277616289,1,15,0
49109678@N04,4745,13,1277609608,1277609608,1,15,0
49109678@N04,4745,3,1277607553,1277607553,1,15,0
49109678@N04,4745,1,1277608512,1277608512,1,15,0
49109678@N04,4745,22,1277613116,1277613116,1,15,0
49109678@N04,4746,19,1278053647,1278053647,1,9,0
49109678@N04,4746,5,1278049126,1278049126,1,9,0
49109678@N04,4746,27,1278039269,1278054846,3,9,15577
49109678@N04,4746,20,1278053099,1278053222,3,9,123
49109678@N04,4746,3,1278046781,1278048301,2,9,1520
49109678@N04,4746,2,1278048810,1278048810,1,9,0
49109678@N04,4746,26,1278052891,1278052891,1,9,0
49109678@N04,4746,23,1278052356,1278052554,3,9,198
49109678@N04,4746,17,1278040270,1278041396,4,9,1126
49109678@N04,4747,27,1303170990,1303170990,1,1,0
49109678@N04,4748,4,1344042966,1344042966,1,1,0
49109678@N04,4749,15,1365118909,1365118909,1,2,0
49109678@N04,4749,10,1365121525,1365121525,1,2,0
49109678@N04,4750,14,1405468971,1405468971,1,1,0
49165041@N00,4751,26,1281505344,1281505344,1,11,0
49165041@N00,4751,21,1281468988,1281468988,1,11,0
49165041@N00,4751,4,1281486398,1281493523,4,11,7125
49165041@N00,4751,23,1281507787,1281508053,2,11,266
49165041@N00,4751,2,1281450028,1281450028,1,11,0
49165041@N00,4751,1,1281500477,1281500900,3,11,423
49165041@N00,4751,14,1281492857,1281493054,3,11,197
49165041@N00,4751,27,1281445187,1281485537,9,11,40350
49165041@N00,4751,13,1281463380,1281501980,3,11,38600
49165041@N00,4751,16,1281491280,1281492994,3,11,1714
49165041@N00,4751,5,1281486548,1281488997,4,11,2449
49169223@N00,4752,16,1230872889,1230901256,17,16,28367
49169223@N00,4752,2,1230901242,1230901245,4,16,3
49169223@N00,4752,23,1230901205,1230901205,1,16,0
49169223@N00,4752,21,1230901206,1230901206,1,16,0
49169223@N00,4752,19,1230901212,1230901216,5,16,4
49169223@N00,4752,22,1230901210,1230901241,6,16,31
49169223@N00,4752,17,1230901224,1230901224,1,16,0
49169223@N00,4752,20,1230901207,1230901209,3,16,2
49169223@N00,4752,26,1230901223,1230901223,1,16,0
49169223@N00,4752,27,1230872656,1230872740,4,16,84
49169223@N00,4752,3,1230901246,1230901246,1,16,0
49169223@N00,4752,25,1230901229,1230901236,8,16,7
49169223@N00,4752,13,1230901226,1230901226,1,16,0
49169223@N00,4752,18,1230901217,1230901225,4,16,8
49169223@N00,4752,4,1230873026,1230873026,1,16,0
49169223@N00,4752,12,1230901249,1230901255,7,16,6
49169223@N00,4753,27,1230962589,1230962589,1,1,0
49169223@N00,4754,21,1231333227,1231333227,1,1,0
49217725@N08,4755,16,1237695562,1237695562,1,1,0
49223458@N00,4756,11,1395982176,1395982176,1,1,0
49275237@N00,4757,15,1206733812,1206733827,2,6,15
49275237@N00,4757,16,1206730817,1206734031,2,6,3214
49275237@N00,4757,13,1206738391,1206739436,4,6,1045
49275237@N00,4757,27,1206730434,1206730555,2,6,121
49275237@N00,4757,12,1206733844,1206733844,1,6,0
49275237@N00,4757,14,1206732718,1206732718,1,6,0
49275237@N00,4758,12,1206776844,1206780211,5,2,3367
49275237@N00,4758,14,1206779086,1206779218,4,2,132
49275237@N00,4759,27,1206837808,1206837818,2,3,10
49275237@N00,4759,22,1206829918,1206837912,5,3,7994
49275237@N00,4759,8,1206834522,1206834612,2,3,90
49275237@N00,4760,17,1329471320,1329474695,12,9,3375
49275237@N00,4760,5,1329479316,1329479996,4,9,680
49275237@N00,4760,12,1329476288,1329476720,8,9,432
49275237@N00,4760,4,1329480903,1329480954,2,9,51
49275237@N00,4760,21,1329438722,1329445786,8,9,7064
49275237@N00,4760,2,1329478280,1329478809,4,9,529
49275237@N00,4760,27,1329434467,1329481490,6,9,47023
49275237@N00,4760,22,1329438477,1329443309,6,9,4832
49275237@N00,4760,9,1329477265,1329477621,7,9,356
49275237@N00,4761,13,1329731676,1329731676,2,1,0
49276854@N08,4762,27,1382214894,1382214894,1,4,0
49276854@N08,4762,4,1382228744,1382228744,1,4,0
49276854@N08,4762,15,1382209881,1382209881,1,4,0
49276854@N08,4762,18,1382210468,1382210468,1,4,0
49280743@N03,4763,27,1380699542,1380699834,17,3,292
49280743@N03,4763,20,1380702588,1380702594,2,3,6
49280743@N03,4763,4,1380710722,1380712336,116,3,1614
49305593@N05,4764,19,1389697989,1389697989,1,1,0
49305593@N05,4765,9,1425895794,1425896813,6,1,1019
49395260@N00,4766,6,1333503315,1333503315,1,1,0
49395260@N00,4767,6,1333961921,1333961933,2,1,12
49472870@N04,4768,24,1385814681,1385814681,1,1,0
49502978053@N01,4769,22,1315897005,1315897005,1,1,0
49502978053@N01,4770,19,1317470070,1317470105,3,7,35
49502978053@N01,4770,20,1317470123,1317470123,1,7,0
49502978053@N01,4770,18,1317469027,1317469099,5,7,72
49502978053@N01,4770,4,1317470150,1317470150,1,7,0
49502978053@N01,4770,22,1317468987,1317469148,4,7,161
49502978053@N01,4770,27,1317466925,1317468971,5,7,2046
49502978053@N01,4770,13,1317469170,1317469170,1,7,0
49502987176@N01,4771,27,1275284878,1275284878,1,1,0
49502987176@N01,4772,11,1275364792,1275365223,4,4,431
49502987176@N01,4772,16,1275350929,1275355037,9,4,4108
49502987176@N01,4772,12,1275368921,1275368964,2,4,43
49502987176@N01,4772,20,1275348996,1275348996,1,4,0
49502987176@N01,4773,25,1314066026,1314068038,3,4,2012
49502987176@N01,4773,19,1314062455,1314062455,1,4,0
49502987176@N01,4773,17,1314063127,1314063127,1,4,0
49502987176@N01,4773,21,1314060147,1314060147,1,4,0
49502987176@N01,4774,4,1314097715,1314097715,1,1,0
49502987176@N01,4775,14,1314517065,1314517065,1,2,0
49502987176@N01,4775,6,1314495289,1314495289,1,2,0
49503068447@N01,4776,22,1203989213,1203989213,1,4,0
49503068447@N01,4776,14,1203998886,1203998954,3,4,68
49503068447@N01,4776,15,1203996887,1203996887,1,4,0
49503068447@N01,4776,16,1204004656,1204004656,1,4,0
49503068447@N01,4777,14,1267416948,1267416948,1,1,0
49503068447@N01,4778,14,1267516268,1267526323,2,1,10055
49503114584@N01,4779,20,1217676288,1217676288,1,2,0
49503114584@N01,4779,4,1217680241,1217680241,1,2,0
49503114584@N01,4780,3,1218283889,1218283889,1,1,0
49503114584@N01,4781,27,1249188817,1249207402,2,2,18585
49503114584@N01,4781,4,1249199510,1249199510,1,2,0
49503114584@N01,4782,19,1249288449,1249288449,1,3,0
49503114584@N01,4782,27,1249296845,1249296845,1,3,0
49503114584@N01,4782,17,1249292581,1249292581,1,3,0
49503114584@N01,4783,19,1344064867,1344064867,1,2,0
49503114584@N01,4783,27,1344068480,1344068480,1,2,0
49503114584@N01,4784,19,1405568986,1405568993,2,1,7
49503128117@N01,4785,10,1391149173,1391149173,1,1,0
49503128117@N01,4786,16,1391366876,1391366876,1,1,0
49503128117@N01,4787,16,1391456693,1391456693,1,1,0
49503181455@N01,4788,18,1246867691,1246867711,5,2,20
49503181455@N01,4788,23,1246857279,1246862760,14,2,5481
49503181455@N01,4789,18,1246919239,1246919889,19,3,650
49503181455@N01,4789,8,1246933864,1246934910,25,3,1046
49503181455@N01,4789,17,1246919949,1246919983,4,3,34
49645702@N00,4790,5,1363425765,1363425829,3,9,64
49645702@N00,4790,14,1363428472,1363431749,10,9,3277
49645702@N00,4790,6,1363426602,1363427997,19,9,1395
49645702@N00,4790,2,1363426075,1363426523,6,9,448
49645702@N00,4790,26,1363429149,1363429472,5,9,323
49645702@N00,4790,27,1363424911,1363424938,2,9,27
49645702@N00,4790,7,1363428105,1363428105,1,9,0
49645702@N00,4790,9,1363428283,1363428346,2,9,63
49645702@N00,4790,18,1363428870,1363429749,4,9,879
49675952@N07,4791,4,1273925381,1273925381,1,1,0
49675952@N07,4792,18,1305332606,1305332606,1,1,0
49675952@N07,4793,27,1305388053,1305388053,1,1,0
49675952@N07,4794,27,1305638234,1305638234,1,1,0
49677598@N00,4795,26,1220788620,1220788620,1,5,0
49677598@N00,4795,2,1220759640,1220759640,1,5,0
49677598@N00,4795,23,1220785860,1220785860,1,5,0
49677598@N00,4795,1,1220757900,1220757930,2,5,30
49677598@N00,4795,14,1220779800,1220779800,1,5,0
49677598@N00,4796,16,1220854320,1220856000,7,1,1680
49677598@N00,4797,26,1221020391,1221020391,1,4,0
49677598@N00,4797,16,1221030120,1221030120,1,4,0
49677598@N00,4797,17,1221029820,1221029820,1,4,0
49677598@N00,4797,27,1221016648,1221016734,2,4,86
49686361@N00,4798,16,1284098886,1284098886,1,1,0
49727271@N00,4799,2,1386308099,1386308099,1,1,0
49727271@N00,4800,19,1386503421,1386503421,1,6,0
49727271@N00,4800,11,1386494745,1386494745,1,6,0
49727271@N00,4800,3,1386485648,1386485648,1,6,0
49727271@N00,4800,20,1386502948,1386502948,1,6,0
49727271@N00,4800,16,1386475330,1386489797,2,6,14467
49727271@N00,4800,9,1386484757,1386484757,1,6,0
49727271@N00,4801,8,1386552447,1386552447,1,1,0
49727271@N00,4802,19,1418033235,1418033235,1,1,0
49731541@N02,4803,27,1400541023,1400541023,1,1,0
49738389@N00,4804,11,1287373666,1287373843,6,3,177
49738389@N00,4804,3,1287384237,1287384237,1,3,0
49738389@N00,4804,27,1287371076,1287372776,5,3,1700
49768774@N02,4805,22,1446092141,1446092141,1,1,0
49786625@N07,4806,10,1416188296,1416188296,1,1,0
49855440@N00,4807,18,1229661226,1229661226,1,8,0
49855440@N00,4807,16,1229649588,1229683265,10,8,33677
49855440@N00,4807,21,1229668847,1229669325,2,8,478
49855440@N00,4807,27,1229690365,1229690365,1,8,0
49855440@N00,4807,14,1229678944,1229678944,1,8,0
49855440@N00,4807,9,1229677625,1229677782,2,8,157
49855440@N00,4807,22,1229663525,1229664727,4,8,1202
49855440@N00,4807,15,1229657792,1229658248,3,8,456
49858381@N04,4808,16,1358016151,1358020960,2,1,4809
49858381@N04,4809,14,1358202959,1358210628,2,1,7669
49887039@N04,4810,17,1283235876,1283236006,3,6,130
49887039@N04,4810,26,1283253990,1283259798,2,6,5808
49887039@N04,4810,20,1283236457,1283236494,2,6,37
49887039@N04,4810,4,1283233560,1283271082,2,6,37522
49887039@N04,4810,9,1283243290,1283243301,2,6,11
49887039@N04,4810,27,1283233128,1283233128,1,6,0
49887039@N04,4811,27,1283651386,1283651533,2,1,147
49887039@N04,4812,17,1283685108,1283685172,2,1,64
49887039@N04,4813,27,1346614736,1346614736,1,1,0
49887039@N04,4814,5,1346836688,1346836688,1,11,0
49887039@N04,4814,17,1346828763,1346859457,3,11,30694
49887039@N04,4814,16,1346848619,1346855470,2,11,6851
49887039@N04,4814,8,1346831337,1346831337,1,11,0
49887039@N04,4814,25,1346843815,1346848659,2,11,4844
49887039@N04,4814,3,1346825142,1346825142,1,11,0
49887039@N04,4814,19,1346825762,1346828795,2,11,3033
49887039@N04,4814,24,1346848752,1346848752,1,11,0
49887039@N04,4814,11,1346831213,1346831213,1,11,0
49887039@N04,4814,27,1346817531,1346839839,8,11,22308
49887039@N04,4814,1,1346824283,1346824283,1,11,0
49887039@N04,4815,13,1347347196,1347348064,2,4,868
49887039@N04,4815,27,1347342796,1347342796,1,4,0
49887039@N04,4815,26,1347360136,1347360136,1,4,0
49887039@N04,4815,1,1347345003,1347387030,2,4,42027
49887039@N04,4816,17,1360572362,1360572362,1,2,0
49887039@N04,4816,14,1360566680,1360566680,1,2,0
49934509@N00,4817,16,1291532401,1291532401,1,1,0
49934509@N00,4818,16,1291718677,1291718677,1,1,0
49934509@N00,4819,16,1291891484,1291891484,1,4,0
49934509@N00,4819,14,1291886874,1291886874,1,4,0
49934509@N00,4819,9,1291853331,1291853331,1,4,0
49934509@N00,4819,4,1291879362,1291879362,1,4,0
49934509@N00,4820,16,1291940207,1291945504,5,1,5297
49934509@N00,4821,14,1292125943,1292125943,1,1,0
49934509@N00,4822,27,1292189842,1292189842,1,4,0
49934509@N00,4822,14,1292191807,1292191807,1,4,0
49934509@N00,4822,16,1292200163,1292200163,1,4,0
49934509@N00,4822,3,1292194442,1292194442,1,4,0
49934509@N00,4823,4,1292235980,1292235980,1,1,0
49934509@N00,4824,21,1326586314,1326586314,1,4,0
49934509@N00,4824,19,1326587321,1326587321,1,4,0
49934509@N00,4824,13,1326591933,1326591933,1,4,0
49934509@N00,4824,16,1326597103,1326597103,1,4,0
49934509@N00,4825,5,1326783169,1326783169,1,6,0
49934509@N00,4825,27,1326758772,1326758772,1,6,0
49934509@N00,4825,2,1326782117,1326782117,1,6,0
49934509@N00,4825,17,1326763506,1326763506,1,6,0
49934509@N00,4825,20,1326770582,1326770582,1,6,0
49934509@N00,4825,25,1326774512,1326774512,1,6,0
49934509@N00,4826,21,1326842727,1326842727,1,4,0
49934509@N00,4826,27,1326842140,1326842140,1,4,0
49934509@N00,4826,16,1326846859,1326846859,1,4,0
49934509@N00,4826,25,1326840171,1326840171,1,4,0
49934509@N00,4827,21,1327108448,1327108448,1,2,0
49934509@N00,4827,27,1327106380,1327106380,1,2,0
49934509@N00,4828,27,1351428387,1351428387,1,3,0
49934509@N00,4828,15,1351426758,1351426758,1,3,0
49934509@N00,4828,14,1351426760,1351426760,1,3,0
49934509@N00,4829,22,1351557851,1351557851,1,10,0
49934509@N00,4829,6,1351565112,1351565112,1,10,0
49934509@N00,4829,10,1351559040,1351559040,1,10,0
49934509@N00,4829,19,1351559044,1351559067,3,10,23
49934509@N00,4829,11,1351564800,1351569729,3,10,4929
49934509@N00,4829,27,1351553944,1351595912,16,10,41968
49934509@N00,4829,9,1351563643,1351564363,3,10,720
49934509@N00,4829,7,1351565753,1351566350,2,10,597
49934509@N00,4829,20,1351559757,1351559757,1,10,0
49934509@N00,4829,8,1351566490,1351566490,1,10,0
49934509@N00,4830,24,1351840573,1351840589,4,1,16
49934509@N00,4831,3,1351916810,1351917460,2,8,650
49934509@N00,4831,16,1351911414,1351911414,1,8,0
49934509@N00,4831,22,1351921657,1351921657,1,8,0
49934509@N00,4831,25,1351923481,1351923481,1,8,0
49934509@N00,4831,17,1351908844,1351909569,2,8,725
49934509@N00,4831,2,1351916084,1351918648,4,8,2564
49934509@N00,4831,9,1351920404,1351920413,3,8,9
49934509@N00,4831,21,1351918647,1351918647,1,8,0
49934509@N00,4832,17,1351978745,1351978749,3,6,4
49934509@N00,4832,14,1351978948,1351994599,16,6,15651
49934509@N00,4832,25,1351991900,1351991900,1,6,0
49934509@N00,4832,12,1351984463,1351984463,1,6,0
49934509@N00,4832,10,1351979859,1351986187,19,6,6328
49934509@N00,4832,15,1351986791,1351986791,1,6,0
49942639@N04,4833,18,1379398422,1379398422,1,2,0
49942639@N04,4833,17,1379394334,1379394334,1,2,0
49952306@N00,4834,27,1303014882,1303014882,2,2,0
49952306@N00,4834,14,1303015308,1303015308,1,2,0
49952306@N00,4835,26,1307160728,1307160728,1,3,0
49952306@N00,4835,27,1307159950,1307159950,1,3,0
49952306@N00,4835,9,1307174293,1307174329,3,3,36
50023219@N05,4836,26,1272250045,1272250998,4,1,953
50073458@N00,4837,17,1339459103,1339472491,2,5,13388
50073458@N00,4837,14,1339492604,1339492807,3,5,203
50073458@N00,4837,6,1339469995,1339469995,1,5,0
50073458@N00,4837,21,1339473465,1339473465,1,5,0
50073458@N00,4837,27,1339483919,1339483922,2,5,3
50073458@N00,4838,8,1340462272,1340462272,1,1,0
50102917@N08,4839,27,1439816586,1439816586,1,1,0
50109110@N00,4840,17,1207108234,1207108234,1,2,0
50109110@N00,4840,3,1207122368,1207122379,2,2,11
50158065@N00,4841,16,1390227881,1390227881,1,1,0
50207065@N00,4842,6,1291452574,1291452574,1,1,0
50216293@N04,4843,15,1192915403,1192915403,1,1,0
50249220@N00,4844,3,1363421328,1363421328,1,1,0
50276147@N05,4845,17,1304842123,1304842123,1,1,0
50403713@N03,4846,2,1391257688,1391257688,1,2,0
50403713@N03,4846,8,1391258307,1391258307,1,2,0
50403713@N03,4847,27,1391304033,1391311619,9,4,7586
50403713@N03,4847,16,1391299281,1391299400,5,4,119
50403713@N03,4847,8,1391299538,1391300063,2,4,525
50403713@N03,4847,17,1391301288,1391309868,7,4,8580
50428026@N00,4848,27,1431823339,1431825636,7,1,2297
50480909@N04,4849,6,1251970223,1251970223,1,1,0
50514133@N00,4850,22,1267331317,1267331317,1,3,0
50514133@N00,4850,14,1267338466,1267347773,3,3,9307
50514133@N00,4850,16,1267312998,1267312998,1,3,0
50514859@N00,4851,16,1248811402,1248833027,9,1,21625
50578763@N07,4852,27,1268189170,1268189170,1,1,0
50591494@N07,4853,17,1348890013,1348890013,1,1,0
50731912@N04,4854,27,1296643714,1296643750,2,1,36
50731912@N04,4855,27,1296829883,1296829883,1,1,0
50731912@N04,4856,27,1296990138,1296990138,1,1,0
50753203@N02,4857,22,1278134454,1278135436,3,1,982
50753203@N02,4858,22,1300060219,1300092719,7,1,32500
50753203@N02,4859,22,1300426139,1300426139,1,1,0
50753203@N02,4860,16,1451571845,1451571845,1,1,0
50811165@N06,4861,12,1275209978,1275209978,1,1,0
50848173@N00,4862,14,1356014115,1356014115,1,1,0
50853888@N00,4863,4,1278725923,1278725923,1,1,0
50881303@N05,4864,27,1374541547,1374541547,1,1,0
50968580@N00,4865,13,1330469951,1330469951,1,1,0
50968580@N00,4866,27,1330543339,1330543339,1,1,0
50968580@N00,4867,23,1330604845,1330604845,1,1,0
50968580@N00,4868,16,1356871682,1356873800,2,3,2118
50968580@N00,4868,10,1356875109,1356876711,3,3,1602
50968580@N00,4868,14,1356874161,1356874161,1,3,0
50968580@N00,4869,10,1387183379,1387183379,1,6,0
50968580@N00,4869,16,1387166885,1387190183,3,6,23298
50968580@N00,4869,14,1387182131,1387182131,1,6,0
50968580@N00,4869,27,1387157516,1387194723,3,6,37207
50968580@N00,4869,17,1387167273,1387168938,5,6,1665
50968580@N00,4869,3,1387166545,1387166545,1,6,0
51011933@N00,4870,17,1366253005,1366253005,1,5,0
51011933@N00,4870,9,1366254754,1366254754,1,5,0
51011933@N00,4870,20,1366259946,1366259946,1,5,0
51011933@N00,4870,18,1366251583,1366251583,1,5,0
51011933@N00,4870,1,1366245176,1366245176,1,5,0
51035587259@N01,4871,27,1354083569,1354083569,1,1,0
51035647214@N01,4872,27,1273969948,1273969983,2,4,35
51035647214@N01,4872,20,1273964254,1273964894,2,4,640
51035647214@N01,4872,4,1273959617,1273959617,1,4,0
51035647214@N01,4872,14,1273961094,1273961094,1,4,0
51035650382@N01,4873,23,1350196338,1350196338,1,1,0
51035693821@N01,4874,9,1249099468,1249102382,5,3,2914
51035693821@N01,4874,2,1249115359,1249115375,3,3,16
51035693821@N01,4874,14,1249108491,1249110894,12,3,2403
51035730365@N01,4875,1,1226891625,1226891625,1,1,0
51037533@N00,4876,16,1359295985,1359295985,1,3,0
51037533@N00,4876,26,1359292306,1359292306,1,3,0
51037533@N00,4876,27,1359281033,1359281033,1,3,0
51038094@N04,4877,16,1360980565,1360980565,1,1,0
51052219@N00,4878,27,1361007001,1361007001,1,1,0
51052219@N00,4879,26,1367997232,1367997232,1,1,0
51065161@N00,4880,16,1386567998,1386595968,3,3,27970
51065161@N00,4880,23,1386563753,1386563753,1,3,0
51065161@N00,4880,3,1386589253,1386589253,1,3,0
51082690@N03,4881,26,1313648192,1313648192,1,1,0
51082690@N03,4882,10,1419641327,1419641327,1,3,0
51082690@N03,4882,19,1419633317,1419633740,2,3,423
51082690@N03,4882,26,1419636682,1419636682,1,3,0
51087604@N07,4883,25,1269658012,1269690646,13,1,32634
51087604@N07,4884,25,1284468203,1284468203,1,1,0
51141147@N02,4885,16,1335235298,1335235298,1,4,0
51141147@N02,4885,22,1335228513,1335228513,1,4,0
51141147@N02,4885,17,1335250104,1335252709,2,4,2605
51141147@N02,4885,27,1335244269,1335244269,1,4,0
51159953@N00,4886,5,1304305457,1304305457,1,12,0
51159953@N00,4886,9,1304296169,1304296169,1,12,0
51159953@N00,4886,18,1304309863,1304309903,2,12,40
51159953@N00,4886,13,1304309204,1304309204,1,12,0
51159953@N00,4886,19,1304311074,1304311074,1,12,0
51159953@N00,4886,16,1304293638,1304305590,5,12,11952
51159953@N00,4886,17,1304312321,1304312390,2,12,69
51159953@N00,4886,14,1304294224,1304294224,1,12,0
51159953@N00,4886,27,1304305942,1304306308,2,12,366
51159953@N00,4886,20,1304308614,1304308614,1,12,0
51159953@N00,4886,12,1304294442,1304295439,9,12,997
51159953@N00,4886,26,1304309108,1304309108,1,12,0
51159953@N00,4887,7,1304553691,1304553691,1,3,0
51159953@N00,4887,16,1304550945,1304551197,2,3,252
51159953@N00,4887,27,1304569251,1304569251,1,3,0
51159953@N00,4888,1,1304673859,1304673859,1,1,0
51166785@N06,4889,6,1352179108,1352185134,2,11,6026
51166785@N06,4889,27,1352156967,1352200490,3,11,43523
51166785@N06,4889,5,1352186018,1352186018,1,11,0
51166785@N06,4889,2,1352188436,1352188436,1,11,0
51166785@N06,4889,10,1352179610,1352181885,5,11,2275
51166785@N06,4889,9,1352176116,1352182400,2,11,6284
51166785@N06,4889,8,1352183846,1352183895,2,11,49
51166785@N06,4889,12,1352165478,1352165478,1,11,0
51166785@N06,4889,20,1352161072,1352162875,3,11,1803
51166785@N06,4889,4,1352193714,1352193728,2,11,14
51166785@N06,4889,21,1352159497,1352159497,1,11,0
51166785@N06,4890,10,1444789925,1444789925,1,10,0
51166785@N06,4890,2,1444787897,1444787897,1,10,0
51166785@N06,4890,21,1444777944,1444778031,5,10,87
51166785@N06,4890,24,1444810790,1444810790,1,10,0
51166785@N06,4890,20,1444814708,1444814708,1,10,0
51166785@N06,4890,9,1444791147,1444820349,7,10,29202
51166785@N06,4890,6,1444821380,1444821380,1,10,0
51166785@N06,4890,27,1444769164,1444776605,14,10,7441
51166785@N06,4890,26,1444777183,1444778178,22,10,995
51166785@N06,4890,19,1444778827,1444778827,1,10,0
51179707@N00,4891,15,1327643173,1327643173,1,1,0
51267780@N00,4892,26,1224213437,1224213474,3,9,37
51267780@N00,4892,22,1224213197,1224213381,3,9,184
51267780@N00,4892,5,1224211456,1224211456,1,9,0
51267780@N00,4892,2,1224210954,1224211428,3,9,474
51267780@N00,4892,27,1224196999,1224198779,34,9,1780
51267780@N00,4892,17,1224199784,1224200007,2,9,223
51267780@N00,4892,21,1224212868,1224213006,4,9,138
51267780@N00,4892,4,1224208829,1224211662,6,9,2833
51267780@N00,4892,15,1224205905,1224206306,6,9,401
51298319@N07,4893,22,1282149097,1282149097,1,1,0
51313971@N08,4894,19,1443335104,1443335104,1,4,0
51313971@N08,4894,26,1443310578,1443318202,2,4,7624
51313971@N08,4894,25,1443317917,1443317917,1,4,0
51313971@N08,4894,17,1443329415,1443329415,1,4,0
51355647@N00,4895,16,1278888052,1278888052,1,2,0
51355647@N00,4895,4,1278890106,1278890106,1,2,0
51422514@N00,4896,5,1228300114,1228300869,2,1,755
51446559@N06,4897,21,1322495648,1322495648,1,1,0
51460585@N03,4898,16,1375092094,1375092094,2,2,0
51460585@N03,4898,3,1375088566,1375088566,1,2,0
51501947@N05,4899,17,1319764063,1319764063,1,1,0
51501947@N05,4900,22,1320361520,1320361520,1,1,0
51512337@N00,4901,9,1364162493,1364162526,2,6,33
51512337@N00,4901,7,1364164268,1364164268,1,6,0
51512337@N00,4901,25,1364203887,1364203887,1,6,0
51512337@N00,4901,20,1364183022,1364183022,1,6,0
51512337@N00,4901,3,1364200025,1364200025,1,6,0
51512337@N00,4901,18,1364184561,1364184561,1,6,0
51547237@N00,4902,23,1253529957,1253529957,1,1,0
51547237@N00,4903,2,1253661905,1253661905,1,1,0
51547237@N00,4904,16,1291978171,1291978475,4,1,304
51547237@N00,4905,14,1292074254,1292074254,1,2,0
51547237@N00,4905,27,1292070879,1292070879,1,2,0
51547237@N00,4906,8,1412398769,1412398889,4,3,120
51547237@N00,4906,14,1412425417,1412425685,6,3,268
51547237@N00,4906,2,1412389401,1412389450,7,3,49
51547237@N00,4907,24,1412916280,1412916280,1,1,0
51547237@N00,4908,2,1431175411,1431175411,1,2,0
51547237@N00,4908,27,1431168350,1431168350,1,2,0
51547237@N00,4909,9,1449095289,1449095289,1,1,0
51571496@N00,4910,27,1337505759,1337505759,1,1,0
51587558@N08,4911,10,1357710415,1357710415,1,4,0
51587558@N08,4911,9,1357710165,1357710165,1,4,0
51587558@N08,4911,14,1357709913,1357709913,1,4,0
51587558@N08,4911,6,1357698113,1357698113,1,4,0
51636307@N00,4912,21,1323315254,1323319290,3,21,4036
51636307@N00,4912,14,1323298393,1323303952,10,21,5559
51636307@N00,4912,15,1323304072,1323313716,6,21,9644
51636307@N00,4912,17,1323310903,1323310903,1,21,0
51636307@N00,4912,5,1323322541,1323322541,1,21,0
51636307@N00,4912,19,1323311768,1323311775,2,21,7
51636307@N00,4912,3,1323323667,1323323667,1,21,0
51636307@N00,4912,12,1323306836,1323307419,10,21,583
51636307@N00,4912,2,1323322174,1323322353,2,21,179
51636307@N00,4912,4,1323321375,1323321375,1,21,0
51636307@N00,4912,16,1323295592,1323321488,5,21,25896
51636307@N00,4912,20,1323312323,1323315162,2,21,2839
51636307@N00,4912,18,1323308822,1323311702,6,21,2880
51636307@N00,4912,26,1323315028,1323320091,3,21,5063
51636307@N00,4912,22,1323320189,1323320189,1,21,0
51636307@N00,4912,13,1323308308,1323308308,1,21,0
51636307@N00,4912,24,1323317928,1323318846,2,21,918
51636307@N00,4912,6,1323295925,1323300955,3,21,5030
51636307@N00,4912,25,1323319566,1323320514,2,21,948
51636307@N00,4912,9,1323297475,1323300530,5,21,3055
51636307@N00,4912,27,1323294703,1323295144,4,21,441
51692964@N05,4913,14,1236897540,1236897540,1,6,0
51692964@N05,4913,16,1236905265,1236905265,1,6,0
51692964@N05,4913,19,1236902872,1236902872,1,6,0
51692964@N05,4913,6,1236894063,1236894063,1,6,0
51692964@N05,4913,5,1236892792,1236892792,1,6,0
51692964@N05,4913,21,1236904026,1236904026,1,6,0
51737371@N00,4914,2,1284901879,1284901879,1,1,0
51746064@N07,4915,16,1362695927,1362695931,3,3,4
51746064@N07,4915,14,1362696543,1362696543,1,3,0
51746064@N07,4915,25,1362712172,1362712264,5,3,92
51746586@N06,4916,17,1281284405,1281284421,2,1,16
51746586@N06,4917,20,1281686233,1281686233,1,4,0
51746586@N06,4917,19,1281691128,1281691128,1,4,0
51746586@N06,4917,27,1281694186,1281694552,5,4,366
51746586@N06,4917,13,1281684604,1281685514,3,4,910
51746586@N06,4918,4,1282356397,1282356397,1,5,0
51746586@N06,4918,20,1282366777,1282367299,22,5,522
51746586@N06,4918,5,1282356393,1282356393,1,5,0
51746586@N06,4918,16,1282351963,1282392791,18,5,40828
51746586@N06,4918,17,1282363062,1282390883,15,5,27821
51746586@N06,4919,16,1312332426,1312332426,1,1,0
51746586@N06,4920,27,1312768430,1312768430,1,4,0
51746586@N06,4920,20,1312787370,1312787370,1,4,0
51746586@N06,4920,16,1312790014,1312790014,1,4,0
51746586@N06,4920,13,1312770242,1312770405,5,4,163
51746586@N06,4921,4,1313303688,1313303688,1,5,0
51746586@N06,4921,21,1313307938,1313307938,1,5,0
51746586@N06,4921,20,1313309917,1313309917,1,5,0
51746586@N06,4921,16,1313302670,1313303813,38,5,1143
51746586@N06,4921,17,1313320699,1313321525,22,5,826
51746586@N06,4922,20,1343961452,1343961518,3,5,66
51746586@N06,4922,16,1343955225,1343988170,43,5,32945
51746586@N06,4922,22,1343977107,1343977107,1,5,0
51746586@N06,4922,14,1343974102,1343974102,1,5,0
51746586@N06,4922,17,1343957208,1343993916,15,5,36708
51746586@N06,4923,27,1344903702,1344906112,29,7,2410
51746586@N06,4923,4,1344920299,1344943659,5,7,23360
51746586@N06,4923,16,1344906369,1344921461,5,7,15092
51746586@N06,4923,14,1344921449,1344921449,1,7,0
51746586@N06,4923,15,1344907923,1344908087,2,7,164
51746586@N06,4923,21,1344917986,1344917986,1,7,0
51746586@N06,4923,17,1344906457,1344943735,25,7,37278
51773303@N00,4924,14,1301727071,1301727071,1,1,0
51791370@N03,4925,14,1299885965,1299885965,1,1,0
51791370@N03,4926,15,1300226791,1300226791,1,3,0
51791370@N03,4926,17,1300226388,1300226388,1,3,0
51791370@N03,4926,19,1300236797,1300236797,1,3,0
51791370@N03,4927,19,1300402161,1300402161,1,3,0
51791370@N03,4927,27,1300417357,1300417357,1,3,0
51791370@N03,4927,3,1300413346,1300413346,1,3,0
51791370@N03,4928,16,1415358481,1415358481,1,1,0
51965232@N06,4929,12,1408077403,1408077403,1,4,0
51965232@N06,4929,6,1408087996,1408087996,1,4,0
51965232@N06,4929,2,1408091604,1408091604,1,4,0
51965232@N06,4929,16,1408071576,1408094041,2,4,22465
51973523@N07,4930,14,1420158832,1420158832,1,1,0
51981360@N07,4931,27,1349677395,1349677395,1,1,0
52034253@N02,4932,17,1319278540,1319278540,1,1,0
52066610@N03,4933,3,1394748504,1394748504,1,1,0
52082189@N03,4934,27,1328014800,1328014800,2,2,0
52082189@N03,4934,16,1328014800,1328014800,4,2,0
52110522@N04,4935,22,1300354755,1300354755,1,1,0
52111934@N00,4936,4,1214981653,1214981715,40,1,62
52168854@N00,4937,26,1348402774,1348402966,4,3,192
52168854@N00,4937,9,1348399936,1348399952,2,3,16
52168854@N00,4937,27,1348398583,1348398586,2,3,3
52168854@N00,4938,9,1348554458,1348554458,1,2,0
52168854@N00,4938,21,1348553026,1348553026,1,2,0
52192784@N08,4939,20,1389749033,1389749033,1,5,0
52192784@N08,4939,9,1389742761,1389742768,2,5,7
52192784@N08,4939,2,1389744158,1389744158,1,5,0
52192784@N08,4939,10,1389742309,1389742309,1,5,0
52192784@N08,4939,15,1389753725,1389753725,1,5,0
52195956@N03,4940,27,1314242250,1314242250,1,2,0
52195956@N03,4940,16,1314223885,1314223885,1,2,0
52195956@N03,4941,27,1383037789,1383037949,6,1,160
52195956@N03,4942,27,1383372154,1383372154,1,3,0
52195956@N03,4942,17,1383391151,1383391741,3,3,590
52195956@N03,4942,16,1383381933,1383392154,3,3,10221
52195956@N03,4943,6,1383446035,1383446051,2,3,16
52195956@N03,4943,17,1383454006,1383454006,1,3,0
52195956@N03,4943,18,1383454276,1383454276,1,3,0
52195956@N03,4944,27,1383712753,1383713705,9,3,952
52195956@N03,4944,6,1383708570,1383709073,5,3,503
52195956@N03,4944,16,1383704872,1383712801,3,3,7929
52195956@N03,4945,8,1408417332,1408417335,2,1,3
52195956@N03,4946,27,1408926253,1408926253,1,1,0
52195956@N03,4947,11,1426122912,1426122928,2,3,16
52195956@N03,4947,17,1426133641,1426133785,3,3,144
52195956@N03,4947,16,1426128658,1426128681,2,3,23
52219207@N03,4948,12,1366438179,1366466705,5,2,28526
52219207@N03,4948,21,1366451199,1366451199,1,2,0
52226961@N04,4949,27,1391837040,1391837040,1,1,0
52254014@N00,4950,17,1278063209,1278068834,3,1,5625
52254014@N00,4951,8,1290653950,1290653950,1,2,0
52254014@N00,4951,26,1290655481,1290655481,1,2,0
52254014@N00,4952,1,1320465309,1320465309,1,1,0
52254014@N00,4953,4,1322466201,1322466494,2,3,293
52254014@N00,4953,27,1322462085,1322462085,1,3,0
52254014@N00,4953,14,1322467673,1322467673,1,3,0
52254014@N00,4954,4,1322639200,1322639200,1,2,0
52254014@N00,4954,17,1322637942,1322637942,1,2,0
52254014@N00,4955,27,1322982948,1322982948,1,1,0
52254014@N00,4956,26,1324368767,1324368767,1,3,0
52254014@N00,4956,17,1324368358,1324368358,1,3,0
52254014@N00,4956,21,1324363647,1324370794,2,3,7147
52254014@N00,4957,19,1324689058,1324689058,1,1,0
52254014@N00,4958,17,1330460423,1330460423,1,2,0
52254014@N00,4958,16,1330461551,1330461551,1,2,0
52254014@N00,4959,15,1333105668,1333105668,1,1,0
52254014@N00,4960,10,1351929064,1351929415,2,1,351
52254014@N00,4961,23,1359236085,1359236085,1,1,0
52254014@N00,4962,9,1373710658,1373710658,1,2,0
52254014@N00,4962,7,1373711318,1373711318,1,2,0
52254014@N00,4963,10,1385798247,1385798247,1,1,0
52273551@N00,4964,16,1412947215,1412947215,1,1,0
52275225@N07,4965,9,1385299934,1385299934,1,2,0
52275225@N07,4965,16,1385290547,1385291617,2,2,1070
52349877@N08,4966,14,1325495769,1325497824,2,2,2055
52349877@N08,4966,27,1325490375,1325490375,1,2,0
52349877@N08,4967,22,1325638146,1325638293,2,1,147
52378595@N06,4968,24,1342418939,1342418939,1,1,0
52378595@N06,4969,4,1342775278,1342775278,1,1,0
52399740@N05,4970,27,1395986171,1395986237,5,3,66
52399740@N05,4970,8,1395985930,1395986022,2,3,92
52399740@N05,4970,19,1395985499,1395985499,1,3,0
52407821@N00,4971,21,1354936418,1354936418,1,1,0
52423581@N00,4972,2,1306822571,1306822571,1,1,0
52446667@N08,4973,27,1373307075,1373308184,3,1,1109
52458519@N07,4974,26,1251157004,1251157004,1,2,0
52458519@N07,4974,17,1251154773,1251154773,1,2,0
52465495@N06,4975,11,1378543010,1378543010,2,5,0
52465495@N06,4975,27,1378543008,1378543017,4,5,9
52465495@N06,4975,16,1378540397,1378540397,1,5,0
52465495@N06,4975,17,1378540397,1378543015,2,5,2618
52465495@N06,4975,26,1378543014,1378543014,1,5,0
52504278@N00,4976,16,1253984345,1253992082,2,1,7737
52504278@N00,4977,16,1333565954,1333565954,1,2,0
52504278@N00,4977,22,1333565193,1333565193,1,2,0
52536373@N02,4978,27,1305252893,1305252893,1,1,0
52574631@N00,4979,9,1269917924,1269918704,7,8,780
52574631@N00,4979,2,1269912963,1269918062,6,8,5099
52574631@N00,4979,1,1269931787,1269931787,1,8,0
52574631@N00,4979,27,1269907657,1269907657,1,8,0
52574631@N00,4979,11,1269934291,1269934558,13,8,267
52574631@N00,4979,19,1269911801,1269926848,10,8,15047
52574631@N00,4979,8,1269909373,1269912213,13,8,2840
52574631@N00,4979,14,1269919407,1269921728,18,8,2321
52574631@N00,4980,17,1323216332,1323216332,1,5,0
52574631@N00,4980,14,1323216871,1323217497,2,5,626
52574631@N00,4980,27,1323212798,1323212798,1,5,0
52574631@N00,4980,22,1323251812,1323251843,2,5,31
52574631@N00,4980,15,1323223413,1323223413,1,5,0
52574631@N00,4981,2,1323857845,1323857845,1,1,0
52574631@N00,4982,14,1363826501,1363847568,5,5,21067
52574631@N00,4982,27,1363854580,1363854580,1,5,0
52574631@N00,4982,3,1363824612,1363824612,1,5,0
52574631@N00,4982,8,1363838487,1363852378,2,5,13891
52574631@N00,4982,10,1363849637,1363849637,1,5,0
52574631@N00,4983,17,1363922717,1363922717,1,6,0
52574631@N00,4983,14,1363910033,1363910317,2,6,284
52574631@N00,4983,27,1363915706,1363916224,2,6,518
52574631@N00,4983,12,1363937999,1363938002,2,6,3
52574631@N00,4983,13,1363937159,1363937255,3,6,96
52574631@N00,4983,20,1363919999,1363919999,1,6,0
52574631@N00,4984,16,1424862100,1424862100,1,1,0
52574631@N00,4985,14,1455578644,1455602710,5,6,24066
52574631@N00,4985,15,1455581554,1455601977,3,6,20423
52574631@N00,4985,16,1455578405,1455601572,4,6,23167
52574631@N00,4985,9,1455587410,1455592053,4,6,4643
52574631@N00,4985,2,1455610172,1455610172,1,6,0
52574631@N00,4985,6,1455588274,1455609401,6,6,21127
52574631@N00,4986,27,1455692974,1455692974,1,7,0
52574631@N00,4986,15,1455676847,1455709882,4,7,33035
52574631@N00,4986,16,1455710876,1455710876,1,7,0
52574631@N00,4986,14,1455669746,1455673835,2,7,4089
52574631@N00,4986,19,1455706063,1455706158,2,7,95
52574631@N00,4986,8,1455702862,1455702877,2,7,15
52574631@N00,4986,10,1455669582,1455673574,6,7,3992
52574631@N00,4987,14,1456015735,1456021018,5,6,5283
52574631@N00,4987,27,1456013554,1456042676,7,6,29122
52574631@N00,4987,2,1456025230,1456031330,5,6,6100
52574631@N00,4987,3,1456025658,1456026098,2,6,440
52574631@N00,4987,1,1456021716,1456033179,2,6,11463
52574631@N00,4987,4,1456029121,1456032558,2,6,3437
52576475@N00,4988,2,1384665613,1384665645,3,2,32
52576475@N00,4988,15,1384653512,1384653677,4,2,165
52627430@N00,4989,16,1222581951,1222582054,5,1,103
52636686@N07,4990,12,1390282264,1390283261,21,21,997
52636686@N07,4990,6,1390276733,1390277375,12,21,642
52636686@N07,4990,16,1390269221,1390269969,8,21,748
52636686@N07,4990,1,1390274461,1390290088,12,21,15627
52636686@N07,4990,18,1390261221,1390261959,12,21,738
52636686@N07,4990,13,1390258699,1390261493,19,21,2794
52636686@N07,4990,22,1390260547,1390260731,5,21,184
52636686@N07,4990,2,1390275113,1390276515,6,21,1402
52636686@N07,4990,15,1390282029,1390283538,6,21,1509
52636686@N07,4990,10,1390273461,1390281102,17,21,7641
52636686@N07,4990,26,1390258527,1390258641,3,21,114
52636686@N07,4990,27,1390248541,1390288700,71,21,40159
52636686@N07,4990,7,1390271915,1390290531,6,21,18616
52636686@N07,4990,14,1390270426,1390281604,8,21,11178
52636686@N07,4990,17,1390259882,1390268872,12,21,8990
52636686@N07,4990,21,1390264033,1390266103,23,21,2070
52636686@N07,4990,20,1390255766,1390256089,6,21,323
52636686@N07,4990,9,1390270149,1390270149,1,21,0
52636686@N07,4990,19,1390256089,1390262822,14,21,6733
52636686@N07,4990,8,1390273858,1390274162,7,21,304
52636686@N07,4990,23,1390266171,1390266376,6,21,205
52666614@N06,4991,10,1407891457,1407891535,3,5,78
52666614@N06,4991,20,1407886896,1407887894,3,5,998
52666614@N06,4991,14,1407891377,1407891377,1,5,0
52666614@N06,4991,27,1407885687,1407885687,1,5,0
52666614@N06,4991,19,1407890342,1407890345,2,5,3
52666614@N06,4992,10,1408082863,1408084099,9,10,1236
52666614@N06,4992,3,1408095713,1408095920,2,10,207
52666614@N06,4992,26,1408091459,1408091459,1,10,0
52666614@N06,4992,14,1408082497,1408082512,2,10,15
52666614@N06,4992,16,1408082615,1408082615,1,10,0
52666614@N06,4992,21,1408079129,1408081495,8,10,2366
52666614@N06,4992,20,1408092260,1408092302,2,10,42
52666614@N06,4992,27,1408077408,1408077408,1,10,0
52666614@N06,4992,4,1408100646,1408100656,2,10,10
52666614@N06,4992,22,1408092724,1408092724,1,10,0
52666614@N06,4993,10,1408194902,1408198919,8,7,4017
52666614@N06,4993,7,1408190788,1408190793,2,7,5
52666614@N06,4993,14,1408191596,1408194345,6,7,2749
52666614@N06,4993,9,1408196038,1408199336,6,7,3298
52666614@N06,4993,6,1408190658,1408190658,1,7,0
52666614@N06,4993,12,1408197800,1408198152,3,7,352
52666614@N06,4993,15,1408194086,1408194086,1,7,0
52666614@N06,4994,13,1408443401,1408443413,2,3,12
52666614@N06,4994,9,1408445413,1408445417,2,3,4
52666614@N06,4994,4,1408448973,1408448978,2,3,5
52683535@N00,4995,16,1322821942,1322821942,1,1,0
52758053@N07,4996,16,1309600251,1309600251,1,1,0
52758053@N07,4997,13,1309655225,1309655225,1,2,0
52758053@N07,4997,1,1309649628,1309649628,1,2,0
52758053@N07,4998,16,1335341713,1335341713,1,1,0
52758053@N07,4999,13,1375606651,1375606651,1,9,0
52758053@N07,4999,12,1375583533,1375583755,2,9,222
52758053@N07,4999,24,1375605182,1375605182,1,9,0
52758053@N07,4999,9,1375571265,1375583713,2,9,12448
52758053@N07,4999,11,1375573470,1375573470,1,9,0
52758053@N07,4999,27,1375604317,1375604317,1,9,0
52758053@N07,4999,14,1375572160,1375580270,3,9,8110
52758053@N07,4999,16,1375616113,1375616113,1,9,0
52758053@N07,4999,10,1375571418,1375571418,1,9,0
52758053@N07,5000,15,1375842460,1375842460,1,1,0
52758053@N07,5001,13,1376005467,1376005467,1,6,0
52758053@N07,5001,19,1376006751,1376011021,2,6,4270
52758053@N07,5001,22,1376005725,1376005725,1,6,0
52758053@N07,5001,18,1376011659,1376011659,1,6,0
52758053@N07,5001,20,1376006728,1376006728,1,6,0
52758053@N07,5001,17,1376005523,1376005523,1,6,0
52758053@N07,5002,27,1376207713,1376207713,1,1,0
52758053@N07,5003,17,1400811815,1400811815,1,2,0
52758053@N07,5003,16,1400790946,1400790946,1,2,0
52758053@N07,5004,3,1431166079,1431166079,1,1,0
52786697@N00,5005,6,1239520634,1239520634,1,3,0
52786697@N00,5005,8,1239524717,1239525043,3,3,326
52786697@N00,5005,27,1239511866,1239511866,1,3,0
52793155@N07,5006,2,1295151475,1295151475,1,1,0
52793155@N07,5007,9,1297430739,1297430739,1,1,0
52793155@N07,5008,14,1297672706,1297672706,1,1,0
52793155@N07,5009,2,1334356357,1334356357,1,1,0
52793155@N07,5010,23,1336815920,1336815920,1,2,0
52793155@N07,5010,24,1336815122,1336815122,1,2,0
52793155@N07,5011,14,1352788403,1352788537,3,6,134
52793155@N07,5011,2,1352794540,1352794540,1,6,0
52793155@N07,5011,16,1352788227,1352788227,1,6,0
52793155@N07,5011,4,1352794883,1352794883,1,6,0
52793155@N07,5011,27,1352780391,1352780391,1,6,0
52793155@N07,5011,9,1352783573,1352783573,1,6,0
52793155@N07,5012,17,1363219991,1363219991,1,1,0
52793155@N07,5013,27,1366504107,1366504107,1,1,0
52793155@N07,5014,23,1383171271,1383171271,1,1,0
52793155@N07,5015,1,1395289275,1395289401,2,3,126
52793155@N07,5015,3,1395295766,1395295766,1,3,0
52793155@N07,5015,27,1395288712,1395288712,1,3,0
52793155@N07,5016,14,1396685350,1396685350,1,1,0
52793155@N07,5017,23,1396919838,1396919838,1,1,0
52793155@N07,5018,12,1420262456,1420262456,1,1,0
52800207@N06,5019,21,1409289614,1409299180,4,1,9566
52800207@N06,5020,21,1409461241,1409461241,1,1,0
52800207@N06,5021,21,1409636217,1409640911,2,1,4694
52842822@N04,5022,17,1372075890,1372075890,1,1,0
52855156@N00,5023,27,1216852438,1216852438,1,1,0
52871849@N04,5024,10,1420345538,1420345538,1,1,0
52872213@N04,5025,16,1301681530,1301681530,1,1,0
52884050@N08,5026,16,1322465837,1322465837,1,1,0
52892088@N02,5027,17,1346558772,1346558772,1,3,0
52892088@N02,5027,10,1346582375,1346582375,1,3,0
52892088@N02,5027,18,1346558968,1346558968,1,3,0
52892088@N02,5028,9,1367702536,1367702536,1,1,0
52906672@N00,5029,27,1407714109,1407714109,1,2,0
52906672@N00,5029,17,1407726241,1407726241,1,2,0
52906672@N00,5030,4,1407923944,1407924093,4,1,149
52906672@N00,5031,9,1408023979,1408023979,1,3,0
52906672@N00,5031,10,1408020569,1408020569,1,3,0
52906672@N00,5031,6,1408010209,1408010209,1,3,0
52976240@N00,5032,27,1354947179,1354983232,6,1,36053
52976240@N00,5033,8,1355040228,1355040228,1,4,0
52976240@N00,5033,10,1355045870,1355045870,1,4,0
52976240@N00,5033,19,1355040906,1355040906,1,4,0
52976240@N00,5033,27,1355055995,1355055995,1,4,0
52976240@N00,5034,26,1424481455,1424481455,1,1,0
52982457@N00,5035,16,1278454717,1278500122,291,1,45405
52999052@N08,5036,27,1278976031,1278976031,1,1,0
53003768@N06,5037,27,1362410218,1362410218,1,1,0
53024970@N07,5038,13,1329087537,1329087537,1,1,0
53024970@N07,5039,8,1334488586,1334488586,1,1,0
53025862@N00,5040,16,1420362522,1420363855,4,13,1333
53025862@N00,5040,15,1420337749,1420348429,11,13,10680
53025862@N00,5040,10,1420370970,1420371414,8,13,444
53025862@N00,5040,14,1420369008,1420370048,36,13,1040
53025862@N00,5040,17,1420336583,1420336583,1,13,0
53025862@N00,5040,2,1420350625,1420350669,2,13,44
53025862@N00,5040,26,1420360994,1420362250,4,13,1256
53025862@N00,5040,12,1420366000,1420366603,12,13,603
53025862@N00,5040,25,1420336679,1420336679,1,13,0
53025862@N00,5040,11,1420364215,1420364215,1,13,0
53025862@N00,5040,9,1420352430,1420356823,9,13,4393
53025862@N00,5040,6,1420356902,1420359755,5,13,2853
53025862@N00,5040,20,1420339416,1420340945,12,13,1529
53046881@N07,5041,27,1389598478,1389598478,1,1,0
53052885@N08,5042,25,1372367209,1372367209,1,1,0
53055319@N00,5043,2,1188722601,1188722665,2,3,64
53055319@N00,5043,27,1188721058,1188721908,10,3,850
53055319@N00,5043,19,1188722732,1188722732,1,3,0
53055319@N00,5044,9,1197884376,1197884376,1,4,0
53055319@N00,5044,2,1197884323,1197884323,1,4,0
53055319@N00,5044,27,1197883967,1197883967,1,4,0
53055319@N00,5044,3,1197884269,1197884269,1,4,0
53079182@N04,5045,16,1251948719,1251948719,1,1,0
53123154@N04,5046,27,1294426761,1294426785,2,1,24
53127166@N04,5047,27,1391208275,1391249658,4,1,41383
53127166@N04,5048,27,1393058579,1393058579,1,1,0
53129881@N00,5049,22,1366614070,1366614070,1,3,0
53129881@N00,5049,16,1366613994,1366613994,1,3,0
53129881@N00,5049,24,1366593439,1366593439,1,3,0
53199533@N07,5050,15,1268658018,1268658018,1,4,0
53199533@N07,5050,21,1268658034,1268658034,1,4,0
53199533@N07,5050,13,1268658014,1268658021,7,4,7
53199533@N07,5050,7,1268658032,1268658033,2,4,1
53199533@N07,5051,6,1269003626,1269003626,1,6,0
53199533@N07,5051,15,1269003619,1269003619,1,6,0
53199533@N07,5051,12,1269003615,1269003620,5,6,5
53199533@N07,5051,19,1269003611,1269003614,4,6,3
53199533@N07,5051,9,1269003623,1269003625,3,6,2
53199533@N07,5051,14,1269003621,1269003621,1,6,0
53199533@N07,5052,16,1269090004,1269090017,14,5,13
53199533@N07,5052,21,1269090020,1269090022,3,5,2
53199533@N07,5052,1,1269090001,1269090001,1,5,0
53199533@N07,5052,4,1269090002,1269090003,2,5,1
53199533@N07,5052,27,1269090025,1269090025,1,5,0
53325263@N07,5053,6,1301193766,1301193800,4,4,34
53325263@N07,5053,11,1301201772,1301201772,1,4,0
53325263@N07,5053,19,1301186568,1301186568,1,4,0
53325263@N07,5053,27,1301210351,1301210481,2,4,130
53342633@N00,5054,27,1224066264,1224066264,1,4,0
53342633@N00,5054,9,1224039450,1224040377,2,4,927
53342633@N00,5054,1,1224047256,1224047256,1,4,0
53342633@N00,5054,3,1224047944,1224047944,1,4,0
53342633@N00,5055,15,1288596905,1288596905,1,3,0
53342633@N00,5055,17,1288597804,1288597804,1,3,0
53342633@N00,5055,14,1288597477,1288597477,1,3,0
53353745@N00,5056,2,1399783721,1399783721,1,3,0
53353745@N00,5056,14,1399763144,1399763144,1,3,0
53353745@N00,5056,8,1399773167,1399773167,1,3,0
53407359@N00,5057,6,1417564934,1417564952,3,2,18
53407359@N00,5057,20,1417580323,1417580323,1,2,0
53438674@N03,5058,22,1256762713,1256775415,23,1,12702
53438674@N03,5059,22,1286834189,1286842556,16,1,8367
53439923@N02,5060,2,1307722816,1307722816,1,2,0
53439923@N02,5060,16,1307720871,1307720871,1,2,0
53467158@N00,5061,3,1319545989,1319545989,1,1,0
53516741@N04,5062,27,1319190205,1319204216,9,2,14011
53516741@N04,5062,13,1319199613,1319199971,2,2,358
53516741@N04,5063,27,1319458196,1319458196,2,8,0
53516741@N04,5063,18,1319408077,1319408385,2,8,308
53516741@N04,5063,16,1319439495,1319439495,1,8,0
53516741@N04,5063,20,1319412532,1319412599,2,8,67
53516741@N04,5063,23,1319456479,1319456479,1,8,0
53516741@N04,5063,15,1319443399,1319443399,1,8,0
53516741@N04,5063,14,1319438809,1319438809,1,8,0
53516741@N04,5063,26,1319450879,1319450879,1,8,0
53516741@N04,5064,20,1386577221,1386577221,1,2,0
53516741@N04,5064,26,1386592403,1386592403,1,2,0
53516741@N04,5065,13,1413549479,1413549479,1,2,0
53516741@N04,5065,26,1413538214,1413538214,1,2,0
53602988@N02,5066,16,1302827784,1302827784,1,2,0
53602988@N02,5066,5,1302826333,1302830286,16,2,3953
53602988@N02,5067,16,1353118837,1353123533,2,2,4696
53602988@N02,5067,8,1353119449,1353119449,1,2,0
53613159@N04,5068,17,1319339097,1319339097,1,3,0
53613159@N04,5068,27,1319326561,1319346434,4,3,19873
53613159@N04,5068,18,1319335600,1319335600,1,3,0
53613159@N04,5069,25,1319770686,1319770686,1,1,0
53727855@N08,5070,16,1327984640,1327991571,7,1,6931
53727855@N08,5071,16,1328051837,1328063341,12,1,11504
53786716@N06,5072,10,1351309703,1351309703,1,1,0
53797701@N07,5073,18,1406462997,1406462997,1,1,0
53798207@N02,5074,22,1303709210,1303709210,1,1,0
53821866@N05,5075,27,1470036084,1470036084,1,1,0
53901034@N00,5076,22,1362715221,1362715221,1,11,0
53901034@N00,5076,23,1362710812,1362710812,1,11,0
53901034@N00,5076,9,1362719484,1362719484,1,11,0
53901034@N00,5076,11,1362721043,1362722224,2,11,1181
53901034@N00,5076,8,1362720222,1362720432,3,11,210
53901034@N00,5076,12,1362730042,1362731245,2,11,1203
53901034@N00,5076,14,1362718456,1362730701,2,11,12245
53901034@N00,5076,16,1362731518,1362731877,2,11,359
53901034@N00,5076,24,1362714121,1362714259,2,11,138
53901034@N00,5076,25,1362708965,1362709151,2,11,186
53901034@N00,5076,27,1362701847,1362706804,5,11,4957
53901034@N00,5077,9,1362898288,1362903512,2,9,5224
53901034@N00,5077,14,1362885839,1362886157,3,9,318
53901034@N00,5077,11,1362897350,1362897362,2,9,12
53901034@N00,5077,3,1362876055,1362876055,1,9,0
53901034@N00,5077,8,1362880753,1362880753,1,9,0
53901034@N00,5077,17,1362892984,1362892984,1,9,0
53901034@N00,5077,16,1362900396,1362900396,1,9,0
53901034@N00,5077,27,1362870667,1362870667,1,9,0
53901034@N00,5077,4,1362898595,1362899614,2,9,1019
53937205@N06,5078,17,1278241340,1278241468,13,1,128
53964849@N08,5079,16,1347016838,1347016861,2,1,23
53964849@N08,5080,16,1347065159,1347065182,2,1,23
53980976@N07,5081,14,1372720428,1372720428,1,1,0
54010592@N03,5082,21,1296156099,1296200539,31,1,44440
54010592@N03,5083,21,1296247223,1296292150,60,1,44927
54010592@N03,5084,21,1296346251,1296361500,8,1,15249
54033452@N00,5085,10,1360205332,1360205332,1,1,0
54034604@N00,5086,10,1381361427,1381361739,13,5,312
54034604@N00,5086,9,1381359371,1381360401,3,5,1030
54034604@N00,5086,15,1381358229,1381358291,3,5,62
54034604@N00,5086,3,1381364107,1381364107,1,5,0
54034604@N00,5086,1,1381366385,1381366385,1,5,0
54182124@N02,5087,26,1363923003,1363923003,1,1,0
54250081@N05,5088,14,1370055673,1370055780,4,12,107
54250081@N05,5088,24,1370040893,1370041673,17,12,780
54250081@N05,5088,17,1370055587,1370055587,1,12,0
54250081@N05,5088,20,1370043052,1370043179,3,12,127
54250081@N05,5088,25,1370034670,1370041191,2,12,6521
54250081@N05,5088,19,1370043482,1370043635,5,12,153
54250081@N05,5088,21,1370035136,1370042963,24,12,7827
54250081@N05,5088,9,1370055841,1370055841,1,12,0
54250081@N05,5088,10,1370055889,1370055889,1,12,0
54250081@N05,5088,16,1370047609,1370048107,3,12,498
54250081@N05,5088,18,1370043358,1370044062,14,12,704
54250081@N05,5088,23,1370039508,1370039650,6,12,142
54354082@N00,5089,27,1283574539,1283582890,3,2,8351
54354082@N00,5089,19,1283572444,1283572444,1,2,0
54364530@N08,5090,27,1354569954,1354570653,3,1,699
54364530@N08,5091,20,1386806668,1386807594,15,3,926
54364530@N08,5091,19,1386807284,1386807284,1,3,0
54364530@N08,5091,22,1386807580,1386807580,1,3,0
54364530@N08,5092,27,1449026181,1449026181,1,1,0
54364530@N08,5093,3,1449402319,1449402322,2,1,3
54417425@N08,5094,5,1329251542,1329251542,1,1,0
54432460@N08,5095,26,1295495305,1295495305,1,1,0
54497431@N05,5096,16,1258534006,1258534006,1,1,0
54502770@N04,5097,27,1288733950,1288733950,1,1,0
54512387@N04,5098,14,1313218619,1313218619,1,2,0
54512387@N04,5098,2,1313222230,1313222232,2,2,2
54573009@N00,5099,11,1295764357,1295764357,1,1,0
54575648@N03,5100,24,1364432174,1364432174,1,1,0
54612194@N05,5101,16,1364518741,1364519876,2,1,1135
54619082@N05,5102,14,1321745292,1321745292,1,1,0
54619082@N05,5103,21,1337765543,1337765543,1,1,0
54623999@N07,5104,27,1307683689,1307712131,3,2,28442
54623999@N07,5104,16,1307656087,1307710790,4,2,54703
54679799@N03,5105,16,1370231973,1370254010,3,1,22037
54679799@N03,5106,8,1370658463,1370658463,1,1,0
54679799@N03,5107,27,1386229497,1386229497,1,1,0
54679799@N03,5108,16,1463810506,1463829123,3,2,18617
54679799@N03,5108,21,1463815393,1463815393,1,2,0
54679799@N03,5109,27,1464228052,1464259937,3,5,31885
54679799@N03,5109,1,1464228823,1464228823,1,5,0
54679799@N03,5109,14,1464226349,1464226349,1,5,0
54679799@N03,5109,15,1464218272,1464218272,1,5,0
54679799@N03,5109,12,1464225881,1464225881,1,5,0
54679799@N03,5110,21,1464300792,1464300792,1,3,0
54679799@N03,5110,4,1464307193,1464307193,1,3,0
54679799@N03,5110,27,1464308923,1464309246,2,3,323
54748189@N05,5111,27,1333770372,1333770372,1,1,0
54780044@N02,5112,3,1302409413,1302418640,6,1,9227
54804105@N07,5113,20,1454740200,1454740200,1,1,0
54821630@N00,5114,27,1190159838,1190189353,116,1,29515
54831087@N00,5115,2,1286946331,1286946331,1,6,0
54831087@N00,5115,27,1286958258,1286958266,2,6,8
54831087@N00,5115,20,1286951271,1286951271,1,6,0
54831087@N00,5115,25,1286927538,1286927863,3,6,325
54831087@N00,5115,10,1286934724,1286958784,2,6,24060
54831087@N00,5115,13,1286941721,1286951938,2,6,10217
54845704@N05,5116,7,1298429144,1298429144,1,8,0
54845704@N05,5116,6,1298425773,1298434955,2,8,9182
54845704@N05,5116,2,1298429777,1298441841,2,8,12064
54845704@N05,5116,14,1298424393,1298424425,2,8,32
54845704@N05,5116,27,1298412756,1298413062,2,8,306
54845704@N05,5116,16,1298444986,1298448600,3,8,3614
54845704@N05,5116,9,1298427196,1298427324,2,8,128
54845704@N05,5116,5,1298434623,1298434623,1,8,0
54845704@N05,5117,17,1298614287,1298614925,4,7,638
54845704@N05,5117,26,1298612002,1298612799,4,7,797
54845704@N05,5117,20,1298609966,1298609966,1,7,0
54845704@N05,5117,27,1298595390,1298595390,1,7,0
54845704@N05,5117,21,1298596435,1298596435,1,7,0
54845704@N05,5117,23,1298608321,1298608414,2,7,93
54845704@N05,5117,22,1298606677,1298606677,1,7,0
54855264@N00,5118,3,1192968525,1192969550,2,8,1025
54855264@N00,5118,17,1192953070,1192963630,3,8,10560
54855264@N00,5118,26,1192954684,1192963135,3,8,8451
54855264@N00,5118,27,1192952290,1192970890,3,8,18600
54855264@N00,5118,16,1192952945,1192970567,8,8,17622
54855264@N00,5118,13,1192964542,1192964555,2,8,13
54855264@N00,5118,7,1192966893,1192966893,1,8,0
54855264@N00,5118,14,1192959372,1192960229,5,8,857
54855264@N00,5119,27,1376218034,1376218034,1,1,0
54886079@N07,5120,26,1282047082,1282047082,1,1,0
54902025@N00,5121,27,1227257139,1227257139,1,1,0
54902025@N00,5122,3,1286535701,1286536481,4,7,780
54902025@N00,5122,14,1286524592,1286524592,1,7,0
54902025@N00,5122,21,1286529135,1286529135,1,7,0
54902025@N00,5122,13,1286526597,1286527212,2,7,615
54902025@N00,5122,27,1286521236,1286543413,2,7,22177
54902025@N00,5122,9,1286531285,1286531285,1,7,0
54902025@N00,5122,20,1286529486,1286529486,1,7,0
54902025@N00,5123,2,1286761420,1286761420,1,5,0
54902025@N00,5123,27,1286771831,1286771831,1,5,0
54902025@N00,5123,18,1286764464,1286764464,1,5,0
54902025@N00,5123,1,1286770282,1286770282,1,5,0
54902025@N00,5123,23,1286766142,1286766160,2,5,18
54902025@N00,5124,12,1329025911,1329025911,1,7,0
54902025@N00,5124,4,1329037298,1329037298,1,7,0
54902025@N00,5124,3,1329032562,1329032562,1,7,0
54902025@N00,5124,21,1329014810,1329014810,1,7,0
54902025@N00,5124,25,1329013853,1329013853,1,7,0
54902025@N00,5124,13,1329021542,1329021542,1,7,0
54902025@N00,5124,18,1329017534,1329017534,1,7,0
54902025@N00,5125,13,1329117497,1329117497,1,2,0
54902025@N00,5125,21,1329110776,1329110982,2,2,206
54902025@N00,5126,1,1332328971,1332328971,1,5,0
54902025@N00,5126,18,1332323123,1332323885,3,5,762
54902025@N00,5126,21,1332309228,1332310115,2,5,887
54902025@N00,5126,7,1332327655,1332327655,1,5,0
54902025@N00,5126,9,1332328230,1332328230,1,5,0
54902025@N00,5127,26,1332412146,1332412146,1,3,0
54902025@N00,5127,16,1332419730,1332419933,2,3,203
54902025@N00,5127,25,1332405745,1332420800,2,3,15055
54902025@N00,5128,27,1354708686,1354708686,1,3,0
54902025@N00,5128,10,1354698498,1354702969,5,3,4471
54902025@N00,5128,7,1354704699,1354704699,1,3,0
54902025@N00,5129,16,1354752676,1354752676,1,1,0
54902025@N00,5130,25,1379332710,1379332710,1,3,0
54902025@N00,5130,14,1379329941,1379329941,1,3,0
54902025@N00,5130,27,1379325798,1379335161,3,3,9363
54902025@N00,5131,26,1379425881,1379425881,1,4,0
54902025@N00,5131,20,1379426060,1379426060,1,4,0
54902025@N00,5131,13,1379427203,1379427203,1,4,0
54902025@N00,5131,27,1379417684,1379418004,3,4,320
54962605@N00,5132,16,1332046942,1332046942,1,1,0
55005522@N00,5133,27,1217809948,1217809948,1,1,0
55005522@N00,5134,27,1249492420,1249492420,1,1,0
55005522@N00,5135,27,1344339041,1344353714,8,1,14673
55041396@N00,5136,8,1367049502,1367049502,1,2,0
55041396@N00,5136,27,1367044482,1367044482,1,2,0
55050519@N08,5137,2,1325841243,1325841243,1,1,0
55095306@N02,5138,10,1310668164,1310668164,1,1,0
55132698@N04,5139,16,1332127151,1332127151,1,1,0
55143107@N00,5140,15,1223948914,1223948946,3,3,32
55143107@N00,5140,5,1223943991,1223944769,5,3,778
55143107@N00,5140,27,1223959967,1223959975,2,3,8
55171970@N00,5141,26,1439205768,1439206538,20,1,770
55191318@N04,5142,2,1287118809,1287118820,4,1,11
55193633@N05,5143,17,1352797872,1352808044,9,1,10172
55206790@N08,5144,14,1309776781,1309778176,9,1,1395
55206790@N08,5145,6,1362733602,1362733602,1,1,0
55217458@N00,5146,25,1352620138,1352620138,1,2,0
55217458@N00,5146,1,1352620296,1352620296,1,2,0
55217458@N00,5147,24,1352864094,1352864094,1,5,0
55217458@N00,5147,14,1352836337,1352836337,1,5,0
55217458@N00,5147,16,1352836288,1352836288,1,5,0
55217458@N00,5147,3,1352836189,1352836189,1,5,0
55217458@N00,5147,10,1352836521,1352864000,2,5,27479
55217458@N00,5148,21,1389143778,1389143778,1,6,0
55217458@N00,5148,1,1389148593,1389148593,1,6,0
55217458@N00,5148,22,1389142574,1389142574,1,6,0
55217458@N00,5148,16,1389145443,1389145443,1,6,0
55217458@N00,5148,14,1389139364,1389139364,1,6,0
55217458@N00,5148,19,1389139849,1389139849,1,6,0
55217458@N00,5149,16,1389384814,1389384814,1,1,0
55217458@N00,5150,16,1389482862,1389482862,1,2,0
55217458@N00,5150,1,1389482774,1389482774,1,2,0
55236153@N04,5151,27,1289913427,1289913427,1,1,0
55332987@N00,5152,18,1257674360,1257674360,1,1,0
55332987@N00,5153,3,1265498173,1265498173,1,1,0
55362088@N06,5154,1,1341975794,1341975794,1,1,0
55364225@N06,5155,27,1251727200,1251727200,10,1,0
55404083@N08,5156,12,1303387376,1303387376,1,1,0
55404083@N08,5157,16,1303983393,1303983393,1,2,0
55404083@N08,5157,12,1303989646,1303989646,1,2,0
55405015@N08,5158,5,1375486199,1375486199,1,5,0
55405015@N08,5158,21,1375502277,1375502277,1,5,0
55405015@N08,5158,27,1375507800,1375531391,3,5,23591
55405015@N08,5158,6,1375488660,1375489106,2,5,446
55405015@N08,5158,4,1375486275,1375486275,1,5,0
55432889@N05,5159,21,1358305674,1358332492,10,1,26818
55442189@N00,5160,27,1403995579,1403995579,1,1,0
55455788@N00,5161,22,1198134983,1198134983,1,10,0
55455788@N00,5161,8,1198107352,1198130690,17,10,23338
55455788@N00,5161,9,1198105666,1198127232,12,10,21566
55455788@N00,5161,21,1198129113,1198139129,3,10,10016
55455788@N00,5161,5,1198132974,1198132974,1,10,0
55455788@N00,5161,6,1198110420,1198132053,7,10,21633
55455788@N00,5161,16,1198100480,1198140488,16,10,40008
55455788@N00,5161,27,1198119067,1198119067,1,10,0
55455788@N00,5161,14,1198100765,1198126142,11,10,25377
55455788@N00,5161,25,1198094305,1198139419,28,10,45114
55455788@N00,5162,3,1222560575,1222561671,5,4,1096
55455788@N00,5162,19,1222580849,1222580849,1,4,0
55455788@N00,5162,21,1222580636,1222580736,2,4,100
55455788@N00,5162,17,1222569648,1222580440,6,4,10792
55455788@N00,5163,16,1239523738,1239525165,15,1,1427
55455788@N00,5164,22,1255776688,1255776688,1,3,0
55455788@N00,5164,9,1255776753,1255776753,1,3,0
55455788@N00,5164,16,1255776724,1255776724,1,3,0
55455788@N00,5165,14,1256680669,1256680669,1,1,0
55455788@N00,5166,17,1276255383,1276256425,52,10,1042
55455788@N00,5166,3,1276248557,1276248557,1,10,0
55455788@N00,5166,12,1276241039,1276243025,22,10,1986
55455788@N00,5166,9,1276247278,1276247278,1,10,0
55455788@N00,5166,6,1276250277,1276250955,3,10,678
55455788@N00,5166,16,1276234484,1276258971,99,10,24487
55455788@N00,5166,22,1276235754,1276236523,14,10,769
55455788@N00,5166,25,1276237453,1276239282,7,10,1829
55455788@N00,5166,27,1276232894,1276232894,1,10,0
55455788@N00,5166,14,1276243079,1276246952,10,10,3873
55455788@N00,5167,26,1292070313,1292070313,1,1,0
55455788@N00,5168,22,1420082070,1420082070,1,7,0
55455788@N00,5168,1,1420092016,1420092016,1,7,0
55455788@N00,5168,13,1420074752,1420074865,2,7,113
55455788@N00,5168,9,1420067580,1420067806,3,7,226
55455788@N00,5168,15,1420108303,1420108303,1,7,0
55455788@N00,5168,10,1420068019,1420068717,3,7,698
55455788@N00,5168,14,1420067538,1420067538,1,7,0
55466956@N00,5169,16,1209338440,1209338440,1,1,0
55474499@N04,5170,27,1317116710,1317116710,1,1,0
55558729@N03,5171,18,1331338471,1331338471,1,1,0
55569174@N00,5172,9,1349328820,1349328820,1,2,0
55569174@N00,5172,13,1349326678,1349326678,1,2,0
55615740@N00,5173,26,1404478995,1404478995,1,4,0
55615740@N00,5173,21,1404480006,1404480734,2,4,728
55615740@N00,5173,27,1404471736,1404471741,2,4,5
55615740@N00,5173,2,1404471948,1404472448,9,4,500
55615740@N00,5174,14,1410050132,1410050132,1,4,0
55615740@N00,5174,12,1410049499,1410049520,3,4,21
55615740@N00,5174,13,1410049534,1410049795,10,4,261
55615740@N00,5174,15,1410049333,1410049438,4,4,105
55653833@N04,5175,27,1379983681,1379983681,1,1,0
55723046@N04,5176,10,1320718270,1320718299,2,1,29
55762226@N00,5177,17,1423983710,1423983710,1,1,0
55762226@N00,5178,2,1439490639,1439490639,1,1,0
55762226@N00,5179,6,1441530840,1441530840,1,1,0
55894487@N00,5180,17,1335007507,1335007507,1,2,0
55894487@N00,5180,9,1335005707,1335005707,1,2,0
55986062@N03,5181,27,1371162034,1371162034,1,1,0
55986062@N03,5182,27,1371255133,1371255133,1,1,0
55991777@N00,5183,9,1433543217,1433543238,4,7,21
55991777@N00,5183,15,1433586600,1433586600,1,7,0
55991777@N00,5183,27,1433541024,1433541024,1,7,0
55991777@N00,5183,19,1433551719,1433551722,2,7,3
55991777@N00,5183,22,1433561910,1433561915,3,7,5
55991777@N00,5183,4,1433546373,1433546373,1,7,0
55991777@N00,5183,26,1433561801,1433561813,3,7,12
55991777@N00,5184,15,1433935727,1433935727,1,1,0
56005337@N03,5185,9,1285216956,1285216956,1,4,0
56005337@N03,5185,16,1285218366,1285218366,1,4,0
56005337@N03,5185,20,1285219468,1285219528,2,4,60
56005337@N03,5185,1,1285215734,1285215734,1,4,0
56027706@N00,5186,24,1264216911,1264216911,1,2,0
56027706@N00,5186,16,1264215646,1264215829,2,2,183
56040377@N07,5187,20,1412235321,1412235321,1,3,0
56040377@N07,5187,14,1412233196,1412233196,1,3,0
56040377@N07,5187,17,1412233654,1412233654,1,3,0
56068273@N06,5188,12,1359619965,1359619965,1,1,0
56072795@N00,5189,16,1358011272,1358011272,1,1,0
56129960@N03,5190,27,1347483120,1347483583,2,2,463
56129960@N03,5190,18,1347496583,1347496612,2,2,29
56176110@N04,5191,14,1307872359,1307872359,1,5,0
56176110@N04,5191,27,1307877759,1307877759,1,5,0
56176110@N04,5191,16,1307876846,1307877024,2,5,178
56176110@N04,5191,4,1307870836,1307870836,1,5,0
56176110@N04,5191,12,1307870972,1307877631,4,5,6659
56223610@N07,5192,20,1335160618,1335160618,1,1,0
56223610@N07,5193,4,1335197251,1335201129,5,1,3878
56279017@N03,5194,2,1383947126,1383947126,1,1,0
56293740@N06,5195,16,1245251747,1245251747,1,1,0
56414555@N03,5196,21,1311837725,1311837725,1,2,0
56414555@N03,5196,27,1311843682,1311843682,1,2,0
56414555@N03,5197,25,1311905239,1311905344,2,5,105
56414555@N03,5197,27,1311902649,1311902649,1,5,0
56414555@N03,5197,21,1311915267,1311918820,2,5,3553
56414555@N03,5197,5,1311920267,1311920267,1,5,0
56414555@N03,5197,1,1311922872,1311924303,2,5,1431
56416261@N00,5198,21,1304045130,1304045226,3,1,96
56507536@N04,5199,1,1351470211,1351470211,1,1,0
56515177@N02,5200,23,1317704611,1317704626,2,9,15
56515177@N02,5200,4,1317716094,1317716113,2,9,19
56515177@N02,5200,13,1317709856,1317711083,4,9,1227
56515177@N02,5200,9,1317716225,1317716246,2,9,21
56515177@N02,5200,27,1317702760,1317718488,3,9,15728
56515177@N02,5200,18,1317710220,1317711161,4,9,941
56515177@N02,5200,17,1317711366,1317711366,1,9,0
56515177@N02,5200,12,1317711423,1317711539,4,9,116
56515177@N02,5200,16,1317709287,1317709287,1,9,0
56572346@N02,5201,16,1345890436,1345890436,1,4,0
56572346@N02,5201,21,1345887974,1345888961,3,4,987
56572346@N02,5201,27,1345876294,1345876294,1,4,0
56572346@N02,5201,13,1345877321,1345877659,6,4,338
56572346@N02,5202,10,1351546187,1351558734,16,5,12547
56572346@N02,5202,27,1351574235,1351574293,3,5,58
56572346@N02,5202,21,1351552844,1351554204,5,5,1360
56572346@N02,5202,13,1351564063,1351564152,3,5,89
56572346@N02,5202,16,1351544400,1351544549,2,5,149
56609749@N02,5203,22,1299666631,1299666631,1,3,0
56609749@N02,5203,16,1299655988,1299655988,1,3,0
56609749@N02,5203,14,1299648463,1299666127,2,3,17664
56615362@N05,5204,19,1288420359,1288420359,1,2,0
56615362@N05,5204,16,1288433487,1288433603,2,2,116
56642201@N00,5205,25,1308362253,1308364771,3,1,2518
56695999@N08,5206,14,1440528290,1440528290,1,1,0
56701972@N00,5207,25,1440770400,1440770411,10,2,11
56701972@N00,5207,27,1440770400,1440770414,14,2,14
56701972@N00,5208,25,1440811118,1440811554,2,2,436
56701972@N00,5208,27,1440810743,1440810743,1,2,0
56726532@N06,5209,16,1419678402,1419678402,1,1,0
56795655@N00,5210,8,1296478800,1296478800,1,4,0
56795655@N00,5210,26,1296478800,1296478800,1,4,0
56795655@N00,5210,17,1296478800,1296478800,3,4,0
56795655@N00,5210,15,1296478800,1296478800,1,4,0
56815302@N00,5211,14,1231061021,1231061021,1,1,0
56881130@N02,5212,18,1295485260,1295485260,1,1,0
56909601@N00,5213,20,1271916320,1271916320,1,1,0
56922122@N03,5214,16,1255216804,1255216804,1,1,0
56922122@N03,5215,16,1260690519,1260690519,1,1,0
56922122@N03,5216,16,1267865571,1267865712,2,1,141
56922122@N03,5217,16,1283505222,1283505255,3,1,33
56922122@N03,5218,16,1283700173,1283700244,2,1,71
56922122@N03,5219,16,1301218401,1301218401,1,1,0
56922122@N03,5220,16,1313310606,1313310985,2,1,379
56922122@N03,5221,16,1320393862,1320394336,7,1,474
56922122@N03,5222,27,1326621292,1326621292,1,2,0
56922122@N03,5222,16,1326623136,1326623136,1,2,0
56972276@N06,5223,24,1309591426,1309591527,2,1,101
57060047@N04,5224,3,1452216783,1452216788,2,1,5
57072623@N00,5225,27,1352452668,1352452668,1,1,0
57102255@N00,5226,12,1354313373,1354313373,1,1,0
57147777@N05,5227,16,1311904293,1311904293,1,1,0
57169261@N06,5228,27,1395456991,1395456991,1,2,0
57169261@N06,5228,16,1395468647,1395468647,1,2,0
57169261@N06,5229,15,1399371285,1399371285,1,1,0
57169261@N06,5230,3,1400114187,1400114187,1,1,0
57169261@N06,5231,3,1400578310,1400578310,1,1,0
57169261@N06,5232,25,1413602817,1413602817,1,1,0
57169261@N06,5233,20,1433494973,1433494973,1,1,0
57248474@N00,5234,27,1250207661,1250207661,1,1,0
57268629@N00,5235,12,1388401426,1388401524,2,5,98
57268629@N00,5235,15,1388401339,1388401351,2,5,12
57268629@N00,5235,13,1388401405,1388401405,1,5,0
57268629@N00,5235,17,1388408552,1388408552,1,5,0
57268629@N00,5235,27,1388395658,1388397617,3,5,1959
57268629@N00,5236,26,1388540044,1388540337,18,6,293
57268629@N00,5236,13,1388553287,1388553287,1,6,0
57268629@N00,5236,10,1388558234,1388560715,5,6,2481
57268629@N00,5236,2,1388563086,1388563086,1,6,0
57268629@N00,5236,17,1388552292,1388552292,2,6,0
57268629@N00,5236,12,1388555348,1388555348,1,6,0
57268629@N00,5237,27,1388744962,1388744962,1,1,0
57268629@N00,5238,23,1389319056,1389319056,1,2,0
57268629@N00,5238,17,1389326351,1389326351,1,2,0
57268629@N00,5239,17,1389849939,1389849939,1,1,0
57311596@N05,5240,17,1259406911,1259407074,3,1,163
57311596@N05,5241,18,1322047575,1322047575,1,2,0
57311596@N05,5241,16,1322054973,1322054973,1,2,0
57377423@N00,5242,27,1362202326,1362202326,1,1,0
57377423@N00,5243,27,1445857597,1445857597,1,1,0
57441548@N00,5244,16,1261623500,1261636575,2,1,13075
57453992@N04,5245,19,1259545767,1259545767,1,2,0
57453992@N04,5245,25,1259555856,1259555856,1,2,0
57453992@N04,5246,27,1295048101,1295055499,9,2,7398
57453992@N04,5246,11,1295048859,1295048859,1,2,0
57507580@N00,5247,23,1336272466,1336272516,2,6,50
57507580@N00,5247,17,1336286389,1336286389,1,6,0
57507580@N00,5247,6,1336276103,1336276103,1,6,0
57507580@N00,5247,2,1336285717,1336285717,1,6,0
57507580@N00,5247,27,1336264329,1336264329,1,6,0
57507580@N00,5247,21,1336269076,1336269076,1,6,0
57510064@N06,5248,27,1403513760,1403513760,1,1,0
57516324@N03,5249,9,1428326346,1428326346,1,1,0
57540523@N07,5250,5,1294909282,1294909282,1,2,0
57540523@N07,5250,9,1294894924,1294909267,2,2,14343
57619740@N05,5251,27,1329130666,1329130666,1,1,0
57657053@N00,5252,27,1189926140,1189926147,2,2,7
57657053@N00,5252,12,1189926120,1189926120,1,2,0
57657053@N00,5253,27,1195363369,1195363369,1,1,0
57657053@N00,5254,9,1207358626,1207358755,2,2,129
57657053@N00,5254,12,1207355193,1207355519,2,2,326
57657053@N00,5255,27,1222414558,1222414671,4,4,113
57657053@N00,5255,17,1222429109,1222429594,3,4,485
57657053@N00,5255,16,1222423453,1222423453,1,4,0
57657053@N00,5255,14,1222419707,1222420845,4,4,1138
57669645@N03,5256,23,1408085880,1408085880,1,4,0
57669645@N03,5256,27,1408111451,1408111451,1,4,0
57669645@N03,5256,24,1408083081,1408083081,1,4,0
57669645@N03,5256,25,1408075762,1408075762,1,4,0
57669645@N03,5257,14,1408854503,1408854503,1,1,0
57672494@N04,5258,14,1415166067,1415166067,1,1,0
57765281@N06,5259,27,1307702226,1307702226,1,1,0
57765281@N06,5260,16,1307921065,1307921065,1,1,0
57799803@N02,5261,3,1393290363,1393290363,1,1,0
57799803@N02,5262,25,1424501926,1424501926,1,1,0
57812277@N05,5263,14,1298675662,1298675662,1,3,0
57812277@N05,5263,16,1298674193,1298674193,1,3,0
57812277@N05,5263,27,1298701237,1298711554,9,3,10317
57812277@N05,5264,19,1343266485,1343266485,1,1,0
57812277@N05,5265,17,1343382312,1343382312,1,1,0
57812277@N05,5266,21,1343700190,1343700190,1,2,0
57812277@N05,5266,9,1343690680,1343690680,1,2,0
57812277@N05,5267,27,1343819088,1343822658,2,1,3570
57812277@N05,5268,10,1356820880,1356820880,1,1,0
57812277@N05,5269,27,1375842610,1375842610,1,1,0
57812277@N05,5270,14,1409544696,1409544696,1,1,0
57812277@N05,5271,27,1426728859,1426728859,1,1,0
57835821@N00,5272,27,1196427600,1196427600,1,1,0
57835821@N00,5273,27,1305412309,1305414394,7,5,2085
57835821@N00,5273,12,1305424693,1305424693,1,5,0
57835821@N00,5273,17,1305416127,1305416325,5,5,198
57835821@N00,5273,9,1305423167,1305423383,5,5,216
57835821@N00,5273,15,1305422922,1305422922,1,5,0
57835821@N00,5274,6,1315636416,1315636416,1,3,0
57835821@N00,5274,2,1315636367,1315636375,2,3,8
57835821@N00,5274,27,1315644850,1315644907,2,3,57
57835821@N00,5275,24,1327708955,1327709554,14,11,599
57835821@N00,5275,27,1327701837,1327731361,7,11,29524
57835821@N00,5275,21,1327704142,1327706805,18,11,2663
57835821@N00,5275,1,1327734435,1327734435,1,11,0
57835821@N00,5275,17,1327740342,1327740421,6,11,79
57835821@N00,5275,14,1327736073,1327736073,1,11,0
57835821@N00,5275,20,1327704551,1327704622,5,11,71
57835821@N00,5275,23,1327744518,1327744526,2,11,8
57835821@N00,5275,3,1327734460,1327734460,1,11,0
57835821@N00,5275,12,1327737591,1327738174,5,11,583
57835821@N00,5275,6,1327734420,1327734441,2,11,21
57835821@N00,5276,16,1362115412,1362115412,1,5,0
57835821@N00,5276,27,1362089278,1362089390,3,5,112
57835821@N00,5276,14,1362112965,1362114419,7,5,1454
57835821@N00,5276,17,1362117329,1362117329,1,5,0
57835821@N00,5276,9,1362091608,1362091980,7,5,372
57835821@N00,5277,22,1368242445,1368245330,4,7,2885
57835821@N00,5277,27,1368232330,1368258281,5,7,25951
57835821@N00,5277,8,1368255952,1368255969,3,7,17
57835821@N00,5277,24,1368237789,1368237789,1,7,0
57835821@N00,5277,4,1368256696,1368256716,2,7,20
57835821@N00,5277,25,1368234147,1368234147,1,7,0
57835821@N00,5277,11,1368251944,1368254005,9,7,2061
57835821@N00,5278,25,1381557211,1381557380,6,13,169
57835821@N00,5278,13,1381555283,1381555484,3,13,201
57835821@N00,5278,22,1381559423,1381559423,1,13,0
57835821@N00,5278,8,1381541962,1381541962,1,13,0
57835821@N00,5278,4,1381571581,1381571593,2,13,12
57835821@N00,5278,2,1381566308,1381566743,2,13,435
57835821@N00,5278,27,1381531527,1381531635,3,13,108
57835821@N00,5278,21,1381561504,1381561636,2,13,132
57835821@N00,5278,18,1381555416,1381555416,1,13,0
57835821@N00,5278,11,1381536815,1381539502,16,13,2687
57835821@N00,5278,17,1381553263,1381563748,6,13,10485
57835821@N00,5278,14,1381544889,1381544889,1,13,0
57835821@N00,5278,26,1381557645,1381557645,1,13,0
57835821@N00,5279,27,1394236073,1394236087,2,3,14
57835821@N00,5279,20,1394236250,1394236250,1,3,0
57835821@N00,5279,26,1394249356,1394249356,1,3,0
57835821@N00,5280,5,1411699015,1411699038,2,9,23
57835821@N00,5280,27,1411691834,1411691840,2,9,6
57835821@N00,5280,18,1411716736,1411717407,7,9,671
57835821@N00,5280,24,1411711817,1411712781,7,9,964
57835821@N00,5280,21,1411706760,1411706774,2,9,14
57835821@N00,5280,22,1411702721,1411702721,1,9,0
57835821@N00,5280,25,1411708460,1411712958,9,9,4498
57835821@N00,5280,19,1411717622,1411717742,3,9,120
57835821@N00,5280,3,1411694938,1411696257,8,9,1319
57835821@N00,5281,27,1413325774,1413363411,3,5,37637
57835821@N00,5281,20,1413348012,1413350998,5,5,2986
57835821@N00,5281,10,1413337535,1413338199,9,5,664
57835821@N00,5281,24,1413359862,1413360388,4,5,526
57835821@N00,5281,2,1413331512,1413334723,4,5,3211
57908463@N00,5282,27,1435361447,1435361447,1,1,0
57915028@N00,5283,13,1357602203,1357602203,1,5,0
57915028@N00,5283,5,1357590964,1357590964,1,5,0
57915028@N00,5283,3,1357597044,1357597044,1,5,0
57915028@N00,5283,18,1357609821,1357609821,1,5,0
57915028@N00,5283,26,1357611356,1357611356,1,5,0
57915028@N00,5284,4,1357717876,1357717912,3,2,36
57915028@N00,5284,27,1357693129,1357693129,1,2,0
57915028@N00,5285,9,1357778882,1357778882,1,2,0
57915028@N00,5285,12,1357777966,1357777966,1,2,0
57915028@N00,5286,10,1357978154,1357978154,1,3,0
57915028@N00,5286,27,1357976367,1357976635,4,3,268
57915028@N00,5286,14,1357978942,1357978942,1,3,0
57937052@N06,5287,27,1394760003,1394760003,1,2,0
57937052@N06,5287,10,1394764012,1394764012,1,2,0
57959349@N00,5288,9,1385006655,1385006655,1,1,0
58013444@N04,5289,26,1284790810,1284790810,1,1,0
58013444@N04,5290,27,1286000908,1286000908,1,1,0
58013444@N04,5291,27,1288935426,1288935426,1,1,0
58013444@N04,5292,23,1295319445,1295319445,1,2,0
58013444@N04,5292,26,1295324912,1295325026,2,2,114
58072194@N08,5293,16,1381362026,1381362836,7,3,810
58072194@N08,5293,24,1381385002,1381385002,1,3,0
58072194@N08,5293,11,1381369186,1381369186,1,3,0
58121556@N04,5294,16,1243778400,1243778400,1,1,0
58147831@N08,5295,27,1381202748,1381202748,1,1,0
58228008@N00,5296,6,1385099379,1385099395,3,6,16
58228008@N00,5296,9,1385097799,1385097952,2,6,153
58228008@N00,5296,7,1385098710,1385099356,3,6,646
58228008@N00,5296,27,1385085117,1385085613,4,6,496
58228008@N00,5296,21,1385088313,1385088360,3,6,47
58228008@N00,5296,17,1385090032,1385090032,1,6,0
58228008@N00,5297,10,1385158134,1385163358,20,9,5224
58228008@N00,5297,14,1385160185,1385174324,26,9,14139
58228008@N00,5297,13,1385164835,1385164835,1,9,0
58228008@N00,5297,16,1385166565,1385172591,16,9,6026
58228008@N00,5297,4,1385179530,1385179530,1,9,0
58228008@N00,5297,17,1385198903,1385198903,1,9,0
58228008@N00,5297,3,1385177601,1385178410,3,9,809
58228008@N00,5297,15,1385164523,1385164561,3,9,38
58228008@N00,5297,12,1385164637,1385164725,3,9,88
58288136@N06,5298,21,1298971026,1298971026,1,1,0
58434175@N08,5299,2,1438737865,1438737865,1,1,0
58436993@N00,5300,6,1301816014,1301817459,2,5,1445
58436993@N00,5300,5,1301788318,1301788318,1,5,0
58436993@N00,5300,24,1301821959,1301821959,1,5,0
58436993@N00,5300,14,1301811635,1301819600,3,5,7965
58436993@N00,5300,17,1301825806,1301825806,1,5,0
58479263@N00,5301,15,1350885769,1350885769,1,1,0
58505724@N00,5302,8,1188718190,1188718239,3,2,49
58505724@N00,5302,16,1188720739,1188720739,1,2,0
58512585@N00,5303,12,1415664737,1415664737,1,11,0
58512585@N00,5303,22,1415680095,1415680095,1,11,0
58512585@N00,5303,10,1415662299,1415662299,1,11,0
58512585@N00,5303,8,1415673109,1415687616,2,11,14507
58512585@N00,5303,27,1415657167,1415657508,2,11,341
58512585@N00,5303,13,1415664549,1415664549,1,11,0
58512585@N00,5303,9,1415685048,1415685048,1,11,0
58512585@N00,5303,19,1415670094,1415672586,6,11,2492
58512585@N00,5303,14,1415659424,1415665866,2,11,6442
58512585@N00,5303,7,1415687286,1415687474,2,11,188
58512585@N00,5303,15,1415663710,1415665281,3,11,1571
58512585@N00,5304,10,1415829898,1415832233,3,9,2335
58512585@N00,5304,20,1415839656,1415839656,1,9,0
58512585@N00,5304,3,1415829090,1415829090,1,9,0
58512585@N00,5304,23,1415835387,1415835387,1,9,0
58512585@N00,5304,21,1415838781,1415838781,1,9,0
58512585@N00,5304,2,1415843721,1415843721,1,9,0
58512585@N00,5304,18,1415849106,1415851154,3,9,2048
58512585@N00,5304,1,1415845752,1415845752,1,9,0
58512585@N00,5304,6,1415845705,1415845705,1,9,0
58518845@N00,5305,8,1351591062,1351591062,1,1,0
58588822@N00,5306,13,1298599808,1298599808,1,1,0
58602712@N04,5307,14,1295573123,1295573123,1,3,0
58602712@N04,5307,3,1295573124,1295573124,1,3,0
58602712@N04,5307,1,1295573126,1295573126,1,3,0
58604743@N04,5308,27,1377747946,1377748983,3,1,1037
58638140@N08,5309,15,1319357363,1319357363,1,2,0
58638140@N08,5309,14,1319327629,1319354089,2,2,26460
58755999@N05,5310,16,1400532507,1400532507,1,1,0
58769150@N04,5311,16,1322547323,1322559266,5,1,11943
58783731@N05,5312,16,1292400276,1292424896,3,1,24620
58853244@N07,5313,23,1295024950,1295024950,1,1,0
58887120@N00,5314,1,1330094841,1330094841,1,5,0
58887120@N00,5314,13,1330065001,1330066537,3,5,1536
58887120@N00,5314,17,1330064152,1330064152,1,5,0
58887120@N00,5314,14,1330087309,1330087693,4,5,384
58887120@N00,5314,25,1330067524,1330082686,3,5,15162
58923069@N02,5315,21,1326373208,1326373208,1,1,0
58953549@N05,5316,23,1332563842,1332563842,1,1,0
58953549@N05,5317,21,1333287919,1333287919,1,5,0
58953549@N05,5317,27,1333293779,1333293779,1,5,0
58953549@N05,5317,5,1333285016,1333285016,1,5,0
58953549@N05,5317,3,1333285003,1333285003,1,5,0
58953549@N05,5317,16,1333300132,1333300530,4,5,398
58991728@N00,5318,27,1260592116,1260592116,1,1,0
58991728@N00,5319,27,1261039449,1261039449,1,1,0
59063529@N02,5320,16,1335176256,1335176256,1,1,0
59067283@N00,5321,27,1279385657,1279456548,24,1,70891
59067283@N00,5322,27,1279501613,1279644360,123,1,142747
59067283@N00,5323,27,1279678194,1279717943,34,1,39749
59067283@N00,5324,27,1279769989,1279800248,24,1,30259
59067283@N00,5325,27,1279840056,1279884719,61,1,44663
59067283@N00,5326,27,1279928309,1279973509,61,1,45200
59071486@N00,5327,16,1354785022,1354785232,2,2,210
59071486@N00,5327,10,1354783051,1354783051,1,2,0
59071486@N00,5328,14,1359267329,1359271280,3,1,3951
59071486@N00,5329,14,1366711330,1366711330,1,1,0
59071486@N00,5330,3,1373703552,1373703552,1,2,0
59071486@N00,5330,16,1373706243,1373706243,1,2,0
59071486@N00,5331,13,1377414564,1377414564,1,1,0
59071486@N00,5332,16,1385812283,1385812283,1,1,0
59071486@N00,5333,16,1392372524,1392372524,1,2,0
59071486@N00,5333,27,1392364320,1392364320,1,2,0
59106234@N00,5334,16,1299877681,1299877681,1,1,0
59162053@N00,5335,17,1347602450,1347602450,1,7,0
59162053@N00,5335,7,1347604922,1347604925,2,7,3
59162053@N00,5335,16,1347592739,1347592845,2,7,106
59162053@N00,5335,9,1347604510,1347604514,2,7,4
59162053@N00,5335,25,1347593400,1347593400,1,7,0
59162053@N00,5335,2,1347599408,1347599408,1,7,0
59162053@N00,5335,4,1347596920,1347596920,1,7,0
59171457@N00,5336,27,1329730170,1329730170,1,1,0
59187662@N05,5337,16,1375661688,1375661688,1,2,0
59187662@N05,5337,14,1375663539,1375663539,1,2,0
59288549@N02,5338,16,1347608196,1347608196,1,2,0
59288549@N02,5338,17,1347608031,1347608031,1,2,0
59288549@N02,5339,27,1347683700,1347683700,1,2,0
59288549@N02,5339,17,1347685089,1347685119,2,2,30
59288549@N02,5340,24,1347749748,1347749823,2,5,75
59288549@N02,5340,20,1347750713,1347750915,3,5,202
59288549@N02,5340,22,1347751820,1347751820,1,5,0
59288549@N02,5340,27,1347764379,1347764788,2,5,409
59288549@N02,5340,18,1347752122,1347752122,1,5,0
59288549@N02,5341,13,1367631525,1367631525,1,4,0
59288549@N02,5341,17,1367626157,1367626157,1,4,0
59288549@N02,5341,22,1367641028,1367641028,1,4,0
59288549@N02,5341,9,1367631758,1367631758,1,4,0
59288549@N02,5342,16,1367925229,1367925418,3,6,189
59288549@N02,5342,21,1367918661,1367918661,1,6,0
59288549@N02,5342,20,1367917473,1367918436,3,6,963
59288549@N02,5342,19,1367918237,1367918237,1,6,0
59288549@N02,5342,27,1367906213,1367907799,2,6,1586
59288549@N02,5342,14,1367924871,1367925059,2,6,188
59305396@N05,5343,21,1306470485,1306470485,1,1,0
59320616@N08,5344,21,1324165939,1324165939,1,1,0
59320616@N08,5345,26,1324351385,1324351385,1,1,0
59320616@N08,5346,26,1324691580,1324691580,1,3,0
59320616@N08,5346,17,1324692180,1324692180,1,3,0
59320616@N08,5346,25,1324692206,1324692206,1,3,0
59361155@N07,5347,17,1334121462,1334121544,2,2,82
59361155@N07,5347,16,1334144228,1334144228,1,2,0
59364175@N00,5348,25,1330134004,1330138058,11,3,4054
59364175@N00,5348,23,1330133420,1330133936,2,3,516
59364175@N00,5348,27,1330140648,1330144464,4,3,3816
59390981@N04,5349,2,1309706185,1309706185,1,8,0
59390981@N04,5349,27,1309683867,1309707509,7,8,23642
59390981@N04,5349,17,1309701109,1309701109,1,8,0
59390981@N04,5349,12,1309690144,1309690452,3,8,308
59390981@N04,5349,13,1309688334,1309688740,4,8,406
59390981@N04,5349,24,1309699367,1309699367,1,8,0
59390981@N04,5349,3,1309705401,1309705401,1,8,0
59390981@N04,5349,18,1309688358,1309688366,2,8,8
59390981@N04,5350,18,1309956492,1309956492,1,2,0
59390981@N04,5350,14,1309958137,1309958137,1,2,0
59451747@N00,5351,17,1358483714,1358483714,1,4,0
59451747@N00,5351,16,1358463603,1358483711,5,4,20108
59451747@N00,5351,10,1358469721,1358469721,1,4,0
59451747@N00,5351,4,1358483704,1358483704,1,4,0
59471679@N04,5352,1,1407554961,1407554961,1,1,0
59471679@N04,5353,22,1408702178,1408702178,1,2,0
59471679@N04,5353,4,1408703317,1408703317,1,2,0
59471679@N04,5354,26,1414814883,1414814883,1,1,0
59471679@N04,5355,27,1417847391,1417847391,1,2,0
59471679@N04,5355,8,1417837903,1417837903,1,2,0
59471679@N04,5356,27,1417934067,1417934067,1,2,0
59471679@N04,5356,15,1417924323,1417924323,1,2,0
59471679@N04,5357,10,1425447899,1425447899,1,1,0
59471679@N04,5358,19,1425780004,1425780337,2,2,333
59471679@N04,5358,22,1425776874,1425777227,2,2,353
59471679@N04,5359,26,1428109768,1428109768,1,1,0
59471679@N04,5360,17,1428189076,1428189076,1,1,0
59471679@N04,5361,8,1431582444,1431582444,1,2,0
59471679@N04,5361,27,1431584475,1431584475,1,2,0
59471679@N04,5362,26,1431742345,1431742487,3,1,142
59471679@N04,5363,26,1432347000,1432347000,1,1,0
59471679@N04,5364,27,1432502611,1432502611,1,1,0
59471679@N04,5365,26,1433555779,1433555779,1,1,0
59471679@N04,5366,27,1442608721,1442608721,1,1,0
59471679@N04,5367,27,1442695055,1442695055,1,1,0
59471679@N04,5368,26,1460867121,1460867121,1,1,0
59487241@N04,5369,26,1387278799,1387278799,1,3,0
59487241@N04,5369,27,1387263606,1387263606,1,3,0
59487241@N04,5369,4,1387267067,1387267067,1,3,0
59513859@N00,5370,20,1316743794,1316776369,4,5,32575
59513859@N00,5370,27,1316737114,1316760668,5,5,23554
59513859@N00,5370,24,1316746810,1316778533,7,5,31723
59513859@N00,5370,16,1316739074,1316764457,2,5,25383
59513859@N00,5370,19,1316749662,1316749662,1,5,0
59543838@N00,5371,27,1317543694,1317543694,1,1,0
59615198@N00,5372,14,1272192195,1272192195,1,4,0
59615198@N00,5372,1,1272169886,1272169903,2,4,17
59615198@N00,5372,3,1272165033,1272165033,1,4,0
59615198@N00,5372,19,1272157502,1272157577,2,4,75
59622473@N06,5373,4,1347156175,1347156175,1,1,0
59643697@N00,5374,9,1390612052,1390612059,3,6,7
59643697@N00,5374,10,1390617145,1390617437,14,6,292
59643697@N00,5374,21,1390612619,1390622989,5,6,10370
59643697@N00,5374,2,1390611505,1390611505,1,6,0
59643697@N00,5374,24,1390612596,1390612596,1,6,0
59643697@N00,5374,6,1390619431,1390619431,1,6,0
59669438@N05,5375,24,1311310717,1311310717,1,3,0
59669438@N05,5375,6,1311304942,1311304942,1,3,0
59669438@N05,5375,27,1311300029,1311300029,1,3,0
59669438@N05,5376,27,1353316258,1353316258,1,1,0
59682384@N03,5377,18,1378526958,1378526958,1,1,0
59686711@N04,5378,27,1388897172,1388900718,2,1,3546
59774801@N07,5379,16,1376838276,1376838276,1,1,0
59794429@N07,5380,27,1338168255,1338168255,1,1,0
59834105@N02,5381,14,1446632496,1446632496,1,1,0
59888795@N03,5382,15,1249533000,1249533000,1,1,0
59888795@N03,5383,17,1253077371,1253077371,1,2,0
59888795@N03,5383,16,1253074473,1253074473,1,2,0
59888795@N03,5384,16,1379401997,1379401997,1,3,0
59888795@N03,5384,17,1379401363,1379401363,1,3,0
59888795@N03,5384,20,1379409848,1379410674,7,3,826
59888795@N03,5385,27,1379561869,1379561869,1,5,0
59888795@N03,5385,13,1379549382,1379549382,1,5,0
59888795@N03,5385,19,1379550866,1379550913,5,5,47
59888795@N03,5385,17,1379549361,1379549494,2,5,133
59888795@N03,5385,18,1379549466,1379549466,1,5,0
59888795@N03,5386,27,1431923556,1431923556,1,3,0
59888795@N03,5386,19,1431906824,1431906824,1,3,0
59888795@N03,5386,17,1431905307,1431905307,1,3,0
59888866@N00,5387,27,1231809336,1231831903,15,1,22567
59888866@N00,5388,2,1286354312,1286355802,2,2,1490
59888866@N00,5388,16,1286352592,1286352592,1,2,0
59888866@N00,5389,27,1317281582,1317281582,1,2,0
59888866@N00,5389,16,1317282110,1317282110,1,2,0
59888866@N00,5390,22,1358405396,1358405396,1,1,0
59888866@N00,5391,25,1358478110,1358478110,1,1,0
59888866@N00,5392,19,1363494550,1363494550,1,2,0
59888866@N00,5392,17,1363494461,1363494461,1,2,0
59888866@N00,5393,19,1370077521,1370077521,1,2,0
59888866@N00,5393,3,1370082689,1370082689,1,2,0
59888866@N00,5394,3,1377308088,1377308088,1,1,0
59888866@N00,5395,2,1379246506,1379246506,1,1,0
59888866@N00,5396,16,1394105527,1394105527,1,1,0
59888866@N00,5397,14,1394947436,1394947436,1,1,0
59918083@N03,5398,27,1246863444,1246863444,1,1,0
59983818@N06,5399,9,1366449621,1366449621,1,1,0
59983818@N06,5400,17,1366546651,1366546770,2,6,119
59983818@N06,5400,4,1366551208,1366551208,1,6,0
59983818@N06,5400,5,1366551650,1366552942,2,6,1292
59983818@N06,5400,21,1366548752,1366549853,5,6,1101
59983818@N06,5400,13,1366546192,1366546192,1,6,0
59983818@N06,5400,9,1366552364,1366552364,1,6,0
59983818@N06,5401,10,1366772449,1366772449,1,2,0
59983818@N06,5401,2,1366769117,1366769117,1,2,0
60007645@N06,5402,15,1316911660,1316911714,8,2,54
60007645@N06,5402,27,1316906778,1316906958,9,2,180
60007645@N06,5403,14,1316986393,1316989829,68,2,3436
60007645@N06,5403,9,1316989474,1316989474,1,2,0
60054626@N00,5404,27,1245833767,1245834023,5,2,256
60054626@N00,5404,4,1245844560,1245844560,1,2,0
60054626@N00,5405,26,1246020354,1246022634,11,6,2280
60054626@N00,5405,15,1246016828,1246020938,13,6,4110
60054626@N00,5405,14,1246015489,1246024702,15,6,9213
60054626@N00,5405,16,1246022372,1246024901,3,6,2529
60054626@N00,5405,17,1246015229,1246015453,3,6,224
60054626@N00,5405,27,1246012388,1246026311,10,6,13923
60054626@N00,5406,1,1246190000,1246190000,1,4,0
60054626@N00,5406,5,1246188280,1246190102,4,4,1822
60054626@N00,5406,14,1246186003,1246186682,2,4,679
60054626@N00,5406,16,1246190109,1246192260,4,4,2151
60054626@N00,5407,1,1431914125,1431914895,2,9,770
60054626@N00,5407,27,1431918890,1431923378,14,9,4488
60054626@N00,5407,12,1431934484,1431935021,3,9,537
60054626@N00,5407,20,1431922198,1431922198,1,9,0
60054626@N00,5407,9,1431910686,1431910700,2,9,14
60054626@N00,5407,2,1431911734,1431918057,4,9,6323
60054626@N00,5407,8,1431909087,1431909486,5,9,399
60054626@N00,5407,16,1431908226,1431927386,3,9,19160
60054626@N00,5407,5,1431932419,1431932593,3,9,174
60054626@N00,5408,9,1432078797,1432081684,10,2,2887
60054626@N00,5408,27,1432077536,1432077706,5,2,170
60054626@N00,5409,27,1432118756,1432118756,1,1,0
60062774@N02,5410,27,1298413378,1298413378,1,2,0
60062774@N02,5410,24,1298435338,1298435338,1,2,0
60065271@N04,5411,3,1307250937,1307250937,1,3,0
60065271@N04,5411,16,1307247705,1307247705,1,3,0
60065271@N04,5411,4,1307275234,1307276288,3,3,1054
60065710@N00,5412,16,1374115480,1374115480,1,1,0
60065710@N00,5413,8,1464261549,1464261549,1,1,0
60082453@N05,5414,16,1394401511,1394449941,13,1,48430
60082453@N05,5415,16,1394679713,1394705478,22,1,25765
60082453@N05,5416,6,1429011074,1429011074,1,7,0
60082453@N05,5416,14,1428975489,1428975489,1,7,0
60082453@N05,5416,20,1428973032,1428973032,1,7,0
60082453@N05,5416,19,1428972104,1428987965,2,7,15861
60082453@N05,5416,27,1428992979,1428993294,4,7,315
60082453@N05,5416,17,1429019011,1429019011,1,7,0
60082453@N05,5416,9,1428970766,1428970766,1,7,0
60082453@N05,5417,22,1429156507,1429156507,1,6,0
60082453@N05,5417,17,1429153400,1429160527,2,6,7127
60082453@N05,5417,20,1429155617,1429157669,2,6,2052
60082453@N05,5417,4,1429152585,1429152585,1,6,0
60082453@N05,5417,16,1429153319,1429153319,1,6,0
60082453@N05,5417,19,1429155785,1429160135,5,6,4350
60082453@N05,5418,27,1447275142,1447275142,1,2,0
60082453@N05,5418,16,1447290378,1447290378,1,2,0
60082453@N05,5419,16,1447319914,1447325036,14,4,5122
60082453@N05,5419,23,1447329462,1447329462,1,4,0
60082453@N05,5419,4,1447328308,1447328308,1,4,0
60082453@N05,5419,27,1447332644,1447332644,1,4,0
60212022@N00,5420,16,1195202340,1195203213,3,1,873
60212022@N00,5421,16,1195894020,1195894020,1,1,0
60212022@N00,5422,16,1212016714,1212016809,2,1,95
60212022@N00,5423,16,1215051791,1215055739,9,1,3948
60212022@N00,5424,16,1215162769,1215162769,1,1,0
60220094@N07,5425,18,1387947603,1387947603,1,2,0
60220094@N07,5425,8,1387940484,1387940484,1,2,0
60272404@N06,5426,2,1400794544,1400794544,1,1,0
60272404@N06,5427,16,1409486924,1409486924,1,1,0
60272404@N06,5428,27,1431996686,1431996686,1,1,0
60328269@N07,5429,27,1418676268,1418676268,1,1,0
60385541@N00,5430,10,1380866573,1380867700,6,3,1127
60385541@N00,5430,27,1380862266,1380879206,8,3,16940
60385541@N00,5430,3,1380866106,1380866174,4,3,68
60385541@N00,5431,9,1412401183,1412401183,1,3,0
60385541@N00,5431,13,1412392274,1412392274,1,3,0
60385541@N00,5431,14,1412397434,1412397434,1,3,0
60388490@N00,5432,20,1407908518,1407908518,1,1,0
60388490@N00,5433,16,1407971254,1407971268,2,1,14
60388490@N00,5434,3,1408163954,1408163954,1,1,0
60417400@N08,5435,16,1315889119,1315889119,1,1,0
60429294@N06,5436,16,1267948787,1267948787,1,1,0
60466267@N05,5437,27,1344037832,1344037832,1,1,0
60481456@N00,5438,16,1387405926,1387405926,1,1,0
60481456@N00,5439,27,1387450948,1387450948,1,1,0
60504322@N04,5440,27,1317391200,1317391200,29,1,0
60504322@N04,5441,23,1372308915,1372309329,14,10,414
60504322@N04,5441,3,1372340035,1372340064,8,10,29
60504322@N04,5441,14,1372314356,1372323158,40,10,8802
60504322@N04,5441,22,1372311842,1372313976,54,10,2134
60504322@N04,5441,11,1372323309,1372326280,15,10,2971
60504322@N04,5441,4,1372341094,1372342832,4,10,1738
60504322@N04,5441,1,1372322467,1372322467,1,10,0
60504322@N04,5441,17,1372317945,1372319978,17,10,2033
60504322@N04,5441,26,1372306652,1372308848,18,10,2196
60504322@N04,5441,16,1372321822,1372338712,52,10,16890
60595282@N07,5442,16,1309647634,1309648407,43,1,773
60595282@N07,5443,16,1309736880,1309737506,26,1,626
60595282@N07,5444,16,1309824082,1309824763,18,1,681
60611201@N02,5445,19,1347946694,1347946694,1,1,0
60667261@N05,5446,10,1349013600,1349013600,4,3,0
60667261@N05,5446,14,1349013600,1349013600,3,3,0
60667261@N05,5446,9,1349013600,1349013600,1,3,0
60667261@N05,5447,10,1350078321,1350081065,3,1,2744
60734465@N07,5448,27,1380701289,1380701581,2,1,292
60822590@N07,5449,17,1447554647,1447554647,1,3,0
60822590@N07,5449,14,1447567240,1447567396,2,3,156
60822590@N07,5449,27,1447569854,1447569857,2,3,3
60881589@N00,5450,20,1392601852,1392601852,1,2,0
60881589@N00,5450,14,1392607935,1392607935,1,2,0
60881589@N00,5451,8,1392774046,1392774046,1,3,0
60881589@N00,5451,27,1392784539,1392784539,1,3,0
60881589@N00,5451,13,1392771203,1392771203,1,3,0
60883325@N03,5452,27,1354832619,1354832619,1,1,0
60883325@N03,5453,27,1354867351,1354867351,1,1,0
60887351@N02,5454,14,1301713527,1301713527,1,1,0
60897658@N00,5455,8,1210826033,1210826076,3,5,43
60897658@N00,5455,9,1210823510,1210823521,2,5,11
60897658@N00,5455,16,1210819206,1210819206,1,5,0
60897658@N00,5455,11,1210828622,1210828622,1,5,0
60897658@N00,5455,22,1210830980,1210830980,1,5,0
60897658@N00,5456,11,1210930048,1210930048,1,1,0
60897658@N00,5457,16,1210983743,1210983743,1,2,0
60897658@N00,5457,22,1210995319,1210995369,3,2,50
60897658@N00,5458,21,1211108516,1211108516,1,5,0
60897658@N00,5458,8,1211098942,1211099399,2,5,457
60897658@N00,5458,12,1211107340,1211107340,1,5,0
60897658@N00,5458,14,1211103811,1211103829,3,5,18
60897658@N00,5458,11,1211098040,1211098175,2,5,135
60981140@N03,5459,27,1386445011,1386445011,1,1,0
61078591@N00,5460,14,1208830855,1208830855,1,5,0
61078591@N00,5460,20,1208828686,1208830145,6,5,1459
61078591@N00,5460,17,1208826686,1208828661,2,5,1975
61078591@N00,5460,9,1208818394,1208818394,1,5,0
61078591@N00,5460,22,1208830221,1208830221,1,5,0
61081531@N00,5461,7,1220595257,1220595257,1,16,0
61081531@N00,5461,11,1220595507,1220597037,6,16,1530
61081531@N00,5461,22,1220590366,1220590392,3,16,26
61081531@N00,5461,23,1220580706,1220580706,1,16,0
61081531@N00,5461,20,1220579062,1220579062,1,16,0
61081531@N00,5461,25,1220586596,1220587045,4,16,449
61081531@N00,5461,9,1220575828,1220595142,4,16,19314
61081531@N00,5461,17,1220591798,1220592269,17,16,471
61081531@N00,5461,15,1220576612,1220577116,5,16,504
61081531@N00,5461,26,1220580159,1220580159,1,16,0
61081531@N00,5461,13,1220582755,1220582755,1,16,0
61081531@N00,5461,27,1220585621,1220600786,3,16,15165
61081531@N00,5461,19,1220579246,1220579676,3,16,430
61081531@N00,5461,24,1220586266,1220586266,1,16,0
61081531@N00,5461,14,1220594760,1220594760,1,16,0
61081531@N00,5461,8,1220595335,1220595411,2,16,76
61083754@N04,5462,3,1199574170,1199574170,1,4,0
61083754@N04,5462,20,1199588664,1199588664,1,4,0
61083754@N04,5462,17,1199600548,1199600548,1,4,0
61083754@N04,5462,19,1199601094,1199601094,1,4,0
61083754@N04,5463,16,1199775853,1199775906,3,2,53
61083754@N04,5463,4,1199774036,1199774036,1,2,0
61083754@N04,5464,3,1252842740,1252842740,2,4,0
61083754@N04,5464,27,1252814284,1252814300,4,4,16
61083754@N04,5464,20,1252827624,1252827665,6,4,41
61083754@N04,5464,14,1252822548,1252822586,4,4,38
61083754@N04,5465,16,1253169314,1253175585,9,7,6271
61083754@N04,5465,27,1253169864,1253169864,2,7,0
61083754@N04,5465,25,1253140687,1253148993,42,7,8306
61083754@N04,5465,2,1253164683,1253164683,1,7,0
61083754@N04,5465,9,1253164318,1253164416,5,7,98
61083754@N04,5465,14,1253153507,1253175472,18,7,21965
61083754@N04,5465,21,1253153184,1253154944,7,7,1760
61096082@N05,5466,19,1418869851,1418869851,1,4,0
61096082@N05,5466,3,1418875583,1418875583,1,4,0
61096082@N05,5466,20,1418868724,1418870505,3,4,1781
61096082@N05,5466,27,1418861292,1418882716,2,4,21424
61102903@N02,5467,12,1459046016,1459046016,1,3,0
61102903@N02,5467,15,1459046663,1459046663,1,3,0
61102903@N02,5467,23,1459051297,1459051297,1,3,0
61102903@N02,5468,16,1466325479,1466325479,1,1,0
61104413@N00,5469,25,1344384764,1344384764,1,1,0
61149901@N06,5470,27,1385975258,1385975258,1,2,0
61149901@N06,5470,16,1385998018,1385998018,1,2,0
61172210@N08,5471,20,1293415157,1293415157,1,1,0
61198674@N00,5472,21,1311468304,1311468304,1,15,0
61198674@N00,5472,15,1311465355,1311465414,2,15,59
61198674@N00,5472,1,1311462300,1311462300,1,15,0
61198674@N00,5472,22,1311477006,1311477006,1,15,0
61198674@N00,5472,2,1311479545,1311479545,1,15,0
61198674@N00,5472,26,1311468404,1311468420,2,15,16
61198674@N00,5472,23,1311468350,1311468350,1,15,0
61198674@N00,5472,25,1311468475,1311468475,1,15,0
61198674@N00,5472,3,1311481600,1311481600,1,15,0
61198674@N00,5472,13,1311465458,1311466699,6,15,1241
61198674@N00,5472,12,1311465373,1311465373,1,15,0
61198674@N00,5472,4,1311468628,1311468628,1,15,0
61198674@N00,5472,27,1311491087,1311491362,2,15,275
61198674@N00,5472,9,1311463988,1311464083,3,15,95
61198674@N00,5472,5,1311468692,1311468711,3,15,19
61198674@N00,5473,16,1311548577,1311548577,1,5,0
61198674@N00,5473,14,1311548571,1311548743,7,5,172
61198674@N00,5473,13,1311550423,1311550427,2,5,4
61198674@N00,5473,27,1311545400,1311545560,3,5,160
61198674@N00,5473,20,1311551616,1311552086,2,5,470
61202488@N00,5474,12,1447635128,1447635197,4,8,69
61202488@N00,5474,10,1447630327,1447630354,3,8,27
61202488@N00,5474,17,1447661345,1447665983,5,8,4638
61202488@N00,5474,23,1447659575,1447659641,3,8,66
61202488@N00,5474,19,1447656376,1447656376,1,8,0
61202488@N00,5474,9,1447628075,1447628292,2,8,217
61202488@N00,5474,14,1447667908,1447668089,4,8,181
61202488@N00,5474,7,1447628898,1447629152,2,8,254
61202488@N00,5475,10,1447837202,1447837259,4,6,57
61202488@N00,5475,6,1447803853,1447803853,1,6,0
61202488@N00,5475,27,1447831085,1447831520,6,6,435
61202488@N00,5475,14,1447806278,1447806539,7,6,261
61202488@N00,5475,9,1447801811,1447801811,1,6,0
61202488@N00,5475,22,1447811874,1447811874,1,6,0
61207928@N04,5476,27,1340615418,1340615418,1,1,0
61207928@N04,5477,25,1340689995,1340689995,1,2,0
61207928@N04,5477,19,1340665620,1340665620,1,2,0
61207928@N04,5478,3,1340881866,1340881866,1,1,0
61207928@N04,5479,2,1341139294,1341139294,1,2,0
61207928@N04,5479,13,1341130995,1341130995,1,2,0
61261095@N02,5480,22,1290772589,1290772589,1,1,0
61261095@N02,5481,9,1292073023,1292073023,1,1,0
61261095@N02,5482,26,1292300173,1292300202,2,2,29
61261095@N02,5482,16,1292293651,1292293651,1,2,0
61261095@N02,5483,4,1295328963,1295330913,2,3,1950
61261095@N02,5483,1,1295329264,1295329264,1,3,0
61261095@N02,5483,16,1295328606,1295328871,2,3,265
61261095@N02,5484,23,1297576862,1297576874,2,1,12
61261095@N02,5485,21,1298113485,1298113485,1,1,0
61261095@N02,5486,17,1299558331,1299558401,2,3,70
61261095@N02,5486,26,1299558364,1299558364,1,3,0
61261095@N02,5486,16,1299545335,1299569365,2,3,24030
61261095@N02,5487,27,1299746594,1299746594,1,1,0
61261095@N02,5488,21,1303102679,1303102693,2,1,14
61261095@N02,5489,14,1339842107,1339842107,1,5,0
61261095@N02,5489,21,1339844999,1339844999,1,5,0
61261095@N02,5489,8,1339840478,1339841055,4,5,577
61261095@N02,5489,11,1339840318,1339840318,1,5,0
61261095@N02,5489,24,1339845348,1339845348,1,5,0
61261095@N02,5490,16,1341317808,1341318440,2,1,632
61261095@N02,5491,12,1346546562,1346546562,1,3,0
61261095@N02,5491,14,1346544250,1346544250,1,3,0
61261095@N02,5491,27,1346540639,1346540639,1,3,0
61261095@N02,5492,27,1347427431,1347427431,1,1,0
61285500@N03,5493,14,1402391162,1402391162,1,1,0
61285553@N00,5494,27,1197115420,1197117670,25,2,2250
61285553@N00,5494,2,1197112204,1197114630,14,2,2426
61308976@N04,5495,4,1320370289,1320370289,1,1,0
61343115@N06,5496,6,1255320402,1255320402,1,1,0
61343955@N00,5497,12,1242516987,1242557683,233,1,40696
61388024@N08,5498,20,1376631067,1376631067,1,1,0
61411564@N04,5499,21,1355132035,1355133023,2,2,988
61411564@N04,5499,9,1355132027,1355133024,2,2,997
61413472@N05,5500,27,1356926930,1356926930,1,1,0
61415829@N08,5501,27,1430559909,1430559909,1,1,0
61473396@N04,5502,17,1374475030,1374475030,1,1,0
61525316@N06,5503,6,1356610254,1356610254,1,3,0
61525316@N06,5503,27,1356619445,1356619445,1,3,0
61525316@N06,5503,16,1356587917,1356587917,1,3,0
61525316@N06,5504,10,1356771782,1356771782,1,3,0
61525316@N06,5504,9,1356775052,1356775052,1,3,0
61525316@N06,5504,14,1356757038,1356757038,1,3,0
61554297@N00,5505,14,1218172302,1218172302,1,1,0
61554297@N00,5506,27,1231211449,1231211449,1,2,0
61554297@N00,5506,14,1231214713,1231214713,1,2,0
61581248@N04,5507,16,1388344185,1388344185,1,3,0
61581248@N04,5507,27,1388344070,1388356364,3,3,12294
61581248@N04,5507,8,1388344230,1388344230,1,3,0
61581248@N04,5508,14,1388429225,1388437166,3,3,7941
61581248@N04,5508,27,1388439192,1388439192,1,3,0
61581248@N04,5508,9,1388437278,1388438081,2,3,803
61581248@N04,5509,16,1388484142,1388484142,1,2,0
61581248@N04,5509,3,1388486050,1388486050,1,2,0
61581248@N04,5510,10,1388711925,1388712660,3,2,735
61581248@N04,5510,27,1388703552,1388703552,1,2,0
61599636@N02,5511,19,1295486515,1295486515,1,1,0
61634238@N07,5512,14,1367228856,1367228856,1,1,0
61634238@N07,5513,27,1367315718,1367315718,1,1,0
61638597@N05,5514,9,1327105240,1327105240,1,3,0
61638597@N05,5514,6,1327132936,1327132936,1,3,0
61638597@N05,5514,16,1327105503,1327105503,1,3,0
61644290@N00,5515,22,1294572420,1294572420,1,1,0
61644290@N00,5516,17,1326618998,1326618998,1,1,0
61644290@N00,5517,22,1332767351,1332767351,2,1,0
61644290@N00,5518,9,1351765009,1351765009,1,1,0
61644290@N00,5519,23,1352067261,1352067261,1,1,0
61644290@N00,5520,13,1379065156,1379065156,1,1,0
61658419@N00,5521,21,1335055494,1335055594,8,1,100
61658419@N00,5522,21,1335167741,1335168085,14,1,344
61658419@N00,5523,21,1349655985,1349664495,3,1,8510
61658419@N00,5524,21,1349822130,1349822130,2,1,0
61658419@N00,5525,21,1349865324,1349865410,2,1,86
61658419@N00,5526,21,1350010661,1350024960,196,1,14299
61658419@N00,5527,21,1350392400,1350392400,18,1,0
61658419@N00,5528,21,1355588919,1355588919,1,1,0
61659566@N00,5529,17,1352073281,1352078982,2,7,5701
61659566@N00,5529,14,1352096155,1352099373,2,7,3218
61659566@N00,5529,22,1352081322,1352081322,1,7,0
61659566@N00,5529,23,1352069893,1352069893,1,7,0
61659566@N00,5529,25,1352079509,1352079509,1,7,0
61659566@N00,5529,26,1352080582,1352080582,1,7,0
61659566@N00,5529,16,1352099084,1352099374,3,7,290
61666954@N06,5530,12,1286974667,1286974667,1,1,0
61756292@N00,5531,10,1358407442,1358407442,1,1,0
61761579@N00,5532,14,1335839474,1335839474,1,1,0
61761579@N00,5533,14,1335905072,1335905072,1,1,0
61806797@N03,5534,21,1393762301,1393762375,2,1,74
61817209@N05,5535,27,1392822190,1392822190,1,1,0
61834460@N00,5536,27,1378534164,1378534164,1,2,0
61834460@N00,5536,18,1378545218,1378545218,1,2,0
61897832@N00,5537,12,1260625780,1260635045,23,1,9265
61897832@N00,5538,12,1260672952,1260675889,3,1,2937
61897832@N00,5539,12,1260788251,1260813965,20,1,25714
61905010@N03,5540,17,1411122453,1411122453,1,1,0
62065836@N00,5541,2,1301028456,1301028456,1,2,0
62065836@N00,5541,13,1301028613,1301028900,4,2,287
62065836@N00,5542,18,1456978400,1456978456,7,1,56
62089667@N00,5543,22,1454631720,1454631720,1,1,0
62092290@N04,5544,27,1338282187,1338282187,1,1,0
62102776@N02,5545,20,1375949218,1375949218,1,1,0
62102776@N02,5546,1,1376181832,1376181832,1,1,0
62102776@N02,5547,8,1376466208,1376466208,1,1,0
62102776@N02,5548,2,1376642357,1376642357,1,1,0
62102776@N02,5549,16,1376723127,1376723127,1,1,0
62102776@N02,5550,2,1376812097,1376812097,1,1,0
62102776@N02,5551,27,1377302266,1377302266,1,2,0
62102776@N02,5551,13,1377322006,1377322006,1,2,0
62121361@N03,5552,9,1307979016,1307979016,1,2,0
62121361@N03,5552,27,1307992647,1307992647,1,2,0
62122462@N00,5553,20,1284440904,1284444016,31,5,3112
62122462@N00,5553,2,1284434263,1284434301,5,5,38
62122462@N00,5553,11,1284427285,1284427995,6,5,710
62122462@N00,5553,24,1284447730,1284448099,6,5,369
62122462@N00,5553,14,1284437344,1284437724,4,5,380
62122462@N00,5554,27,1347575512,1347577179,15,2,1667
62122462@N00,5554,14,1347598687,1347598961,3,2,274
62147041@N08,5555,2,1454124399,1454124399,1,1,0
62205900@N00,5556,27,1268852180,1268852227,2,1,47
62205900@N00,5557,27,1268940792,1268944295,24,1,3503
62208823@N00,5558,3,1308381271,1308381271,1,1,0
62208823@N00,5559,16,1317425935,1317428234,2,1,2299
62208823@N00,5560,3,1343450709,1343450709,1,1,0
62208823@N00,5561,10,1351404961,1351404961,1,1,0
62208823@N00,5562,27,1372570823,1372570823,1,1,0
62213164@N00,5563,21,1188736779,1188738109,5,7,1330
62213164@N00,5563,27,1188735590,1188735590,1,7,0
62213164@N00,5563,23,1188739978,1188739978,1,7,0
62213164@N00,5563,4,1188741030,1188742620,5,7,1590
62213164@N00,5563,20,1188736511,1188736511,1,7,0
62213164@N00,5563,16,1188740525,1188740525,1,7,0
62213164@N00,5563,24,1188738358,1188738358,1,7,0
62213164@N00,5564,26,1188823235,1188823235,1,7,0
62213164@N00,5564,5,1188827470,1188827511,2,7,41
62213164@N00,5564,27,1188810348,1188827879,2,7,17531
62213164@N00,5564,14,1188815577,1188815577,1,7,0
62213164@N00,5564,20,1188812052,1188813329,5,7,1277
62213164@N00,5564,16,1188815018,1188826269,9,7,11251
62213164@N00,5564,22,1188824666,1188824666,1,7,0
62213164@N00,5565,4,1338542133,1338542133,1,1,0
62221880@N00,5566,25,1307619662,1307619662,1,2,0
62221880@N00,5566,21,1307628045,1307628056,2,2,11
62221880@N00,5567,14,1307671201,1307671201,1,6,0
62221880@N00,5567,2,1307666703,1307666703,1,6,0
62221880@N00,5567,26,1307668560,1307668560,1,6,0
62221880@N00,5567,5,1307662699,1307662699,1,6,0
62221880@N00,5567,21,1307674989,1307676568,4,6,1579
62221880@N00,5567,19,1307672853,1307672853,1,6,0
62221880@N00,5568,14,1307708989,1307709351,2,3,362
62221880@N00,5568,17,1307707000,1307709987,3,3,2987
62221880@N00,5568,22,1307712867,1307712867,1,3,0
62221880@N00,5569,18,1307763369,1307764361,3,4,992
62221880@N00,5569,17,1307756149,1307756149,1,4,0
62221880@N00,5569,13,1307760273,1307760463,5,4,190
62221880@N00,5569,23,1307757676,1307757676,1,4,0
62221880@N00,5570,2,1307857352,1307857401,2,4,49
62221880@N00,5570,27,1307841145,1307841466,2,4,321
62221880@N00,5570,13,1307846619,1307846619,1,4,0
62221880@N00,5570,1,1307856776,1307856776,1,4,0
62236593@N04,5571,17,1316862495,1316863523,2,1,1028
62236593@N04,5572,17,1416876931,1416876931,1,1,0
62256889@N05,5573,4,1305523578,1305523578,1,2,0
62256889@N05,5573,16,1305510367,1305510367,1,2,0
62256889@N05,5574,22,1328339183,1328347211,4,1,8028
62256889@N05,5575,27,1328577269,1328577269,1,1,0
62256889@N05,5576,27,1328606095,1328607520,3,1,1425
62256889@N05,5577,27,1328691401,1328691401,1,1,0
62256889@N05,5578,26,1328850555,1328850555,1,2,0
62256889@N05,5578,27,1328832697,1328863929,4,2,31232
62256889@N05,5579,10,1358559475,1358559475,1,2,0
62256889@N05,5579,8,1358568379,1358568379,1,2,0
62256889@N05,5580,17,1359009456,1359009456,1,1,0
62256889@N05,5581,23,1387963527,1387963527,1,2,0
62256889@N05,5581,27,1387950422,1387950767,2,2,345
62282437@N00,5582,18,1211355661,1211357631,3,6,1970
62282437@N00,5582,19,1211357108,1211357108,1,6,0
62282437@N00,5582,4,1211361931,1211362006,3,6,75
62282437@N00,5582,17,1211360473,1211360473,1,6,0
62282437@N00,5582,27,1211352670,1211353036,3,6,366
62282437@N00,5582,22,1211358113,1211358113,1,6,0
62328663@N02,5583,4,1255874681,1255874681,1,1,0
62372928@N03,5584,16,1256107520,1256107520,1,1,0
62372928@N03,5585,27,1369091789,1369091789,1,4,0
62372928@N03,5585,2,1369105028,1369105028,1,4,0
62372928@N03,5585,17,1369092600,1369092600,1,4,0
62372928@N03,5585,14,1369103942,1369103942,1,4,0
62372928@N03,5586,19,1369141882,1369141882,1,2,0
62372928@N03,5586,20,1369142151,1369142151,1,2,0
62372928@N03,5587,16,1369224745,1369224745,1,1,0
62382210@N02,5588,3,1400675956,1400675956,1,4,0
62382210@N02,5588,14,1400679426,1400679574,2,4,148
62382210@N02,5588,20,1400676978,1400676978,1,4,0
62382210@N02,5588,13,1400676971,1400676971,1,4,0
62396405@N03,5589,5,1368362620,1368362620,1,2,0
62396405@N03,5589,17,1368365994,1368365994,1,2,0
62482223@N07,5590,18,1304326979,1304326979,1,1,0
62486370@N00,5591,9,1191541532,1191560560,2,1,19028
62595633@N06,5592,26,1370478495,1370487651,2,16,9156
62595633@N06,5592,10,1370471199,1370471897,4,16,698
62595633@N06,5592,12,1370484025,1370495302,5,16,11277
62595633@N06,5592,17,1370482379,1370495072,2,16,12693
62595633@N06,5592,27,1370469565,1370521100,12,16,51535
62595633@N06,5592,14,1370470181,1370520754,17,16,50573
62595633@N06,5592,9,1370470753,1370470753,1,16,0
62595633@N06,5592,20,1370478621,1370498761,2,16,20140
62595633@N06,5592,22,1370479909,1370499349,3,16,19440
62595633@N06,5592,13,1370482350,1370499496,7,16,17146
62595633@N06,5592,5,1370477737,1370477737,1,16,0
62595633@N06,5592,21,1370493499,1370493519,2,16,20
62595633@N06,5592,25,1370487595,1370487799,2,16,204
62595633@N06,5592,19,1370478947,1370479394,2,16,447
62595633@N06,5592,2,1370477636,1370477636,1,16,0
62595633@N06,5592,15,1370483767,1370495451,3,16,11684
62595633@N06,5593,14,1370730619,1370736691,10,1,6072
62598671@N04,5594,1,1210846419,1210846419,1,1,0
62598671@N04,5595,16,1230804238,1230804238,1,1,0
62598671@N04,5596,3,1282041211,1282041211,1,2,0
62598671@N04,5596,16,1282037016,1282037016,1,2,0
62599993@N06,5597,14,1369345921,1369345921,1,2,0
62599993@N06,5597,18,1369352099,1369352206,4,2,107
62599993@N06,5598,27,1400834530,1400834530,1,1,0
62599993@N06,5599,27,1461376432,1461376432,1,1,0
62624768@N02,5600,12,1361523860,1361523860,1,3,0
62624768@N02,5600,14,1361524215,1361524215,1,3,0
62624768@N02,5600,27,1361520775,1361520775,1,3,0
62624768@N02,5601,17,1361648777,1361648777,1,1,0
62665100@N00,5602,16,1347513126,1347513126,1,2,0
62665100@N00,5602,22,1347513113,1347513113,1,2,0
62667441@N00,5603,19,1224472153,1224472611,4,4,458
62667441@N00,5603,13,1224470401,1224470401,2,4,0
62667441@N00,5603,16,1224454719,1224454719,1,4,0
62667441@N00,5603,3,1224456771,1224456771,1,4,0
62704710@N03,5604,27,1350116442,1350116442,1,3,0
62704710@N03,5604,3,1350120772,1350120772,1,3,0
62704710@N03,5604,2,1350122339,1350122339,1,3,0
62704710@N03,5605,11,1350441877,1350441877,1,5,0
62704710@N03,5605,21,1350430943,1350430943,1,5,0
62704710@N03,5605,18,1350429688,1350429811,2,5,123
62704710@N03,5605,9,1350441132,1350441132,1,5,0
62704710@N03,5605,19,1350429319,1350429319,1,5,0
62704710@N03,5606,27,1362887128,1362887128,1,2,0
62704710@N03,5606,2,1362905226,1362905226,1,2,0
62704710@N03,5607,4,1363428115,1363428115,1,1,0
62705831@N05,5608,16,1259307643,1259307643,1,2,0
62705831@N05,5608,20,1259281567,1259281567,1,2,0
62772368@N00,5609,9,1441507313,1441537074,4,3,29761
62772368@N00,5609,6,1441520379,1441543012,2,3,22633
62772368@N00,5609,27,1441507311,1441542748,4,3,35437
62789043@N07,5610,22,1303201693,1303201693,1,1,0
62891726@N08,5611,16,1318763437,1318763437,1,1,0
62935145@N05,5612,27,1224568386,1224568386,1,1,0
62935145@N05,5613,27,1224722374,1224723855,3,3,1481
62935145@N05,5613,4,1224724807,1224727283,3,3,2476
62935145@N05,5613,25,1224727686,1224732877,4,3,5191
62935145@N05,5614,27,1224913907,1224913907,1,1,0
62935145@N05,5615,18,1225161554,1225161554,1,2,0
62935145@N05,5615,27,1225170949,1225170949,1,2,0
62935145@N05,5616,25,1249290396,1249290396,1,1,0
62950363@N05,5617,17,1349073563,1349073566,3,2,3
62950363@N05,5617,4,1349071033,1349071094,9,2,61
62950363@N05,5618,27,1349243185,1349243190,3,1,5
62950363@N05,5619,9,1349485809,1349485821,4,2,12
62950363@N05,5619,23,1349481255,1349481264,3,2,9
62975060@N07,5620,14,1382341915,1382341915,1,1,0
63014850@N00,5621,17,1434847622,1434847622,1,1,0
63051331@N00,5622,14,1225513483,1225513483,1,1,0
63084736@N00,5623,1,1437619952,1437619952,1,3,0
63084736@N00,5623,9,1437614558,1437614558,1,3,0
63084736@N00,5623,2,1437618481,1437618844,2,3,363
63084736@N00,5624,27,1438166955,1438172750,5,2,5795
63084736@N00,5624,22,1438161353,1438161382,2,2,29
63084736@N00,5625,1,1438245560,1438253094,2,2,7534
63084736@N00,5625,5,1438253546,1438253546,1,2,0
63084736@N00,5626,14,1438582491,1438582491,1,2,0
63084736@N00,5626,6,1438576589,1438576599,2,2,10
63098965@N00,5627,9,1465815268,1465815268,1,1,0
63186081@N00,5628,1,1365410931,1365410931,1,2,0
63186081@N00,5628,17,1365429350,1365429354,2,2,4
63202442@N00,5629,16,1189632434,1189632434,1,1,0
63202442@N00,5630,19,1201224164,1201224164,1,1,0
63202442@N00,5631,13,1201428174,1201428174,1,1,0
63202442@N00,5632,13,1201606265,1201606265,1,2,0
63202442@N00,5632,9,1201604623,1201604623,1,2,0
63202442@N00,5633,21,1220578645,1220578645,1,1,0
63202442@N00,5634,14,1220656181,1220657213,2,4,1032
63202442@N00,5634,9,1220657531,1220657531,1,4,0
63202442@N00,5634,4,1220672516,1220672516,1,4,0
63202442@N00,5634,5,1220669455,1220669455,1,4,0
63202442@N00,5635,6,1220788974,1220788974,1,4,0
63202442@N00,5635,4,1220783562,1220783562,1,4,0
63202442@N00,5635,27,1220791634,1220791634,1,4,0
63202442@N00,5635,24,1220786408,1220786408,1,4,0
63202442@N00,5636,21,1220953330,1220953753,3,5,423
63202442@N00,5636,4,1220961273,1220961273,1,5,0
63202442@N00,5636,13,1220954339,1220966991,3,5,12652
63202442@N00,5636,27,1220958001,1220958001,1,5,0
63202442@N00,5636,15,1220955648,1220955648,1,5,0
63202442@N00,5637,27,1221304823,1221307418,5,1,2595
63202442@N00,5638,17,1221348108,1221348108,1,3,0
63202442@N00,5638,14,1221348257,1221348257,1,3,0
63202442@N00,5638,16,1221348220,1221348593,2,3,373
63202442@N00,5639,13,1264927446,1264927446,1,9,0
63202442@N00,5639,21,1264911306,1264911306,1,9,0
63202442@N00,5639,3,1264919211,1264919211,1,9,0
63202442@N00,5639,4,1264936908,1264936908,1,9,0
63202442@N00,5639,2,1264933521,1264933521,1,9,0
63202442@N00,5639,5,1264933747,1264933747,1,9,0
63202442@N00,5639,14,1264900108,1264930950,2,9,30842
63202442@N00,5639,27,1264917623,1264937877,2,9,20254
63202442@N00,5639,7,1264915530,1264915530,1,9,0
63202442@N00,5640,13,1265003291,1265005770,2,1,2479
63202442@N00,5641,19,1265156229,1265156229,1,4,0
63202442@N00,5641,1,1265161536,1265161843,2,4,307
63202442@N00,5641,3,1265164112,1265164301,2,4,189
63202442@N00,5641,4,1265160939,1265160939,1,4,0
63202442@N00,5642,20,1265233850,1265234017,2,4,167
63202442@N00,5642,27,1265237658,1265237658,1,4,0
63202442@N00,5642,19,1265235303,1265235303,1,4,0
63202442@N00,5642,16,1265231011,1265231011,1,4,0
63202442@N00,5643,5,1291467802,1291467802,1,4,0
63202442@N00,5643,4,1291468113,1291468113,1,4,0
63202442@N00,5643,27,1291460280,1291460280,1,4,0
63202442@N00,5643,2,1291467692,1291467692,1,4,0
63202442@N00,5644,14,1327845474,1327845474,1,1,0
63211078@N00,5645,27,1245644425,1245644425,1,1,0
63211078@N00,5646,27,1245915902,1245915902,1,2,0
63211078@N00,5646,14,1245921894,1245921894,1,2,0
63219576@N08,5647,22,1435632422,1435632422,1,2,0
63219576@N08,5647,26,1435632722,1435632722,1,2,0
63257911@N00,5648,14,1188013746,1188013746,1,4,0
63257911@N00,5648,4,1188008612,1188008612,1,4,0
63257911@N00,5648,15,1188029822,1188029843,2,4,21
63257911@N00,5648,6,1188013054,1188013054,1,4,0
63257911@N00,5649,8,1188090017,1188090029,2,5,12
63257911@N00,5649,5,1188093230,1188093690,2,5,460
63257911@N00,5649,21,1188096031,1188096031,1,5,0
63257911@N00,5649,20,1188095273,1188095273,1,5,0
63257911@N00,5649,6,1188086838,1188086838,1,5,0
63257911@N00,5650,13,1212895045,1212918895,7,13,23850
63257911@N00,5650,19,1212898597,1212898804,2,13,207
63257911@N00,5650,20,1212900155,1212920119,2,13,19964
63257911@N00,5650,3,1212908061,1212922242,7,13,14181
63257911@N00,5650,2,1212906381,1212906590,5,13,209
63257911@N00,5650,6,1212907069,1212907069,1,13,0
63257911@N00,5650,9,1212909198,1212920609,4,13,11411
63257911@N00,5650,27,1212926542,1212927858,6,13,1316
63257911@N00,5650,4,1212922341,1212922462,2,13,121
63257911@N00,5650,5,1212913711,1212913711,1,13,0
63257911@N00,5650,1,1212914696,1212922046,4,13,7350
63257911@N00,5650,21,1212920253,1212920253,1,13,0
63257911@N00,5650,12,1212912414,1212913147,12,13,733
63257911@N00,5651,12,1212963476,1212963476,1,3,0
63257911@N00,5651,13,1212963409,1212963409,1,3,0
63257911@N00,5651,15,1212963582,1212963582,1,3,0
63257911@N00,5652,16,1229140452,1229144581,2,12,4129
63257911@N00,5652,6,1229152190,1229152296,2,12,106
63257911@N00,5652,17,1229152957,1229153880,3,12,923
63257911@N00,5652,2,1229151246,1229151290,3,12,44
63257911@N00,5652,9,1229151472,1229151494,2,12,22
63257911@N00,5652,3,1229163792,1229163792,1,12,0
63257911@N00,5652,8,1229157361,1229160091,3,12,2730
63257911@N00,5652,12,1229147351,1229148324,16,12,973
63257911@N00,5652,4,1229162550,1229165692,8,12,3142
63257911@N00,5652,1,1229151089,1229151089,1,12,0
63257911@N00,5652,11,1229156179,1229159865,3,12,3686
63257911@N00,5652,27,1229168169,1229168822,5,12,653
63257911@N00,5653,16,1229225160,1229225418,3,6,258
63257911@N00,5653,1,1229226555,1229232663,10,6,6108
63257911@N00,5653,14,1229217060,1229217060,1,6,0
63257911@N00,5653,13,1229220687,1229220687,1,6,0
63257911@N00,5653,9,1229214452,1229214517,2,6,65
63257911@N00,5653,3,1229226794,1229226849,2,6,55
63257911@N00,5654,3,1277469639,1277470082,3,6,443
63257911@N00,5654,2,1277462480,1277462488,2,6,8
63257911@N00,5654,15,1277450070,1277458313,3,6,8243
63257911@N00,5654,22,1277462311,1277465975,15,6,3664
63257911@N00,5654,9,1277461596,1277461613,2,6,17
63257911@N00,5654,12,1277459976,1277460820,5,6,844
63257911@N00,5655,21,1277509442,1277516863,6,7,7421
63257911@N00,5655,20,1277509762,1277514464,2,7,4702
63257911@N00,5655,14,1277510853,1277510968,3,7,115
63257911@N00,5655,17,1277517840,1277517865,2,7,25
63257911@N00,5655,15,1277518828,1277518828,1,7,0
63257911@N00,5655,26,1277517520,1277517520,1,7,0
63257911@N00,5655,25,1277513223,1277513223,1,7,0
63257911@N00,5656,26,1277595506,1277611892,5,15,16386
63257911@N00,5656,21,1277596546,1277597510,2,15,964
63257911@N00,5656,19,1277597828,1277599093,6,15,1265
63257911@N00,5656,24,1277595744,1277596251,4,15,507
63257911@N00,5656,15,1277599854,1277599854,1,15,0
63257911@N00,5656,23,1277606917,1277608005,4,15,1088
63257911@N00,5656,1,1277621554,1277622934,8,15,1380
63257911@N00,5656,6,1277618483,1277620227,10,15,1744
63257911@N00,5656,3,1277614219,1277614219,1,15,0
63257911@N00,5656,18,1277597979,1277598309,3,15,330
63257911@N00,5656,27,1277629205,1277631950,5,15,2745
63257911@N00,5656,22,1277605932,1277605932,1,15,0
63257911@N00,5656,2,1277616727,1277623611,5,15,6884
63257911@N00,5656,11,1277625797,1277627834,7,15,2037
63257911@N00,5656,14,1277622364,1277622415,2,15,51
63257911@N00,5657,26,1308909756,1308909756,1,3,0
63257911@N00,5657,20,1308909777,1308909777,1,3,0
63257911@N00,5657,4,1308909757,1308909757,1,3,0
63257911@N00,5658,2,1316839330,1316839339,2,7,9
63257911@N00,5658,13,1316841190,1316842650,9,7,1460
63257911@N00,5658,21,1316843840,1316844040,5,7,200
63257911@N00,5658,4,1316838131,1316848139,5,7,10008
63257911@N00,5658,1,1316839046,1316846898,2,7,7852
63257911@N00,5658,27,1316836869,1316836869,1,7,0
63257911@N00,5658,23,1316844448,1316844489,2,7,41
63265130@N03,5659,10,1416016635,1416017473,4,12,838
63265130@N03,5659,2,1416036091,1416036608,5,12,517
63265130@N03,5659,14,1416015852,1416015852,1,12,0
63265130@N03,5659,3,1416034780,1416034780,1,12,0
63265130@N03,5659,7,1416045044,1416045044,1,12,0
63265130@N03,5659,16,1416015759,1416050336,5,12,34577
63265130@N03,5659,19,1416028198,1416028715,4,12,517
63265130@N03,5659,25,1416024177,1416024177,1,12,0
63265130@N03,5659,11,1416017337,1416019185,3,12,1848
63265130@N03,5659,27,1416013876,1416031783,18,12,17907
63265130@N03,5659,21,1416024867,1416025724,5,12,857
63265130@N03,5659,20,1416030198,1416030198,1,12,0
63287267@N00,5660,27,1332825716,1332825716,1,1,0
63287402@N00,5661,14,1257571592,1257571592,1,2,0
63287402@N00,5661,27,1257569590,1257569602,2,2,12
63287402@N00,5662,19,1272258453,1272258453,1,2,0
63287402@N00,5662,16,1272257074,1272257074,1,2,0
63287402@N00,5663,2,1272424528,1272424528,1,2,0
63287402@N00,5663,21,1272427611,1272427611,1,2,0
63287402@N00,5664,19,1289256681,1289256681,1,2,0
63287402@N00,5664,6,1289263835,1289263835,1,2,0
63287402@N00,5665,20,1291953957,1291953957,1,1,0
63287402@N00,5666,15,1304213571,1304213571,1,1,0
63287402@N00,5667,3,1306976109,1306976109,2,2,0
63287402@N00,5667,1,1306976109,1306976109,1,2,0
63287402@N00,5668,22,1313450315,1313450315,1,1,0
63311968@N07,5669,14,1373506445,1373506445,1,1,0
63330642@N06,5670,1,1372849611,1372849611,1,1,0
63330642@N06,5671,1,1379828179,1379828179,1,1,0
63330642@N06,5672,20,1380269624,1380269679,2,4,55
63330642@N06,5672,27,1380261792,1380261792,1,4,0
63330642@N06,5672,10,1380268213,1380268213,1,4,0
63330642@N06,5672,1,1380265574,1380265574,1,4,0
63330642@N06,5673,27,1383450270,1383451405,2,2,1135
63330642@N06,5673,3,1383452851,1383452851,1,2,0
63330642@N06,5674,16,1385278407,1385278407,1,1,0
63330642@N06,5675,2,1385719045,1385719045,1,1,0
63330642@N06,5676,27,1387007369,1387007369,1,1,0
63330642@N06,5677,1,1390718564,1390718564,1,1,0
63330642@N06,5678,4,1391242855,1391242855,1,1,0
63330642@N06,5679,21,1391845829,1391845829,1,2,0
63330642@N06,5679,16,1391843858,1391843858,1,2,0
63330642@N06,5680,3,1393746731,1393746784,3,2,53
63330642@N06,5680,5,1393742872,1393742872,1,2,0
63330642@N06,5681,9,1394262532,1394262532,1,1,0
63330642@N06,5682,13,1394868825,1394868825,1,1,0
63330642@N06,5683,1,1396083918,1396083918,1,6,0
63330642@N06,5683,9,1396085031,1396085031,1,6,0
63330642@N06,5683,24,1396078810,1396078810,1,6,0
63330642@N06,5683,20,1396074049,1396075094,4,6,1045
63330642@N06,5683,19,1396076739,1396076739,1,6,0
63330642@N06,5683,14,1396072624,1396072624,1,6,0
63330642@N06,5684,10,1396683259,1396683259,1,5,0
63330642@N06,5684,11,1396686906,1396686906,1,5,0
63330642@N06,5684,17,1396679118,1396679118,1,5,0
63330642@N06,5684,14,1396681778,1396681778,1,5,0
63330642@N06,5684,13,1396679511,1396679511,1,5,0
63330642@N06,5685,2,1440829135,1440829135,1,1,0
63338696@N00,5686,16,1221572170,1221572170,1,2,0
63338696@N00,5686,14,1221563024,1221563024,1,2,0
63365181@N00,5687,27,1326705763,1326723704,2,1,17941
63513545@N00,5688,14,1380275004,1380275004,1,5,0
63513545@N00,5688,27,1380271423,1380278900,10,5,7477
63513545@N00,5688,6,1380274292,1380274292,1,5,0
63513545@N00,5688,9,1380274931,1380274931,1,5,0
63513545@N00,5688,4,1380272773,1380272773,1,5,0
63513545@N00,5689,16,1380341739,1380341739,1,6,0
63513545@N00,5689,13,1380332973,1380333157,3,6,184
63513545@N00,5689,18,1380333048,1380337447,2,6,4399
63513545@N00,5689,25,1380332086,1380332327,3,6,241
63513545@N00,5689,19,1380337379,1380343268,5,6,5889
63513545@N00,5689,14,1380341489,1380341489,1,6,0
63513545@N00,5690,1,1380612850,1380613602,2,1,752
63513545@N00,5691,7,1415243907,1415244224,4,7,317
63513545@N00,5691,21,1415250979,1415250979,1,7,0
63513545@N00,5691,27,1415236480,1415236480,1,7,0
63513545@N00,5691,9,1415240809,1415240809,1,7,0
63513545@N00,5691,23,1415253710,1415256757,3,7,3047
63513545@N00,5691,15,1415247833,1415247856,2,7,23
63513545@N00,5691,6,1415242514,1415242514,1,7,0
63513545@N00,5692,7,1415404808,1415404808,1,1,0
63559604@N00,5693,2,1252645800,1252645800,1,1,0
63631877@N00,5694,27,1220217854,1220217854,1,1,0
63631877@N00,5695,27,1223369986,1223369986,1,1,0
63631877@N00,5696,9,1231046875,1231046875,1,3,0
63631877@N00,5696,3,1231046879,1231046879,1,3,0
63631877@N00,5696,16,1231046861,1231046861,1,3,0
63631877@N00,5697,5,1234743329,1234743329,1,2,0
63631877@N00,5697,13,1234743348,1234743348,1,2,0
63631877@N00,5698,1,1239513205,1239513205,1,2,0
63631877@N00,5698,25,1239513248,1239513248,1,2,0
63631877@N00,5699,14,1249100957,1249100957,1,1,0
63631877@N00,5700,27,1271122031,1271122031,1,2,0
63631877@N00,5700,22,1271122036,1271122036,1,2,0
63631877@N00,5701,12,1400202932,1400202932,1,1,0
63637045@N07,5702,27,1400990947,1400996227,7,1,5280
63679518@N00,5703,17,1319497489,1319497489,1,1,0
63691080@N00,5704,15,1311320589,1311320589,1,11,0
63691080@N00,5704,27,1311309998,1311310001,2,11,3
63691080@N00,5704,22,1311313101,1311313101,2,11,0
63691080@N00,5704,4,1311328699,1311328699,1,11,0
63691080@N00,5704,23,1311315452,1311315611,2,11,159
63691080@N00,5704,2,1311323441,1311323441,1,11,0
63691080@N00,5704,16,1311317117,1311336102,3,11,18985
63691080@N00,5704,13,1311321173,1311321173,1,11,0
63691080@N00,5704,1,1311332186,1311332186,1,11,0
63691080@N00,5704,6,1311318419,1311318419,2,11,0
63691080@N00,5704,14,1311319330,1311322930,2,11,3600
63691080@N00,5705,14,1311595360,1311595360,1,1,0
63765222@N02,5706,9,1461040630,1461040630,1,2,0
63765222@N02,5706,13,1461030059,1461030059,1,2,0
63786834@N00,5707,20,1298807433,1298807433,1,6,0
63786834@N00,5707,14,1298808283,1298808283,1,6,0
63786834@N00,5707,21,1298805937,1298805937,1,6,0
63786834@N00,5707,13,1298803193,1298803193,1,6,0
63786834@N00,5707,19,1298804248,1298804248,1,6,0
63786834@N00,5707,1,1298800123,1298800123,1,6,0
63812709@N02,5708,19,1306452732,1306460114,3,4,7382
63812709@N02,5708,17,1306452955,1306453935,6,4,980
63812709@N02,5708,9,1306463911,1306463911,1,4,0
63812709@N02,5708,27,1306448277,1306469205,71,4,20928
63812709@N02,5709,27,1306535016,1306538805,3,1,3789
63818228@N03,5710,15,1310641759,1310641759,1,1,0
63818228@N03,5711,26,1312927872,1312927872,1,1,0
63883907@N00,5712,26,1290723856,1290723856,1,5,0
63883907@N00,5712,25,1290723948,1290723948,1,5,0
63883907@N00,5712,12,1290734626,1290734755,2,5,129
63883907@N00,5712,20,1290717352,1290717352,1,5,0
63883907@N00,5712,9,1290733274,1290733274,1,5,0
63958044@N03,5713,27,1347282474,1347282474,1,1,0
64034745@N02,5714,21,1373071589,1373071595,2,1,6
64105048@N00,5715,9,1442974053,1442974053,1,1,0
64105875@N00,5716,16,1218060704,1218075366,4,15,14662
64105875@N00,5716,14,1218077295,1218078302,6,15,1007
64105875@N00,5716,4,1218073856,1218073856,1,15,0
64105875@N00,5716,12,1218062195,1218062904,8,15,709
64105875@N00,5716,17,1218091905,1218097622,3,15,5717
64105875@N00,5716,19,1218066628,1218067987,4,15,1359
64105875@N00,5716,24,1218072206,1218072913,9,15,707
64105875@N00,5716,18,1218095393,1218096450,3,15,1057
64105875@N00,5716,21,1218068123,1218070125,3,15,2002
64105875@N00,5716,20,1218065391,1218065845,4,15,454
64105875@N00,5716,1,1218074951,1218090642,3,15,15691
64105875@N00,5716,9,1218063633,1218063975,5,15,342
64105875@N00,5716,27,1218060099,1218111510,27,15,51411
64105875@N00,5716,22,1218071121,1218072109,4,15,988
64105875@N00,5716,8,1218099397,1218099397,1,15,0
64111638@N00,5717,16,1382021092,1382021092,1,1,0
64171510@N00,5718,9,1247236586,1247236831,2,7,245
64171510@N00,5718,21,1247212659,1247212659,1,7,0
64171510@N00,5718,26,1247215585,1247225753,6,7,10168
64171510@N00,5718,17,1247227319,1247227319,1,7,0
64171510@N00,5718,14,1247237135,1247237135,1,7,0
64171510@N00,5718,25,1247212175,1247212175,1,7,0
64171510@N00,5718,16,1247238772,1247238772,1,7,0
64220937@N02,5719,26,1322288036,1322288036,1,1,0
64285153@N00,5720,16,1291415629,1291415926,2,1,297
64298924@N04,5721,27,1409411102,1409411102,1,1,0
64318110@N00,5722,27,1363902184,1363902184,1,2,0
64318110@N00,5722,13,1363910560,1363910560,1,2,0
64355339@N02,5723,4,1197309858,1197309858,1,1,0
64406224@N07,5724,27,1372406941,1372406941,1,1,0
64415341@N07,5725,27,1315699994,1315699994,1,1,0
64440833@N05,5726,15,1302350272,1302350283,2,6,11
64440833@N05,5726,22,1302341658,1302341678,2,6,20
64440833@N05,5726,18,1302340239,1302340239,1,6,0
64440833@N05,5726,20,1302344802,1302345317,2,6,515
64440833@N05,5726,17,1302339536,1302339551,2,6,15
64440833@N05,5726,13,1302339964,1302339983,4,6,19
64440833@N05,5727,15,1303769439,1303769439,1,4,0
64440833@N05,5727,1,1303767540,1303767540,1,4,0
64440833@N05,5727,27,1303766782,1303766782,1,4,0
64440833@N05,5727,14,1303768861,1303768861,1,4,0
64440833@N05,5728,14,1312531565,1312531616,2,6,51
64440833@N05,5728,12,1312532534,1312532534,1,6,0
64440833@N05,5728,9,1312531204,1312531206,2,6,2
64440833@N05,5728,21,1312543246,1312543376,3,6,130
64440833@N05,5728,17,1312541729,1312541729,1,6,0
64440833@N05,5728,13,1312537658,1312537658,1,6,0
64440833@N05,5729,27,1371771700,1371776827,10,1,5127
64440833@N05,5730,27,1371811549,1371811549,1,1,0
64440833@N05,5731,27,1374801408,1374815359,22,1,13951
64440833@N05,5732,27,1387012553,1387012589,2,1,36
64465885@N03,5733,24,1309399595,1309399595,1,2,0
64465885@N03,5733,25,1309403557,1309403557,1,2,0
64465885@N03,5734,25,1328066096,1328066096,1,1,0
64465885@N03,5735,25,1409204212,1409205189,2,1,977
64465885@N03,5736,10,1421017200,1421025483,2,9,8283
64465885@N03,5736,15,1421030441,1421030441,1,9,0
64465885@N03,5736,14,1421013320,1421017746,4,9,4426
64465885@N03,5736,3,1421037336,1421037336,1,9,0
64465885@N03,5736,21,1421033551,1421033551,1,9,0
64465885@N03,5736,16,1421013893,1421048999,33,9,35106
64465885@N03,5736,24,1421033461,1421033989,7,9,528
64465885@N03,5736,23,1421034674,1421034681,2,9,7
64465885@N03,5736,9,1421020800,1421024745,11,9,3945
64465885@N03,5737,13,1421291881,1421291899,4,10,18
64465885@N03,5737,3,1421281210,1421301738,2,10,20528
64465885@N03,5737,17,1421279663,1421279751,10,10,88
64465885@N03,5737,27,1421277731,1421282031,20,10,4300
64465885@N03,5737,1,1421281028,1421281028,1,10,0
64465885@N03,5737,16,1421275083,1421316275,8,10,41192
64465885@N03,5737,14,1421274353,1421290393,12,10,16040
64465885@N03,5737,10,1421285364,1421286991,7,10,1627
64465885@N03,5737,23,1421300252,1421300301,6,10,49
64465885@N03,5737,9,1421285413,1421285473,6,10,60
64466278@N03,5738,16,1340015018,1340015222,2,5,204
64466278@N03,5738,21,1340014898,1340014898,1,5,0
64466278@N03,5738,9,1340015156,1340015179,2,5,23
64466278@N03,5738,14,1340015118,1340015118,1,5,0
64466278@N03,5738,24,1340014961,1340015007,2,5,46
64466278@N03,5739,13,1344504187,1344504187,1,3,0
64466278@N03,5739,27,1344504348,1344504348,1,3,0
64466278@N03,5739,21,1344504476,1344504542,2,3,66
64466278@N03,5740,11,1348977035,1348977035,1,1,0
64466278@N03,5741,10,1350164887,1350165067,11,1,180
64466278@N03,5742,27,1352467230,1352467230,1,2,0
64466278@N03,5742,9,1352462174,1352462174,1,2,0
64478148@N07,5743,9,1333787777,1333787875,3,2,98
64478148@N07,5743,8,1333788234,1333789452,17,2,1218
64478148@N07,5744,23,1333889434,1333889482,4,3,48
64478148@N07,5744,7,1333892558,1333892667,3,3,109
64478148@N07,5744,8,1333892375,1333892607,7,3,232
64478148@N07,5745,8,1335870598,1335870792,5,2,194
64478148@N07,5745,7,1335871025,1335871025,1,2,0
64478148@N07,5746,9,1339834440,1339834440,1,4,0
64478148@N07,5746,11,1339833125,1339833462,11,4,337
64478148@N07,5746,7,1339834217,1339834301,6,4,84
64478148@N07,5746,8,1339833256,1339834138,7,4,882
64478148@N07,5747,16,1347620435,1347620436,2,1,1
64478148@N07,5748,9,1350005491,1350010689,23,7,5198
64478148@N07,5748,7,1350008900,1350008900,1,7,0
64478148@N07,5748,11,1350006528,1350008812,65,7,2284
64478148@N07,5748,25,1350009355,1350009355,1,7,0
64478148@N07,5748,10,1350005670,1350010800,63,7,5130
64478148@N07,5748,14,1350005470,1350005478,2,7,8
64478148@N07,5748,6,1350005356,1350005356,1,7,0
64478148@N07,5749,10,1350637744,1350638340,30,2,596
64478148@N07,5749,9,1350637735,1350637735,1,2,0
64478148@N07,5750,10,1351928798,1351928911,3,1,113
64478148@N07,5751,25,1352965144,1352965144,1,2,0
64478148@N07,5751,27,1352965203,1352965451,3,2,248
64478148@N07,5752,27,1358736628,1358743552,15,1,6924
64478148@N07,5753,19,1359263310,1359264664,22,3,1354
64478148@N07,5753,20,1359263262,1359266380,6,3,3118
64478148@N07,5753,22,1359263087,1359263087,1,3,0
64478148@N07,5754,27,1360904295,1360904584,3,2,289
64478148@N07,5754,14,1360908164,1360908235,3,2,71
64478148@N07,5755,13,1362700445,1362700445,1,5,0
64478148@N07,5755,17,1362700494,1362700570,5,5,76
64478148@N07,5755,15,1362699631,1362701423,27,5,1792
64478148@N07,5755,27,1362698994,1362699155,7,5,161
64478148@N07,5755,12,1362699962,1362701283,4,5,1321
64478148@N07,5756,19,1363005567,1363005958,3,5,391
64478148@N07,5756,13,1362996669,1362996738,4,5,69
64478148@N07,5756,15,1362996207,1362996689,28,5,482
64478148@N07,5756,8,1363005545,1363005546,2,5,1
64478148@N07,5756,7,1363005409,1363005495,5,5,86
64478148@N07,5757,27,1363999126,1363999679,6,1,553
64478148@N07,5758,25,1365981111,1365982216,2,6,1105
64478148@N07,5758,20,1365985168,1365985168,1,6,0
64478148@N07,5758,27,1365978737,1365979018,2,6,281
64478148@N07,5758,26,1365981299,1365984984,4,6,3685
64478148@N07,5758,21,1365985094,1365988779,12,6,3685
64478148@N07,5758,22,1365985124,1365985124,1,6,0
64478148@N07,5759,25,1366955391,1366955398,3,2,7
64478148@N07,5759,17,1366955544,1366955544,1,2,0
64478148@N07,5760,10,1368254102,1368254136,5,4,34
64478148@N07,5760,23,1368228283,1368228283,1,4,0
64478148@N07,5760,21,1368228046,1368231680,14,4,3634
64478148@N07,5760,17,1368230949,1368230949,1,4,0
64478148@N07,5761,27,1369398560,1369402253,4,1,3693
64478148@N07,5762,27,1374367771,1374369868,11,1,2097
64478148@N07,5763,27,1378082217,1378082756,17,1,539
64478148@N07,5764,20,1379075452,1379076319,19,8,867
64478148@N07,5764,4,1379071834,1379072459,48,8,625
64478148@N07,5764,5,1379069815,1379069815,1,8,0
64478148@N07,5764,14,1379062096,1379068621,47,8,6525
64478148@N07,5764,6,1379069679,1379069679,1,8,0
64478148@N07,5764,26,1379077508,1379077508,1,8,0
64478148@N07,5764,13,1379077979,1379077979,1,8,0
64478148@N07,5764,15,1379069236,1379069236,1,8,0
64478148@N07,5765,9,1382932583,1382932583,1,3,0
64478148@N07,5765,7,1382932672,1382932695,4,3,23
64478148@N07,5765,14,1382932499,1382932547,4,3,48
64478148@N07,5766,27,1384175200,1384175751,14,6,551
64478148@N07,5766,21,1384156269,1384156269,1,6,0
64478148@N07,5766,14,1384170760,1384170760,1,6,0
64478148@N07,5766,26,1384166348,1384166348,1,6,0
64478148@N07,5766,17,1384166506,1384172178,4,6,5672
64478148@N07,5766,16,1384154555,1384154555,1,6,0
64478148@N07,5767,20,1384238555,1384238555,1,2,0
64478148@N07,5767,26,1384238559,1384238559,1,2,0
64478148@N07,5768,10,1392723396,1392723639,3,2,243
64478148@N07,5768,9,1392723253,1392723253,1,2,0
64478148@N07,5769,9,1394942706,1394942982,6,2,276
64478148@N07,5769,14,1394943024,1394943029,3,2,5
64478148@N07,5770,7,1397992716,1397993100,4,1,384
64478148@N07,5771,9,1400793273,1400841222,11,8,47949
64478148@N07,5771,2,1400800356,1400800356,1,8,0
64478148@N07,5771,20,1400820028,1400820028,1,8,0
64478148@N07,5771,17,1400831023,1400835267,4,8,4244
64478148@N07,5771,14,1400837508,1400837533,2,8,25
64478148@N07,5771,10,1400791671,1400858995,5,8,67324
64478148@N07,5771,27,1400852977,1400856282,24,8,3305
64478148@N07,5771,26,1400850217,1400850219,2,8,2
64478148@N07,5772,25,1409348258,1409348258,1,4,0
64478148@N07,5772,14,1409349234,1409349319,4,4,85
64478148@N07,5772,16,1409346896,1409347770,3,4,874
64478148@N07,5772,26,1409348753,1409348864,2,4,111
64478148@N07,5773,17,1409575166,1409575166,1,3,0
64478148@N07,5773,4,1409577945,1409577945,1,3,0
64478148@N07,5773,27,1409554106,1409565235,25,3,11129
64478148@N07,5774,17,1409677962,1409677962,1,3,0
64478148@N07,5774,27,1409677944,1409677958,7,3,14
64478148@N07,5774,26,1409677943,1409677943,1,3,0
64478148@N07,5775,27,1420377192,1420377192,1,1,0
64542402@N07,5776,27,1355527948,1355575612,4,11,47664
64542402@N07,5776,10,1355530165,1355544747,2,11,14582
64542402@N07,5776,21,1355541653,1355541653,1,11,0
64542402@N07,5776,19,1355558774,1355558774,1,11,0
64542402@N07,5776,25,1355538519,1355553908,5,11,15389
64542402@N07,5776,6,1355529403,1355529403,1,11,0
64542402@N07,5776,5,1355542338,1355542338,1,11,0
64542402@N07,5776,14,1355528875,1355546772,6,11,17897
64542402@N07,5776,9,1355529941,1355551408,2,11,21467
64542402@N07,5776,24,1355535100,1355535100,1,11,0
64542402@N07,5776,8,1355559306,1355559306,1,11,0
64552430@N08,5777,16,1290157354,1290157354,1,1,0
64574649@N00,5778,16,1308392814,1308392814,1,1,0
64574649@N00,5779,27,1341211965,1341211965,1,1,0
64588066@N00,5780,27,1392471487,1392471487,1,1,0
64592191@N00,5781,16,1197769467,1197769467,1,1,0
64623188@N00,5782,18,1428812884,1428812884,1,1,0
64634237@N02,5783,12,1291703266,1291703266,1,1,0
64634237@N02,5784,12,1311041099,1311043399,31,1,2300
64667804@N00,5785,17,1190934243,1190944800,2,1,10557
64667804@N00,5786,17,1191221657,1191225140,2,1,3483
64667804@N00,5787,17,1194125599,1194125599,1,1,0
64667804@N00,5788,17,1194473183,1194473294,13,1,111
64669762@N02,5789,27,1350985282,1350997065,3,3,11783
64669762@N02,5789,10,1350991510,1350991510,1,3,0
64669762@N02,5789,13,1350993107,1350993107,1,3,0
64697193@N06,5790,16,1365035187,1365037363,3,1,2176
64713954@N00,5791,3,1345513468,1345513468,1,1,0
64769958@N07,5792,13,1311999372,1311999372,1,1,0
64777759@N06,5793,19,1319337684,1319337684,1,1,0
64779594@N00,5794,9,1195259069,1195259069,1,7,0
64779594@N00,5794,27,1195249559,1195275144,6,7,25585
64779594@N00,5794,19,1195255072,1195255072,1,7,0
64779594@N00,5794,13,1195252936,1195252936,1,7,0
64779594@N00,5794,4,1195271188,1195271188,1,7,0
64779594@N00,5794,18,1195255904,1195256004,2,7,100
64779594@N00,5794,1,1195250597,1195250597,1,7,0
64779594@N00,5795,15,1201393993,1201394014,2,1,21
64779594@N00,5796,21,1205032392,1205032425,4,1,33
64779594@N00,5797,27,1377411157,1377411157,1,1,0
64779594@N00,5798,13,1390697567,1390697608,2,2,41
64779594@N00,5798,18,1390697217,1390697261,2,2,44
64779594@N00,5799,16,1394800528,1394800528,1,1,0
64779594@N00,5800,9,1418332517,1418333006,4,1,489
64779594@N00,5801,27,1454038868,1454049092,9,7,10224
64779594@N00,5801,11,1454049840,1454049951,3,7,111
64779594@N00,5801,21,1454040201,1454040201,1,7,0
64779594@N00,5801,2,1454043419,1454043419,1,7,0
64779594@N00,5801,4,1454044403,1454044421,2,7,18
64779594@N00,5801,20,1454049313,1454049313,1,7,0
64779594@N00,5801,14,1454047294,1454047294,1,7,0
64787247@N02,5802,10,1367899433,1367899433,1,1,0
64812054@N06,5803,4,1324646231,1324699048,31,1,52817
64812054@N06,5804,4,1324729177,1324869871,52,1,140694
64812054@N06,5805,4,1324920989,1324957615,18,1,36626
64812054@N06,5806,4,1325029698,1325050929,12,1,21231
64812054@N06,5807,4,1325545020,1325545149,4,1,129
64834051@N00,5808,12,1230155167,1230155914,5,3,747
64834051@N00,5808,27,1230151851,1230152702,7,3,851
64834051@N00,5808,14,1230161313,1230163150,7,3,1837
64834051@N00,5809,16,1230403876,1230403991,5,6,115
64834051@N00,5809,12,1230410926,1230412498,4,6,1572
64834051@N00,5809,11,1230423504,1230425902,10,6,2398
64834051@N00,5809,14,1230404113,1230409684,28,6,5571
64834051@N00,5809,23,1230429036,1230429096,3,6,60
64834051@N00,5809,27,1230402465,1230403537,5,6,1072
64834051@N00,5810,14,1292894724,1292894724,1,1,0
64834051@N00,5811,21,1341637399,1341637401,4,1,2
64834051@N00,5812,27,1342231351,1342231351,1,2,0
64834051@N00,5812,16,1342231567,1342253738,4,2,22171
64834051@N00,5813,6,1421543178,1421543178,1,8,0
64834051@N00,5813,26,1421554670,1421554670,1,8,0
64834051@N00,5813,14,1421562675,1421562677,2,8,2
64834051@N00,5813,27,1421533729,1421534161,3,8,432
64834051@N00,5813,10,1421559439,1421561500,3,8,2061
64834051@N00,5813,11,1421559161,1421559161,1,8,0
64834051@N00,5813,8,1421559190,1421559876,2,8,686
64834051@N00,5813,19,1421549871,1421553624,3,8,3753
64834051@N00,5814,6,1421974478,1421974556,2,14,78
64834051@N00,5814,10,1421994832,1421994832,1,14,0
64834051@N00,5814,7,1421976379,1421985578,2,14,9199
64834051@N00,5814,23,1421988031,1421988031,1,14,0
64834051@N00,5814,5,1421972651,1421972651,1,14,0
64834051@N00,5814,27,1421969435,1421969435,1,14,0
64834051@N00,5814,2,1421984034,1421984440,3,14,406
64834051@N00,5814,9,1421985184,1422003757,5,14,18573
64834051@N00,5814,16,1422009411,1422009411,1,14,0
64834051@N00,5814,17,1421982300,1421982300,1,14,0
64834051@N00,5814,25,1421989512,1421994225,3,14,4713
64834051@N00,5814,14,1421997170,1422005773,13,14,8603
64834051@N00,5814,8,1421976915,1421977417,2,14,502
64834051@N00,5814,19,1421978819,1421978819,1,14,0
64834051@N00,5815,10,1439017837,1439017837,1,4,0
64834051@N00,5815,20,1439014020,1439014020,1,4,0
64834051@N00,5815,14,1439005380,1439018139,2,4,12759
64834051@N00,5815,16,1439018129,1439018129,1,4,0
64834051@N00,5816,19,1439429825,1439433677,2,1,3852
64834051@N00,5817,9,1439475595,1439475595,1,1,0
64854604@N07,5818,23,1429196511,1429196511,1,2,0
64854604@N07,5818,2,1429193344,1429193344,1,2,0
64874983@N00,5819,24,1254286682,1254286682,1,2,0
64874983@N00,5819,20,1254290243,1254290243,1,2,0
64874983@N00,5820,27,1254350694,1254350694,1,1,0
64874983@N00,5821,20,1254618208,1254618208,1,2,0
64874983@N00,5821,27,1254618317,1254618416,2,2,99
64876770@N08,5822,27,1309699637,1309699637,1,1,0
64907932@N00,5823,14,1443491828,1443491828,1,1,0
64907932@N00,5824,14,1443764286,1443764286,1,1,0
64917984@N00,5825,25,1269228292,1269228292,1,2,0
64917984@N00,5825,26,1269228088,1269228088,1,2,0
64923481@N00,5826,18,1363223412,1363223412,1,1,0
64975676@N03,5827,14,1310127927,1310127927,1,1,0
64999331@N04,5828,16,1311963935,1311963935,1,1,0
65067379@N08,5829,27,1384331834,1384332267,2,1,433
65098523@N02,5830,4,1313119187,1313119187,1,1,0
65105672@N00,5831,16,1379219419,1379219419,1,1,0
65105672@N00,5832,16,1379251310,1379251310,1,1,0
65105672@N00,5833,15,1379461227,1379461244,2,3,17
65105672@N00,5833,16,1379458804,1379468144,4,3,9340
65105672@N00,5833,22,1379462911,1379462915,3,3,4
65105672@N00,5834,10,1442969849,1442982728,7,6,12879
65105672@N00,5834,9,1442966383,1442966383,1,6,0
65105672@N00,5834,13,1442974758,1442975351,3,6,593
65105672@N00,5834,16,1442977179,1442997231,3,6,20052
65105672@N00,5834,2,1442979927,1442979927,1,6,0
65105672@N00,5834,12,1442968750,1442969024,2,6,274
65105672@N00,5835,27,1443191616,1443191626,2,4,10
65105672@N00,5835,13,1443177829,1443179135,3,4,1306
65105672@N00,5835,17,1443181396,1443187791,6,4,6395
65105672@N00,5835,16,1443189045,1443189045,1,4,0
65105672@N00,5836,17,1443331046,1443331065,2,2,19
65105672@N00,5836,27,1443307019,1443307756,2,2,737
65105672@N00,5837,13,1443606822,1443612426,2,9,5604
65105672@N00,5837,21,1443610241,1443610527,7,9,286
65105672@N00,5837,15,1443612442,1443612442,1,9,0
65105672@N00,5837,17,1443608351,1443611389,12,9,3038
65105672@N00,5837,10,1443612799,1443612897,2,9,98
65105672@N00,5837,7,1443613098,1443613098,1,9,0
65105672@N00,5837,4,1443615415,1443615415,1,9,0
65105672@N00,5837,14,1443612532,1443612532,1,9,0
65105672@N00,5837,27,1443602528,1443617502,3,9,14974
65105672@N00,5838,17,1443671232,1443673125,6,2,1893
65105672@N00,5838,8,1443684317,1443684317,1,2,0
65105672@N00,5839,21,1443757489,1443757489,1,1,0
65105672@N00,5840,27,1460540788,1460543559,3,1,2771
65105672@N00,5841,27,1460844824,1460844824,1,1,0
65105672@N00,5842,6,1460887077,1460887111,4,1,34
65145534@N06,5843,16,1310003087,1310003087,1,1,0
65164043@N02,5844,16,1414125373,1414125373,1,2,0
65164043@N02,5844,27,1414107984,1414107984,1,2,0
65164043@N02,5845,19,1414632744,1414632744,1,1,0
65184867@N04,5846,27,1393718808,1393718808,1,1,0
65184867@N04,5847,14,1393752610,1393752610,1,1,0
65223931@N00,5848,16,1387875691,1387888630,2,1,12939
65228321@N00,5849,9,1448777911,1448777911,1,6,0
65228321@N00,5849,16,1448775887,1448797160,4,6,21273
65228321@N00,5849,27,1448774376,1448802932,12,6,28556
65228321@N00,5849,17,1448782112,1448782112,1,6,0
65228321@N00,5849,6,1448777137,1448777707,5,6,570
65228321@N00,5849,22,1448789479,1448789806,3,6,327
65228321@N00,5850,27,1449298760,1449298760,1,1,0
65315936@N00,5851,2,1371208894,1371208894,1,1,0
65350711@N08,5852,25,1253433366,1253433366,1,1,0
65353764@N06,5853,27,1402361879,1402361879,1,1,0
65353764@N06,5854,3,1402640912,1402640912,1,2,0
65353764@N06,5854,10,1402647501,1402647501,1,2,0
65353764@N06,5855,20,1402813202,1402813202,1,4,0
65353764@N06,5855,3,1402828654,1402828654,1,4,0
65353764@N06,5855,21,1402819281,1402819418,3,4,137
65353764@N06,5855,9,1402825955,1402826089,3,4,134
65367128@N00,5856,21,1198235054,1198235069,3,4,15
65367128@N00,5856,27,1198230169,1198244099,12,4,13930
65367128@N00,5856,17,1198235002,1198235016,2,4,14
65367128@N00,5856,22,1198232689,1198242266,6,4,9577
65367128@N00,5857,27,1198324055,1198324055,1,2,0
65367128@N00,5857,4,1198317039,1198317215,6,2,176
65367128@N00,5858,6,1229677682,1229677682,1,1,0
65367128@N00,5859,9,1261133495,1261133495,1,1,0
65367128@N00,5860,4,1278264725,1278264725,1,1,0
65367128@N00,5861,27,1292575408,1292575408,1,1,0
65367128@N00,5862,12,1374120172,1374120172,1,2,0
65367128@N00,5862,15,1374122557,1374122557,1,2,0
65367128@N00,5863,3,1396095550,1396096056,2,1,506
65367128@N00,5864,27,1456020716,1456020716,1,2,0
65367128@N00,5864,20,1456023016,1456023016,1,2,0
65367128@N00,5865,27,1456093122,1456093163,2,7,41
65367128@N00,5865,20,1456097227,1456098319,6,7,1092
65367128@N00,5865,24,1456095041,1456095041,1,7,0
65367128@N00,5865,14,1456127545,1456127545,1,7,0
65367128@N00,5865,10,1456118595,1456118658,4,7,63
65367128@N00,5865,21,1456096523,1456096523,1,7,0
65367128@N00,5865,26,1456109703,1456115054,2,7,5351
65451028@N00,5866,14,1239369214,1239369214,1,1,0
65451028@N00,5867,23,1282711837,1282711837,1,2,0
65451028@N00,5867,9,1282708036,1282735487,19,2,27451
65461349@N08,5868,16,1393573591,1393573591,1,1,0
65547015@N00,5869,21,1388886366,1388888322,15,16,1956
65547015@N00,5869,19,1388889672,1388889819,3,16,147
65547015@N00,5869,15,1388896964,1388896964,1,16,0
65547015@N00,5869,25,1388885230,1388885985,17,16,755
65547015@N00,5869,26,1388886261,1388890168,6,16,3907
65547015@N00,5869,6,1388916432,1388917637,2,16,1205
65547015@N00,5869,20,1388889162,1388889456,5,16,294
65547015@N00,5869,11,1388892704,1388895138,7,16,2434
65547015@N00,5869,16,1388890417,1388898963,7,16,8546
65547015@N00,5869,27,1388882114,1388921691,35,16,39577
65547015@N00,5869,10,1388900071,1388904641,13,16,4570
65547015@N00,5869,9,1388890701,1388896580,3,16,5879
65547015@N00,5869,17,1388890336,1388897979,7,16,7643
65547015@N00,5869,12,1388907076,1388908065,4,16,989
65547015@N00,5869,8,1388896176,1388896335,3,16,159
65547015@N00,5869,14,1388896709,1388912094,12,16,15385
65660258@N03,5870,16,1367369305,1367369305,1,1,0
65701179@N00,5871,16,1313147210,1313147210,1,1,0
65746045@N00,5872,19,1218170257,1218170257,1,2,0
65746045@N00,5872,18,1218161156,1218161156,1,2,0
65746045@N00,5873,22,1218432775,1218438450,2,3,5675
65746045@N00,5873,18,1218439286,1218439286,1,3,0
65746045@N00,5873,27,1218410807,1218410847,2,3,40
65746519@N00,5874,16,1227876266,1227876266,1,1,0
65784570@N00,5875,13,1382601093,1382601093,1,1,0
65785294@N07,5876,27,1359706309,1359706309,1,1,0
65825924@N03,5877,14,1311333224,1311333224,1,2,0
65825924@N03,5877,16,1311333195,1311333195,1,2,0
65825924@N03,5878,26,1343969219,1343969219,1,2,0
65825924@N03,5878,16,1343997714,1343997714,1,2,0
65825924@N03,5879,22,1363227511,1363227511,1,1,0
65825924@N03,5880,16,1363259607,1363259607,1,1,0
65825924@N03,5881,11,1395308266,1395308266,1,3,0
65825924@N03,5881,22,1395296301,1395296484,2,3,183
65825924@N03,5881,9,1395308911,1395308911,1,3,0
65825924@N03,5882,27,1395455839,1395455839,1,1,0
65825924@N03,5883,17,1395571638,1395571638,1,4,0
65825924@N03,5883,4,1395573747,1395573747,1,4,0
65825924@N03,5883,16,1395565691,1395565691,1,4,0
65825924@N03,5883,27,1395574609,1395574609,1,4,0
65825924@N03,5884,16,1418887626,1418902266,2,2,14640
65825924@N03,5884,27,1418895731,1418896557,2,2,826
65825924@N03,5885,16,1419070073,1419083844,4,4,13771
65825924@N03,5885,20,1419079005,1419079005,1,4,0
65825924@N03,5885,27,1419084528,1419084528,1,4,0
65825924@N03,5885,18,1419077943,1419077943,1,4,0
65825924@N03,5886,14,1440673745,1440673745,1,2,0
65825924@N03,5886,27,1440674077,1440674077,1,2,0
65825924@N03,5887,16,1458098561,1458129368,5,2,30807
65825924@N03,5887,10,1458124448,1458127039,2,2,2591
65976254@N05,5888,10,1464057307,1464057307,1,1,0
65987396@N00,5889,2,1308043699,1308043699,1,2,0
65987396@N00,5889,27,1308044552,1308044552,1,2,0
65988422@N07,5890,27,1373368075,1373368075,1,1,0
65990642@N06,5891,24,1383617020,1383617020,1,4,0
65990642@N06,5891,27,1383603700,1383603700,1,4,0
65990642@N06,5891,8,1383625631,1383625631,1,4,0
65990642@N06,5891,16,1383605547,1383605547,1,4,0
66139507@N05,5892,3,1316329152,1316334090,4,11,4938
66139507@N05,5892,9,1316334820,1316334888,2,11,68
66139507@N05,5892,5,1316332134,1316332134,1,11,0
66139507@N05,5892,1,1316334295,1316334295,1,11,0
66139507@N05,5892,6,1316334445,1316334473,2,11,28
66139507@N05,5892,15,1316335091,1316335152,3,11,61
66139507@N05,5892,13,1316335968,1316336152,10,11,184
66139507@N05,5892,27,1316326167,1316326688,6,11,521
66139507@N05,5892,16,1316348388,1316349457,3,11,1069
66139507@N05,5892,4,1316328797,1316329109,6,11,312
66139507@N05,5892,22,1316341110,1316341125,2,11,15
66147934@N04,5893,24,1386384589,1386384589,1,1,0
66147934@N04,5894,27,1417170362,1417170362,1,1,0
66186191@N00,5895,6,1235531270,1235531270,1,1,0
66222834@N05,5896,7,1370223521,1370223521,1,1,0
66222834@N05,5897,14,1370258694,1370258694,1,1,0
66231302@N00,5898,14,1280224686,1280224939,5,1,253
66231302@N00,5899,7,1280282521,1280282521,1,4,0
66231302@N00,5899,8,1280282613,1280285115,5,4,2502
66231302@N00,5899,14,1280276327,1280279677,3,4,3350
66231302@N00,5899,16,1280277199,1280278411,9,4,1212
66231302@N00,5900,27,1280401136,1280407933,6,1,6797
66231302@N00,5901,7,1280487222,1280489497,4,1,2275
66231596@N04,5902,2,1445832231,1445832231,1,2,0
66231596@N04,5902,4,1445825314,1445825314,1,2,0
66231596@N04,5903,3,1446089830,1446089830,1,1,0
66293290@N06,5904,14,1417676079,1417676079,1,1,0
66372986@N00,5905,17,1280914298,1280921828,46,14,7530
66372986@N00,5905,27,1280881993,1280882178,6,14,185
66372986@N00,5905,11,1280901555,1280901555,1,14,0
66372986@N00,5905,3,1280909425,1280909431,2,14,6
66372986@N00,5905,5,1280891893,1280891944,4,14,51
66372986@N00,5905,21,1280883922,1280883922,1,14,0
66372986@N00,5905,6,1280890861,1280890892,2,14,31
66372986@N00,5905,2,1280891811,1280891862,6,14,51
66372986@N00,5905,24,1280883684,1280883881,3,14,197
66372986@N00,5905,15,1280906586,1280906731,4,14,145
66372986@N00,5905,9,1280910831,1280910831,1,14,0
66372986@N00,5905,18,1280903969,1280903969,1,14,0
66372986@N00,5905,14,1280896025,1280896025,1,14,0
66372986@N00,5905,13,1280921955,1280921955,1,14,0
66372986@N00,5906,21,1343705648,1343732459,3,5,26811
66372986@N00,5906,27,1343713161,1343713976,7,5,815
66372986@N00,5906,19,1343709208,1343709208,1,5,0
66372986@N00,5906,8,1343709795,1343709825,3,5,30
66372986@N00,5906,13,1343728200,1343728200,1,5,0
66372986@N00,5907,4,1373966011,1373966049,6,3,38
66372986@N00,5907,17,1373949129,1373949129,1,3,0
66372986@N00,5907,1,1373965855,1373965886,5,3,31
66406888@N08,5908,13,1345865866,1345865866,1,1,0
66408130@N07,5909,27,1304948337,1304948337,1,1,0
66408130@N07,5910,27,1418443099,1418443099,1,2,0
66408130@N07,5910,10,1418431660,1418431660,1,2,0
66408130@N07,5911,14,1418684785,1418684785,1,4,0
66408130@N07,5911,19,1418711425,1418711425,1,4,0
66408130@N07,5911,15,1418691558,1418691558,1,4,0
66408130@N07,5911,10,1418680548,1418680548,1,4,0
66408130@N07,5912,15,1419312667,1419312667,1,3,0
66408130@N07,5912,9,1419307468,1419307468,1,3,0
66408130@N07,5912,3,1419298850,1419298850,1,3,0
66408130@N07,5913,19,1419550222,1419550222,1,1,0
66543355@N00,5914,27,1215475927,1215475927,1,1,0
66685507@N03,5915,16,1309259672,1309259672,1,1,0
66691654@N00,5916,27,1327465512,1327499848,88,1,34336
66718423@N03,5917,27,1230339471,1230342791,5,7,3320
66718423@N03,5917,20,1230346156,1230346848,3,7,692
66718423@N03,5917,14,1230377178,1230386788,13,7,9610
66718423@N03,5917,21,1230346976,1230347323,2,7,347
66718423@N03,5917,5,1230378381,1230378381,1,7,0
66718423@N03,5917,6,1230342121,1230349125,6,7,7004
66718423@N03,5917,18,1230357371,1230373743,3,7,16372
66718423@N03,5918,17,1287396110,1287396119,2,8,9
66718423@N03,5918,27,1287388999,1287405617,6,8,16618
66718423@N03,5918,14,1287405119,1287405249,2,8,130
66718423@N03,5918,23,1287403216,1287403334,5,8,118
66718423@N03,5918,20,1287389877,1287389877,1,8,0
66718423@N03,5918,19,1287401571,1287401646,4,8,75
66718423@N03,5918,26,1287403485,1287405018,6,8,1533
66718423@N03,5918,18,1287401820,1287401972,5,8,152
66718423@N03,5919,21,1287632503,1287632503,1,6,0
66718423@N03,5919,27,1287640841,1287640913,5,6,72
66718423@N03,5919,23,1287633039,1287633408,4,6,369
66718423@N03,5919,2,1287627664,1287627679,3,6,15
66718423@N03,5919,14,1287637321,1287637321,1,6,0
66718423@N03,5919,6,1287628820,1287628935,6,6,115
66718423@N03,5920,5,1288019795,1288019795,1,3,0
66718423@N03,5920,21,1288017784,1288017792,2,3,8
66718423@N03,5920,27,1288011313,1288027310,4,3,15997
66718423@N03,5921,27,1288259782,1288262011,7,11,2229
66718423@N03,5921,26,1288241755,1288241922,6,11,167
66718423@N03,5921,6,1288231705,1288258813,12,11,27108
66718423@N03,5921,19,1288236907,1288253871,22,11,16964
66718423@N03,5921,18,1288237795,1288238179,11,11,384
66718423@N03,5921,17,1288259342,1288259520,5,11,178
66718423@N03,5921,11,1288254202,1288254625,4,11,423
66718423@N03,5921,23,1288240482,1288240489,2,11,7
66718423@N03,5921,13,1288250263,1288250263,1,11,0
66718423@N03,5921,14,1288248302,1288249962,6,11,1660
66718423@N03,5921,20,1288236398,1288252822,12,11,16424
66736603@N00,5922,19,1458884913,1458884913,1,1,0
66755680@N06,5923,27,1319890239,1319890239,1,1,0
66755680@N06,5924,27,1319967670,1319968753,10,2,1083
66755680@N06,5924,14,1319972865,1319972865,1,2,0
66874291@N07,5925,16,1298586011,1298586011,1,1,0
66884161@N05,5926,13,1330491379,1330491379,1,1,0
66884161@N05,5927,27,1337340200,1337340200,1,1,0
66943671@N05,5928,14,1279632907,1279632907,1,6,0
66943671@N05,5928,27,1279609898,1279609898,1,6,0
66943671@N05,5928,9,1279595184,1279595184,1,6,0
66943671@N05,5928,18,1279632514,1279632514,1,6,0
66943671@N05,5928,24,1279617790,1279617790,1,6,0
66943671@N05,5928,20,1279632895,1279632895,1,6,0
66950820@N08,5929,4,1256629604,1256629604,1,1,0
66985846@N08,5930,9,1470898857,1470898857,1,1,0
66985846@N08,5931,27,1471391138,1471391138,1,1,0
67037430@N06,5932,27,1385958542,1385962340,48,1,3798
67038581@N00,5933,9,1315714203,1315714203,1,2,0
67038581@N00,5933,27,1315715839,1315716785,2,2,946
67038581@N00,5934,25,1315973813,1315973813,1,2,0
67038581@N00,5934,16,1315983809,1315986850,4,2,3041
67065233@N02,5935,16,1339451885,1339452638,2,2,753
67065233@N02,5935,27,1339451610,1339451610,1,2,0
67093054@N00,5936,14,1377407992,1377410665,3,6,2673
67093054@N00,5936,10,1377408188,1377410545,29,6,2357
67093054@N00,5936,26,1377411414,1377411414,1,6,0
67093054@N00,5936,16,1377407985,1377407985,1,6,0
67093054@N00,5936,27,1377407402,1377415957,3,6,8555
67093054@N00,5936,15,1377411071,1377411071,1,6,0
67123974@N05,5937,19,1361315157,1361315157,1,1,0
67157140@N00,5938,8,1359522232,1359522232,1,1,0
67237167@N03,5939,25,1387968284,1387968284,1,5,0
67237167@N03,5939,26,1387968235,1387968254,2,5,19
67237167@N03,5939,19,1387947932,1387948510,3,5,578
67237167@N03,5939,4,1387963728,1387963794,2,5,66
67237167@N03,5939,27,1387941391,1387971452,4,5,30061
67246822@N00,5940,13,1323648774,1323677221,3,7,28447
67246822@N00,5940,4,1323663057,1323663258,2,7,201
67246822@N00,5940,12,1323656819,1323656819,1,7,0
67246822@N00,5940,16,1323678755,1323678755,1,7,0
67246822@N00,5940,27,1323639892,1323640027,2,7,135
67246822@N00,5940,17,1323642128,1323642128,1,7,0
67246822@N00,5940,2,1323670929,1323670929,1,7,0
67246822@N00,5941,17,1323928960,1323928960,1,1,0
67298936@N05,5942,27,1333933433,1333933433,1,2,0
67298936@N05,5942,9,1333940036,1333940036,1,2,0
67298936@N05,5943,27,1346750201,1346750201,1,1,0
67298936@N05,5944,2,1429675386,1429675386,1,1,0
67299437@N06,5945,6,1433414209,1433414209,1,3,0
67299437@N06,5945,14,1433407555,1433409668,20,3,2113
67299437@N06,5945,16,1433406542,1433415577,2,3,9035
67299437@N06,5946,14,1433469313,1433470286,6,1,973
67302249@N08,5947,10,1309598752,1309598752,1,1,0
67336497@N05,5948,27,1413421227,1413421227,1,1,0
67397176@N02,5949,27,1247114531,1247114531,1,2,0
67397176@N02,5949,11,1247119057,1247119057,1,2,0
67407588@N00,5950,16,1203207688,1203207688,1,2,0
67407588@N00,5950,5,1203207661,1203207661,1,2,0
67407588@N00,5951,5,1203293012,1203293012,1,2,0
67407588@N00,5951,18,1203293009,1203293009,1,2,0
67485106@N05,5952,27,1379979870,1380020798,10,1,40928
67485106@N05,5953,27,1380095803,1380095803,1,1,0
67485106@N05,5954,27,1380151179,1380151179,1,1,0
67522962@N07,5955,14,1394929413,1394935129,4,1,5716
67527549@N00,5956,27,1293946748,1293947188,3,1,440
67527549@N00,5957,23,1294019273,1294019283,2,3,10
67527549@N00,5957,14,1294005091,1294010939,6,3,5848
67527549@N00,5957,16,1294005134,1294009286,53,3,4152
67527549@N00,5958,11,1294377353,1294377490,5,2,137
67527549@N00,5958,17,1294368859,1294368947,7,2,88
67559929@N00,5959,19,1440922418,1440922418,1,1,0
67621043@N00,5960,16,1323885783,1323885783,1,1,0
67621043@N00,5961,11,1332030331,1332032273,2,1,1942
67621043@N00,5962,8,1337637320,1337639479,4,1,2159
67621043@N00,5963,14,1351812014,1351812014,1,1,0
67622575@N00,5964,9,1359329414,1359329414,1,1,0
67645990@N00,5965,9,1398603683,1398603968,3,1,285
67661617@N04,5966,27,1389603784,1389603784,1,1,0
67678180@N04,5967,21,1242093028,1242093028,1,1,0
67678180@N04,5968,9,1257672551,1257672551,1,1,0
67700845@N07,5969,27,1349830568,1349830780,3,1,212
67737010@N08,5970,22,1470901907,1470901907,1,1,0
67774977@N00,5971,17,1266070794,1266070794,1,8,0
67774977@N00,5971,22,1266073285,1266074362,2,8,1077
67774977@N00,5971,21,1266076139,1266076287,2,8,148
67774977@N00,5971,16,1266060997,1266061018,2,8,21
67774977@N00,5971,4,1266067605,1266067605,1,8,0
67774977@N00,5971,12,1266063120,1266064953,6,8,1833
67774977@N00,5971,9,1266059508,1266067487,3,8,7979
67774977@N00,5971,1,1266056757,1266056757,1,8,0
67839110@N02,5972,16,1436268606,1436268976,2,1,370
67875732@N05,5973,21,1389302258,1389302258,1,2,0
67875732@N05,5973,19,1389295565,1389295565,1,2,0
67949678@N00,5974,2,1419811355,1419811355,1,11,0
67949678@N00,5974,8,1419815435,1419815435,1,11,0
67949678@N00,5974,9,1419828703,1419828703,1,11,0
67949678@N00,5974,3,1419810034,1419810034,1,11,0
67949678@N00,5974,27,1419808073,1419848975,2,11,40902
67949678@N00,5974,14,1419828354,1419835028,3,11,6674
67949678@N00,5974,22,1419821877,1419821877,1,11,0
67949678@N00,5974,11,1419814963,1419815454,3,11,491
67949678@N00,5974,25,1419846054,1419846182,3,11,128
67949678@N00,5974,17,1419820147,1419820156,2,11,9
67949678@N00,5974,16,1419831464,1419831464,1,11,0
68010648@N07,5975,9,1343291125,1343291125,1,3,0
68010648@N07,5975,4,1343298858,1343298858,1,3,0
68010648@N07,5975,27,1343287289,1343287289,1,3,0
68010648@N07,5976,16,1343700163,1343700163,1,1,0
68026024@N00,5977,27,1389407758,1389429329,2,6,21571
68026024@N00,5977,25,1389409259,1389409259,1,6,0
68026024@N00,5977,8,1389424187,1389424371,2,6,184
68026024@N00,5977,14,1389415539,1389415605,2,6,66
68026024@N00,5977,7,1389420484,1389420686,3,6,202
68026024@N00,5977,15,1389415526,1389415526,1,6,0
68194729@N00,5978,27,1422165639,1422165639,1,1,0
68235353@N00,5979,13,1328728458,1328728458,1,2,0
68235353@N00,5979,19,1328729045,1328729045,1,2,0
68235353@N00,5980,14,1328809498,1328809498,1,1,0
68255606@N00,5981,18,1345635652,1345635652,1,1,0
68559301@N00,5982,20,1335948225,1335948225,1,2,0
68559301@N00,5982,16,1335964452,1335964452,1,2,0
68559301@N00,5983,1,1374496787,1374496787,1,2,0
68559301@N00,5983,27,1374496565,1374500713,3,2,4148
68574102@N00,5984,17,1376833440,1376833440,1,1,0
68577094@N06,5985,24,1352289529,1352289529,1,2,0
68577094@N06,5985,10,1352288281,1352288281,1,2,0
68577094@N06,5986,17,1355229105,1355229105,1,1,0
68655192@N08,5987,18,1468730515,1468730515,1,1,0
68655192@N08,5988,10,1470376371,1470376371,1,1,0
68731864@N04,5989,13,1394856130,1394856130,1,3,0
68731864@N04,5989,16,1394864409,1394864409,1,3,0
68731864@N04,5989,17,1394856205,1394856205,1,3,0
68743655@N00,5990,21,1240101913,1240101913,1,1,0
68743655@N00,5991,5,1240132366,1240132407,2,1,41
68821991@N03,5992,15,1438562730,1438562730,1,1,0
68821991@N03,5993,9,1438593757,1438593757,1,1,0
68846374@N00,5994,15,1235796791,1235796791,1,1,0
68903520@N04,5995,15,1329189141,1329201968,14,5,12827
68903520@N04,5995,16,1329203312,1329203431,3,5,119
68903520@N04,5995,13,1329186311,1329187974,8,5,1663
68903520@N04,5995,20,1329193300,1329199712,34,5,6412
68903520@N04,5995,27,1329179497,1329181715,6,5,2218
68997488@N00,5996,1,1363875460,1363875460,1,1,0
68997488@N00,5997,19,1389787268,1389787268,1,1,0
68997488@N00,5998,27,1390102506,1390102506,1,1,0
68998347@N00,5999,27,1324600246,1324629819,5,2,29573
68998347@N00,5999,14,1324623159,1324623497,2,2,338
68998347@N00,6000,14,1365128636,1365128636,1,2,0
68998347@N00,6000,24,1365120952,1365120952,1,2,0
68998347@N00,6001,7,1365298838,1365298838,1,2,0
68998347@N00,6001,16,1365312483,1365312483,1,2,0
68998347@N00,6002,16,1396833696,1396842673,5,5,8977
68998347@N00,6002,14,1396843747,1396846137,2,5,2390
68998347@N00,6002,20,1396847292,1396847292,1,5,0
68998347@N00,6002,10,1396844431,1396844431,1,5,0
68998347@N00,6002,15,1396846470,1396846470,1,5,0
68998347@N00,6003,2,1397029424,1397032189,3,6,2765
68998347@N00,6003,7,1397019759,1397019759,1,6,0
68998347@N00,6003,4,1397032404,1397032473,2,6,69
68998347@N00,6003,8,1397017169,1397018355,5,6,1186
68998347@N00,6003,10,1397015316,1397015316,1,6,0
68998347@N00,6003,15,1397009921,1397012017,2,6,2096
68998347@N00,6004,27,1414278108,1414294728,5,1,16620
68998347@N00,6005,17,1414488431,1414489110,7,2,679
68998347@N00,6005,27,1414487219,1414487416,2,2,197
69031754@N06,6006,4,1393113633,1393113633,1,1,0
69056984@N07,6007,9,1389409563,1389409563,1,1,0
69056984@N07,6008,19,1408237874,1408237874,1,4,0
69056984@N07,6008,18,1408239119,1408239119,1,4,0
69056984@N07,6008,6,1408248220,1408248220,1,4,0
69056984@N07,6008,1,1408248441,1408248441,1,4,0
69066018@N00,6009,22,1421403822,1421404405,2,2,583
69066018@N00,6009,26,1421404574,1421404574,1,2,0
69108709@N07,6010,15,1319215030,1319215030,1,1,0
69108709@N07,6011,1,1321109615,1321109615,1,1,0
69108709@N07,6012,27,1323326754,1323326770,2,1,16
69108709@N07,6013,23,1330575213,1330575213,1,6,0
69108709@N07,6013,22,1330575212,1330575212,1,6,0
69108709@N07,6013,14,1330575198,1330575211,2,6,13
69108709@N07,6013,4,1330551707,1330551707,1,6,0
69108709@N07,6013,17,1330554930,1330575212,4,6,20282
69108709@N07,6013,9,1330575211,1330575211,1,6,0
69108709@N07,6014,1,1333505365,1333505365,1,2,0
69108709@N07,6014,8,1333505365,1333505365,1,2,0
69121654@N00,6015,9,1264761203,1264761203,1,2,0
69121654@N00,6015,14,1264761193,1264761193,1,2,0
69161765@N08,6016,1,1352094541,1352094581,3,13,40
69161765@N08,6016,17,1352078575,1352078589,2,13,14
69161765@N08,6016,18,1352090886,1352094507,15,13,3621
69161765@N08,6016,24,1352086133,1352086133,1,13,0
69161765@N08,6016,27,1352077609,1352077720,4,13,111
69161765@N08,6016,26,1352078639,1352078639,1,13,0
69161765@N08,6016,23,1352086107,1352086120,3,13,13
69161765@N08,6016,22,1352078739,1352078739,1,13,0
69161765@N08,6016,20,1352078798,1352080395,3,13,1597
69161765@N08,6016,10,1352097704,1352100554,47,13,2850
69161765@N08,6016,2,1352096056,1352096056,1,13,0
69161765@N08,6016,6,1352096080,1352096482,4,13,402
69161765@N08,6016,13,1352091431,1352091435,2,13,4
69219361@N05,6017,3,1371364371,1371364371,1,2,0
69219361@N05,6017,2,1371364365,1371364365,1,2,0
69219361@N05,6018,21,1433032900,1433032900,1,1,0
69219361@N05,6019,22,1433225488,1433225488,1,1,0
69256737@N00,6020,18,1311305601,1311305601,1,1,0
69271250@N00,6021,27,1290756175,1290757650,3,1,1475
69271250@N00,6022,26,1290940815,1290940815,1,1,0
69271250@N00,6023,3,1448262414,1448262414,1,2,0
69271250@N00,6023,15,1448262142,1448262322,4,2,180
69271250@N00,6024,1,1448848632,1448849037,6,2,405
69271250@N00,6024,27,1448844197,1448844197,1,2,0
69301930@N03,6025,17,1315624286,1315624286,1,2,0
69301930@N03,6025,18,1315612326,1315612326,1,2,0
69343619@N08,6026,14,1371099170,1371099170,1,2,0
69343619@N08,6026,7,1371121092,1371121092,1,2,0
69343619@N08,6027,7,1371349186,1371349186,1,1,0
69343619@N08,6028,2,1371383229,1371383229,1,3,0
69343619@N08,6028,10,1371384239,1371384676,3,3,437
69343619@N08,6028,14,1371385271,1371385271,1,3,0
69377536@N00,6029,1,1339047883,1339047883,1,1,0
69416229@N00,6030,27,1248040116,1248040116,1,2,0
69416229@N00,6030,17,1248045310,1248045310,1,2,0
69487366@N02,6031,27,1375001545,1375001545,1,1,0
69548110@N08,6032,27,1320884275,1320884275,1,2,0
69548110@N08,6032,14,1320885791,1320885812,2,2,21
69573456@N00,6033,23,1206729091,1206729091,1,4,0
69573456@N00,6033,9,1206743577,1206743691,3,4,114
69573456@N00,6033,4,1206744491,1206744491,1,4,0
69573456@N00,6033,5,1206745040,1206745040,1,4,0
69573456@N00,6034,6,1206876523,1206879825,3,3,3302
69573456@N00,6034,27,1206889592,1206891624,5,3,2032
69573456@N00,6034,20,1206882780,1206883141,3,3,361
69574134@N00,6035,19,1214834400,1214834400,1,1,0
69574134@N00,6036,27,1346122148,1346122708,2,12,560
69574134@N00,6036,16,1346138322,1346138322,1,12,0
69574134@N00,6036,19,1346148856,1346148903,4,12,47
69574134@N00,6036,24,1346141863,1346142212,4,12,349
69574134@N00,6036,12,1346152976,1346159998,3,12,7022
69574134@N00,6036,18,1346133625,1346151585,12,12,17960
69574134@N00,6036,1,1346160081,1346160081,1,12,0
69574134@N00,6036,17,1346146463,1346152736,2,12,6273
69574134@N00,6036,21,1346139285,1346143753,7,12,4468
69574134@N00,6036,10,1346158287,1346158287,1,12,0
69574134@N00,6036,4,1346166421,1346167243,22,12,822
69574134@N00,6036,3,1346160027,1346160027,1,12,0
69591415@N02,6037,13,1330134669,1330135625,2,4,956
69591415@N02,6037,4,1330133742,1330133742,1,4,0
69591415@N02,6037,20,1330135916,1330135916,1,4,0
69591415@N02,6037,17,1330134447,1330137597,2,4,3150
69689125@N02,6038,27,1395633807,1395633807,1,1,0
69720780@N05,6039,27,1340061111,1340062815,8,1,1704
69765102@N04,6040,14,1432252935,1432252935,1,1,0
69781071@N00,6041,27,1299626441,1299657292,24,1,30851
69811005@N00,6042,14,1433292360,1433305973,3,3,13613
69811005@N00,6042,7,1433302441,1433302783,5,3,342
69811005@N00,6042,9,1433294454,1433300925,4,3,6471
69811005@N00,6043,27,1433494825,1433510276,29,5,15451
69811005@N00,6043,12,1433498142,1433498207,3,5,65
69811005@N00,6043,15,1433498004,1433498031,2,5,27
69811005@N00,6043,14,1433499381,1433499456,4,5,75
69811005@N00,6043,10,1433496447,1433496798,3,5,351
69811005@N00,6044,14,1433937714,1433937714,1,1,0
69872692@N07,6045,20,1322889347,1322889347,1,1,0
69872692@N07,6046,21,1380433976,1380433976,1,1,0
69880349@N08,6047,14,1448917142,1448917142,1,1,0
69882141@N06,6048,14,1294889715,1294893448,3,1,3733
69882141@N06,6049,16,1322618006,1322618006,1,1,0
69882141@N06,6050,14,1322656512,1322656557,2,1,45
69882141@N06,6051,14,1357801892,1357805406,4,1,3514
69882141@N06,6052,14,1375877966,1375918042,38,1,40076
69883003@N00,6053,21,1348880391,1348880391,1,2,0
69883003@N00,6053,13,1348880266,1348880266,1,2,0
69883003@N00,6054,17,1431739073,1431745980,2,5,6907
69883003@N00,6054,2,1431747692,1431747692,1,5,0
69883003@N00,6054,10,1431737362,1431737432,2,5,70
69883003@N00,6054,22,1431743244,1431743244,1,5,0
69883003@N00,6054,14,1431758723,1431758723,1,5,0
69904569@N00,6055,27,1219268216,1219268216,1,1,0
70084804@N00,6056,19,1349000359,1349000359,1,1,0
70084804@N00,6057,27,1349564354,1349564354,1,1,0
70133294@N08,6058,13,1345453118,1345453118,1,1,0
70268120@N00,6059,14,1217449058,1217449058,3,1,0
70268120@N00,6060,14,1218267012,1218274364,12,1,7352
70378830@N08,6061,21,1413882943,1413882943,1,1,0
70414449@N06,6062,26,1457930866,1457930937,9,3,71
70414449@N06,6062,2,1457919326,1457919333,3,3,7
70414449@N06,6062,4,1457923591,1457923591,1,3,0
70456885@N00,6063,27,1319365617,1319365617,1,1,0
70626136@N00,6064,2,1348392271,1348392271,1,2,0
70626136@N00,6064,4,1348393100,1348393100,1,2,0
70824604@N00,6065,16,1217295585,1217295603,2,1,18
70862502@N00,6066,13,1330575588,1330575588,1,1,0
70862502@N00,6067,16,1330878482,1330878482,1,1,0
70862502@N00,6068,13,1331130609,1331130609,1,1,0
70862502@N00,6069,21,1331273936,1331273936,1,1,0
70862502@N00,6070,14,1358163862,1358164221,2,1,359
70862502@N00,6071,16,1358346157,1358346157,1,2,0
70862502@N00,6071,14,1358345994,1358345994,1,2,0
70862502@N00,6072,27,1383952854,1383952854,1,2,0
70862502@N00,6072,21,1383951792,1383951792,1,2,0
70862502@N00,6073,21,1384071816,1384072315,2,3,499
70862502@N00,6073,13,1384077541,1384077541,1,3,0
70862502@N00,6073,16,1384078949,1384078949,1,3,0
70862502@N00,6074,27,1384289283,1384289283,1,1,0
70862502@N00,6075,27,1384456704,1384456704,1,1,0
70862502@N00,6076,13,1384592396,1384592396,1,2,0
70862502@N00,6076,16,1384587645,1384588720,2,2,1075
70926999@N00,6077,27,1406263864,1406263915,3,1,51
70926999@N00,6078,7,1406426060,1406426060,1,4,0
70926999@N00,6078,17,1406434801,1406434804,2,4,3
70926999@N00,6078,6,1406426155,1406426155,1,4,0
70926999@N00,6078,13,1406437524,1406437524,1,4,0
70926999@N00,6079,15,1406628168,1406633128,5,5,4960
70926999@N00,6079,12,1406632260,1406632260,1,5,0
70926999@N00,6079,17,1406628208,1406629432,3,5,1224
70926999@N00,6079,9,1406630247,1406630247,1,5,0
70926999@N00,6079,14,1406631213,1406631213,1,5,0
70926999@N00,6080,7,1406758519,1406758613,3,2,94
70926999@N00,6080,1,1406760420,1406760420,1,2,0
70926999@N00,6081,1,1406862740,1406862813,3,5,73
70926999@N00,6081,24,1406867720,1406867725,2,5,5
70926999@N00,6081,26,1406858704,1406858704,1,5,0
70926999@N00,6081,11,1406866031,1406866031,1,5,0
70926999@N00,6081,22,1406859260,1406859260,1,5,0
70928085@N00,6082,9,1214698303,1214698303,1,1,0
70928085@N00,6083,26,1224130738,1224130738,1,10,0
70928085@N00,6083,1,1224134975,1224134975,1,10,0
70928085@N00,6083,16,1224122006,1224159475,10,10,37469
70928085@N00,6083,22,1224148771,1224149524,28,10,753
70928085@N00,6083,11,1224119509,1224119538,2,10,29
70928085@N00,6083,13,1224154537,1224155581,4,10,1044
70928085@N00,6083,20,1224132945,1224132945,1,10,0
70928085@N00,6083,27,1224136831,1224137034,7,10,203
70928085@N00,6083,5,1224112238,1224112303,2,10,65
70928085@N00,6083,15,1224150188,1224153649,2,10,3461
70928085@N00,6084,2,1461227377,1461227377,1,2,0
70928085@N00,6084,14,1461236404,1461236404,1,2,0
70944869@N00,6085,27,1425722195,1425722195,1,1,0
70944869@N00,6086,5,1429343902,1429343902,1,2,0
70944869@N00,6086,4,1429313013,1429330604,6,2,17591
71061535@N00,6087,27,1339995256,1340012722,2,1,17466
71079304@N04,6088,20,1335547724,1335547724,1,2,0
71079304@N04,6088,19,1335547953,1335547953,1,2,0
71121295@N00,6089,3,1363039102,1363039102,1,1,0
71128153@N00,6090,25,1369899798,1369899798,1,2,0
71128153@N00,6090,12,1369899799,1369899799,1,2,0
71214537@N00,6091,8,1382342203,1382342203,1,1,0
71214537@N00,6092,10,1455244480,1455244824,2,2,344
71214537@N00,6092,9,1455247889,1455247889,1,2,0
71214537@N00,6093,10,1455360858,1455365198,2,1,4340
7128421@N05,6094,27,1447133195,1447133195,1,1,0
7128421@N05,6095,14,1463313509,1463313509,1,1,0
7141509@N02,6096,6,1323324574,1323324574,1,1,0
7151738@N03,6097,18,1353289340,1353289340,1,1,0
7151738@N03,6098,16,1390623432,1390623432,1,2,0
7151738@N03,6098,21,1390624919,1390624919,1,2,0
7151738@N03,6099,3,1393205950,1393212099,5,2,6149
7151738@N03,6099,14,1393194512,1393198049,4,2,3537
7151738@N03,6100,27,1396757355,1396757355,1,2,0
7151738@N03,6100,19,1396743908,1396743908,1,2,0
7151738@N03,6101,27,1412975721,1412975721,1,1,0
7151738@N03,6102,10,1415576039,1415576039,2,1,0
7151738@N03,6103,10,1421370172,1421378269,7,6,8097
7151738@N03,6103,12,1421376429,1421376776,2,6,347
7151738@N03,6103,16,1421369631,1421369631,1,6,0
7151738@N03,6103,14,1421369521,1421369521,1,6,0
7151738@N03,6103,27,1421383542,1421383542,1,6,0
7151738@N03,6103,9,1421385161,1421385161,1,6,0
7151738@N03,6104,11,1421451594,1421451600,2,8,6
7151738@N03,6104,10,1421456033,1421456387,2,8,354
7151738@N03,6104,8,1421454639,1421454639,1,8,0
7151738@N03,6104,14,1421482313,1421484131,8,8,1818
7151738@N03,6104,27,1421444782,1421444791,2,8,9
7151738@N03,6104,26,1421447793,1421447793,1,8,0
7151738@N03,6104,7,1421453945,1421453945,1,8,0
7151738@N03,6104,15,1421457567,1421457567,1,8,0
71577463@N02,6105,16,1363928629,1363928629,1,1,0
71665812@N00,6106,3,1365321891,1365321973,2,6,82
71665812@N00,6106,2,1365327224,1365327224,1,6,0
71665812@N00,6106,26,1365307822,1365334434,11,6,26612
71665812@N00,6106,9,1365302524,1365302524,1,6,0
71665812@N00,6106,15,1365300728,1365300728,1,6,0
71665812@N00,6106,5,1365319005,1365319005,1,6,0
71665812@N00,6107,3,1365748907,1365749038,5,4,131
71665812@N00,6107,24,1365730247,1365730437,2,4,190
71665812@N00,6107,10,1365733267,1365734312,7,4,1045
71665812@N00,6107,27,1365751461,1365751766,3,4,305
71680505@N05,6108,16,1266311590,1266311590,1,1,0
7168480@N02,6109,17,1391931612,1391931612,1,1,0
71722325@N00,6110,27,1426320628,1426320628,1,1,0
71745361@N06,6111,14,1188129418,1188129653,2,1,235
71752988@N08,6112,19,1384027911,1384027911,1,1,0
71778096@N00,6113,26,1240233090,1240234483,6,3,1393
71778096@N00,6113,14,1240220829,1240224263,3,3,3434
71778096@N00,6113,20,1240231876,1240231876,1,3,0
71814567@N02,6114,4,1297914988,1297915129,2,1,141
71922377@N00,6115,9,1350175418,1350175418,1,1,0
71922377@N00,6116,27,1391217572,1391217572,1,1,0
71922377@N00,6117,9,1412461214,1412461267,2,1,53
71922377@N00,6118,7,1470464023,1470464023,1,1,0
71965292@N00,6119,14,1213189174,1213189875,183,1,701
7197250@N06,6120,27,1368381523,1368381523,1,1,0
7197250@N06,6121,11,1368632344,1368632344,1,1,0
7197250@N06,6122,14,1368733136,1368733136,1,3,0
7197250@N06,6122,27,1368689337,1368725722,4,3,36385
7197250@N06,6122,11,1368689187,1368689187,1,3,0
7197250@N06,6123,24,1368814280,1368814280,1,2,0
7197250@N06,6123,27,1368823206,1368823206,1,2,0
7197250@N06,6124,27,1368856258,1368856258,1,2,0
7197250@N06,6124,17,1368855795,1368855795,1,2,0
7197250@N06,6125,16,1368903480,1368903480,1,3,0
7197250@N06,6125,14,1368911929,1368911929,1,3,0
7197250@N06,6125,27,1368911800,1368911800,1,3,0
7197250@N06,6126,14,1368950578,1368950578,1,2,0
7197250@N06,6126,27,1368950248,1368950248,1,2,0
7197250@N06,6127,27,1368985018,1368985018,1,1,0
7197250@N06,6128,27,1369036770,1369036770,1,1,0
7197250@N06,6129,22,1399038727,1399038727,1,1,0
7200488@N08,6130,8,1191420000,1191420000,1,1,0
72043907@N00,6131,6,1223892130,1223901465,3,1,9335
72048386@N00,6132,4,1200877184,1200877184,1,6,0
72048386@N00,6132,27,1200875894,1200875894,1,6,0
72048386@N00,6132,20,1200892631,1200892631,1,6,0
72048386@N00,6132,18,1200884177,1200884177,1,6,0
72048386@N00,6132,14,1200900574,1200900574,1,6,0
72048386@N00,6132,3,1200877092,1200877092,1,6,0
72048386@N00,6133,21,1204719358,1204719478,2,1,120
72048386@N00,6134,25,1204804669,1204804669,1,1,0
72069620@N00,6135,20,1273995863,1273995863,1,3,0
72069620@N00,6135,22,1273997187,1273997187,1,3,0
72069620@N00,6135,27,1273991291,1273991410,2,3,119
7206981@N03,6136,26,1244764447,1244771489,2,4,7042
7206981@N03,6136,14,1244766390,1244766426,3,4,36
7206981@N03,6136,18,1244765161,1244765251,2,4,90
7206981@N03,6136,16,1244770175,1244770175,1,4,0
7210398@N05,6137,2,1314372846,1314372846,1,1,0
72126458@N00,6138,25,1310969240,1310969837,17,5,597
72126458@N00,6138,16,1310982735,1310982735,1,5,0
72126458@N00,6138,17,1310987741,1310988813,41,5,1072
72126458@N00,6138,14,1310956832,1310991083,55,5,34251
72126458@N00,6138,24,1310971242,1310971822,9,5,580
72126458@N00,6139,2,1311164903,1311165010,10,4,107
72126458@N00,6139,19,1311169505,1311169537,5,4,32
72126458@N00,6139,3,1311165282,1311166101,6,4,819
72126458@N00,6139,16,1311167632,1311167632,1,4,0
72173566@N04,6140,6,1340687947,1340707394,3,2,19447
72173566@N04,6140,2,1340688136,1340688136,1,2,0
72173566@N04,6141,17,1341386397,1341386397,1,1,0
72256065@N07,6142,27,1366238597,1366238597,1,3,0
72256065@N07,6142,14,1366244974,1366244974,1,3,0
72256065@N07,6142,5,1366247636,1366247636,1,3,0
72256065@N07,6143,21,1366333205,1366333205,1,2,0
72256065@N07,6143,16,1366356972,1366357226,2,2,254
72312878@N00,6144,27,1334457215,1334457215,1,1,0
72324747@N00,6145,16,1286934708,1286934708,1,3,0
72324747@N00,6145,27,1286950619,1286950619,1,3,0
72324747@N00,6145,21,1286943838,1286943838,1,3,0
72324747@N00,6146,14,1287366569,1287366569,1,3,0
72324747@N00,6146,19,1287371174,1287371174,1,3,0
72324747@N00,6146,22,1287376999,1287376999,1,3,0
72324747@N00,6147,27,1288315296,1288315296,1,1,0
72324747@N00,6148,5,1288478757,1288478757,1,1,0
72324747@N00,6149,27,1288690659,1288690659,1,1,0
72408746@N08,6150,27,1384215600,1384215600,1,1,0
7256184@N02,6151,16,1228787475,1228814583,15,4,27108
7256184@N02,6151,27,1228786565,1228786691,4,4,126
7256184@N02,6151,21,1228806621,1228806621,1,4,0
7256184@N02,6151,14,1228790173,1228795978,7,4,5805
7256184@N02,6152,16,1228890002,1228903252,2,1,13250
7256184@N02,6153,11,1229049392,1229055097,13,1,5705
7256454@N05,6154,21,1214266971,1214267658,20,1,687
7256454@N05,6155,16,1214607130,1214607166,2,1,36
7256454@N05,6156,22,1214787203,1214795370,11,8,8167
7256454@N05,6156,19,1214800595,1214800740,13,8,145
7256454@N05,6156,20,1214786936,1214786939,4,8,3
7256454@N05,6156,27,1214786209,1214786484,6,8,275
7256454@N05,6156,17,1214799344,1214803106,38,8,3762
7256454@N05,6156,23,1214788403,1214788900,8,8,497
7256454@N05,6156,18,1214799867,1214801536,14,8,1669
7256454@N05,6156,25,1214791811,1214794193,4,8,2382
7256454@N05,6157,21,1239719157,1239719564,10,1,407
7256454@N05,6158,16,1244972390,1244983476,8,1,11086
7256454@N05,6159,16,1245411711,1245411711,1,1,0
7256454@N05,6160,6,1279707902,1279708010,7,1,108
7256454@N05,6161,14,1288346099,1288346099,1,2,0
7256454@N05,6161,12,1288348340,1288348353,2,2,13
7256454@N05,6162,17,1352513564,1352516467,13,2,2903
7256454@N05,6162,27,1352504638,1352505027,7,2,389
72589879@N00,6163,5,1291460336,1291460336,1,2,0
72589879@N00,6163,4,1291460085,1291460085,1,2,0
72589879@N00,6164,18,1348901870,1348902204,2,2,334
72589879@N00,6164,4,1348912650,1348912650,1,2,0
72640719@N07,6165,9,1431755006,1431755006,1,1,0
72655656@N00,6166,16,1409904400,1409904400,1,1,0
72670227@N06,6167,8,1429253384,1429253384,1,3,0
72670227@N06,6167,27,1429238186,1429239076,14,3,890
72670227@N06,6167,9,1429241627,1429248950,40,3,7323
72685908@N00,6168,16,1380432748,1380432748,1,4,0
72685908@N00,6168,3,1380435079,1380435079,1,4,0
72685908@N00,6168,27,1380427934,1380427934,1,4,0
72685908@N00,6168,13,1380432641,1380432641,1,4,0
72685908@N00,6169,10,1380544778,1380544778,1,2,0
72685908@N00,6169,14,1380545002,1380545002,1,2,0
72776097@N00,6170,9,1205972966,1205972966,1,1,0
72844756@N00,6171,16,1249802486,1249802486,1,1,0
7287512@N02,6172,24,1270346193,1270346193,1,10,0
7287512@N02,6172,12,1270362290,1270362290,1,10,0
7287512@N02,6172,18,1270369706,1270369706,1,10,0
7287512@N02,6172,7,1270354628,1270354628,1,10,0
7287512@N02,6172,4,1270339843,1270339843,1,10,0
7287512@N02,6172,23,1270348238,1270348238,1,10,0
7287512@N02,6172,27,1270338745,1270339313,6,10,568
7287512@N02,6172,8,1270354762,1270354762,1,10,0
7287512@N02,6172,25,1270344715,1270348369,5,10,3654
7287512@N02,6172,11,1270358704,1270358872,4,10,168
7293619@N07,6173,6,1329785455,1329785455,1,5,0
7293619@N07,6173,20,1329802842,1329802842,1,5,0
7293619@N07,6173,14,1329796745,1329796745,1,5,0
7293619@N07,6173,16,1329809384,1329809384,1,5,0
7293619@N07,6173,27,1329776764,1329777989,2,5,1225
72949871@N00,6174,14,1301965145,1301965145,1,1,0
72949871@N00,6175,9,1302002827,1302002827,1,2,0
72949871@N00,6175,21,1302002840,1302002840,1,2,0
72949871@N00,6176,14,1302214764,1302214764,1,1,0
72977144@N00,6177,27,1380878365,1380878365,1,1,0
73055057@N00,6178,2,1323490228,1323490228,1,1,0
7305851@N07,6179,27,1206938907,1206938907,1,4,0
7305851@N07,6179,4,1206940069,1206940069,1,4,0
7305851@N07,6179,18,1206946563,1206946563,1,4,0
7305851@N07,6179,17,1206945158,1206945158,1,4,0
7305851@N07,6180,19,1207359039,1207359039,1,1,0
7305851@N07,6181,14,1353477379,1353477379,1,3,0
7305851@N07,6181,10,1353470409,1353477516,2,3,7107
7305851@N07,6181,18,1353479930,1353479930,1,3,0
73059826@N00,6182,10,1403943605,1403943605,1,1,0
73105116@N00,6183,20,1210860006,1210860006,1,1,0
73105116@N00,6184,26,1210946402,1210946402,1,4,0
73105116@N00,6184,3,1210946404,1210946404,1,4,0
73105116@N00,6184,20,1210946403,1210946403,1,4,0
73105116@N00,6184,9,1210946400,1210946401,2,4,1
73105116@N00,6185,21,1211032800,1211032800,1,1,0
73105116@N00,6186,18,1242707760,1242707760,1,1,0
73105116@N00,6187,18,1242767893,1242767893,1,2,0
73105116@N00,6187,9,1242771896,1242773240,2,2,1344
73105116@N00,6188,27,1242870832,1242870832,1,1,0
73105116@N00,6189,17,1273884247,1273884247,1,1,0
73105116@N00,6190,20,1273955453,1273955453,1,3,0
73105116@N00,6190,27,1273952762,1273952762,1,3,0
73105116@N00,6190,22,1273955329,1273955734,2,3,405
73114641@N00,6191,21,1329645524,1329645524,1,1,0
73114641@N00,6192,14,1359263590,1359270701,9,1,7111
73114641@N00,6193,27,1452399164,1452414463,11,1,15299
73114641@N00,6194,27,1452574589,1452574589,1,1,0
73122205@N07,6195,17,1363507880,1363507880,1,1,0
73122205@N07,6196,4,1363947529,1363947529,1,1,0
73181922@N00,6197,27,1227154792,1227155030,2,1,238
73260031@N05,6198,4,1388124164,1388124164,1,1,0
73265016@N00,6199,3,1207621039,1207621114,2,8,75
73265016@N00,6199,2,1207616519,1207616519,1,8,0
73265016@N00,6199,6,1207615254,1207633562,3,8,18308
73265016@N00,6199,12,1207612747,1207612747,1,8,0
73265016@N00,6199,24,1207623396,1207623396,1,8,0
73265016@N00,6199,8,1207631752,1207631752,1,8,0
73265016@N00,6199,16,1207653129,1207653129,1,8,0
73265016@N00,6199,14,1207619573,1207619573,1,8,0
7327560@N06,6200,7,1231745643,1231745643,1,2,0
7327560@N06,6200,27,1231726645,1231726645,1,2,0
7327560@N06,6201,22,1231986763,1231986763,1,2,0
7327560@N06,6201,24,1231982330,1231982330,1,2,0
7327560@N06,6202,22,1232720595,1232720595,1,1,0
73281647@N03,6203,9,1421407960,1421407960,1,5,0
73281647@N03,6203,27,1421412998,1421413007,2,5,9
73281647@N03,6203,22,1421409639,1421409639,1,5,0
73281647@N03,6203,2,1421389586,1421391252,2,5,1666
73281647@N03,6203,26,1421380280,1421380280,1,5,0
73287343@N03,6204,16,1360204709,1360204897,2,4,188
73287343@N03,6204,15,1360205643,1360205643,1,4,0
73287343@N03,6204,27,1360195700,1360195831,4,4,131
73287343@N03,6204,7,1360203900,1360203900,1,4,0
7334692@N04,6205,16,1329201072,1329201072,1,1,0
73366745@N02,6206,3,1321351800,1321351800,1,1,0
73376948@N00,6207,25,1423275072,1423275072,1,3,0
73376948@N00,6207,20,1423277442,1423277442,1,3,0
73376948@N00,6207,23,1423275558,1423275558,1,3,0
73389359@N07,6208,27,1427625180,1427625180,1,1,0
73427821@N00,6209,23,1257747237,1257747561,10,7,324
73427821@N00,6209,11,1257730171,1257733544,13,7,3373
73427821@N00,6209,27,1257724838,1257725689,10,7,851
73427821@N00,6209,14,1257734816,1257745109,4,7,10293
73427821@N00,6209,7,1257728431,1257728522,8,7,91
73427821@N00,6209,17,1257727039,1257727076,5,7,37
73427821@N00,6209,8,1257728931,1257729216,7,7,285
73427821@N00,6210,18,1257925176,1257925176,1,2,0
73427821@N00,6210,7,1257907580,1257907599,3,2,19
73427821@N00,6211,14,1273626132,1273626143,4,5,11
73427821@N00,6211,9,1273622629,1273623130,7,5,501
73427821@N00,6211,17,1273630816,1273631488,24,5,672
73427821@N00,6211,16,1273618734,1273626070,14,5,7336
73427821@N00,6211,7,1273622259,1273639583,11,5,17324
73427821@N00,6212,4,1317512393,1317515291,7,1,2898
73427821@N00,6213,17,1345943238,1345943292,4,2,54
73427821@N00,6213,20,1345959941,1345959968,3,2,27
73427821@N00,6214,14,1346036664,1346036685,5,2,21
73427821@N00,6214,4,1346039252,1346039255,3,2,3
73427821@N00,6215,14,1352530638,1352540864,18,3,10226
73427821@N00,6215,6,1352528657,1352528716,10,3,59
73427821@N00,6215,9,1352525653,1352540703,40,3,15050
73427821@N00,6216,9,1352962398,1352962587,14,1,189
73451901@N00,6217,15,1244098010,1244098010,1,3,0
73451901@N00,6217,6,1244092575,1244092575,1,3,0
73451901@N00,6217,9,1244092220,1244092220,1,3,0
73451901@N00,6218,9,1300705505,1300705683,9,2,178
73451901@N00,6218,14,1300705353,1300705353,1,2,0
7349370@N04,6219,27,1241848014,1241848914,2,11,900
7349370@N04,6219,21,1241854527,1241854527,1,11,0
7349370@N04,6219,11,1241861363,1241861363,1,11,0
7349370@N04,6219,4,1241865205,1241865205,1,11,0
7349370@N04,6219,24,1241852652,1241852652,1,11,0
7349370@N04,6219,13,1241857116,1241857309,3,11,193
7349370@N04,6219,19,1241855730,1241855883,2,11,153
7349370@N04,6219,3,1241867843,1241868841,9,11,998
7349370@N04,6219,20,1241856235,1241856302,2,11,67
7349370@N04,6219,7,1241860839,1241860839,1,11,0
7349370@N04,6219,16,1241865290,1241865357,2,11,67
7349370@N04,6220,17,1242270849,1242274262,8,5,3413
7349370@N04,6220,19,1242265901,1242269541,5,5,3640
7349370@N04,6220,22,1242269891,1242269929,2,5,38
7349370@N04,6220,18,1242266389,1242266700,6,5,311
7349370@N04,6220,27,1242257402,1242278750,9,5,21348
7349370@N04,6221,17,1260580094,1260580094,1,6,0
7349370@N04,6221,9,1260582188,1260582188,1,6,0
7349370@N04,6221,4,1260586874,1260586885,2,6,11
7349370@N04,6221,24,1260571456,1260571456,1,6,0
7349370@N04,6221,16,1260581998,1260581998,1,6,0
7349370@N04,6221,27,1260565435,1260565435,1,6,0
7349370@N04,6222,27,1286506616,1286506616,1,1,0
7349370@N04,6223,12,1289188036,1289188036,1,11,0
7349370@N04,6223,17,1289187885,1289187943,3,11,58
7349370@N04,6223,22,1289187797,1289187797,1,11,0
7349370@N04,6223,13,1289187686,1289187686,1,11,0
7349370@N04,6223,9,1289187815,1289187815,1,11,0
7349370@N04,6223,16,1289185695,1289188860,28,11,3165
7349370@N04,6223,21,1289187414,1289187661,5,11,247
7349370@N04,6223,27,1289183594,1289202298,23,11,18704
7349370@N04,6223,14,1289186592,1289188095,12,11,1503
7349370@N04,6223,23,1289187198,1289187348,4,11,150
7349370@N04,6223,24,1289187293,1289187393,4,11,100
7356139@N05,6224,13,1361802530,1361802530,1,1,0
7356405@N05,6225,16,1213348901,1213349221,4,1,320
7356405@N05,6226,16,1213489377,1213489438,2,1,61
7356405@N05,6227,16,1213586990,1213586990,1,1,0
7356405@N05,6228,27,1213916746,1213916807,7,2,61
7356405@N05,6228,16,1213916760,1213920008,2,2,3248
7356405@N05,6229,16,1214132640,1214133161,7,1,521
7356405@N05,6230,9,1228538889,1228538889,1,1,0
7357708@N03,6231,27,1320215347,1320215347,1,1,0
7357708@N03,6232,16,1320411600,1320411600,1,1,0
73626640@N00,6233,17,1200307063,1200316844,2,3,9781
73626640@N00,6233,14,1200304368,1200312885,4,3,8517
73626640@N00,6233,27,1200303387,1200319755,3,3,16368
7366969@N02,6234,27,1335912695,1335913136,7,3,441
7366969@N02,6234,9,1335915659,1335918826,4,3,3167
7366969@N02,6234,2,1335931705,1335931705,1,3,0
7366969@N02,6235,16,1336213996,1336217557,11,1,3561
7366969@N02,6236,7,1391557261,1391557425,4,9,164
7366969@N02,6236,16,1391563097,1391563624,20,9,527
7366969@N02,6236,6,1391558283,1391558488,3,9,205
7366969@N02,6236,27,1391580162,1391580172,2,9,10
7366969@N02,6236,23,1391575549,1391575762,3,9,213
7366969@N02,6236,13,1391561821,1391562307,3,9,486
7366969@N02,6236,18,1391561130,1391561263,3,9,133
7366969@N02,6236,20,1391578267,1391578409,10,9,142
7366969@N02,6236,24,1391575736,1391575736,1,9,0
7366969@N02,6237,15,1391836561,1391845094,23,3,8533
7366969@N02,6237,9,1391832257,1391832285,2,3,28
7366969@N02,6237,21,1391849271,1391850934,2,3,1663
7366969@N02,6238,7,1392184550,1392184550,1,2,0
7366969@N02,6238,6,1392184440,1392184440,1,2,0
7366969@N02,6239,7,1392338491,1392340064,6,7,1573
7366969@N02,6239,27,1392333606,1392346500,15,7,12894
7366969@N02,6239,1,1392334575,1392334575,1,7,0
7366969@N02,6239,9,1392338256,1392338268,2,7,12
7366969@N02,6239,18,1392335149,1392335149,1,7,0
7366969@N02,6239,12,1392335623,1392336408,6,7,785
7366969@N02,6239,16,1392334425,1392344486,7,7,10061
7366969@N02,6240,27,1392376020,1392376066,3,1,46
7366969@N02,6241,16,1392538385,1392538385,1,4,0
7366969@N02,6241,4,1392544218,1392544218,1,4,0
7366969@N02,6241,27,1392544924,1392546051,16,4,1127
7366969@N02,6241,21,1392539469,1392539712,2,4,243
7367216@N05,6242,20,1218844067,1218845174,3,1,1107
7367216@N05,6243,27,1239068244,1239068244,1,1,0
7367216@N05,6244,27,1239159349,1239159706,6,1,357
7367216@N05,6245,27,1341351301,1341352124,4,3,823
7367216@N05,6245,22,1341357334,1341359823,5,3,2489
7367216@N05,6245,18,1341361865,1341362701,15,3,836
7367216@N05,6246,7,1341399716,1341403276,5,1,3560
7367216@N05,6247,27,1341720935,1341721468,6,2,533
7367216@N05,6247,1,1341711025,1341718932,4,2,7907
7367216@N05,6248,14,1348560685,1348560751,2,4,66
7367216@N05,6248,13,1348569616,1348569628,2,4,12
7367216@N05,6248,17,1348556960,1348577509,3,4,20549
7367216@N05,6248,10,1348560955,1348560955,1,4,0
7367216@N05,6249,27,1348613026,1348613056,2,6,30
7367216@N05,6249,18,1348614784,1348614800,2,6,16
7367216@N05,6249,13,1348614488,1348614517,3,6,29
7367216@N05,6249,14,1348624716,1348630415,29,6,5699
7367216@N05,6249,11,1348618159,1348618159,1,6,0
7367216@N05,6249,22,1348621431,1348621431,1,6,0
7367216@N05,6250,14,1351204175,1351204224,2,3,49
7367216@N05,6250,27,1351203797,1351203966,2,3,169
7367216@N05,6250,13,1351203726,1351203726,1,3,0
73783753@N00,6251,27,1260594990,1260594990,1,2,0
73783753@N00,6251,17,1260593382,1260594507,4,2,1125
73783753@N00,6252,27,1283663464,1283666370,36,1,2906
73783753@N00,6253,27,1292044984,1292044984,1,1,0
73799444@N00,6254,20,1197829970,1197829970,1,1,0
73802184@N00,6255,26,1297744544,1297746859,3,2,2315
73802184@N00,6255,17,1297746847,1297746847,1,2,0
73813555@N00,6256,14,1236379728,1236383000,6,4,3272
73813555@N00,6256,24,1236388845,1236389080,3,4,235
73813555@N00,6256,17,1236402806,1236402806,1,4,0
73813555@N00,6256,19,1236379058,1236379182,5,4,124
73825591@N00,6257,23,1357280518,1357280518,1,1,0
7383636@N06,6258,12,1272862287,1272862287,1,4,0
7383636@N06,6258,27,1272843984,1272844535,3,4,551
7383636@N06,6258,20,1272855017,1272855017,1,4,0
7383636@N06,6258,5,1272876142,1272876142,1,4,0
7383636@N06,6259,27,1396050577,1396076215,4,2,25638
7383636@N06,6259,9,1396045192,1396046081,4,2,889
7383636@N06,6260,7,1416797896,1416797896,1,5,0
7383636@N06,6260,15,1416799845,1416799845,1,5,0
7383636@N06,6260,13,1416800079,1416800102,2,5,23
7383636@N06,6260,27,1416793923,1416794500,3,5,577
7383636@N06,6260,17,1416802295,1416806018,10,5,3723
7383636@N06,6261,27,1420859561,1420859561,1,2,0
7383636@N06,6261,4,1420860536,1420860553,2,2,17
7383636@N06,6262,27,1420929084,1420929084,1,3,0
7383636@N06,6262,2,1420935115,1420935115,1,3,0
7383636@N06,6262,16,1420922031,1420922031,1,3,0
7383636@N06,6263,22,1443067707,1443067974,2,1,267
7383636@N06,6264,27,1464304340,1464305228,3,12,888
7383636@N06,6264,23,1464320434,1464320477,2,12,43
7383636@N06,6264,7,1464307523,1464307523,1,12,0
7383636@N06,6264,17,1464314281,1464314281,1,12,0
7383636@N06,6264,11,1464307567,1464307567,1,12,0
7383636@N06,6264,10,1464310294,1464310294,1,12,0
7383636@N06,6264,20,1464319258,1464319258,1,12,0
7383636@N06,6264,8,1464307778,1464308135,5,12,357
7383636@N06,6264,6,1464306586,1464306870,2,12,284
7383636@N06,6264,2,1464306761,1464306761,1,12,0
7383636@N06,6264,9,1464307401,1464307401,1,12,0
7383636@N06,6264,14,1464311655,1464311674,3,12,19
73850513@N02,6265,17,1378579570,1378579652,2,2,82
73850513@N02,6265,27,1378565133,1378579943,7,2,14810
7387139@N03,6266,9,1306316537,1306316561,3,2,24
7387139@N03,6266,23,1306310507,1306310507,3,2,0
7397829@N06,6267,16,1228627490,1228627490,1,1,0
74051711@N00,6268,27,1193835600,1193835600,8,1,0
74089168@N00,6269,2,1382508388,1382508388,1,5,0
74089168@N00,6269,8,1382525970,1382525970,1,5,0
74089168@N00,6269,27,1382527550,1382527550,1,5,0
74089168@N00,6269,17,1382517893,1382517893,1,5,0
74089168@N00,6269,16,1382526865,1382526865,1,5,0
74101007@N00,6270,8,1356158137,1356158137,1,11,0
74101007@N00,6270,2,1356165004,1356165964,13,11,960
74101007@N00,6270,27,1356155198,1356155296,2,11,98
74101007@N00,6270,9,1356157849,1356169694,3,11,11845
74101007@N00,6270,10,1356158757,1356158984,2,11,227
74101007@N00,6270,16,1356163921,1356163921,1,11,0
74101007@N00,6270,11,1356158181,1356158181,1,11,0
74101007@N00,6270,14,1356159462,1356163604,8,11,4142
74101007@N00,6270,7,1356157958,1356157988,2,11,30
74101007@N00,6270,4,1356164592,1356164592,1,11,0
74101007@N00,6270,5,1356177249,1356177249,1,11,0
74111533@N00,6271,20,1286327058,1286329628,2,2,2570
74111533@N00,6271,27,1286336997,1286336997,1,2,0
7416177@N04,6272,14,1293531279,1293537889,9,1,6610
7416177@N04,6273,14,1293566779,1293575622,3,1,8843
7416177@N04,6274,16,1293611671,1293611671,1,1,0
7416177@N04,6275,22,1293843841,1293844249,3,3,408
7416177@N04,6275,16,1293829033,1293829033,1,3,0
7416177@N04,6275,14,1293821715,1293861099,25,3,39384
74221923@N02,6276,27,1397619382,1397619382,1,1,0
74227781@N00,6277,3,1359867690,1359867690,1,4,0
74227781@N00,6277,4,1359867910,1359867910,1,4,0
74227781@N00,6277,6,1359862569,1359864419,2,4,1850
74227781@N00,6277,8,1359861603,1359861603,1,4,0
74246558@N00,6278,15,1468035437,1468035437,1,1,0
74285955@N00,6279,9,1230168192,1230168192,1,1,0
74285955@N00,6280,18,1320363125,1320388285,2,1,25160
74289372@N00,6281,16,1318906656,1318906656,1,5,0
74289372@N00,6281,15,1318905105,1318905105,1,5,0
74289372@N00,6281,17,1318905106,1318905106,1,5,0
74289372@N00,6281,3,1318910365,1318912089,4,5,1724
74289372@N00,6281,1,1318908364,1318908364,1,5,0
74324897@N06,6282,20,1256116720,1256116720,1,1,0
74366817@N06,6283,27,1386855518,1386855518,1,1,0
74366817@N06,6284,26,1387599302,1387599302,1,2,0
74366817@N06,6284,13,1387627187,1387627187,1,2,0
74366817@N06,6285,13,1388810663,1388811090,2,1,427
74366817@N06,6286,13,1389415128,1389415128,1,2,0
74366817@N06,6286,21,1389394143,1389394143,1,2,0
74366817@N06,6287,2,1391300755,1391300755,1,1,0
74366817@N06,6288,20,1393050869,1393050990,2,2,121
74366817@N06,6288,19,1393051439,1393051590,2,2,151
74366817@N06,6289,13,1399191269,1399191269,1,1,0
74372164@N04,6290,13,1352154835,1352155697,2,9,862
74372164@N04,6290,19,1352156927,1352156927,1,9,0
74372164@N04,6290,17,1352152992,1352156907,2,9,3915
74372164@N04,6290,16,1352188509,1352195848,2,9,7339
74372164@N04,6290,21,1352152838,1352194843,9,9,42005
74372164@N04,6290,9,1352182229,1352182229,1,9,0
74372164@N04,6290,10,1352180712,1352182184,3,9,1472
74372164@N04,6290,3,1352194993,1352194993,1,9,0
74372164@N04,6290,25,1352157981,1352157981,1,9,0
74372164@N04,6291,21,1363860409,1363860409,1,1,0
74382902@N00,6292,19,1334737450,1334737450,1,3,0
74382902@N00,6292,2,1334724867,1334724867,1,3,0
74382902@N00,6292,7,1334728448,1334728448,1,3,0
74417388@N08,6293,1,1361948136,1361948136,1,1,0
74417388@N08,6294,27,1380007896,1380007896,1,1,0
74434146@N04,6295,9,1329611607,1329612390,2,2,783
74434146@N04,6295,14,1329616355,1329616355,1,2,0
74461555@N05,6296,23,1326682238,1326682238,1,1,0
74461555@N05,6297,14,1330653237,1330658614,2,3,5377
74461555@N05,6297,12,1330653314,1330653413,2,3,99
74461555@N05,6297,20,1330660987,1330660987,1,3,0
74461555@N05,6298,21,1330820762,1330820762,1,2,0
74461555@N05,6298,13,1330824256,1330825021,4,2,765
74461555@N05,6299,15,1336008782,1336008782,1,1,0
74461555@N05,6300,27,1352756413,1352763836,2,6,7423
74461555@N05,6300,17,1352757695,1352758920,20,6,1225
74461555@N05,6300,19,1352761771,1352761854,5,6,83
74461555@N05,6300,21,1352762954,1352762954,1,6,0
74461555@N05,6300,23,1352763350,1352763470,2,6,120
74461555@N05,6300,16,1352759758,1352759758,1,6,0
74461555@N05,6301,27,1352798082,1352807371,9,9,9289
74461555@N05,6301,20,1352805682,1352806155,2,9,473
74461555@N05,6301,17,1352800049,1352804136,2,9,4087
74461555@N05,6301,18,1352804757,1352804757,2,9,0
74461555@N05,6301,8,1352803480,1352803480,2,9,0
74461555@N05,6301,22,1352805143,1352805230,2,9,87
74461555@N05,6301,7,1352803863,1352803863,1,9,0
74461555@N05,6301,4,1352802625,1352803149,3,9,524
74461555@N05,6301,16,1352803991,1352803991,2,9,0
74461555@N05,6302,18,1360286835,1360288946,6,2,2111
74461555@N05,6302,7,1360284404,1360284588,2,2,184
74461555@N05,6303,2,1360321550,1360321907,2,2,357
74461555@N05,6303,7,1360320747,1360320747,1,2,0
74461555@N05,6304,22,1375491753,1375495745,3,3,3992
74461555@N05,6304,13,1375490829,1375490829,1,3,0
74461555@N05,6304,12,1375490977,1375490977,1,3,0
74476774@N00,6305,27,1382364117,1382385555,2,1,21438
7450381@N05,6306,27,1414920825,1414920825,1,2,0
7450381@N05,6306,18,1414901752,1414901752,1,2,0
7450381@N05,6307,2,1415072317,1415072317,1,1,0
7451382@N03,6308,8,1393980749,1393980749,2,3,0
7451382@N03,6308,7,1393979599,1393979599,1,3,0
7451382@N03,6308,21,1394004390,1394004390,1,3,0
74571557@N07,6309,17,1333009456,1333009456,1,2,0
74571557@N07,6309,16,1333015016,1333019421,2,2,4405
74571557@N07,6310,16,1333863966,1333863966,1,1,0
74712199@N00,6311,1,1334814715,1334814715,1,2,0
74712199@N00,6311,16,1334831059,1334831059,1,2,0
74712199@N00,6312,20,1428632214,1428632214,1,4,0
74712199@N00,6312,9,1428646337,1428646337,1,4,0
74712199@N00,6312,23,1428627569,1428627569,1,4,0
74712199@N00,6312,14,1428643686,1428643686,1,4,0
7472274@N05,6313,6,1245627647,1245628052,4,5,405
7472274@N05,6313,2,1245626639,1245626639,1,5,0
7472274@N05,6313,11,1245629891,1245629891,1,5,0
7472274@N05,6313,3,1245626216,1245626216,1,5,0
7472274@N05,6313,20,1245636580,1245636612,2,5,32
74762807@N00,6314,2,1438235296,1438235316,2,5,20
74762807@N00,6314,14,1438225944,1438258658,6,5,32714
74762807@N00,6314,17,1438255392,1438255783,4,5,391
74762807@N00,6314,22,1438249656,1438250286,2,5,630
74762807@N00,6314,7,1438232446,1438232446,1,5,0
74865359@N00,6315,27,1386814631,1386825280,11,1,10649
74865359@N00,6316,12,1391651784,1391651853,3,1,69
74865359@N00,6317,27,1412033030,1412033030,1,2,0
74865359@N00,6317,2,1412035755,1412035755,1,2,0
74865359@N00,6318,27,1425290730,1425291608,12,1,878
74875454@N00,6319,6,1241074722,1241074722,1,1,0
74875454@N00,6320,6,1241224674,1241224674,1,1,0
7490466@N08,6321,16,1298713689,1298713689,1,2,0
7490466@N08,6321,22,1298715922,1298715990,3,2,68
74985978@N00,6322,27,1353402139,1353402139,1,1,0
7503886@N06,6323,2,1399975890,1399975893,2,4,3
7503886@N06,6323,3,1399974728,1399974804,2,4,76
7503886@N06,6323,10,1399968831,1399968831,1,4,0
7503886@N06,6323,9,1399968898,1399968898,1,4,0
7504153@N07,6324,27,1371951919,1371951919,1,1,0
7504153@N07,6325,27,1390444660,1390444660,1,1,0
75070889@N07,6326,16,1372133322,1372133322,1,1,0
75113045@N07,6327,27,1380880241,1380880241,1,1,0
75122326@N00,6328,16,1258687089,1258687089,1,1,0
75122326@N00,6329,6,1258868104,1258868104,1,4,0
75122326@N00,6329,5,1258856345,1258856345,1,4,0
75122326@N00,6329,9,1258866754,1258866754,1,4,0
75122326@N00,6329,16,1258867820,1258867820,1,4,0
75132636@N00,6330,4,1228279479,1228291892,10,1,12413
75132636@N00,6331,27,1228354339,1228354355,3,1,16
7527751@N05,6332,1,1290249744,1290249744,1,1,0
75296851@N06,6333,16,1326628114,1326628799,4,2,685
75296851@N06,6333,2,1326631435,1326631435,1,2,0
75316711@N00,6334,4,1365249517,1365284513,16,1,34996
75316711@N00,6335,4,1365337805,1365348512,20,1,10707
75316711@N00,6336,4,1365398294,1365448943,20,1,50649
75316711@N00,6337,4,1365508662,1365539731,32,1,31069
75316711@N00,6338,4,1365597391,1365597391,1,1,0
75316711@N00,6339,4,1365684770,1365705824,28,1,21054
75316711@N00,6340,4,1365770901,1365812134,49,1,41233
75316711@N00,6341,4,1365939507,1365964737,54,1,25230
75316711@N00,6342,4,1366034027,1366061197,18,1,27170
75316711@N00,6343,4,1367828644,1367828644,1,1,0
75321142@N00,6344,27,1247090226,1247090322,2,1,96
75321142@N00,6345,16,1247233888,1247240905,2,1,7017
75321142@N00,6346,16,1247411328,1247411328,1,2,0
75321142@N00,6346,20,1247409052,1247409089,2,2,37
75321142@N00,6347,16,1247542503,1247542668,2,2,165
75321142@N00,6347,11,1247544019,1247544019,1,2,0
75338025@N07,6348,20,1383521803,1383522585,5,15,782
75338025@N07,6348,27,1383520404,1383561277,8,15,40873
75338025@N07,6348,24,1383521297,1383521299,2,15,2
75338025@N07,6348,18,1383524189,1383524197,2,15,8
75338025@N07,6348,4,1383533956,1383533956,1,15,0
75338025@N07,6348,19,1383522352,1383522432,4,15,80
75338025@N07,6348,25,1383520751,1383520751,1,15,0
75338025@N07,6348,17,1383524130,1383527238,4,15,3108
75338025@N07,6348,23,1383520861,1383520861,1,15,0
75338025@N07,6348,13,1383524166,1383526552,5,15,2386
75338025@N07,6348,15,1383525045,1383527366,9,15,2321
75338025@N07,6348,22,1383523853,1383523859,2,15,6
75338025@N07,6348,2,1383533215,1383533215,1,15,0
75338025@N07,6348,10,1383528093,1383528209,4,15,116
75338025@N07,6348,12,1383526302,1383526754,12,15,452
7548090@N03,6349,17,1352372566,1352372652,2,1,86
75515006@N00,6350,11,1208442051,1208446235,5,1,4184
75601845@N06,6351,22,1209986793,1209993684,29,1,6891
75601845@N06,6352,22,1210139676,1210150565,8,1,10889
75601845@N06,6353,22,1210183152,1210186773,6,1,3621
75601845@N06,6354,22,1210345228,1210354574,63,1,9346
75601845@N06,6355,22,1231978390,1231978390,1,1,0
75601845@N06,6356,22,1283417764,1283427961,89,1,10197
75601845@N06,6357,22,1283615455,1283624059,79,1,8604
75601845@N06,6358,22,1284007999,1284018722,284,1,10723
75601845@N06,6359,22,1284047819,1284058218,163,1,10399
75601845@N06,6360,22,1284097768,1284125500,545,1,27732
75601845@N06,6361,22,1284377732,1284398049,72,1,20317
75601845@N06,6362,22,1284468048,1284496203,577,1,28155
75601845@N06,6363,22,1322730995,1322753464,282,1,22469
75601845@N06,6364,22,1322826862,1322853643,194,1,26781
75601845@N06,6365,22,1323267552,1323286458,209,1,18906
75601845@N06,6366,22,1323521214,1323544977,131,1,23763
75601845@N06,6367,22,1323662284,1323704556,80,1,42272
75601845@N06,6368,22,1323793146,1323802606,25,1,9460
75601845@N06,6369,22,1323835939,1323853604,141,1,17665
75601845@N06,6370,22,1323929871,1323937770,53,1,7899
75671401@N08,6371,16,1325298050,1325298050,1,1,0
75722661@N00,6372,16,1302266843,1302266843,1,1,0
75736915@N00,6373,9,1332719886,1332719886,1,4,0
75736915@N00,6373,14,1332719790,1332719790,1,4,0
75736915@N00,6373,21,1332713282,1332740571,3,4,27289
75736915@N00,6373,27,1332712520,1332743551,2,4,31031
7573710@N02,6374,15,1233344078,1233344860,6,1,782
75742976@N05,6375,20,1289096348,1289096457,2,3,109
75742976@N05,6375,21,1289094831,1289094831,1,3,0
75742976@N05,6375,15,1289101278,1289101278,1,3,0
75742976@N05,6376,16,1326000043,1326000043,1,1,0
75742976@N05,6377,10,1353715511,1353715511,1,2,0
75742976@N05,6377,27,1353711504,1353711504,1,2,0
75742976@N05,6378,22,1362804741,1362804741,1,3,0
75742976@N05,6378,13,1362810887,1362810887,1,3,0
75742976@N05,6378,17,1362808340,1362808384,2,3,44
75742976@N05,6379,27,1365860451,1365860451,1,1,0
75742976@N05,6380,13,1367649091,1367649091,1,2,0
75742976@N05,6380,19,1367647312,1367647312,1,2,0
75742976@N05,6381,4,1368878404,1368878404,1,1,0
75742976@N05,6382,26,1369386961,1369386961,1,4,0
75742976@N05,6382,19,1369362887,1369362925,2,4,38
75742976@N05,6382,8,1369346463,1369346497,2,4,34
75742976@N05,6382,4,1369375468,1369375468,1,4,0
75825285@N05,6383,27,1428453682,1428480244,3,1,26562
75825285@N05,6384,15,1460527126,1460527126,1,4,0
75825285@N05,6384,4,1460541699,1460541707,2,4,8
75825285@N05,6384,21,1460530526,1460531960,8,4,1434
75825285@N05,6384,27,1460522987,1460522987,1,4,0
75871529@N02,6385,26,1330488735,1330488735,1,5,0
75871529@N02,6385,4,1330486119,1330491996,2,5,5877
75871529@N02,6385,16,1330491873,1330494034,2,5,2161
75871529@N02,6385,12,1330484504,1330484855,4,5,351
75871529@N02,6385,14,1330491330,1330491517,3,5,187
75871529@N02,6386,14,1330601118,1330601118,1,4,0
75871529@N02,6386,12,1330599588,1330600138,4,4,550
75871529@N02,6386,10,1330600906,1330600906,1,4,0
75871529@N02,6386,16,1330600648,1330600806,2,4,158
75990687@N05,6387,8,1437742119,1437742135,3,8,16
75990687@N05,6387,13,1437740661,1437740685,2,8,24
75990687@N05,6387,7,1437741956,1437741963,2,8,7
75990687@N05,6387,2,1437715118,1437718060,2,8,2942
75990687@N05,6387,4,1437719156,1437719161,2,8,5
75990687@N05,6387,11,1437742263,1437742263,1,8,0
75990687@N05,6387,9,1437719360,1437739300,6,8,19940
75990687@N05,6387,24,1437727060,1437727060,1,8,0
75990687@N05,6388,25,1454131831,1454136249,23,7,4418
75990687@N05,6388,26,1454132356,1454132356,1,7,0
75990687@N05,6388,14,1454104965,1454126728,3,7,21763
75990687@N05,6388,17,1454105494,1454128983,5,7,23489
75990687@N05,6388,24,1454105809,1454106333,5,7,524
75990687@N05,6388,7,1454104951,1454104959,2,7,8
75990687@N05,6388,3,1454141346,1454141351,3,7,5
76024515@N07,6389,25,1347572466,1347573436,2,3,970
76024515@N07,6389,19,1347575463,1347575463,1,3,0
76024515@N07,6389,17,1347589157,1347589157,1,3,0
76024515@N07,6390,21,1348024590,1348025018,2,5,428
76024515@N07,6390,16,1348028965,1348028965,1,5,0
76024515@N07,6390,22,1348025369,1348026555,2,5,1186
76024515@N07,6390,13,1348029569,1348029569,1,5,0
76024515@N07,6390,23,1348024723,1348024723,1,5,0
76101503@N00,6391,21,1415067485,1415067485,1,1,0
76151808@N00,6392,27,1234570527,1234612501,9,5,41974
76151808@N00,6392,14,1234583867,1234583867,1,5,0
76151808@N00,6392,22,1234588062,1234588698,5,5,636
76151808@N00,6392,12,1234595181,1234595181,1,5,0
76151808@N00,6392,16,1234586208,1234586208,1,5,0
76151808@N00,6393,17,1234870930,1234870938,2,3,8
76151808@N00,6393,4,1234871067,1234871067,1,3,0
76151808@N00,6393,9,1234868800,1234868925,2,3,125
76151808@N00,6394,18,1265865865,1265865865,1,14,0
76151808@N00,6394,24,1265873930,1265874635,3,14,705
76151808@N00,6394,1,1265850653,1265868971,4,14,18318
76151808@N00,6394,20,1265857195,1265857195,1,14,0
76151808@N00,6394,9,1265863689,1265863689,1,14,0
76151808@N00,6394,13,1265865745,1265866175,2,14,430
76151808@N00,6394,27,1265856092,1265876049,3,14,19957
76151808@N00,6394,14,1265852833,1265852833,1,14,0
76151808@N00,6394,3,1265851596,1265851596,1,14,0
76151808@N00,6394,4,1265872520,1265872520,1,14,0
76151808@N00,6394,7,1265869046,1265869046,1,14,0
76151808@N00,6394,2,1265888844,1265889022,2,14,178
76151808@N00,6394,12,1265887560,1265887560,1,14,0
76151808@N00,6394,16,1265885509,1265886239,2,14,730
76151808@N00,6395,16,1266380150,1266381942,2,9,1792
76151808@N00,6395,14,1266408951,1266408951,1,9,0
76151808@N00,6395,13,1266408544,1266408544,1,9,0
76151808@N00,6395,20,1266364539,1266364539,1,9,0
76151808@N00,6395,26,1266364738,1266364738,1,9,0
76151808@N00,6395,18,1266387419,1266387419,1,9,0
76151808@N00,6395,11,1266377666,1266378480,2,9,814
76151808@N00,6395,8,1266377476,1266379550,3,9,2074
76151808@N00,6395,21,1266367073,1266368375,6,9,1302
76151808@N00,6396,17,1298253703,1298253703,1,4,0
76151808@N00,6396,13,1298248651,1298248651,1,4,0
76151808@N00,6396,24,1298260075,1298260075,1,4,0
76151808@N00,6396,21,1298258021,1298258777,2,4,756
76151808@N00,6397,27,1298456691,1298456691,1,1,0
76151808@N00,6398,3,1345771962,1345771962,1,4,0
76151808@N00,6398,22,1345786852,1345786852,1,4,0
76151808@N00,6398,26,1345776180,1345776180,1,4,0
76151808@N00,6398,14,1345772991,1345772991,1,4,0
76151808@N00,6399,8,1360895547,1360895547,1,2,0
76151808@N00,6399,16,1360886236,1360886236,1,2,0
76151808@N00,6400,21,1361099237,1361099237,1,1,0
76151808@N00,6401,27,1361182814,1361182814,1,1,0
76151808@N00,6402,10,1361270617,1361270617,1,1,0
76151808@N00,6403,19,1361318909,1361318909,1,1,0
76151808@N00,6404,10,1361349574,1361349574,1,2,0
76151808@N00,6404,26,1361359822,1361359822,1,2,0
76151808@N00,6405,26,1387530207,1387530207,1,1,0
76151808@N00,6406,11,1388201662,1388201662,1,1,0
76151808@N00,6407,27,1424321897,1424321897,1,2,0
76151808@N00,6407,14,1424313666,1424313666,1,2,0
76151808@N00,6408,2,1424566230,1424566230,1,2,0
76151808@N00,6408,16,1424560426,1424560426,1,2,0
76151808@N00,6409,26,1424654014,1424654014,1,1,0
76151808@N00,6410,26,1451264920,1451264920,1,1,0
76151808@N00,6411,24,1451434432,1451434432,1,2,0
76151808@N00,6411,15,1451448490,1451448490,1,2,0
76193525@N05,6412,16,1328693172,1328693172,1,1,0
76193525@N05,6413,27,1328844924,1328844924,1,1,0
76287763@N00,6414,16,1391214264,1391214264,1,1,0
76343652@N04,6415,27,1461642861,1461642861,1,2,0
76343652@N04,6415,4,1461648810,1461670221,3,2,21411
7635377@N05,6416,9,1221735666,1221736009,8,1,343
76356046@N05,6417,27,1272514541,1272514541,1,1,0
76356046@N05,6418,4,1272858768,1272858828,2,1,60
7638121@N03,6419,16,1277811866,1277811866,1,1,0
76475184@N02,6420,27,1410586152,1410588732,19,1,2580
76485411@N00,6421,27,1398202515,1398202515,1,1,0
76485411@N00,6422,27,1398726587,1398726587,1,1,0
76500745@N03,6423,26,1320200617,1320200617,1,1,0
76663697@N00,6424,20,1212480354,1212480839,5,9,485
76663697@N00,6424,17,1212481696,1212482177,7,9,481
76663697@N00,6424,27,1212466726,1212467203,8,9,477
76663697@N00,6424,14,1212485985,1212485985,1,9,0
76663697@N00,6424,4,1212471355,1212471355,1,9,0
76663697@N00,6424,25,1212472322,1212472592,4,9,270
76663697@N00,6424,15,1212483687,1212485035,4,9,1348
76663697@N00,6424,13,1212482294,1212482294,1,9,0
76663697@N00,6424,21,1212477041,1212479194,2,9,2153
76663697@N00,6425,27,1212518237,1212518237,1,1,0
76663697@N00,6426,6,1212900485,1212902465,17,1,1980
76665138@N00,6427,27,1262934043,1262934043,1,2,0
76665138@N00,6427,3,1262936982,1262936982,1,2,0
76665138@N00,6428,26,1262982371,1262982371,1,3,0
76665138@N00,6428,5,1262981861,1262981861,1,3,0
76665138@N00,6428,9,1262982014,1262982014,1,3,0
76665138@N00,6429,11,1263285841,1263285852,2,1,11
76665138@N00,6430,4,1273821288,1273821288,1,1,0
76665138@N00,6431,3,1274106437,1274106437,1,1,0
76665138@N00,6432,22,1325904469,1325904469,1,7,0
76665138@N00,6432,14,1325881035,1325908518,4,7,27483
76665138@N00,6432,18,1325902535,1325902836,2,7,301
76665138@N00,6432,6,1325880591,1325880591,1,7,0
76665138@N00,6432,9,1325880810,1325913016,2,7,32206
76665138@N00,6432,3,1325909214,1325909214,1,7,0
76665138@N00,6432,17,1325900558,1325900933,4,7,375
76665138@N00,6433,26,1325989281,1325989286,2,10,5
76665138@N00,6433,2,1325996943,1325996982,4,10,39
76665138@N00,6433,25,1325994119,1325996078,2,10,1959
76665138@N00,6433,14,1326002599,1326002611,2,10,12
76665138@N00,6433,27,1325982471,1326003719,30,10,21248
76665138@N00,6433,9,1326001667,1326001667,1,10,0
76665138@N00,6433,20,1325990058,1325991397,4,10,1339
76665138@N00,6433,19,1325991855,1325991971,8,10,116
76665138@N00,6433,17,1325986960,1325986960,1,10,0
76665138@N00,6433,3,1326000244,1326000249,2,10,5
76665138@N00,6434,2,1326415546,1326416781,2,7,1235
76665138@N00,6434,4,1326414709,1326414709,1,7,0
76665138@N00,6434,1,1326415357,1326418996,2,7,3639
76665138@N00,6434,14,1326425564,1326425591,4,7,27
76665138@N00,6434,27,1326410557,1326410755,3,7,198
76665138@N00,6434,9,1326423777,1326425178,6,7,1401
76665138@N00,6434,3,1326418744,1326418744,1,7,0
76665138@N00,6435,17,1326504987,1326504994,2,2,7
76665138@N00,6435,3,1326508403,1326509775,2,2,1372
76698900@N00,6436,19,1214549564,1214549564,1,1,0
76701708@N00,6437,7,1369533425,1369533425,1,1,0
76704164@N00,6438,21,1371030163,1371030163,1,2,0
76704164@N00,6438,15,1371027375,1371027375,1,2,0
76730958@N07,6439,26,1364860354,1364860354,1,1,0
7675784@N04,6440,22,1376291337,1376291349,2,2,12
7675784@N04,6440,16,1376312650,1376312904,7,2,254
76786681@N00,6441,16,1300396062,1300396062,1,3,0
76786681@N00,6441,2,1300402073,1300402073,1,3,0
76786681@N00,6441,3,1300404020,1300404020,1,3,0
76786681@N00,6442,14,1300488542,1300505547,2,3,17005
76786681@N00,6442,16,1300493939,1300494027,2,3,88
76786681@N00,6442,9,1300494957,1300494957,1,3,0
76795008@N04,6443,27,1356918104,1356918122,22,1,18
7682911@N05,6444,25,1319284179,1319284179,1,1,0
76830337@N07,6445,26,1231863802,1231863802,1,3,0
76830337@N07,6445,9,1231858542,1231863791,3,3,5249
76830337@N07,6445,19,1231865196,1231865196,1,3,0
76830337@N07,6446,13,1282974496,1282974496,1,1,0
76830337@N07,6447,27,1288416534,1288416534,1,1,0
76830337@N07,6448,13,1317534431,1317534431,1,1,0
76830337@N07,6449,14,1331979666,1331979666,1,3,0
76830337@N07,6449,18,1331961659,1331961659,1,3,0
76830337@N07,6449,16,1331967878,1331967878,1,3,0
76830337@N07,6450,14,1338343140,1338343140,1,1,0
76830337@N07,6451,13,1339502342,1339502342,1,1,0
76830337@N07,6452,15,1342015200,1342015200,1,1,0
76830337@N07,6453,13,1347662428,1347662600,2,1,172
76830337@N07,6454,13,1364907600,1364907600,1,1,0
76830337@N07,6455,13,1364994000,1364994000,1,1,0
76830337@N07,6456,13,1365429600,1365429600,1,2,0
76830337@N07,6456,22,1365429600,1365429600,1,2,0
76830337@N07,6457,13,1365600609,1365600609,1,2,0
76830337@N07,6457,8,1365602402,1365602402,1,2,0
76830337@N07,6458,13,1365861671,1365861671,1,1,0
76830337@N07,6459,8,1366165530,1366165530,1,1,0
76830337@N07,6460,14,1366402382,1366402382,1,4,0
76830337@N07,6460,10,1366402381,1366402381,1,4,0
76830337@N07,6460,27,1366402388,1366402388,1,4,0
76830337@N07,6460,16,1366402383,1366402383,1,4,0
76939038@N00,6461,9,1295583126,1295614132,32,1,31006
76939038@N00,6462,9,1295652646,1295690470,42,1,37824
76939038@N00,6463,9,1295743936,1295772587,14,1,28651
76939038@N00,6464,9,1295827089,1295859523,24,1,32434
76939038@N00,6465,9,1295924529,1295942769,4,1,18240
76939038@N00,6466,9,1296005411,1296019698,5,1,14287
76954449@N08,6467,17,1259835479,1259835479,1,1,0
76954449@N08,6468,14,1354970726,1354970726,1,1,0
76954449@N08,6469,16,1368708065,1368708065,1,2,0
76954449@N08,6469,4,1368697689,1368697689,1,2,0
76954449@N08,6470,27,1369339225,1369339225,1,1,0
76954449@N08,6471,26,1369572782,1369572782,1,2,0
76954449@N08,6471,13,1369573443,1369573443,1,2,0
76954449@N08,6472,4,1369627070,1369627070,1,1,0
76954449@N08,6473,27,1399875398,1399875398,1,1,0
76954449@N08,6474,27,1400159474,1400159474,1,2,0
76954449@N08,6474,17,1400161168,1400161168,1,2,0
76985374@N00,6475,27,1300409582,1300430708,38,1,21126
76991932@N00,6476,9,1433733564,1433733564,1,3,0
76991932@N00,6476,19,1433746260,1433746260,1,3,0
76991932@N00,6476,13,1433750127,1433750127,1,3,0
76991932@N00,6477,14,1433932024,1433932024,1,1,0
7704455@N02,6478,16,1254200096,1254200096,1,1,0
77179348@N00,6479,2,1342009366,1342009575,4,6,209
77179348@N00,6479,5,1342007430,1342009557,4,6,2127
77179348@N00,6479,1,1342009601,1342009717,4,6,116
77179348@N00,6479,4,1342007503,1342012163,18,6,4660
77179348@N00,6479,27,1342007022,1342007150,3,6,128
77179348@N00,6479,3,1342007882,1342009887,7,6,2005
77179348@N00,6480,14,1342270604,1342270604,1,2,0
77179348@N00,6480,17,1342271889,1342271894,2,2,5
77179348@N00,6481,10,1442532828,1442541121,49,25,8293
77179348@N00,6481,24,1442547462,1442549347,21,25,1885
77179348@N00,6481,27,1442530184,1442564297,9,25,34113
77179348@N00,6481,5,1442553942,1442555314,16,25,1372
77179348@N00,6481,15,1442535291,1442543668,27,25,8377
77179348@N00,6481,3,1442555616,1442558231,30,25,2615
77179348@N00,6481,26,1442543778,1442551214,8,25,7436
77179348@N00,6481,2,1442554969,1442556989,38,25,2020
77179348@N00,6481,25,1442549045,1442551934,27,25,2889
77179348@N00,6481,1,1442555345,1442559741,36,25,4396
77179348@N00,6481,13,1442536297,1442538569,27,25,2272
77179348@N00,6481,9,1442530899,1442562365,62,25,31466
77179348@N00,6481,18,1442537473,1442550375,3,25,12902
77179348@N00,6481,14,1442535236,1442563750,12,25,28514
77179348@N00,6481,16,1442535609,1442563796,9,25,28187
77179348@N00,6481,6,1442554373,1442555338,8,25,965
77179348@N00,6481,12,1442535987,1442536444,10,25,457
77179348@N00,6481,4,1442552116,1442555681,25,25,3565
77179348@N00,6481,23,1442547488,1442551047,20,25,3559
77179348@N00,6481,19,1442546226,1442547064,23,25,838
77179348@N00,6481,21,1442547385,1442548923,14,25,1538
77179348@N00,6481,20,1442544814,1442547351,90,25,2537
77179348@N00,6481,11,1442532821,1442532821,1,25,0
77179348@N00,6481,22,1442543887,1442544730,31,25,843
77179348@N00,6481,17,1442543735,1442563887,16,25,20152
77179348@N00,6482,26,1442668661,1442669421,9,4,760
77179348@N00,6482,20,1442666890,1442666890,1,4,0
77179348@N00,6482,27,1442669990,1442670328,4,4,338
77179348@N00,6482,17,1442665109,1442669453,12,4,4344
77205577@N06,6483,27,1429440345,1429440345,1,1,0
77260531@N03,6484,16,1364387334,1364387334,1,1,0
77265242@N00,6485,10,1356334939,1356334939,1,1,0
77382220@N08,6486,27,1364630973,1364630973,1,1,0
77382220@N08,6487,27,1364813755,1364814609,5,1,854
77395664@N00,6488,9,1412317939,1412317939,1,1,0
77437178@N00,6489,17,1317439384,1317439384,1,1,0
77437178@N00,6490,27,1345259624,1345259624,1,1,0
77437178@N00,6491,13,1350712175,1350712175,1,1,0
77463997@N03,6492,19,1307354958,1307354958,1,1,0
77463997@N03,6493,21,1351128651,1351128651,1,1,0
77463997@N03,6494,27,1354159280,1354159280,1,1,0
77463997@N03,6495,21,1359802288,1359802288,1,1,0
77463997@N03,6496,21,1360201341,1360201341,1,1,0
77463997@N03,6497,9,1360404194,1360404194,1,2,0
77463997@N03,6497,14,1360408403,1360408403,1,2,0
77463997@N03,6498,13,1373797639,1373797639,1,1,0
77463997@N03,6499,9,1375538403,1375538403,1,1,0
77463997@N03,6500,20,1378443507,1378443507,1,2,0
77463997@N03,6500,27,1378428510,1378428510,1,2,0
77463997@N03,6501,19,1378542123,1378542123,1,1,0
77463997@N03,6502,21,1379206742,1379206742,1,1,0
77463997@N03,6503,21,1382132944,1382132944,1,1,0
77463997@N03,6504,7,1384162883,1384162883,1,1,0
77463997@N03,6505,27,1384747713,1384747713,1,1,0
77463997@N03,6506,14,1385018079,1385018079,1,1,0
77463997@N03,6507,19,1390185390,1390185390,1,3,0
77463997@N03,6507,27,1390215089,1390215089,1,3,0
77463997@N03,6507,21,1390188830,1390189219,2,3,389
77463997@N03,6508,19,1390822675,1390822675,1,1,0
77463997@N03,6509,19,1391081351,1391081351,1,1,0
77463997@N03,6510,27,1395181053,1395181053,1,1,0
77463997@N03,6511,27,1395269097,1395269097,1,1,0
77463997@N03,6512,27,1395356978,1395356978,1,1,0
77463997@N03,6513,27,1395619469,1395619470,2,1,1
77463997@N03,6514,27,1395699245,1395699245,1,1,0
77463997@N03,6515,27,1395870050,1395870050,1,1,0
77463997@N03,6516,27,1398986711,1398986711,1,1,0
77463997@N03,6517,27,1399417792,1399417792,1,1,0
77463997@N03,6518,19,1401959214,1401959214,1,1,0
77463997@N03,6519,27,1414710859,1414710859,1,1,0
77463997@N03,6520,27,1418813390,1418813390,1,1,0
77463997@N03,6521,9,1421400954,1421400954,1,1,0
77463997@N03,6522,23,1421711624,1421711624,1,1,0
77463997@N03,6523,16,1425418339,1425418339,1,1,0
77463997@N03,6524,10,1429615053,1429615053,1,1,0
77463997@N03,6525,16,1430039203,1430039203,1,1,0
77463997@N03,6526,16,1434621914,1434621915,2,1,1
77463997@N03,6527,27,1441949290,1441949290,1,1,0
77463997@N03,6528,21,1443134641,1443134641,1,1,0
77463997@N03,6529,13,1444342133,1444342133,1,1,0
77463997@N03,6530,27,1445637815,1445637815,1,1,0
77463997@N03,6531,27,1446022139,1446022139,1,1,0
77463997@N03,6532,13,1446241295,1446241295,1,1,0
77463997@N03,6533,4,1453588021,1453588021,1,1,0
77503031@N00,6534,27,1261492310,1261492310,1,1,0
77503031@N00,6535,21,1261578289,1261578289,1,5,0
77503031@N00,6535,25,1261578352,1261578352,1,5,0
77503031@N00,6535,16,1261598637,1261599324,6,5,687
77503031@N00,6535,22,1261584461,1261584663,7,5,202
77503031@N00,6535,20,1261584506,1261584771,5,5,265
77506321@N00,6536,27,1395720616,1395720616,1,1,0
77506321@N00,6537,27,1395798446,1395798446,1,1,0
77528595@N00,6538,1,1318558613,1318558613,1,5,0
77528595@N00,6538,26,1318567703,1318567866,2,5,163
77528595@N00,6538,9,1318559800,1318559800,1,5,0
77528595@N00,6538,24,1318556135,1318564930,4,5,8795
77528595@N00,6538,27,1318549327,1318567714,2,5,18387
77528595@N00,6539,24,1318898155,1318898155,1,1,0
77545914@N00,6540,23,1268190188,1268190276,3,2,88
77545914@N00,6540,16,1268204010,1268204047,2,2,37
7755564@N06,6541,27,1354453419,1354453419,1,1,0
77643438@N08,6542,4,1325738186,1325738186,1,1,0
77665450@N08,6543,16,1331530266,1331530266,1,1,0
7768857@N04,6544,14,1369128131,1369128131,1,1,0
77692940@N00,6545,6,1367133891,1367133891,1,1,0
77709469@N03,6546,27,1391986921,1391986921,1,1,0
77709469@N03,6547,27,1392020770,1392022660,3,1,1890
7772172@N02,6548,16,1298620592,1298624077,10,1,3485
7772172@N02,6549,16,1298753053,1298753109,4,4,56
7772172@N02,6549,14,1298752953,1298753017,2,4,64
7772172@N02,6549,4,1298752723,1298752723,1,4,0
7772172@N02,6549,26,1298753174,1298753192,2,4,18
77744839@N00,6550,2,1389490392,1389490392,1,2,0
77744839@N00,6550,3,1389491462,1389491462,1,2,0
77744839@N00,6551,1,1389605781,1389605781,1,10,0
77744839@N00,6551,16,1389609040,1389609040,1,10,0
77744839@N00,6551,14,1389602510,1389602510,1,10,0
77744839@N00,6551,19,1389589503,1389589503,1,10,0
77744839@N00,6551,27,1389580227,1389580227,1,10,0
77744839@N00,6551,13,1389600755,1389600755,1,10,0
77744839@N00,6551,22,1389594426,1389595245,2,10,819
77744839@N00,6551,21,1389593370,1389593370,1,10,0
77744839@N00,6551,15,1389603372,1389603372,1,10,0
77744839@N00,6551,9,1389581870,1389604528,2,10,22658
7776897@N02,6552,16,1223022036,1223032269,30,1,10233
7776897@N02,6553,16,1223257610,1223258138,10,2,528
7776897@N02,6553,1,1223257146,1223262657,3,2,5511
7784444@N07,6554,13,1325112684,1325112759,9,4,75
7784444@N07,6554,27,1325113055,1325113065,2,4,10
7784444@N07,6554,21,1325113046,1325113046,1,4,0
7784444@N07,6554,15,1325112674,1325113036,2,4,362
77850199@N02,6555,13,1331078314,1331078328,2,7,14
77850199@N02,6555,14,1331075198,1331106208,5,7,31010
77850199@N02,6555,21,1331104476,1331104703,2,7,227
77850199@N02,6555,26,1331079711,1331084257,4,7,4546
77850199@N02,6555,16,1331097888,1331117440,4,7,19552
77850199@N02,6555,2,1331112382,1331112382,1,7,0
77850199@N02,6555,27,1331086748,1331091613,2,7,4865
77865420@N00,6556,18,1343743200,1343743200,1,1,0
77865420@N00,6557,16,1344780011,1344780020,10,6,9
77865420@N00,6557,27,1344780026,1344780030,3,6,4
77865420@N00,6557,13,1344780000,1344780044,22,6,44
77865420@N00,6557,10,1344780009,1344780010,2,6,1
77865420@N00,6557,18,1344780007,1344780007,1,6,0
77865420@N00,6557,4,1344780021,1344780024,4,6,3
77876033@N00,6558,25,1223714082,1223714082,1,2,0
77876033@N00,6558,9,1223697898,1223697929,2,2,31
77876033@N00,6559,25,1292553855,1292553855,1,1,0
77876033@N00,6560,27,1292992316,1292992316,1,1,0
77876033@N00,6561,22,1293538338,1293538338,1,3,0
77876033@N00,6561,1,1293504785,1293504785,1,3,0
77876033@N00,6561,25,1293513053,1293513053,1,3,0
77919685@N00,6562,14,1196932248,1196945982,28,1,13734
77932199@N07,6563,19,1312697431,1312697431,1,1,0
77932199@N07,6564,27,1334207368,1334207695,7,1,327
77932199@N07,6565,7,1340878747,1340878917,6,6,170
77932199@N07,6565,14,1340873524,1340878215,19,6,4691
77932199@N07,6565,9,1340882056,1340882158,3,6,102
77932199@N07,6565,27,1340868051,1340870431,3,6,2380
77932199@N07,6565,12,1340883667,1340883982,4,6,315
77932199@N07,6565,16,1340874925,1340874925,1,6,0
77932199@N07,6566,22,1341291813,1341293721,14,6,1908
77932199@N07,6566,24,1341288091,1341288099,2,6,8
77932199@N07,6566,15,1341301716,1341301716,1,6,0
77932199@N07,6566,8,1341303964,1341304548,6,6,584
77932199@N07,6566,18,1341296523,1341296523,1,6,0
77932199@N07,6566,27,1341278148,1341278148,1,6,0
77932199@N07,6567,18,1374631329,1374631337,3,1,8
77988256@N05,6568,17,1419839960,1419840768,2,1,808
78027754@N00,6569,12,1355885090,1355885090,1,2,0
78027754@N00,6569,27,1355873619,1355873619,1,2,0
78027754@N00,6570,17,1396915176,1396915195,2,1,19
78027754@N00,6571,21,1406507896,1406507896,2,2,0
78027754@N00,6571,20,1406507628,1406507974,2,2,346
78027754@N00,6572,12,1429477808,1429478038,4,7,230
78027754@N00,6572,10,1429480733,1429481181,3,7,448
78027754@N00,6572,17,1429487638,1429488181,8,7,543
78027754@N00,6572,15,1429481764,1429481764,1,7,0
78027754@N00,6572,27,1429436670,1429476521,14,7,39851
78027754@N00,6572,14,1429445830,1429486766,13,7,40936
78027754@N00,6572,16,1429441849,1429496281,50,7,54432
78027754@N00,6573,17,1432543700,1432543700,1,1,0
7804123@N08,6574,20,1410088458,1410088458,1,1,0
7804123@N08,6575,14,1410189092,1410189092,1,1,0
78046504@N07,6576,14,1336387622,1336387622,1,1,0
7806128@N03,6577,16,1192949786,1192949786,1,1,0
78089576@N06,6578,18,1333177129,1333177129,1,1,0
78132024@N00,6579,14,1389233793,1389233793,1,1,0
78147513@N00,6580,4,1291514211,1291514211,1,1,0
78147513@N00,6581,3,1357725069,1357725069,1,1,0
78166585@N05,6582,18,1414560852,1414560852,1,2,0
78166585@N05,6582,16,1414552497,1414552497,1,2,0
78186649@N00,6583,8,1383376109,1383377960,5,2,1851
78186649@N00,6583,12,1383374968,1383374972,3,2,4
7830943@N03,6584,27,1381575942,1381580226,7,8,4284
7830943@N03,6584,9,1381543973,1381543973,1,8,0
7830943@N03,6584,2,1381535693,1381535720,2,8,27
7830943@N03,6584,4,1381533741,1381533741,1,8,0
7830943@N03,6584,23,1381547206,1381547206,1,8,0
7830943@N03,6584,6,1381534116,1381534116,1,8,0
7830943@N03,6584,10,1381538802,1381538802,1,8,0
7830943@N03,6584,18,1381555902,1381555932,2,8,30
78319592@N00,6585,14,1376369201,1376369206,2,8,5
78319592@N00,6585,17,1376368881,1376368881,1,8,0
78319592@N00,6585,21,1376378464,1376379098,3,8,634
78319592@N00,6585,15,1376369083,1376369152,3,8,69
78319592@N00,6585,26,1376378865,1376378865,1,8,0
78319592@N00,6585,24,1376378459,1376378984,2,8,525
78319592@N00,6585,25,1376378440,1376378792,3,8,352
78319592@N00,6585,27,1376364431,1376367432,7,8,3001
78345092@N07,6586,2,1372500697,1372500697,1,5,0
78345092@N07,6586,16,1372487628,1372503445,3,5,15817
78345092@N07,6586,19,1372462634,1372462634,1,5,0
78345092@N07,6586,18,1372464297,1372464297,1,5,0
78345092@N07,6586,14,1372486539,1372486539,1,5,0
78364960@N04,6587,21,1318646519,1318646519,1,1,0
78364960@N04,6588,27,1336811029,1336811029,1,2,0
78364960@N04,6588,14,1336823651,1336823651,1,2,0
78364960@N04,6589,26,1341054702,1341056223,2,4,1521
78364960@N04,6589,27,1341061145,1341061145,1,4,0
78364960@N04,6589,7,1341057234,1341057234,1,4,0
78364960@N04,6589,21,1341052951,1341052951,1,4,0
78364960@N04,6590,21,1344510813,1344510813,1,1,0
78364960@N04,6591,27,1346592958,1346592958,1,1,0
78364960@N04,6592,27,1350106136,1350106136,1,4,0
78364960@N04,6592,10,1350108863,1350111848,2,4,2985
78364960@N04,6592,14,1350113291,1350113291,1,4,0
78364960@N04,6592,9,1350115444,1350115444,1,4,0
78364960@N04,6593,14,1351731269,1351731269,1,1,0
78364960@N04,6594,22,1354350937,1354350937,1,2,0
78364960@N04,6594,10,1354363716,1354363837,2,2,121
78364960@N04,6595,14,1354944136,1354944136,1,3,0
78364960@N04,6595,13,1354945894,1354946593,2,3,699
78364960@N04,6595,10,1354935284,1354935284,1,3,0
78364960@N04,6596,9,1360406217,1360406217,1,4,0
78364960@N04,6596,10,1360407203,1360407203,1,4,0
78364960@N04,6596,17,1360392802,1360400164,2,4,7362
78364960@N04,6596,27,1360391425,1360391425,1,4,0
78364960@N04,6597,27,1361076841,1361076953,2,1,112
78364960@N04,6598,21,1363938787,1363940399,2,6,1612
78364960@N04,6598,18,1363929365,1363929365,1,6,0
78364960@N04,6598,14,1363947850,1363947850,1,6,0
78364960@N04,6598,23,1363938356,1363938356,1,6,0
78364960@N04,6598,9,1363936738,1363936738,1,6,0
78364960@N04,6598,10,1363946883,1363947100,2,6,217
78364960@N04,6599,27,1366419149,1366419149,1,2,0
78364960@N04,6599,9,1366428429,1366428429,1,2,0
78364960@N04,6600,19,1368238903,1368238903,1,6,0
78364960@N04,6600,13,1368243816,1368243816,1,6,0
78364960@N04,6600,21,1368232504,1368232504,1,6,0
78364960@N04,6600,24,1368232963,1368233619,2,6,656
78364960@N04,6600,16,1368229689,1368242535,4,6,12846
78364960@N04,6600,17,1368243176,1368249522,2,6,6346
78364960@N04,6601,19,1369343579,1369343579,1,3,0
78364960@N04,6601,16,1369339646,1369339646,1,3,0
78364960@N04,6601,27,1369339030,1369339030,1,3,0
78364960@N04,6602,9,1369388624,1369388624,1,4,0
78364960@N04,6602,14,1369400196,1369400196,1,4,0
78364960@N04,6602,10,1369388016,1369388252,2,4,236
78364960@N04,6602,16,1369386815,1369413290,2,4,26475
78364960@N04,6603,10,1370092506,1370092693,2,1,187
78364960@N04,6604,15,1373029539,1373029539,1,5,0
78364960@N04,6604,14,1373019258,1373019258,1,5,0
78364960@N04,6604,17,1373030393,1373030675,2,5,282
78364960@N04,6604,10,1373019277,1373019352,2,5,75
78364960@N04,6604,21,1373032583,1373032583,1,5,0
78364960@N04,6605,4,1375445221,1375445497,4,5,276
78364960@N04,6605,12,1375434943,1375434943,1,5,0
78364960@N04,6605,6,1375440759,1375440759,1,5,0
78364960@N04,6605,14,1375438468,1375438468,1,5,0
78364960@N04,6605,10,1375436629,1375436629,1,5,0
78364960@N04,6606,13,1379410508,1379426966,2,4,16458
78364960@N04,6606,9,1379407181,1379407181,1,4,0
78364960@N04,6606,14,1379407237,1379407237,1,4,0
78364960@N04,6606,27,1379416046,1379422662,9,4,6616
78364960@N04,6607,27,1380370202,1380370202,1,2,0
78364960@N04,6607,10,1380360375,1380360375,1,2,0
78364960@N04,6608,14,1382363243,1382364028,2,3,785
78364960@N04,6608,10,1382359289,1382359289,1,3,0
78364960@N04,6608,19,1382340910,1382365079,2,3,24169
78364960@N04,6609,9,1382426412,1382426412,1,2,0
78364960@N04,6609,27,1382421569,1382421569,1,2,0
78364960@N04,6610,26,1384081685,1384081834,2,2,149
78364960@N04,6610,13,1384076752,1384085475,2,2,8723
78364960@N04,6611,10,1387693975,1387693975,1,2,0
78364960@N04,6611,26,1387711978,1387711978,1,2,0
78364960@N04,6612,16,1392627539,1392627539,1,2,0
78364960@N04,6612,10,1392631219,1392631219,1,2,0
78364960@N04,6613,26,1394939770,1394939770,1,2,0
78364960@N04,6613,15,1394942642,1394942642,1,2,0
78364960@N04,6614,14,1398081892,1398082177,2,1,285
78364960@N04,6615,16,1398764111,1398764111,1,3,0
78364960@N04,6615,9,1398770026,1398770026,1,3,0
78364960@N04,6615,13,1398763829,1398763829,1,3,0
78364960@N04,6616,27,1400812522,1400812522,1,2,0
78364960@N04,6616,17,1400794101,1400794139,2,2,38
78364960@N04,6617,17,1400850136,1400850136,1,2,0
78364960@N04,6617,27,1400856404,1400856404,1,2,0
78364960@N04,6618,27,1413692780,1413692819,2,1,39
78364960@N04,6619,10,1417235557,1417235557,1,1,0
78364960@N04,6620,27,1421123507,1421123525,2,1,18
78364960@N04,6621,9,1423281843,1423281843,1,2,0
78364960@N04,6621,10,1423307579,1423307579,1,2,0
78364960@N04,6622,8,1424310992,1424310992,1,2,0
78364960@N04,6622,17,1424308523,1424308523,1,2,0
78364960@N04,6623,15,1428131328,1428131328,1,1,0
78364960@N04,6624,10,1430439369,1430439369,1,1,0
78364960@N04,6625,10,1430741815,1430741815,1,1,0
78364960@N04,6626,17,1432307752,1432307752,1,2,0
78364960@N04,6626,14,1432287389,1432287389,1,2,0
78364960@N04,6627,27,1444125602,1444135637,5,1,10035
78364960@N04,6628,22,1450849635,1450849635,1,1,0
78364960@N04,6629,27,1452144521,1452144868,4,1,347
78364960@N04,6630,27,1455945987,1455946207,4,1,220
78364960@N04,6631,6,1457167420,1457168597,2,1,1177
78364960@N04,6632,27,1461475489,1461476056,8,3,567
78364960@N04,6632,10,1461485060,1461485255,2,3,195
78364960@N04,6632,4,1461487069,1461487069,1,3,0
78364960@N04,6633,27,1462598804,1462599184,7,2,380
78364960@N04,6633,10,1462623198,1462623198,1,2,0
78364960@N04,6634,16,1466257733,1466258938,2,1,1205
78364960@N04,6635,16,1467774581,1467775152,4,1,571
78364960@N04,6636,27,1471329005,1471329005,1,1,0
78395763@N00,6637,20,1249181254,1249181254,1,1,0
78427651@N00,6638,3,1357137762,1357137762,1,1,0
7846658@N05,6639,16,1204954200,1204954200,1,1,0
78473524@N00,6640,27,1344502025,1344502025,1,1,0
78493611@N00,6641,25,1383713811,1383713811,1,1,0
7849988@N04,6642,27,1429182860,1429183910,16,1,1050
7849988@N04,6643,19,1466294789,1466294949,7,2,160
7849988@N04,6643,9,1466298812,1466298814,2,2,2
78562800@N05,6644,16,1355371620,1355371620,1,1,0
78569471@N00,6645,4,1209297565,1209298026,3,1,461
78569471@N00,6646,17,1211179628,1211179628,1,1,0
78569471@N00,6647,27,1214135000,1214136409,24,3,1409
78569471@N00,6647,16,1214142857,1214142868,2,3,11
78569471@N00,6647,17,1214141604,1214141654,4,3,50
78569471@N00,6648,2,1214270304,1214271482,4,9,1178
78569471@N00,6648,27,1214266573,1214266573,1,9,0
78569471@N00,6648,18,1214274378,1214275348,6,9,970
78569471@N00,6648,19,1214274749,1214274854,4,9,105
78569471@N00,6648,6,1214268869,1214273499,9,9,4630
78569471@N00,6648,17,1214274031,1214277985,5,9,3954
78569471@N00,6648,25,1214278310,1214283909,5,9,5599
78569471@N00,6648,13,1214274366,1214275340,12,9,974
78569471@N00,6648,4,1214267505,1214267525,2,9,20
78569471@N00,6649,17,1227354654,1227354654,1,1,0
78588112@N03,6650,27,1435632746,1435642492,27,1,9746
7859316@N03,6651,6,1276079523,1276079523,1,1,0
78644369@N03,6652,24,1383611689,1383611689,1,4,0
78644369@N03,6652,13,1383611652,1383611652,1,4,0
78644369@N03,6652,27,1383611570,1383611570,1,4,0
78644369@N03,6652,9,1383611794,1383611794,1,4,0
78672040@N00,6653,17,1197137666,1197137666,1,1,0
78672040@N00,6654,25,1272061266,1272061266,1,1,0
78672040@N00,6655,25,1357335556,1357335556,1,1,0
78732663@N03,6656,15,1397519814,1397519814,1,3,0
78732663@N03,6656,9,1397527042,1397527042,1,3,0
78732663@N03,6656,14,1397518812,1397518815,2,3,3
78732663@N03,6657,9,1397708701,1397713405,2,9,4704
78732663@N03,6657,11,1397709625,1397709625,1,9,0
78732663@N03,6657,24,1397693190,1397693190,1,9,0
78732663@N03,6657,6,1397708668,1397708668,1,9,0
78732663@N03,6657,4,1397711302,1397711302,1,9,0
78732663@N03,6657,27,1397692137,1397692150,2,9,13
78732663@N03,6657,2,1397697643,1397699835,6,9,2192
78732663@N03,6657,20,1397717723,1397717723,1,9,0
78732663@N03,6657,1,1397710581,1397710581,1,9,0
78743109@N00,6658,16,1325593850,1325593850,1,5,0
78743109@N00,6658,14,1325566848,1325566848,1,5,0
78743109@N00,6658,9,1325571824,1325571871,3,5,47
78743109@N00,6658,17,1325564757,1325583423,4,5,18666
78743109@N00,6658,27,1325549920,1325594121,12,5,44201
78779574@N00,6659,27,1336094673,1336094829,7,1,156
78779574@N00,6660,22,1336267654,1336271132,2,9,3478
78779574@N00,6660,18,1336274684,1336274684,1,9,0
78779574@N00,6660,20,1336277429,1336283114,33,9,5685
78779574@N00,6660,24,1336269339,1336277906,3,9,8567
78779574@N00,6660,23,1336266768,1336277922,9,9,11154
78779574@N00,6660,25,1336269701,1336278817,4,9,9116
78779574@N00,6660,26,1336279391,1336279391,1,9,0
78779574@N00,6660,21,1336269476,1336269476,1,9,0
78779574@N00,6660,6,1336265240,1336265754,2,9,514
78798856@N00,6661,14,1316999995,1317031757,10,1,31762
78798856@N00,6662,14,1317116869,1317116869,1,1,0
7883384@N04,6663,9,1276869444,1276870084,8,8,640
7883384@N04,6663,5,1276860996,1276861041,2,8,45
7883384@N04,6663,7,1276868552,1276868552,1,8,0
7883384@N04,6663,6,1276869235,1276869250,3,8,15
7883384@N04,6663,2,1276863786,1276863903,4,8,117
7883384@N04,6663,14,1276870317,1276871998,9,8,1681
7883384@N04,6663,18,1276872002,1276872007,2,8,5
7883384@N04,6663,27,1276858931,1276858931,1,8,0
7886635@N06,6664,16,1425381537,1425381537,1,3,0
7886635@N06,6664,22,1425354217,1425356116,45,3,1899
7886635@N06,6664,7,1425339772,1425377910,4,3,38138
7886635@N06,6665,10,1425546438,1425546693,10,1,255
78956712@N02,6666,16,1333272764,1333272764,1,1,0
79023626@N00,6667,14,1274235115,1274235115,1,1,0
79023626@N00,6668,14,1308191492,1308208037,3,1,16545
79023626@N00,6669,22,1335507795,1335507795,1,2,0
79023626@N00,6669,18,1335506806,1335506806,1,2,0
79023626@N00,6670,6,1351166312,1351166312,1,2,0
79023626@N00,6670,8,1351164254,1351164254,1,2,0
79023626@N00,6671,3,1352978203,1352978203,1,3,0
79023626@N00,6671,27,1352962577,1352962577,1,3,0
79023626@N00,6671,8,1352985231,1352985231,1,3,0
79023626@N00,6672,3,1354446918,1354447494,2,1,576
79038884@N04,6673,1,1364993268,1364993268,1,1,0
7908450@N03,6674,27,1303937113,1303937113,1,1,0
79092915@N00,6675,16,1280580701,1280580701,1,3,0
79092915@N00,6675,20,1280568075,1280568075,1,3,0
79092915@N00,6675,27,1280566047,1280566047,1,3,0
79121533@N00,6676,21,1335660395,1335660395,1,5,0
79121533@N00,6676,10,1335665616,1335665678,2,5,62
79121533@N00,6676,13,1335666648,1335666648,1,5,0
79121533@N00,6676,11,1335665406,1335665434,2,5,28
79121533@N00,6676,18,1335666710,1335666843,2,5,133
79121533@N00,6677,10,1389152024,1389155221,2,1,3197
79128990@N00,6678,22,1405858021,1405858021,1,1,0
79134215@N00,6679,20,1210665610,1210665797,2,1,187
79134215@N00,6680,20,1211877097,1211877097,1,1,0
79154294@N00,6681,8,1334302485,1334302485,1,5,0
79154294@N00,6681,11,1334277685,1334304554,4,5,26869
79154294@N00,6681,1,1334277051,1334277051,1,5,0
79154294@N00,6681,6,1334277096,1334277096,1,5,0
79154294@N00,6681,14,1334291042,1334291042,1,5,0
7917124@N07,6682,14,1458115438,1458115442,2,7,4
7917124@N07,6682,16,1458089668,1458089902,5,7,234
7917124@N07,6682,27,1458085293,1458134966,2,7,49673
7917124@N07,6682,9,1458093994,1458093997,2,7,3
7917124@N07,6682,17,1458126086,1458126439,6,7,353
7917124@N07,6682,22,1458129495,1458129495,1,7,0
7917124@N07,6682,10,1458115605,1458115605,1,7,0
79172203@N00,6683,13,1291683347,1291683393,2,13,46
79172203@N00,6683,9,1291691703,1291691703,1,13,0
79172203@N00,6683,17,1291684578,1291688504,2,13,3926
79172203@N00,6683,16,1291691065,1291696516,3,13,5451
79172203@N00,6683,4,1291711233,1291715131,20,13,3898
79172203@N00,6683,12,1291688771,1291690871,5,13,2100
79172203@N00,6683,14,1291691222,1291693692,6,13,2470
79172203@N00,6683,25,1291680100,1291703730,5,13,23630
79172203@N00,6683,21,1291680230,1291680239,2,13,9
79172203@N00,6683,22,1291682306,1291682306,1,13,0
79172203@N00,6683,15,1291688651,1291721277,2,13,32626
79172203@N00,6683,20,1291681672,1291681672,1,13,0
79172203@N00,6683,27,1291679547,1291721925,5,13,42378
79172203@N00,6684,12,1292016455,1292016494,2,23,39
79172203@N00,6684,13,1292016611,1292016698,5,23,87
79172203@N00,6684,3,1292020778,1292020778,1,23,0
79172203@N00,6684,14,1292016055,1292018929,6,23,2874
79172203@N00,6684,20,1292017788,1292017904,3,23,116
79172203@N00,6684,2,1292020721,1292020865,3,23,144
79172203@N00,6684,17,1292016786,1292018663,11,23,1877
79172203@N00,6684,11,1292019659,1292020104,19,23,445
79172203@N00,6684,15,1292016411,1292018821,5,23,2410
79172203@N00,6684,5,1292020924,1292020924,1,23,0
79172203@N00,6684,22,1292017502,1292017725,6,23,223
79172203@N00,6684,1,1292020561,1292020626,3,23,65
79172203@N00,6684,8,1292019220,1292020274,18,23,1054
79172203@N00,6684,24,1292022096,1292022096,1,23,0
79172203@N00,6684,25,1292022329,1292022329,1,23,0
79172203@N00,6684,23,1292021982,1292022075,3,23,93
79172203@N00,6684,19,1292017968,1292018065,3,23,97
79172203@N00,6684,4,1292020952,1292021028,3,23,76
79172203@N00,6684,21,1292022157,1292048597,3,23,26440
79172203@N00,6684,7,1292019144,1292019161,2,23,17
79172203@N00,6684,26,1292017103,1292017103,1,23,0
79172203@N00,6684,16,1292015495,1292063261,58,23,47766
79172203@N00,6684,27,1292014556,1292024870,13,23,10314
79172203@N00,6685,10,1399337245,1399346220,29,3,8975
79172203@N00,6685,15,1399328014,1399328014,1,3,0
79172203@N00,6685,13,1399328098,1399328551,5,3,453
79172203@N00,6686,16,1399494400,1399498153,22,11,3753
79172203@N00,6686,13,1399499372,1399499876,15,11,504
79172203@N00,6686,15,1399498217,1399499331,28,11,1114
79172203@N00,6686,11,1399497043,1399497473,18,11,430
79172203@N00,6686,9,1399497579,1399518500,11,11,20921
79172203@N00,6686,26,1399515647,1399516394,70,11,747
79172203@N00,6686,10,1399495306,1399517471,65,11,22165
79172203@N00,6686,17,1399499920,1399500148,4,11,228
79172203@N00,6686,14,1399494614,1399527287,36,11,32673
79172203@N00,6686,4,1399518686,1399518686,1,11,0
79172203@N00,6686,27,1399493390,1399513987,22,11,20597
79172203@N00,6687,26,1399624457,1399625545,66,3,1088
79172203@N00,6687,12,1399626577,1399626577,1,3,0
79172203@N00,6687,27,1399640586,1399640586,1,3,0
79344793@N02,6688,16,1330846188,1330846188,1,1,0
79344793@N02,6689,27,1331079660,1331079660,1,2,0
79344793@N02,6689,14,1331093833,1331093833,1,2,0
79344793@N02,6690,11,1344478946,1344478946,1,2,0
79344793@N02,6690,17,1344490550,1344490679,3,2,129
79366282@N00,6691,27,1385765924,1385765924,1,1,0
79399703@N00,6692,9,1366967430,1366967430,1,1,0
79433444@N07,6693,17,1355291426,1355323734,5,6,32308
79433444@N07,6693,14,1355302139,1355302725,4,6,586
79433444@N07,6693,20,1355294571,1355294571,1,6,0
79433444@N07,6693,27,1355290953,1355291040,4,6,87
79433444@N07,6693,23,1355297891,1355297891,1,6,0
79433444@N07,6693,18,1355296962,1355299985,5,6,3023
7945368@N05,6694,16,1341644300,1341677934,7,2,33634
7945368@N05,6694,27,1341644217,1341644217,1,2,0
7945368@N05,6695,16,1404906306,1404908747,5,3,2441
7945368@N05,6695,18,1404860060,1404908944,6,3,48884
7945368@N05,6695,14,1404877583,1404877583,1,3,0
7945637@N07,6696,17,1189094249,1189094249,1,1,0
7945637@N07,6697,22,1216289472,1216289472,1,1,0
7945637@N07,6698,16,1216723932,1216723932,1,1,0
7945637@N07,6699,19,1217588234,1217588234,1,2,0
7945637@N07,6699,22,1217587452,1217587815,2,2,363
7945637@N07,6700,16,1219036911,1219036911,1,1,0
7945637@N07,6701,16,1244717405,1244717405,1,1,0
7945637@N07,6702,5,1247230320,1247230320,1,2,0
7945637@N07,6702,16,1247222767,1247222767,1,2,0
7945637@N07,6703,26,1255749909,1255750657,4,4,748
7945637@N07,6703,21,1255752070,1255752273,2,4,203
7945637@N07,6703,16,1255749513,1255749513,1,4,0
7945637@N07,6703,23,1255750919,1255750919,1,4,0
7945637@N07,6704,1,1256961851,1256961867,4,1,16
7945637@N07,6705,1,1257496638,1257496647,2,1,9
7945637@N07,6706,26,1258175266,1258175266,1,2,0
7945637@N07,6706,14,1258171375,1258171375,1,2,0
7945637@N07,6707,16,1258795528,1258799152,2,1,3624
7945637@N07,6708,19,1264222935,1264222935,1,1,0
7945637@N07,6709,17,1277714925,1277716448,2,1,1523
7945637@N07,6710,19,1281093113,1281093113,1,1,0
7945637@N07,6711,16,1289216536,1289216536,1,1,0
7945637@N07,6712,11,1293953836,1293955316,2,2,1480
7945637@N07,6712,7,1293955758,1293955758,1,2,0
7945637@N07,6713,26,1296358128,1296358128,1,1,0
7945637@N07,6714,11,1297155768,1297155768,1,1,0
7945637@N07,6715,16,1297417990,1297418840,2,1,850
7945637@N07,6716,16,1323945974,1323945974,1,1,0
7945637@N07,6717,16,1330546723,1330546723,1,2,0
7945637@N07,6717,27,1330547394,1330547394,1,2,0
7945637@N07,6718,14,1350693743,1350693814,2,1,71
79478905@N04,6719,14,1458663214,1458663214,1,1,0
79498503@N03,6720,19,1315715715,1315715715,1,1,0
7955606@N05,6721,27,1217402382,1217402392,2,1,10
7956743@N08,6722,17,1257915664,1257915664,1,3,0
7956743@N08,6722,27,1257905422,1257905564,2,3,142
7956743@N08,6722,6,1257921653,1257921653,1,3,0
79577915@N00,6723,17,1290167950,1290167950,1,4,0
79577915@N00,6723,16,1290130467,1290132901,6,4,2434
79577915@N00,6723,9,1290123277,1290123277,1,4,0
79577915@N00,6723,6,1290154292,1290154292,1,4,0
79577915@N00,6724,20,1290564899,1290564899,1,3,0
79577915@N00,6724,17,1290560804,1290560804,1,3,0
79577915@N00,6724,19,1290551342,1290551822,2,3,480
79599121@N00,6725,9,1418982886,1418982891,2,2,5
79599121@N00,6725,27,1418992522,1418992522,1,2,0
79620786@N08,6726,14,1363400366,1363400366,1,1,0
79639617@N00,6727,27,1453001453,1453008427,6,2,6974
79639617@N00,6727,11,1452989831,1452990009,6,2,178
79642617@N06,6728,14,1355965131,1355965131,1,1,0
7973770@N05,6729,13,1217993000,1217993000,1,7,0
7973770@N05,6729,14,1218010930,1218010930,1,7,0
7973770@N05,6729,27,1217990095,1217990191,2,7,96
7973770@N05,6729,16,1218011704,1218011831,2,7,127
7973770@N05,6729,21,1217996366,1218007975,6,7,11609
7973770@N05,6729,17,1217990634,1217990896,2,7,262
7973770@N05,6729,12,1218014037,1218014037,1,7,0
79761301@N00,6730,27,1287778096,1287791647,3,1,13551
79761301@N00,6731,16,1287834571,1287835814,2,5,1243
79761301@N00,6731,25,1287825439,1287845080,18,5,19641
79761301@N00,6731,27,1287823811,1287846067,28,5,22256
79761301@N00,6731,22,1287828170,1287843575,9,5,15405
79761301@N00,6731,1,1287837522,1287837783,2,5,261
79761301@N00,6732,16,1288017568,1288034664,5,5,17096
79761301@N00,6732,14,1288017912,1288042421,34,5,24509
79761301@N00,6732,17,1288017648,1288041791,16,5,24143
79761301@N00,6732,25,1288023999,1288026411,2,5,2412
79761301@N00,6732,27,1288017357,1288017468,3,5,111
79761301@N00,6733,16,1288265210,1288265210,1,7,0
79761301@N00,6733,14,1288260012,1288260354,6,7,342
79761301@N00,6733,1,1288260678,1288264995,10,7,4317
79761301@N00,6733,17,1288259655,1288259873,4,7,218
79761301@N00,6733,25,1288258870,1288272656,17,7,13786
79761301@N00,6733,22,1288259406,1288270545,5,7,11139
79761301@N00,6733,27,1288257969,1288258578,5,7,609
79761301@N00,6734,17,1402106094,1402106094,1,12,0
79761301@N00,6734,13,1402098028,1402100119,8,12,2091
79761301@N00,6734,4,1402105782,1402105886,3,12,104
79761301@N00,6734,27,1402091874,1402125358,5,12,33484
79761301@N00,6734,18,1402098302,1402098472,2,12,170
79761301@N00,6734,15,1402097831,1402131286,5,12,33455
79761301@N00,6734,2,1402103108,1402103108,1,12,0
79761301@N00,6734,12,1402099985,1402100070,5,12,85
79761301@N00,6734,22,1402108163,1402109077,8,12,914
79761301@N00,6734,10,1402129477,1402130651,2,12,1174
79761301@N00,6734,26,1402109107,1402109107,1,12,0
79761301@N00,6734,16,1402097129,1402126577,2,12,29448
79761301@N00,6735,16,1402238861,1402238861,1,3,0
79761301@N00,6735,14,1402238708,1402238708,1,3,0
79761301@N00,6735,27,1402239889,1402240483,2,3,594
7988769@N08,6736,10,1425693414,1425693414,1,1,0
7988769@N08,6737,17,1458863517,1458863517,1,1,0
7989225@N08,6738,14,1336471506,1336471506,1,1,0
79939076@N02,6739,26,1342405352,1342408591,9,7,3239
79939076@N02,6739,20,1342402494,1342410470,8,7,7976
79939076@N02,6739,25,1342406678,1342435053,6,7,28375
79939076@N02,6739,27,1342399954,1342401191,3,7,1237
79939076@N02,6739,19,1342414112,1342414132,5,7,20
79939076@N02,6739,18,1342411779,1342411803,2,7,24
79939076@N02,6739,17,1342430061,1342432377,3,7,2316
79959485@N00,6740,20,1219105844,1219105867,2,7,23
79959485@N00,6740,1,1219117575,1219117593,2,7,18
79959485@N00,6740,19,1219107217,1219107217,1,7,0
79959485@N00,6740,25,1219103264,1219103391,5,7,127
79959485@N00,6740,14,1219115942,1219115988,2,7,46
79959485@N00,6740,24,1219103754,1219103772,2,7,18
79959485@N00,6740,4,1219119258,1219119267,2,7,9
79959485@N00,6741,16,1219375341,1219375369,2,9,28
79959485@N00,6741,27,1219380469,1219380469,1,9,0
79959485@N00,6741,3,1219376327,1219380444,2,9,4117
79959485@N00,6741,1,1219376007,1219376247,4,9,240
79959485@N00,6741,5,1219375928,1219375957,3,9,29
79959485@N00,6741,17,1219373191,1219373200,2,9,9
79959485@N00,6741,21,1219369151,1219369597,4,9,446
79959485@N00,6741,6,1219375973,1219375991,2,9,18
79959485@N00,6741,13,1219373237,1219374145,7,9,908
79959485@N00,6742,20,1219475565,1219487255,6,3,11690
79959485@N00,6742,19,1219484934,1219486298,4,3,1364
79959485@N00,6742,21,1219483900,1219487345,10,3,3445
79959485@N00,6743,20,1219657975,1219657975,1,4,0
79959485@N00,6743,21,1219658074,1219658074,1,4,0
79959485@N00,6743,13,1219656750,1219657584,4,4,834
79959485@N00,6743,17,1219655705,1219656529,9,4,824
79959485@N00,6744,25,1225364651,1225366048,2,1,1397
79959485@N00,6745,1,1331627453,1331631550,11,8,4097
79959485@N00,6745,27,1331626782,1331637052,3,8,10270
79959485@N00,6745,2,1331627665,1331627726,3,8,61
79959485@N00,6745,16,1331632029,1331632048,3,8,19
79959485@N00,6745,21,1331635353,1331636177,4,8,824
79959485@N00,6745,4,1331627227,1331627271,4,8,44
79959485@N00,6745,17,1331633672,1331634881,2,8,1209
79959485@N00,6745,25,1331636636,1331636701,3,8,65
79959485@N00,6746,8,1331771691,1331771979,9,10,288
79959485@N00,6746,14,1331772255,1331778374,15,10,6119
79959485@N00,6746,23,1331781019,1331783240,17,10,2221
79959485@N00,6746,27,1331770088,1331784921,9,10,14833
79959485@N00,6746,18,1331776029,1331776037,2,10,8
79959485@N00,6746,9,1331778771,1331779153,3,10,382
79959485@N00,6746,17,1331773321,1331775585,11,10,2264
79959485@N00,6746,13,1331776120,1331776843,4,10,723
79959485@N00,6746,25,1331783655,1331783687,3,10,32
79959485@N00,6746,16,1331772603,1331777935,4,10,5332
79959485@N00,6747,27,1332052847,1332062764,13,4,9917
79959485@N00,6747,3,1332059383,1332060553,7,4,1170
79959485@N00,6747,24,1332054209,1332054209,1,4,0
79959485@N00,6747,13,1332057092,1332057104,2,4,12
80084904@N00,6748,27,1200866053,1200866172,10,7,119
80084904@N00,6748,16,1200866061,1200866081,18,7,20
80084904@N00,6748,13,1200866056,1200866092,8,7,36
80084904@N00,6748,21,1200866083,1200866084,2,7,1
80084904@N00,6748,17,1200866085,1200866087,3,7,2
80084904@N00,6748,18,1200866090,1200866090,1,7,0
80084904@N00,6748,14,1200866055,1200866055,1,7,0
80084904@N00,6749,4,1227010912,1227011492,4,7,580
80084904@N00,6749,27,1227009000,1227010591,3,7,1591
80084904@N00,6749,6,1227014433,1227014942,10,7,509
80084904@N00,6749,7,1227015081,1227016651,7,7,1570
80084904@N00,6749,2,1227012709,1227012744,3,7,35
80084904@N00,6749,3,1227012833,1227013972,23,7,1139
80084904@N00,6749,9,1227016663,1227017002,10,7,339
80084904@N00,6750,14,1227288898,1227288898,1,3,0
80084904@N00,6750,12,1227290636,1227290664,3,3,28
80084904@N00,6750,6,1227284545,1227284550,2,3,5
80172766@N04,6751,27,1337424715,1337424715,1,1,0
80172766@N04,6752,16,1337579950,1337579950,1,1,0
8021465@N08,6753,14,1262565443,1262565443,1,1,0
8021465@N08,6754,14,1262822083,1262849390,4,1,27307
8021465@N08,6755,27,1336913546,1336913546,1,1,0
8021465@N08,6756,27,1383107133,1383107133,1,1,0
80304458@N00,6757,4,1419397389,1419397389,1,4,0
80304458@N00,6757,6,1419396555,1419396555,1,4,0
80304458@N00,6757,15,1419399933,1419399933,1,4,0
80304458@N00,6757,9,1419397266,1419397266,1,4,0
80341011@N00,6758,16,1416017895,1416017895,1,1,0
8042568@N06,6759,22,1222086210,1222086210,1,1,0
80446452@N00,6760,23,1328662231,1328662231,1,1,0
80446452@N00,6761,7,1363493950,1363493950,1,2,0
80446452@N00,6761,27,1363483571,1363483678,2,2,107
80446452@N00,6762,27,1367123465,1367123467,2,5,2
80446452@N00,6762,15,1367119605,1367119605,1,5,0
80446452@N00,6762,7,1367114710,1367115034,11,5,324
80446452@N00,6762,8,1367112632,1367115035,14,5,2403
80446452@N00,6762,13,1367119606,1367119606,1,5,0
80446452@N00,6763,7,1456995047,1456995047,1,1,0
8044860@N04,6764,15,1371888950,1371888950,1,1,0
8044860@N04,6765,6,1371984610,1371984610,1,1,0
80521687@N00,6766,9,1349243477,1349243545,2,8,68
80521687@N00,6766,26,1349234486,1349235646,3,8,1160
80521687@N00,6766,25,1349251222,1349251222,1,8,0
80521687@N00,6766,18,1349239675,1349239675,1,8,0
80521687@N00,6766,2,1349234405,1349234431,2,8,26
80521687@N00,6766,16,1349242395,1349258720,7,8,16325
80521687@N00,6766,27,1349229449,1349256102,8,8,26653
80521687@N00,6766,13,1349239767,1349241231,6,8,1464
8054352@N06,6767,27,1355833586,1355833586,1,1,0
8054352@N06,6768,27,1384752558,1384752558,1,1,0
8054352@N06,6769,27,1386365943,1386365943,1,1,0
80558292@N00,6770,14,1382415805,1382415805,1,2,0
80558292@N00,6770,27,1382427161,1382427161,1,2,0
80558292@N00,6771,1,1382668513,1382668513,1,4,0
80558292@N00,6771,24,1382664596,1382664596,1,4,0
80558292@N00,6771,2,1382668580,1382668580,1,4,0
80558292@N00,6771,27,1382663017,1382663017,1,4,0
80558292@N00,6772,27,1383290271,1383290271,1,3,0
80558292@N00,6772,19,1383278839,1383278839,1,3,0
80558292@N00,6772,16,1383280842,1383280842,1,3,0
80578129@N00,6773,20,1366501616,1366501616,1,2,0
80578129@N00,6773,27,1366496323,1366524445,3,2,28122
8066628@N02,6774,7,1287552898,1287552898,1,1,0
8068421@N07,6775,4,1192530880,1192531278,2,1,398
8068421@N07,6776,19,1200972084,1200972084,1,4,0
8068421@N07,6776,13,1200968559,1200968559,1,4,0
8068421@N07,6776,17,1200967338,1200967338,1,4,0
8068421@N07,6776,18,1200969932,1200969932,1,4,0
8068421@N07,6777,27,1209896905,1209896905,1,1,0
8068421@N07,6778,27,1260100396,1260100396,1,1,0
8068421@N07,6779,22,1260601769,1260601769,1,1,0
8068421@N07,6780,27,1287385491,1287385991,3,2,500
8068421@N07,6780,3,1287384559,1287384559,1,2,0
8068421@N07,6781,27,1296008335,1296032787,2,1,24452
8068421@N07,6782,9,1337227331,1337228941,2,1,1610
8068835@N04,6783,27,1333274365,1333286812,9,3,12447
8068835@N04,6783,1,1333282320,1333282338,17,3,18
8068835@N04,6783,6,1333277915,1333278840,26,3,925
8068835@N04,6784,27,1333330838,1333345594,479,12,14756
8068835@N04,6784,2,1333336344,1333337657,30,12,1313
8068835@N04,6784,3,1333337487,1333337557,9,12,70
8068835@N04,6784,15,1333335440,1333335547,12,12,107
8068835@N04,6784,19,1333334272,1333334272,3,12,0
8068835@N04,6784,18,1333333650,1333335093,28,12,1443
8068835@N04,6784,5,1333336248,1333336252,6,12,4
8068835@N04,6784,6,1333336171,1333336221,6,12,50
8068835@N04,6784,17,1333333294,1333335275,18,12,1981
8068835@N04,6784,13,1333334637,1333334638,2,12,1
8068835@N04,6784,14,1333335478,1333335972,31,12,494
8068835@N04,6784,9,1333336015,1333340121,14,12,4106
8068835@N04,6785,27,1333960436,1333969028,29,5,8592
8068835@N04,6785,15,1333963311,1333963469,12,5,158
8068835@N04,6785,17,1333961092,1333964011,21,5,2919
8068835@N04,6785,13,1333961349,1333962963,5,5,1614
8068835@N04,6785,18,1333961622,1333961674,6,5,52
8068835@N04,6786,2,1409799868,1409800342,10,11,474
8068835@N04,6786,1,1409798896,1409799868,8,11,972
8068835@N04,6786,26,1409806656,1409808683,60,11,2027
8068835@N04,6786,15,1409816637,1409816637,4,11,0
8068835@N04,6786,17,1409807959,1409808123,4,11,164
8068835@N04,6786,13,1409811366,1409811508,7,11,142
8068835@N04,6786,22,1409808765,1409808790,4,11,25
8068835@N04,6786,19,1409808850,1409809033,12,11,183
8068835@N04,6786,18,1409808123,1409808824,24,11,701
8068835@N04,6786,12,1409811556,1409811556,3,11,0
8068835@N04,6786,27,1409795733,1409821117,61,11,25384
80722134@N00,6787,17,1237052697,1237052697,1,1,0
80729198@N00,6788,27,1358340639,1358352245,17,1,11606
80729198@N00,6789,27,1370612468,1370623756,10,1,11288
80729198@N00,6790,27,1382006865,1382015258,27,1,8393
80730316@N05,6791,6,1421721895,1421721908,2,2,13
80730316@N05,6791,27,1421748040,1421748047,2,2,7
8074702@N06,6792,27,1371435855,1371435855,1,1,0
80749386@N05,6793,1,1342053848,1342053848,1,2,0
80749386@N05,6793,7,1342053564,1342053564,1,2,0
80775532@N06,6794,27,1442700507,1442700507,1,2,0
80775532@N06,6794,26,1442706275,1442706275,1,2,0
8077563@N08,6795,27,1357935725,1357935725,1,1,0
80784859@N00,6796,16,1307939713,1307939713,1,1,0
8078549@N07,6797,14,1255569506,1255570272,2,1,766
80852176@N00,6798,14,1430868520,1430870526,2,3,2006
80852176@N00,6798,26,1430873656,1430873745,2,3,89
80852176@N00,6798,23,1430884250,1430884250,1,3,0
80852176@N00,6799,25,1431049870,1431049870,1,2,0
80852176@N00,6799,27,1431044804,1431044804,1,2,0
80874876@N07,6800,27,1471171223,1471171223,1,1,0
80874876@N07,6801,27,1471847444,1471862607,25,1,15163
8089996@N06,6802,14,1459829638,1459871730,6,1,42092
80954242@N00,6803,27,1229377774,1229414558,9,1,36784
80954242@N00,6804,18,1244264678,1244284996,44,5,20318
80954242@N00,6804,25,1244280189,1244285004,2,5,4815
80954242@N00,6804,26,1244280026,1244284167,20,5,4141
80954242@N00,6804,27,1244247936,1244248464,9,5,528
80954242@N00,6804,17,1244279680,1244279737,3,5,57
80994469@N00,6805,13,1267759679,1267759679,1,2,0
80994469@N00,6805,18,1267768514,1267768514,1,2,0
8100133@N05,6806,1,1413263750,1413263750,1,2,0
8100133@N05,6806,18,1413254073,1413254073,1,2,0
8100133@N05,6807,2,1413296628,1413296628,1,1,0
81092458@N05,6808,2,1352165128,1352165128,1,2,0
81092458@N05,6808,16,1352172890,1352172890,1,2,0
81092458@N05,6809,14,1352373598,1352373598,1,1,0
81118954@N00,6810,27,1418806251,1418806251,1,1,0
8116972@N07,6811,25,1417565638,1417565638,1,1,0
8116972@N07,6812,9,1417638934,1417638934,1,1,0
8116972@N07,6813,15,1417915091,1417915091,1,1,0
8124939@N07,6814,16,1200553348,1200553349,2,1,1
81291546@N02,6815,26,1343779820,1343779820,1,1,0
81291546@N02,6816,14,1357960492,1357989014,4,4,28522
81291546@N02,6816,27,1357992587,1357992587,1,4,0
81291546@N02,6816,25,1357974874,1357974874,1,4,0
81291546@N02,6816,21,1357975056,1357975056,1,4,0
81291546@N02,6817,22,1382347926,1382347926,1,2,0
81291546@N02,6817,17,1382340819,1382340819,1,2,0
81291546@N02,6818,21,1403356202,1403356202,1,1,0
81291546@N02,6819,14,1408049290,1408049290,1,1,0
81292745@N00,6820,21,1305245908,1305245908,1,1,0
81309725@N00,6821,22,1330045645,1330045645,1,1,0
81322238@N00,6822,13,1274340730,1274340736,2,9,6
81322238@N00,6822,24,1274344756,1274344851,2,9,95
81322238@N00,6822,2,1274338665,1274338665,1,9,0
81322238@N00,6822,4,1274339566,1274339572,3,9,6
81322238@N00,6822,22,1274352576,1274354156,7,9,1580
81322238@N00,6822,1,1274347446,1274350790,5,9,3344
81322238@N00,6822,27,1274338759,1274338759,1,9,0
81322238@N00,6822,16,1274354553,1274354553,1,9,0
81322238@N00,6822,15,1274345664,1274345664,1,9,0
81322238@N00,6823,20,1398985474,1398985474,1,1,0
8136496@N05,6824,19,1262219117,1262220422,5,3,1305
8136496@N05,6824,11,1262244167,1262247301,5,3,3134
8136496@N05,6824,16,1262225216,1262225216,1,3,0
81383122@N05,6825,1,1298505844,1298505849,2,2,5
81383122@N05,6825,17,1298509615,1298516218,4,2,6603
81383122@N05,6826,16,1298547908,1298547908,1,1,0
8141469@N07,6827,16,1197800918,1197800918,1,1,0
81431079@N00,6828,14,1353293206,1353293206,1,1,0
81475308@N00,6829,27,1436782168,1436785189,16,3,3021
81475308@N00,6829,17,1436760797,1436761599,24,3,802
81475308@N00,6829,16,1436744915,1436745025,6,3,110
81546947@N00,6830,1,1193401083,1193401083,1,1,0
81704044@N06,6831,24,1365669360,1365669360,1,1,0
81704044@N06,6832,19,1366187057,1366187057,1,1,0
81704044@N06,6833,17,1367921821,1367921821,1,1,0
81704044@N06,6834,16,1368916353,1368916353,1,1,0
81704044@N06,6835,13,1370507050,1370507050,1,1,0
81713706@N05,6836,15,1399189611,1399190904,5,3,1293
81713706@N05,6836,12,1399176211,1399177081,3,3,870
81713706@N05,6836,7,1399186276,1399186317,6,3,41
81713706@N05,6837,8,1399369060,1399369116,4,2,56
81713706@N05,6837,7,1399369083,1399369118,4,2,35
81713706@N05,6838,13,1399541732,1399541732,1,1,0
81713774@N03,6839,14,1445639576,1445639576,1,1,0
81714212@N05,6840,17,1415423311,1415423311,1,1,0
8177037@N06,6841,27,1339103950,1339128478,27,1,24528
8177037@N06,6842,27,1372020702,1372062083,81,1,41381
81834077@N00,6843,16,1214368625,1214406612,9,2,37987
81834077@N00,6843,27,1214408259,1214408259,1,2,0
8184900@N02,6844,2,1383772638,1383772638,1,1,0
81855582@N00,6845,27,1255064847,1255065091,4,1,244
81932021@N00,6846,9,1230068772,1230070755,3,1,1983
81932021@N00,6847,9,1230107459,1230107459,1,1,0
8193351@N03,6848,14,1283372888,1283374133,3,3,1245
8193351@N03,6848,4,1283376495,1283385260,6,3,8765
8193351@N03,6848,27,1283372324,1283372324,1,3,0
81938914@N00,6849,2,1271563364,1271563364,1,5,0
81938914@N00,6849,4,1271563814,1271563814,1,5,0
81938914@N00,6849,1,1271563376,1271563376,1,5,0
81938914@N00,6849,3,1271563358,1271563358,1,5,0
81938914@N00,6849,16,1271541973,1271541973,1,5,0
82109786@N06,6850,10,1430620863,1430620863,1,4,0
82109786@N06,6850,26,1430622957,1430622958,2,4,1
82109786@N06,6850,9,1430627588,1430627588,1,4,0
82109786@N06,6850,17,1430620866,1430620866,1,4,0
82109786@N06,6851,7,1430952052,1430952069,3,1,17
82109786@N06,6852,15,1445153986,1445153986,1,3,0
82109786@N06,6852,12,1445153989,1445154871,13,3,882
82109786@N06,6852,17,1445152667,1445152667,1,3,0
82109786@N06,6853,27,1445219922,1445219944,4,1,22
82109786@N06,6854,27,1461911899,1461911899,1,3,0
82109786@N06,6854,8,1461895827,1461895940,3,3,113
82109786@N06,6854,1,1461896011,1461896011,1,3,0
82109786@N06,6855,17,1462231378,1462231405,2,2,27
82109786@N06,6855,13,1462231372,1462231372,1,2,0
82211889@N00,6856,2,1326337857,1326340290,2,2,2433
82211889@N00,6856,16,1326332133,1326332133,1,2,0
82211889@N00,6857,18,1326501125,1326502511,5,4,1386
82211889@N00,6857,19,1326501776,1326501921,6,4,145
82211889@N00,6857,9,1326497760,1326497772,5,4,12
82211889@N00,6857,16,1326493419,1326507609,33,4,14190
82211889@N00,6858,16,1326613749,1326613749,1,1,0
82211889@N00,6859,27,1326697879,1326698936,48,1,1057
82211889@N00,6860,6,1326771225,1326771486,2,1,261
82211889@N00,6861,27,1459159644,1459159675,2,1,31
82211889@N00,6862,6,1459315819,1459316068,4,4,249
82211889@N00,6862,27,1459329286,1459329286,1,4,0
82211889@N00,6862,7,1459316039,1459316039,1,4,0
82211889@N00,6862,14,1459314744,1459314756,2,4,12
82211889@N00,6863,10,1459549065,1459549065,1,4,0
82211889@N00,6863,21,1459552688,1459552688,1,4,0
82211889@N00,6863,25,1459551044,1459551044,1,4,0
82211889@N00,6863,9,1459549980,1459549981,2,4,1
82251283@N08,6864,15,1421888724,1421888727,2,3,3
82251283@N08,6864,14,1421886880,1421886959,9,3,79
82251283@N08,6864,27,1421883126,1421883236,9,3,110
8226446@N06,6865,4,1273056969,1273058505,7,2,1536
8226446@N06,6865,2,1273054084,1273056793,14,2,2709
8226892@N07,6866,27,1394022088,1394023043,52,1,955
82335642@N00,6867,17,1258790377,1258790377,1,7,0
82335642@N00,6867,2,1258785456,1258785527,2,7,71
82335642@N00,6867,9,1258787785,1258787785,1,7,0
82335642@N00,6867,4,1258785073,1258785073,1,7,0
82335642@N00,6867,14,1258787884,1258787884,1,7,0
82335642@N00,6867,16,1258781330,1258792408,12,7,11078
82335642@N00,6867,15,1258788561,1258789691,8,7,1130
82335642@N00,6868,16,1258891440,1258891932,6,3,492
82335642@N00,6868,21,1258887148,1258887148,1,3,0
82335642@N00,6868,2,1258883119,1258883868,3,3,749
82335642@N00,6869,16,1259063168,1259064694,7,1,1526
82418556@N00,6870,10,1357865948,1357874252,4,5,8304
82418556@N00,6870,13,1357867859,1357867859,1,5,0
82418556@N00,6870,8,1357867748,1357867748,1,5,0
82418556@N00,6870,14,1357860049,1357865865,3,5,5816
82418556@N00,6870,16,1357872804,1357872804,1,5,0
82418556@N00,6871,1,1357924458,1357924458,1,6,0
82418556@N00,6871,16,1357924764,1357935780,3,6,11016
82418556@N00,6871,4,1357935478,1357935481,2,6,3
82418556@N00,6871,14,1357935721,1357935721,1,6,0
82418556@N00,6871,27,1357924703,1357935332,2,6,10629
82418556@N00,6871,20,1357926067,1357926067,1,6,0
82418556@N00,6872,16,1358010827,1358036475,2,3,25648
82418556@N00,6872,24,1358043666,1358043667,2,3,1
82418556@N00,6872,14,1358021520,1358056307,3,3,34787
82418556@N00,6873,16,1358224523,1358224523,1,1,0
82418556@N00,6874,1,1380771565,1380771565,1,12,0
82418556@N00,6874,16,1380758953,1380758953,1,12,0
82418556@N00,6874,11,1380767061,1380767061,1,12,0
82418556@N00,6874,3,1380770935,1380770935,1,12,0
82418556@N00,6874,19,1380777535,1380777535,1,12,0
82418556@N00,6874,8,1380770358,1380770358,1,12,0
82418556@N00,6874,14,1380764077,1380764077,1,12,0
82418556@N00,6874,20,1380775391,1380776610,2,12,1219
82418556@N00,6874,10,1380767542,1380767542,1,12,0
82418556@N00,6874,17,1380763668,1380763668,1,12,0
82418556@N00,6874,2,1380772980,1380772980,1,12,0
82418556@N00,6874,23,1380782117,1380782117,1,12,0
82418556@N00,6875,16,1389324340,1389324340,1,2,0
82418556@N00,6875,27,1389320402,1389320402,1,2,0
82418556@N00,6876,10,1389405637,1389405637,1,1,0
82418556@N00,6877,1,1399020383,1399020383,1,3,0
82418556@N00,6877,14,1398997826,1398999420,2,3,1594
82418556@N00,6877,27,1399011902,1399011902,1,3,0
82418556@N00,6878,14,1399177910,1399177910,1,1,0
82432080@N00,6879,9,1317349930,1317349930,1,2,0
82432080@N00,6879,12,1317347605,1317347605,1,2,0
82432080@N00,6880,14,1317605660,1317605660,1,5,0
82432080@N00,6880,27,1317608672,1317609569,2,5,897
82432080@N00,6880,5,1317611597,1317611597,1,5,0
82432080@N00,6880,20,1317604031,1317604210,2,5,179
82432080@N00,6880,16,1317608140,1317608140,1,5,0
82507219@N08,6881,5,1381220083,1381220083,1,1,0
82539779@N00,6882,16,1196505359,1196505359,1,1,0
82541612@N00,6883,24,1395114761,1395114761,1,2,0
82541612@N00,6883,12,1395141666,1395141808,2,2,142
82624704@N00,6884,5,1273920762,1273921940,3,4,1178
82624704@N00,6884,8,1273919306,1273919791,16,4,485
82624704@N00,6884,18,1273916472,1273917341,13,4,869
82624704@N00,6884,14,1273917872,1273918962,3,4,1090
82624704@N00,6885,2,1274100855,1274100871,3,4,16
82624704@N00,6885,27,1274095984,1274097155,25,4,1171
82624704@N00,6885,17,1274101188,1274101208,2,4,20
82624704@N00,6885,14,1274101263,1274103286,15,4,2023
82624704@N00,6886,6,1274240726,1274240785,3,5,59
82624704@N00,6886,27,1274233017,1274233214,4,5,197
82624704@N00,6886,2,1274240989,1274241138,4,5,149
82624704@N00,6886,18,1274233556,1274246265,21,5,12709
82624704@N00,6886,1,1274240812,1274240812,1,5,0
82647132@N03,6887,9,1443501466,1443501466,1,1,0
82651370@N03,6888,27,1381811946,1381811946,1,1,0
82651989@N00,6889,9,1321492400,1321492400,1,3,0
82651989@N00,6889,6,1321491100,1321491100,1,3,0
82651989@N00,6889,16,1321492117,1321492117,1,3,0
82688850@N02,6890,16,1292219982,1292219982,1,2,0
82688850@N02,6890,17,1292220166,1292220166,1,2,0
82697718@N07,6891,14,1422841395,1422841395,1,2,0
82697718@N07,6891,22,1422851961,1422851961,1,2,0
8270603@N02,6892,27,1368582887,1368582887,1,11,0
8270603@N02,6892,14,1368594008,1368594181,3,11,173
8270603@N02,6892,15,1368591802,1368591802,1,11,0
8270603@N02,6892,25,1368586258,1368586258,1,11,0
8270603@N02,6892,16,1368608773,1368608773,1,11,0
8270603@N02,6892,9,1368594755,1368603075,6,11,8320
8270603@N02,6892,4,1368604697,1368604697,1,11,0
8270603@N02,6892,22,1368588826,1368588864,3,11,38
8270603@N02,6892,10,1368594286,1368594519,5,11,233
8270603@N02,6892,17,1368589472,1368599040,4,11,9568
8270603@N02,6892,26,1368589004,1368589178,2,11,174
82746306@N00,6893,19,1247793319,1247793319,1,5,0
82746306@N00,6893,16,1247792104,1247836262,20,5,44158
82746306@N00,6893,18,1247792686,1247792686,1,5,0
82746306@N00,6893,7,1247814496,1247814496,1,5,0
82746306@N00,6893,27,1247827324,1247827657,2,5,333
82746306@N00,6894,16,1248426869,1248449342,10,2,22473
82746306@N00,6894,14,1248427282,1248427282,1,2,0
8280384@N03,6895,21,1300326963,1300326963,1,1,0
8282554@N06,6896,5,1278295923,1278295923,1,2,0
8282554@N06,6896,1,1278293951,1278293951,1,2,0
8282554@N06,6897,27,1279795122,1279795122,1,1,0
8282554@N06,6898,2,1324344565,1324344565,1,1,0
82841979@N04,6899,10,1398479372,1398479372,1,1,0
82841979@N04,6900,23,1436586537,1436586537,1,1,0
8285785@N06,6901,27,1404821972,1404822235,10,1,263
82893865@N00,6902,22,1403068351,1403068351,1,2,0
82893865@N00,6902,14,1403051218,1403051218,1,2,0
8290293@N02,6903,16,1227837588,1227838722,2,2,1134
8290293@N02,6903,19,1227833214,1227833214,1,2,0
8297555@N02,6904,27,1240112437,1240112437,1,2,0
8297555@N02,6904,20,1240122426,1240122426,2,2,0
8298273@N05,6905,20,1435113625,1435113625,1,1,0
83035350@N06,6906,17,1362786470,1362786470,1,3,0
83035350@N06,6906,14,1362784716,1362784716,1,3,0
83035350@N06,6906,15,1362784291,1362784291,1,3,0
83083483@N04,6907,9,1399479888,1399479888,1,2,0
83083483@N04,6907,14,1399465665,1399465665,1,2,0
83088992@N06,6908,27,1366051482,1366051482,1,1,0
83092888@N03,6909,21,1379150019,1379150019,1,2,0
83092888@N03,6909,27,1379155677,1379155952,2,2,275
83092888@N03,6910,27,1379369305,1379369305,1,1,0
83092888@N03,6911,27,1380107321,1380107321,1,1,0
83092888@N03,6912,20,1380280432,1380280432,1,1,0
83106697@N00,6913,4,1225250580,1225260417,2,3,9837
83106697@N00,6913,20,1225240552,1225240552,1,3,0
83106697@N00,6913,14,1225235880,1225235903,3,3,23
83106697@N00,6914,16,1354514328,1354514328,1,3,0
83106697@N00,6914,8,1354491263,1354491282,2,3,19
83106697@N00,6914,14,1354496911,1354496911,1,3,0
83106697@N00,6915,6,1354586667,1354586781,2,3,114
83106697@N00,6915,16,1354598005,1354599504,2,3,1499
83106697@N00,6915,2,1354589461,1354590927,2,3,1466
8311873@N03,6916,27,1346808360,1346808360,1,1,0
8311873@N03,6917,13,1349213832,1349213967,3,1,135
8311873@N03,6918,3,1351480813,1351480813,1,10,0
8311873@N03,6918,25,1351457799,1351457799,1,10,0
8311873@N03,6918,5,1351480725,1351480725,1,10,0
8311873@N03,6918,21,1351459168,1351479982,9,10,20814
8311873@N03,6918,24,1351458432,1351458876,4,10,444
8311873@N03,6918,18,1351480396,1351480461,2,10,65
8311873@N03,6918,15,1351480554,1351480554,1,10,0
8311873@N03,6918,20,1351480193,1351480307,3,10,114
8311873@N03,6918,9,1351480651,1351480651,1,10,0
8311873@N03,6918,23,1351458974,1351458974,1,10,0
8311873@N03,6919,13,1354421359,1354422370,2,2,1011
8311873@N03,6919,23,1354422633,1354422633,1,2,0
8311873@N03,6920,14,1354518064,1354518064,1,1,0
8311873@N03,6921,13,1357110012,1357110012,1,1,0
8311873@N03,6922,16,1365589469,1365589969,2,3,500
8311873@N03,6922,21,1365589651,1365589651,1,3,0
8311873@N03,6922,4,1365590549,1365590549,1,3,0
8311873@N03,6923,27,1392784728,1392807164,5,1,22436
8311873@N03,6924,27,1392875494,1392881088,3,1,5594
8311873@N03,6925,4,1393832455,1393832455,1,3,0
8311873@N03,6925,27,1393828779,1393828779,1,3,0
8311873@N03,6925,2,1393829662,1393829662,1,3,0
8311873@N03,6926,20,1394099464,1394099464,1,2,0
8311873@N03,6926,27,1394099719,1394099719,1,2,0
8311873@N03,6927,6,1394441617,1394441617,1,1,0
8311873@N03,6928,27,1394522043,1394522043,1,1,0
8311873@N03,6929,16,1401271711,1401272417,10,1,706
8311873@N03,6930,16,1401309696,1401311347,9,1,1651
8311873@N03,6931,16,1419673428,1419673562,2,2,134
8311873@N03,6931,27,1419673174,1419673174,1,2,0
8311873@N03,6932,8,1420017526,1420017526,1,1,0
8311873@N03,6933,16,1420958401,1420959960,4,3,1559
8311873@N03,6933,9,1420957769,1420959371,3,3,1602
8311873@N03,6933,27,1420959011,1420959011,1,3,0
8311873@N03,6934,27,1421130689,1421130689,1,1,0
8311873@N03,6935,14,1422172081,1422176781,3,1,4700
8311873@N03,6936,8,1423436557,1423436557,1,2,0
8311873@N03,6936,14,1423464162,1423464739,3,2,577
8311873@N03,6937,14,1423894003,1423894003,1,1,0
8311873@N03,6938,15,1424424805,1424424805,1,1,0
8311873@N03,6939,27,1431992185,1431992185,1,1,0
83133472@N05,6940,1,1300501318,1300501318,1,1,0
83133472@N05,6941,6,1347671024,1347671024,1,1,0
83133472@N05,6942,16,1360226490,1360226490,1,3,0
83133472@N05,6942,18,1360215197,1360215197,1,3,0
83133472@N05,6942,25,1360215882,1360215882,1,3,0
83133472@N05,6943,16,1368955996,1368955996,1,1,0
83133472@N05,6944,16,1369315300,1369315300,1,1,0
83133472@N05,6945,16,1369399891,1369399891,1,1,0
83133472@N05,6946,14,1370589143,1370589143,1,2,0
83133472@N05,6946,27,1370591689,1370591689,1,2,0
83133472@N05,6947,24,1370698772,1370698772,1,1,0
83133472@N05,6948,16,1374311504,1374311504,1,1,0
83133472@N05,6949,1,1374838064,1374838064,1,1,0
83133472@N05,6950,16,1376208488,1376208488,1,1,0
83133472@N05,6951,27,1376471837,1376471837,1,1,0
83133472@N05,6952,27,1385785929,1385785929,1,1,0
83133472@N05,6953,27,1386058936,1386058936,1,1,0
83133472@N05,6954,13,1397825450,1397825450,1,1,0
83133472@N05,6955,16,1400243986,1400243986,1,3,0
83133472@N05,6955,27,1400243056,1400243823,5,3,767
83133472@N05,6955,22,1400243120,1400243120,1,3,0
83133472@N05,6956,16,1400321596,1400321596,1,1,0
83133472@N05,6957,27,1410512530,1410512530,1,1,0
83133472@N05,6958,27,1421050108,1421050108,1,2,0
83133472@N05,6958,1,1421050196,1421050196,1,2,0
83167112@N06,6959,15,1389156879,1389156879,1,1,0
83167112@N06,6960,27,1416475783,1416475783,1,1,0
83168551@N00,6961,6,1233544738,1233544738,1,1,0
83206670@N05,6962,27,1314162738,1314162738,1,4,0
83206670@N05,6962,23,1314169264,1314175631,7,4,6367
83206670@N05,6962,25,1314173995,1314174253,5,4,258
83206670@N05,6962,17,1314181323,1314182312,32,4,989
83206670@N05,6963,27,1314656665,1314656869,4,1,204
8325414@N05,6964,12,1296284314,1296284314,1,2,0
8325414@N05,6964,14,1296279565,1296286883,2,2,7318
8327824@N05,6965,16,1354724999,1354749154,8,1,24155
8327824@N05,6966,10,1356664130,1356692782,2,2,28652
8327824@N05,6966,16,1356664011,1356667370,3,2,3359
83286805@N00,6967,23,1320607299,1320607299,1,1,0
8348059@N02,6968,8,1223460962,1223460962,1,1,0
8348059@N02,6969,2,1300660120,1300664091,5,18,3971
8348059@N02,6969,6,1300663604,1300663604,1,18,0
8348059@N02,6969,25,1300664535,1300664778,2,18,243
8348059@N02,6969,21,1300664829,1300671429,9,18,6600
8348059@N02,6969,5,1300663763,1300663763,1,18,0
8348059@N02,6969,19,1300672309,1300674939,6,18,2630
8348059@N02,6969,15,1300656460,1300656876,4,18,416
8348059@N02,6969,24,1300669766,1300670428,18,18,662
8348059@N02,6969,27,1300655037,1300708348,12,18,53311
8348059@N02,6969,17,1300664380,1300681702,25,18,17322
8348059@N02,6969,18,1300676196,1300676196,1,18,0
8348059@N02,6969,20,1300672896,1300672896,1,18,0
8348059@N02,6969,1,1300663308,1300663631,3,18,323
8348059@N02,6969,13,1300667843,1300667915,3,18,72
8348059@N02,6969,3,1300662669,1300663979,2,18,1310
8348059@N02,6969,9,1300656146,1300659936,9,18,3790
8348059@N02,6969,4,1300664172,1300706356,36,18,42184
8348059@N02,6969,12,1300658887,1300659577,24,18,690
8348059@N02,6970,10,1448978402,1449008780,7,17,30378
8348059@N02,6970,12,1449009301,1449050449,13,17,41148
8348059@N02,6970,27,1448974877,1449060110,14,17,85233
8348059@N02,6970,23,1449014478,1449024904,5,17,10426
8348059@N02,6970,26,1449011287,1449011311,2,17,24
8348059@N02,6970,8,1449008322,1449008322,1,17,0
8348059@N02,6970,7,1449008499,1449008526,2,17,27
8348059@N02,6970,20,1449012498,1449012500,2,17,2
8348059@N02,6970,22,1449023593,1449023593,1,17,0
8348059@N02,6970,14,1449049109,1449056721,14,17,7612
8348059@N02,6970,17,1449011132,1449047747,21,17,36615
8348059@N02,6970,16,1449056691,1449056691,1,17,0
8348059@N02,6970,15,1449010109,1449016642,3,17,6533
8348059@N02,6970,13,1449009606,1449010256,3,17,650
8348059@N02,6970,21,1449014188,1449014188,1,17,0
8348059@N02,6970,4,1449018553,1449018553,1,17,0
8348059@N02,6970,19,1449011994,1449018457,2,17,6463
8348059@N02,6971,27,1449111956,1449145273,7,7,33317
8348059@N02,6971,22,1449131031,1449131031,1,7,0
8348059@N02,6971,20,1449129026,1449129026,1,7,0
8348059@N02,6971,17,1449114848,1449144046,16,7,29198
8348059@N02,6971,21,1449128247,1449128300,2,7,53
8348059@N02,6971,9,1449135063,1449135095,2,7,32
8348059@N02,6971,24,1449131891,1449132620,3,7,729
83599989@N00,6972,26,1351054508,1351054508,1,1,0
83657528@N00,6973,1,1299903924,1299903924,1,1,0
8372417@N05,6974,10,1437352343,1437352343,1,3,0
8372417@N05,6974,7,1437364090,1437365091,2,3,1001
8372417@N05,6974,9,1437387303,1437387303,1,3,0
83794242@N07,6975,27,1435826836,1435826836,1,1,0
83794242@N07,6976,21,1449282208,1449282208,1,1,0
83825280@N06,6977,20,1356835813,1356835813,1,1,0
83825280@N06,6978,14,1358758998,1358758998,1,1,0
83825280@N06,6979,9,1359173175,1359173175,1,1,0
83825280@N06,6980,12,1362283540,1362283540,1,1,0
83825280@N06,6981,22,1362690460,1362690460,1,1,0
83848625@N00,6982,16,1456130078,1456130078,1,3,0
83848625@N00,6982,17,1456129746,1456129746,1,3,0
83848625@N00,6982,6,1456104030,1456104030,1,3,0
8391606@N06,6983,4,1210341253,1210341253,1,1,0
83935707@N00,6984,25,1240273195,1240273195,1,7,0
83935707@N00,6984,17,1240280383,1240280383,1,7,0
83935707@N00,6984,5,1240285277,1240285277,1,7,0
83935707@N00,6984,6,1240276703,1240286852,5,7,10149
83935707@N00,6984,27,1240272702,1240272940,4,7,238
83935707@N00,6984,18,1240281173,1240281173,1,7,0
83935707@N00,6984,20,1240279542,1240279542,1,7,0
83935707@N00,6985,1,1271896849,1271897614,2,6,765
83935707@N00,6985,9,1271901129,1271901164,2,6,35
83935707@N00,6985,27,1271893230,1271893436,3,6,206
83935707@N00,6985,4,1271893893,1271897512,2,6,3619
83935707@N00,6985,19,1271913880,1271913880,1,6,0
83935707@N00,6985,6,1271898501,1271901322,2,6,2821
83935707@N00,6986,27,1302993829,1302993829,1,1,0
84013956@N00,6987,25,1325212412,1325230410,2,1,17998
84013956@N00,6988,2,1325304355,1325304355,1,1,0
84013956@N00,6989,27,1357931263,1357931267,4,1,4
84013956@N00,6990,27,1358018484,1358018625,6,1,141
8404074@N04,6991,16,1214753757,1214753757,1,1,0
84057311@N04,6992,16,1415596665,1415596665,1,1,0
84057311@N04,6993,16,1415769000,1415769000,1,1,0
84057763@N00,6994,27,1453001078,1453001078,1,1,0
84057763@N00,6995,27,1453368280,1453368280,1,1,0
8405842@N02,6996,21,1235691161,1235691325,4,10,164
8405842@N02,6996,27,1235688812,1235689125,7,10,313
8405842@N02,6996,26,1235693641,1235693683,2,10,42
8405842@N02,6996,4,1235707079,1235707079,1,10,0
8405842@N02,6996,18,1235699097,1235699199,3,10,102
8405842@N02,6996,9,1235703696,1235703696,1,10,0
8405842@N02,6996,15,1235700529,1235700529,1,10,0
8405842@N02,6996,6,1235703779,1235703779,1,10,0
8405842@N02,6996,20,1235692746,1235695440,4,10,2694
8405842@N02,6996,23,1235691067,1235691067,1,10,0
8405842@N02,6997,27,1235898916,1235898929,2,1,13
84132551@N00,6998,27,1450902610,1450902610,1,1,0
8416606@N06,6999,9,1290757125,1290757125,1,1,0
84168064@N02,7000,19,1445814489,1445814489,1,3,0
84168064@N02,7000,26,1445833105,1445854894,3,3,21789
84168064@N02,7000,17,1445833521,1445850821,3,3,17300
84169004@N00,7001,27,1228272720,1228272720,1,1,0
84169004@N00,7002,23,1228525560,1228525740,2,5,180
84169004@N00,7002,15,1228526520,1228526520,1,5,0
84169004@N00,7002,27,1228527480,1228528560,4,5,1080
84169004@N00,7002,14,1228526340,1228526340,1,5,0
84169004@N00,7002,20,1228525200,1228525260,2,5,60
84169004@N00,7003,9,1228616160,1228616160,1,3,0
84169004@N00,7003,6,1228613940,1228615140,6,3,1200
84169004@N00,7003,2,1228612740,1228612740,1,3,0
84169004@N00,7004,27,1228700040,1228700040,1,2,0
84169004@N00,7004,16,1228700580,1228700700,2,2,120
84169004@N00,7005,8,1228872720,1228872840,2,3,120
84169004@N00,7005,22,1228873680,1228873680,1,3,0
84169004@N00,7005,9,1228872060,1228872240,2,3,180
84169004@N00,7006,14,1228957380,1228957380,1,1,0
84169004@N00,7007,19,1386133229,1386133229,1,1,0
84169004@N00,7008,17,1386485605,1386485605,1,2,0
84169004@N00,7008,18,1386483981,1386483981,1,2,0
84221632@N00,7009,13,1359272231,1359272231,1,2,0
84221632@N00,7009,19,1359266091,1359266091,1,2,0
84221632@N00,7010,10,1359691299,1359691299,1,1,0
84221632@N00,7011,19,1381898594,1381898594,1,2,0
84221632@N00,7011,27,1381896445,1381896445,1,2,0
84221632@N00,7012,18,1423049310,1423049310,1,1,0
84221632@N00,7013,15,1423563228,1423563228,1,1,0
84227486@N02,7014,19,1354748902,1354748916,3,3,14
84227486@N02,7014,14,1354744530,1354746742,2,3,2212
84227486@N02,7014,10,1354750162,1354752214,24,3,2052
84227486@N02,7015,27,1354868539,1354868553,2,2,14
84227486@N02,7015,14,1354869231,1354869231,1,2,0
84227486@N02,7016,12,1366159510,1366159510,1,1,0
84227486@N02,7017,10,1366423618,1366423618,1,1,0
84227486@N02,7018,8,1374537300,1374537754,2,3,454
84227486@N02,7018,3,1374532741,1374532741,1,3,0
84227486@N02,7018,14,1374533580,1374533580,1,3,0
84227486@N02,7019,6,1374661886,1374661886,1,3,0
84227486@N02,7019,27,1374663490,1374663490,1,3,0
84227486@N02,7019,10,1374661165,1374661165,1,3,0
84227486@N02,7020,14,1396144957,1396144957,1,2,0
84227486@N02,7020,4,1396148403,1396148420,2,2,17
84227486@N02,7021,15,1429058206,1429058206,1,1,0
84227486@N02,7022,8,1429249228,1429249251,4,1,23
84337669@N04,7023,16,1378036390,1378036390,1,1,0
84376126@N03,7024,16,1369026180,1369026202,2,4,22
84376126@N03,7024,22,1369024892,1369024892,1,4,0
84376126@N03,7024,27,1369026258,1369028136,4,4,1878
84376126@N03,7024,4,1369028578,1369028769,2,4,191
84496998@N00,7025,16,1257412281,1257412335,7,1,54
84512908@N07,7026,16,1442550619,1442550619,1,1,0
84512908@N07,7027,27,1448025359,1448025359,1,1,0
84531937@N00,7028,18,1309301337,1309302289,2,2,952
84531937@N00,7028,16,1309297921,1309297921,1,2,0
8459320@N03,7029,9,1246597774,1246597774,1,4,0
8459320@N03,7029,19,1246583927,1246583927,1,4,0
8459320@N03,7029,20,1246587518,1246588501,7,4,983
8459320@N03,7029,14,1246580326,1246580326,1,4,0
8459320@N03,7030,27,1246663310,1246664998,6,1,1688
84624316@N03,7031,27,1330919197,1330919204,2,1,7
84687470@N00,7032,16,1322894254,1322894254,1,1,0
84697271@N00,7033,16,1389376421,1389376421,1,1,0
84697271@N00,7034,16,1389462416,1389462416,1,1,0
84713471@N00,7035,20,1377733282,1377733282,1,3,0
84713471@N00,7035,9,1377732407,1377732407,1,3,0
84713471@N00,7035,15,1377730683,1377730683,1,3,0
8476511@N03,7036,13,1304669876,1304669903,20,1,27
84808392@N03,7037,10,1373711779,1373711779,1,1,0
84824340@N07,7038,19,1409984431,1409984431,1,3,0
84824340@N07,7038,27,1409974502,1409974502,1,3,0
84824340@N07,7038,22,1409984081,1409984081,1,3,0
84827867@N00,7039,19,1369606560,1369606840,2,1,280
84861343@N00,7040,2,1330647292,1330648736,3,1,1444
84861343@N00,7041,1,1370758411,1370758411,1,2,0
84861343@N00,7041,14,1370745051,1370745051,1,2,0
84861343@N00,7042,2,1423630363,1423630363,1,1,0
84861343@N00,7043,7,1423798331,1423798331,1,1,0
84897223@N00,7044,15,1434022947,1434022947,1,1,0
8502118@N08,7045,14,1420010808,1420010808,1,3,0
8502118@N08,7045,13,1420015829,1420016065,2,3,236
8502118@N08,7045,27,1420020819,1420020914,5,3,95
85095974@N05,7046,27,1374667257,1374667277,4,1,20
85095974@N05,7047,4,1402669238,1402669276,2,2,38
85095974@N05,7047,2,1402669231,1402669231,1,2,0
85095974@N05,7048,15,1434455410,1434455410,2,4,0
85095974@N05,7048,10,1434447510,1434447539,8,4,29
85095974@N05,7048,13,1434455546,1434455804,18,4,258
85095974@N05,7048,12,1434455413,1434455826,19,4,413
85095974@N05,7049,3,1434539279,1434539569,9,2,290
85095974@N05,7049,2,1434539456,1434539644,16,2,188
85095974@N05,7050,15,1470356112,1470362801,9,8,6689
85095974@N05,7050,17,1470360777,1470361585,3,8,808
85095974@N05,7050,16,1470357487,1470357487,1,8,0
85095974@N05,7050,4,1470387357,1470392561,4,8,5204
85095974@N05,7050,25,1470392186,1470392191,2,8,5
85095974@N05,7050,20,1470366361,1470366364,2,8,3
85095974@N05,7050,12,1470356210,1470356474,16,8,264
85095974@N05,7050,13,1470354935,1470356639,6,8,1704
85095974@N05,7051,9,1470439953,1470439957,2,6,4
85095974@N05,7051,26,1470470787,1470474403,4,6,3616
85095974@N05,7051,23,1470467161,1470469617,4,6,2456
85095974@N05,7051,22,1470470752,1470470752,1,6,0
85095974@N05,7051,25,1470467141,1470472536,15,6,5395
85095974@N05,7051,19,1470444113,1470444209,4,6,96
85095974@N05,7052,17,1470742136,1470743281,5,4,1145
85095974@N05,7052,15,1470744810,1470744857,3,4,47
85095974@N05,7052,12,1470744471,1470744503,4,4,32
85095974@N05,7052,13,1470739625,1470744609,6,4,4984
85095974@N05,7053,14,1470791878,1470791887,2,9,9
85095974@N05,7053,3,1470796142,1470796162,2,9,20
85095974@N05,7053,22,1470789271,1470789271,1,9,0
85095974@N05,7053,26,1470823196,1470823196,1,9,0
85095974@N05,7053,18,1470788897,1470789300,10,9,403
85095974@N05,7053,20,1470821434,1470821434,1,9,0
85095974@N05,7053,2,1470825131,1470827190,6,9,2059
85095974@N05,7053,21,1470784861,1470822260,16,9,37399
85095974@N05,7053,9,1470827915,1470827915,1,9,0
85095974@N05,7054,3,1470878190,1470878218,3,6,28
85095974@N05,7054,2,1470877606,1470878185,10,6,579
85095974@N05,7054,6,1470877697,1470877736,10,6,39
85095974@N05,7054,5,1470877642,1470877690,4,6,48
85095974@N05,7054,4,1470877652,1470878276,6,6,624
85095974@N05,7054,1,1470877767,1470878146,5,6,379
85095974@N05,7055,21,1470914823,1470915356,33,1,533
85121305@N08,7056,16,1261583860,1261583860,1,1,0
85121305@N08,7057,14,1356172119,1356172119,1,3,0
85121305@N08,7057,4,1356175198,1356175198,1,3,0
85121305@N08,7057,16,1356163723,1356175218,5,3,11495
85121305@N08,7058,16,1356348775,1356348775,1,1,0
85121305@N08,7059,13,1440747388,1440747388,1,2,0
85121305@N08,7059,22,1440763732,1440763732,1,2,0
8515441@N06,7060,27,1302043002,1302043002,1,2,0
8515441@N06,7060,17,1302056364,1302056808,20,2,444
8519304@N03,7061,18,1329850101,1329850101,1,1,0
85213896@N00,7062,13,1353192737,1353192737,1,1,0
8523419@N08,7063,15,1214796773,1214796773,1,1,0
85281436@N03,7064,27,1362365175,1362365175,1,1,0
85281436@N03,7065,8,1362491836,1362491836,1,1,0
85281436@N03,7066,21,1362573415,1362573415,1,1,0
85288320@N00,7067,24,1312367945,1312367945,1,4,0
85288320@N00,7067,9,1312366937,1312366937,1,4,0
85288320@N00,7067,18,1312365635,1312366510,17,4,875
85288320@N00,7067,13,1312365918,1312365948,3,4,30
85404061@N00,7068,17,1195860391,1195869437,2,1,9046
85433978@N00,7069,13,1449730287,1449730287,1,2,0
85433978@N00,7069,12,1449729911,1449730349,3,2,438
85433978@N00,7070,15,1449984567,1449984567,1,5,0
85433978@N00,7070,17,1449968945,1449968945,1,5,0
85433978@N00,7070,27,1449956509,1449987222,4,5,30713
85433978@N00,7070,1,1449974676,1449974676,1,5,0
85433978@N00,7070,16,1449957353,1449957353,1,5,0
8544697@N08,7071,16,1267925436,1267925436,1,1,0
8544697@N08,7072,16,1295440406,1295440406,1,1,0
85466831@N00,7073,27,1280876109,1280876109,1,1,0
85509341@N00,7074,21,1392732603,1392732603,1,5,0
85509341@N00,7074,23,1392711133,1392711133,1,5,0
85509341@N00,7074,17,1392719200,1392719200,1,5,0
85509341@N00,7074,14,1392688744,1392694683,4,5,5939
85509341@N00,7074,16,1392732343,1392732343,1,5,0
85509341@N00,7075,2,1435822485,1435822485,1,5,0
85509341@N00,7075,13,1435837907,1435837907,1,5,0
85509341@N00,7075,22,1435833224,1435834031,2,5,807
85509341@N00,7075,25,1435840848,1435840848,1,5,0
85509341@N00,7075,20,1435807262,1435807262,1,5,0
85509341@N00,7076,20,1435899203,1435899203,1,2,0
85509341@N00,7076,27,1435916300,1435916300,1,2,0
85543411@N08,7077,27,1423344500,1423344500,1,1,0
85543411@N08,7078,27,1423689930,1423689930,1,1,0
85543411@N08,7079,27,1428792649,1428792649,1,1,0
85543411@N08,7080,27,1430432799,1430432799,1,1,0
85543411@N08,7081,27,1433110893,1433110893,1,1,0
85543411@N08,7082,27,1438991280,1438991280,1,1,0
85543411@N08,7083,27,1440282887,1440282887,1,1,0
85566955@N00,7084,23,1379394519,1379394872,2,2,353
85566955@N00,7084,27,1379421348,1379421348,1,2,0
85566955@N00,7085,17,1379655095,1379655095,1,2,0
85566955@N00,7085,16,1379655023,1379655023,1,2,0
8562579@N08,7086,17,1315974924,1315974924,1,1,0
8562768@N07,7087,16,1351290477,1351294682,3,6,4205
8562768@N07,7087,14,1351290882,1351293114,25,6,2232
8562768@N07,7087,20,1351298478,1351298480,2,6,2
8562768@N07,7087,26,1351301761,1351301762,2,6,1
8562768@N07,7087,19,1351299892,1351299910,3,6,18
8562768@N07,7087,11,1351319711,1351319855,4,6,144
85631149@N00,7088,3,1393223681,1393223681,1,3,0
85631149@N00,7088,14,1393226069,1393226069,1,3,0
85631149@N00,7088,16,1393198169,1393226880,2,3,28711
85632208@N03,7089,3,1329349565,1329350115,3,5,550
85632208@N03,7089,12,1329327596,1329327596,1,5,0
85632208@N03,7089,13,1329312185,1329312185,1,5,0
85632208@N03,7089,27,1329346353,1329346417,2,5,64
85632208@N03,7089,18,1329310260,1329310425,3,5,165
85639028@N02,7090,16,1386398279,1386413122,3,1,14843
85644119@N00,7091,21,1198712051,1198712051,1,8,0
85644119@N00,7091,27,1198703975,1198704071,2,8,96
85644119@N00,7091,23,1198709879,1198710390,2,8,511
85644119@N00,7091,17,1198704991,1198752889,7,8,47898
85644119@N00,7091,22,1198726573,1198726573,1,8,0
85644119@N00,7091,19,1198727547,1198727547,1,8,0
85644119@N00,7091,11,1198730714,1198730714,1,8,0
85644119@N00,7091,16,1198748699,1198748699,1,8,0
85644119@N00,7092,17,1213055170,1213055170,1,1,0
85644119@N00,7093,22,1213315066,1213327303,2,12,12237
85644119@N00,7093,13,1213317848,1213317848,1,12,0
85644119@N00,7093,18,1213327452,1213327452,1,12,0
85644119@N00,7093,27,1213310119,1213338226,5,12,28107
85644119@N00,7093,17,1213311964,1213355351,14,12,43387
85644119@N00,7093,20,1213315312,1213324743,2,12,9431
85644119@N00,7093,2,1213345651,1213345651,1,12,0
85644119@N00,7093,26,1213314953,1213314953,1,12,0
85644119@N00,7093,19,1213315725,1213322409,4,12,6684
85644119@N00,7093,14,1213342030,1213347177,2,12,5147
85644119@N00,7093,16,1213347117,1213347255,2,12,138
85644119@N00,7093,5,1213312015,1213314519,2,12,2504
85644119@N00,7094,17,1229036873,1229036873,1,1,0
85644119@N00,7095,17,1229295870,1229295870,1,1,0
85644119@N00,7096,12,1248243588,1248243588,1,17,0
85644119@N00,7096,22,1248214585,1248214710,3,17,125
85644119@N00,7096,20,1248214844,1248233415,2,17,18571
85644119@N00,7096,3,1248223129,1248223129,1,17,0
85644119@N00,7096,27,1248213415,1248239041,11,17,25626
85644119@N00,7096,17,1248230033,1248230650,2,17,617
85644119@N00,7096,23,1248224082,1248224082,1,17,0
85644119@N00,7096,4,1248222692,1248254444,3,17,31752
85644119@N00,7096,8,1248240761,1248240761,1,17,0
85644119@N00,7096,13,1248216910,1248216910,1,17,0
85644119@N00,7096,9,1248227060,1248227060,1,17,0
85644119@N00,7096,25,1248221168,1248223933,5,17,2765
85644119@N00,7096,26,1248214573,1248226443,2,17,11870
85644119@N00,7096,19,1248216868,1248219243,2,17,2375
85644119@N00,7096,14,1248227776,1248246994,4,17,19218
85644119@N00,7096,21,1248215387,1248215387,1,17,0
85644119@N00,7096,16,1248254533,1248254540,2,17,7
85644119@N00,7097,2,1261949911,1261949911,1,10,0
85644119@N00,7097,14,1261949399,1261949399,1,10,0
85644119@N00,7097,1,1261952047,1261952180,3,10,133
85644119@N00,7097,4,1261949848,1261967133,3,10,17285
85644119@N00,7097,17,1261953949,1261989832,4,10,35883
85644119@N00,7097,27,1261948392,1262001727,5,10,53335
85644119@N00,7097,23,1261982226,1261982226,1,10,0
85644119@N00,7097,8,1261964226,1261964226,1,10,0
85644119@N00,7097,19,1261954321,1261958856,2,10,4535
85644119@N00,7097,21,1261956138,1261956138,1,10,0
85644119@N00,7098,19,1275873957,1275891358,2,13,17401
85644119@N00,7098,17,1275868147,1275894049,4,13,25902
85644119@N00,7098,16,1275893897,1275893897,1,13,0
85644119@N00,7098,23,1275884439,1275884439,1,13,0
85644119@N00,7098,1,1275864018,1275864081,2,13,63
85644119@N00,7098,4,1275862900,1275867928,3,13,5028
85644119@N00,7098,27,1275862642,1275902392,8,13,39750
85644119@N00,7098,22,1275868230,1275868230,1,13,0
85644119@N00,7098,26,1275892770,1275892770,1,13,0
85644119@N00,7098,13,1275882025,1275882025,1,13,0
85644119@N00,7098,3,1275866470,1275866470,1,13,0
85644119@N00,7098,20,1275873500,1275889905,3,13,16405
85644119@N00,7098,14,1275893580,1275893596,2,13,16
85644119@N00,7099,21,1307415824,1307440947,2,12,25123
85644119@N00,7099,16,1307402273,1307402294,3,12,21
85644119@N00,7099,14,1307425599,1307425599,1,12,0
85644119@N00,7099,13,1307407052,1307407052,1,12,0
85644119@N00,7099,26,1307402555,1307402555,1,12,0
85644119@N00,7099,9,1307437910,1307437910,1,12,0
85644119@N00,7099,7,1307424597,1307424597,1,12,0
85644119@N00,7099,17,1307406962,1307406962,1,12,0
85644119@N00,7099,27,1307432084,1307432084,1,12,0
85644119@N00,7099,20,1307406766,1307406766,1,12,0
85644119@N00,7099,6,1307417024,1307417024,1,12,0
85644119@N00,7099,23,1307440865,1307440865,1,12,0
85644119@N00,7100,21,1324331123,1324332021,2,14,898
85644119@N00,7100,22,1324327503,1324327531,2,14,28
85644119@N00,7100,19,1324327621,1324329028,4,14,1407
85644119@N00,7100,23,1324332082,1324332082,1,14,0
85644119@N00,7100,9,1324372618,1324372618,1,14,0
85644119@N00,7100,26,1324335234,1324335234,1,14,0
85644119@N00,7100,27,1324327604,1324358121,4,14,30517
85644119@N00,7100,5,1324339489,1324339489,1,14,0
85644119@N00,7100,13,1324332338,1324332338,1,14,0
85644119@N00,7100,20,1324331006,1324331034,2,14,28
85644119@N00,7100,17,1324327357,1324359402,4,14,32045
85644119@N00,7100,16,1324359527,1324375798,5,14,16271
85644119@N00,7100,15,1324335030,1324335030,1,14,0
85644119@N00,7100,4,1324324840,1324355275,4,14,30435
85644119@N00,7101,20,1337651433,1337651433,1,1,0
85644119@N00,7102,8,1339737265,1339737265,1,13,0
85644119@N00,7102,20,1339736064,1339736648,2,13,584
85644119@N00,7102,26,1339727397,1339727397,1,13,0
85644119@N00,7102,25,1339744797,1339744797,1,13,0
85644119@N00,7102,22,1339745856,1339745856,1,13,0
85644119@N00,7102,21,1339729250,1339729435,2,13,185
85644119@N00,7102,2,1339713001,1339713908,2,13,907
85644119@N00,7102,23,1339726509,1339730002,3,13,3493
85644119@N00,7102,27,1339708012,1339720420,4,13,12408
85644119@N00,7102,16,1339708556,1339750289,2,13,41733
85644119@N00,7102,14,1339708627,1339750603,3,13,41976
85644119@N00,7102,6,1339711791,1339712565,2,13,774
85644119@N00,7102,4,1339717618,1339743994,3,13,26376
85644119@N00,7103,9,1370580606,1370583142,2,9,2536
85644119@N00,7103,10,1370580718,1370588156,3,9,7438
85644119@N00,7103,26,1370559587,1370559587,1,9,0
85644119@N00,7103,27,1370553982,1370595787,3,9,41805
85644119@N00,7103,13,1370570631,1370570672,2,9,41
85644119@N00,7103,17,1370559418,1370559418,1,9,0
85644119@N00,7103,24,1370562810,1370562810,1,9,0
85644119@N00,7103,14,1370571276,1370591641,4,9,20365
85644119@N00,7103,19,1370565871,1370565991,2,9,120
85644119@N00,7104,27,1402563496,1402564824,2,1,1328
85644119@N00,7105,27,1433674118,1433674163,2,1,45
85644119@N00,7106,13,1434016980,1434017003,2,8,23
85644119@N00,7106,23,1434020019,1434020019,1,8,0
85644119@N00,7106,22,1434021044,1434021044,1,8,0
85644119@N00,7106,27,1433978462,1433978462,1,8,0
85644119@N00,7106,19,1433986037,1433986037,1,8,0
85644119@N00,7106,17,1433978831,1433992530,2,8,13699
85644119@N00,7106,12,1434016571,1434016906,2,8,335
85644119@N00,7106,24,1433980941,1433980941,1,8,0
8565602@N03,7107,13,1330528347,1330528347,1,1,0
8567292@N04,7108,15,1441411461,1441411461,2,1,0
8569755@N06,7109,16,1289569506,1289569506,1,1,0
85744958@N00,7110,16,1255761664,1255763716,7,2,2052
85744958@N00,7110,27,1255764013,1255764013,1,2,0
85744958@N00,7111,27,1319131083,1319143487,14,1,12404
85744958@N00,7112,27,1327994672,1328004650,8,1,9978
85744958@N00,7113,27,1353756104,1353758962,4,1,2858
85744958@N00,7114,9,1353798987,1353809376,24,2,10389
85744958@N00,7114,27,1353798024,1353798062,2,2,38
8576764@N02,7115,27,1335074166,1335074318,5,2,152
8576764@N02,7115,15,1335077124,1335077134,3,2,10
8576764@N02,7116,27,1337185356,1337185356,1,2,0
8576764@N02,7116,15,1337185230,1337185230,1,2,0
8576764@N02,7117,25,1409486355,1409486355,1,8,0
8576764@N02,7117,27,1409474546,1409474546,1,8,0
8576764@N02,7117,16,1409477981,1409477991,4,8,10
8576764@N02,7117,13,1409477695,1409477695,1,8,0
8576764@N02,7117,10,1409482393,1409482424,3,8,31
8576764@N02,7117,18,1409484755,1409484827,3,8,72
8576764@N02,7117,15,1409475829,1409475829,1,8,0
8576764@N02,7117,17,1409475126,1409475126,1,8,0
8576764@N02,7118,27,1409629185,1409629209,3,7,24
8576764@N02,7118,3,1409637003,1409637452,8,7,449
8576764@N02,7118,25,1409631420,1409633516,11,7,2096
8576764@N02,7118,26,1409634890,1409634890,1,7,0
8576764@N02,7118,20,1409647160,1409647160,2,7,0
8576764@N02,7118,9,1409648595,1409648595,1,7,0
8576764@N02,7118,1,1409638750,1409638990,5,7,240
8576764@N02,7119,9,1409820957,1409834399,4,3,13442
8576764@N02,7119,10,1409823300,1409833675,9,3,10375
8576764@N02,7119,7,1409824119,1409824241,8,3,122
8576764@N02,7120,27,1410075477,1410075477,1,1,0
85813749@N00,7121,2,1418707514,1418707514,1,7,0
85813749@N00,7121,4,1418700149,1418708203,2,7,8054
85813749@N00,7121,17,1418713732,1418714020,2,7,288
85813749@N00,7121,19,1418712082,1418712082,1,7,0
85813749@N00,7121,27,1418699533,1418721701,8,7,22168
85813749@N00,7121,13,1418710026,1418710026,1,7,0
85813749@N00,7121,1,1418701678,1418701678,1,7,0
85813749@N00,7122,22,1419079452,1419079607,2,3,155
85813749@N00,7122,18,1419053787,1419053787,1,3,0
85813749@N00,7122,12,1419047753,1419047753,1,3,0
85843151@N00,7123,14,1359856263,1359856263,1,5,0
85843151@N00,7123,27,1359876265,1359894643,4,5,18378
85843151@N00,7123,10,1359861687,1359861831,2,5,144
85843151@N00,7123,2,1359865739,1359865739,1,5,0
85843151@N00,7123,15,1359860317,1359860317,1,5,0
85855667@N00,7124,26,1309227582,1309227582,1,5,0
85855667@N00,7124,13,1309223865,1309223865,1,5,0
85855667@N00,7124,22,1309239003,1309239235,2,5,232
85855667@N00,7124,17,1309240675,1309240675,1,5,0
85855667@N00,7124,21,1309232605,1309232605,1,5,0
85859494@N02,7125,21,1369355641,1369355743,2,7,102
85859494@N02,7125,22,1369362891,1369362903,5,7,12
85859494@N02,7125,24,1369353557,1369353919,3,7,362
85859494@N02,7125,27,1369348849,1369392834,13,7,43985
85859494@N02,7125,18,1369364192,1369364192,1,7,0
85859494@N02,7125,26,1369352337,1369363340,9,7,11003
85859494@N02,7125,25,1369352746,1369352746,1,7,0
85859494@N02,7126,27,1369739019,1369741373,18,2,2354
85859494@N02,7126,3,1369736338,1369736341,2,2,3
85859494@N02,7127,13,1369795157,1369795157,1,2,0
85859494@N02,7127,11,1369790717,1369791475,2,2,758
85859494@N02,7128,9,1370128549,1370130605,8,4,2056
85859494@N02,7128,17,1370130950,1370130950,1,4,0
85859494@N02,7128,14,1370130754,1370130754,1,4,0
85859494@N02,7128,27,1370127966,1370127995,4,4,29
85859494@N02,7129,25,1370392835,1370392835,1,1,0
85863433@N04,7130,26,1323841076,1323841076,1,2,0
85863433@N04,7130,6,1323830252,1323830252,1,2,0
85863433@N04,7131,4,1323938498,1323938613,3,1,115
85864407@N08,7132,21,1384487138,1384487340,2,4,202
85864407@N08,7132,10,1384500741,1384503438,4,4,2697
85864407@N08,7132,13,1384489189,1384497463,5,4,8274
85864407@N08,7132,22,1384484822,1384485793,2,4,971
85864407@N08,7133,16,1384605601,1384605601,1,4,0
85864407@N08,7133,9,1384600401,1384600401,1,4,0
85864407@N08,7133,22,1384597154,1384597154,1,4,0
85864407@N08,7133,10,1384600908,1384600908,1,4,0
85864407@N08,7134,2,1384776639,1384776639,1,7,0
85864407@N08,7134,13,1384756043,1384756043,1,7,0
85864407@N08,7134,16,1384758873,1384781636,2,7,22763
85864407@N08,7134,9,1384779893,1384779893,1,7,0
85864407@N08,7134,19,1384771256,1384771256,1,7,0
85864407@N08,7134,14,1384756893,1384781395,2,7,24502
85864407@N08,7134,22,1384773798,1384773798,1,7,0
85864407@N08,7135,21,1385008877,1385008877,1,6,0
85864407@N08,7135,13,1384994497,1384994723,5,6,226
85864407@N08,7135,5,1384990919,1384990919,1,6,0
85864407@N08,7135,14,1385017530,1385017530,1,6,0
85864407@N08,7135,4,1385021514,1385021514,1,6,0
85864407@N08,7135,27,1385011369,1385011369,1,6,0
85879323@N08,7136,10,1450256245,1450256245,1,1,0
85882671@N00,7137,16,1415508931,1415508931,1,2,0
85882671@N00,7137,21,1415503785,1415503785,1,2,0
85909608@N00,7138,17,1296960969,1296960983,2,3,14
85909608@N00,7138,27,1296945721,1296945721,1,3,0
85909608@N00,7138,18,1296957174,1296958478,7,3,1304
85909608@N00,7139,17,1337512843,1337513279,26,1,436
85912588@N00,7140,8,1353540047,1353540047,1,1,0
85921343@N08,7141,27,1379972305,1379972305,1,1,0
85940078@N07,7142,14,1362904489,1362904489,1,1,0
85977134@N00,7143,22,1356940745,1356940745,1,1,0
8599745@N08,7144,1,1210766228,1210766228,1,8,0
8599745@N08,7144,18,1210766228,1210766228,2,8,0
8599745@N08,7144,11,1210765768,1210765768,1,8,0
8599745@N08,7144,13,1210765768,1210765768,1,8,0
8599745@N08,7144,22,1210766228,1210766228,1,8,0
8599745@N08,7144,9,1210765119,1210766228,2,8,1109
8599745@N08,7144,24,1210765119,1210765119,2,8,0
8599745@N08,7144,27,1210766438,1210766438,1,8,0
86001309@N00,7145,5,1335775784,1335775784,1,1,0
86001309@N00,7146,10,1359098375,1359098375,1,1,0
86061580@N00,7147,4,1290753805,1290753805,1,2,0
86061580@N00,7147,14,1290759559,1290763112,8,2,3553
86111910@N03,7148,9,1348380506,1348380560,2,3,54
86111910@N03,7148,26,1348394151,1348394151,1,3,0
86111910@N03,7148,24,1348397674,1348397674,1,3,0
86177168@N03,7149,15,1281931725,1281931725,1,1,0
8619760@N07,7150,22,1191725052,1191753096,66,1,28044
86235456@N07,7151,9,1452669511,1452669511,1,1,0
86275327@N00,7152,9,1209423194,1209423253,2,2,59
86275327@N00,7152,22,1209425761,1209425761,1,2,0
86278660@N00,7153,14,1386143556,1386143649,2,1,93
86278660@N00,7154,14,1388308642,1388308642,1,1,0
86285103@N00,7155,16,1260778410,1260778417,4,3,7
86285103@N00,7155,17,1260778458,1260779900,79,3,1442
86285103@N00,7155,25,1260773114,1260775833,16,3,2719
86285103@N00,7156,24,1260829592,1260830052,35,11,460
86285103@N00,7156,19,1260832311,1260832354,8,11,43
86285103@N00,7156,18,1260833567,1260836023,55,11,2456
86285103@N00,7156,26,1260829476,1260829487,4,11,11
86285103@N00,7156,13,1260836029,1260862415,10,11,26386
86285103@N00,7156,20,1260832468,1260833559,10,11,1091
86285103@N00,7156,23,1260829515,1260829515,2,11,0
86285103@N00,7156,27,1260838432,1260838432,4,11,0
86285103@N00,7156,12,1260836474,1260837043,73,11,569
86285103@N00,7156,22,1260832666,1260835894,10,11,3228
86285103@N00,7156,25,1260829371,1260829544,10,11,173
8638605@N02,7157,14,1211516909,1211516909,1,4,0
8638605@N02,7157,9,1211516577,1211516760,3,4,183
8638605@N02,7157,1,1211516133,1211516262,2,4,129
8638605@N02,7157,13,1211516986,1211516986,1,4,0
8638605@N02,7158,24,1275651615,1275651846,3,3,231
8638605@N02,7158,20,1275653342,1275653342,1,3,0
8638605@N02,7158,27,1275649517,1275650694,21,3,1177
8638605@N02,7159,17,1275733036,1275737639,12,1,4603
8638605@N02,7160,6,1275831233,1275831233,1,4,0
8638605@N02,7160,9,1275832543,1275832580,4,4,37
8638605@N02,7160,5,1275831212,1275831212,1,4,0
8638605@N02,7160,3,1275830540,1275830837,3,4,297
8638605@N02,7161,6,1275959394,1275959425,3,11,31
8638605@N02,7161,11,1275958579,1275958697,6,11,118
8638605@N02,7161,2,1275951790,1275952690,6,11,900
8638605@N02,7161,8,1275958620,1275959003,4,11,383
8638605@N02,7161,20,1275953817,1275954926,3,11,1109
8638605@N02,7161,19,1275957042,1275958389,22,11,1347
8638605@N02,7161,9,1275959255,1275959265,3,11,10
8638605@N02,7161,4,1275951649,1275951649,1,11,0
8638605@N02,7161,14,1275953057,1275953057,1,11,0
8638605@N02,7161,18,1275956028,1275956028,1,11,0
8638605@N02,7161,7,1275959030,1275959067,3,11,37
86459399@N00,7162,27,1255246418,1255246418,1,1,0
86459399@N00,7163,21,1255414740,1255417639,5,2,2899
86459399@N00,7163,27,1255412565,1255412565,1,2,0
86459399@N00,7164,27,1275173648,1275176845,3,2,3197
86459399@N00,7164,21,1275185361,1275185361,1,2,0
86459399@N00,7165,11,1291687552,1291687552,1,2,0
86459399@N00,7165,27,1291685485,1291687539,3,2,2054
86459399@N00,7166,19,1291794187,1291794340,2,1,153
86459399@N00,7167,19,1291860963,1291864090,3,3,3127
86459399@N00,7167,21,1291865658,1291865658,1,3,0
86459399@N00,7167,27,1291871022,1291871022,1,3,0
86459399@N00,7168,2,1296360576,1296360576,1,3,0
86459399@N00,7168,6,1296381780,1296381780,1,3,0
86459399@N00,7168,27,1296353276,1296366009,12,3,12733
86459399@N00,7169,20,1318847157,1318849251,2,2,2094
86459399@N00,7169,27,1318844662,1318844954,6,2,292
86459399@N00,7170,27,1318916771,1318943877,5,4,27106
86459399@N00,7170,20,1318930865,1318930865,1,4,0
86459399@N00,7170,17,1318923954,1318923954,1,4,0
86459399@N00,7170,14,1318927468,1318927479,2,4,11
86459399@N00,7171,27,1319082183,1319082190,2,1,7
86459399@N00,7172,14,1350101283,1350130334,2,2,29051
86459399@N00,7172,25,1350125128,1350125128,1,2,0
86459399@N00,7173,20,1350205639,1350205639,1,4,0
86459399@N00,7173,24,1350202950,1350203012,2,4,62
86459399@N00,7173,2,1350198690,1350198696,2,4,6
86459399@N00,7173,27,1350192899,1350192899,1,4,0
86459399@N00,7174,17,1350267288,1350267288,1,1,0
86459399@N00,7175,19,1350304289,1350304289,1,2,0
86459399@N00,7175,3,1350307916,1350307939,3,2,23
86459399@N00,7176,17,1350384040,1350384051,8,1,11
86459399@N00,7177,7,1367054893,1367059872,4,3,4979
86459399@N00,7177,27,1367057687,1367057727,8,3,40
86459399@N00,7177,4,1367051986,1367052009,5,3,23
86459399@N00,7178,22,1367112890,1367112890,1,2,0
86459399@N00,7178,26,1367112664,1367112664,2,2,0
86476099@N00,7179,19,1261443151,1261443151,1,1,0
86482004@N00,7180,7,1337563144,1337563257,4,10,113
86482004@N00,7180,6,1337562649,1337563311,12,10,662
86482004@N00,7180,11,1337579689,1337579689,1,10,0
86482004@N00,7180,24,1337572905,1337573209,9,10,304
86482004@N00,7180,4,1337560954,1337560954,1,10,0
86482004@N00,7180,27,1337560359,1337560359,1,10,0
86482004@N00,7180,1,1337563122,1337566731,6,10,3609
86482004@N00,7180,8,1337566919,1337567115,5,10,196
86482004@N00,7180,23,1337574146,1337574544,5,10,398
86482004@N00,7180,20,1337570216,1337579396,2,10,9180
86493735@N00,7181,16,1298466000,1298466000,1,1,0
86493735@N00,7182,20,1298510452,1298510452,1,5,0
86493735@N00,7182,1,1298517966,1298517966,1,5,0
86493735@N00,7182,19,1298504697,1298513150,2,5,8453
86493735@N00,7182,17,1298507573,1298507573,1,5,0
86493735@N00,7182,13,1298508092,1298508092,1,5,0
86499991@N00,7183,16,1198027128,1198052821,5,1,25693
86643038@N07,7184,27,1399982880,1399982881,2,1,1
86650842@N07,7185,27,1419806437,1419806437,1,1,0
86694404@N00,7186,5,1244370425,1244370425,1,1,0
86694404@N00,7187,9,1244503437,1244504339,2,6,902
86694404@N00,7187,6,1244505932,1244505932,1,6,0
86694404@N00,7187,5,1244502536,1244528972,7,6,26436
86694404@N00,7187,18,1244526811,1244526819,2,6,8
86694404@N00,7187,2,1244520334,1244520381,6,6,47
86694404@N00,7187,17,1244509831,1244526832,5,6,17001
86694404@N00,7188,5,1244763687,1244795324,5,3,31637
86694404@N00,7188,27,1244801343,1244805252,3,3,3909
86694404@N00,7188,18,1244775011,1244775011,1,3,0
86712012@N00,7189,17,1228875149,1228875149,1,1,0
86719158@N00,7190,7,1299216364,1299216364,1,6,0
86719158@N00,7190,19,1299201314,1299201324,2,6,10
86719158@N00,7190,27,1299203931,1299221092,14,6,17161
86719158@N00,7190,12,1299216853,1299216860,2,6,7
86719158@N00,7190,14,1299190402,1299190402,1,6,0
86719158@N00,7190,9,1299216575,1299216575,1,6,0
86761686@N00,7191,19,1227400752,1227400752,1,1,0
86840096@N03,7192,16,1420290288,1420290288,1,1,0
86843321@N04,7193,21,1381624199,1381624199,1,1,0
86864767@N00,7194,13,1205081084,1205081490,2,3,406
86864767@N00,7194,12,1205083542,1205083542,1,3,0
86864767@N00,7194,15,1205082853,1205082853,1,3,0
86864767@N00,7195,24,1205152889,1205153103,2,1,214
86889597@N00,7196,4,1233632290,1233632290,1,1,0
86889597@N00,7197,16,1233908163,1233908163,1,1,0
86902064@N02,7198,27,1397713045,1397713045,1,1,0
86917764@N00,7199,7,1222058946,1222058946,1,3,0
86917764@N00,7199,6,1222059413,1222059421,2,3,8
86917764@N00,7199,17,1222078615,1222079637,28,3,1022
86961551@N00,7200,9,1419679198,1419679201,2,11,3
86961551@N00,7200,17,1419659420,1419659431,2,11,11
86961551@N00,7200,18,1419659458,1419660415,3,11,957
86961551@N00,7200,25,1419640682,1419640788,4,11,106
86961551@N00,7200,20,1419642118,1419650413,31,11,8295
86961551@N00,7200,6,1419666319,1419666683,7,11,364
86961551@N00,7200,21,1419641677,1419651346,3,11,9669
86961551@N00,7200,14,1419685108,1419685108,1,11,0
86961551@N00,7200,27,1419637501,1419637544,3,11,43
86961551@N00,7200,19,1419655649,1419655653,2,11,4
86961551@N00,7200,22,1419642308,1419642308,1,11,0
8702124@N05,7201,26,1317205983,1317205983,1,1,0
8702274@N07,7202,17,1227672572,1227672572,1,1,0
87029301@N00,7203,27,1364890975,1364890975,1,1,0
87049901@N00,7204,1,1317207087,1317207087,1,1,0
87060797@N07,7205,11,1345954552,1345954552,1,4,0
87060797@N07,7205,16,1345942971,1345943977,20,4,1006
87060797@N07,7205,14,1345943000,1345943415,2,4,415
87060797@N07,7205,15,1345957116,1345957116,1,4,0
87076987@N05,7206,10,1358216846,1358216846,1,1,0
87110377@N07,7207,1,1226666878,1226666878,1,1,0
87173471@N00,7208,12,1323218708,1323218708,1,1,0
87226959@N05,7209,21,1367116337,1367118378,55,1,2041
87261736@N00,7210,14,1443143856,1443143856,1,1,0
87267387@N00,7211,19,1230691120,1230691120,1,1,0
87267387@N00,7212,1,1230775541,1230775541,1,1,0
8729032@N06,7213,27,1224312773,1224313115,3,1,342
8729032@N06,7214,21,1224375420,1224375420,1,9,0
8729032@N06,7214,4,1224373519,1224373519,1,9,0
8729032@N06,7214,8,1224375659,1224375659,1,9,0
8729032@N06,7214,18,1224396283,1224396283,1,9,0
8729032@N06,7214,7,1224375293,1224375293,1,9,0
8729032@N06,7214,1,1224373498,1224373664,6,9,166
8729032@N06,7214,27,1224376032,1224376032,1,9,0
8729032@N06,7214,6,1224373676,1224373676,1,9,0
8729032@N06,7214,26,1224397163,1224397163,1,9,0
8729032@N06,7215,19,1287878951,1287878972,3,11,21
8729032@N06,7215,21,1287880657,1287886502,3,11,5845
8729032@N06,7215,4,1287872288,1287873826,8,11,1538
8729032@N06,7215,18,1287878819,1287879552,5,11,733
8729032@N06,7215,2,1287872294,1287873637,5,11,1343
8729032@N06,7215,13,1287876294,1287879348,13,11,3054
8729032@N06,7215,5,1287872332,1287872332,1,11,0
8729032@N06,7215,3,1287872317,1287872410,5,11,93
8729032@N06,7215,12,1287875421,1287876104,25,11,683
8729032@N06,7215,27,1287869711,1287887441,24,11,17730
8729032@N06,7215,17,1287879774,1287879819,4,11,45
8729032@N06,7216,12,1373345227,1373345412,2,8,185
8729032@N06,7216,1,1373334795,1373334836,3,8,41
8729032@N06,7216,13,1373345643,1373345643,1,8,0
8729032@N06,7216,7,1373342703,1373342703,1,8,0
8729032@N06,7216,27,1373330983,1373331081,4,8,98
8729032@N06,7216,8,1373342691,1373342691,1,8,0
8729032@N06,7216,17,1373345241,1373347928,21,8,2687
8729032@N06,7216,11,1373342713,1373342762,3,8,49
8729032@N06,7217,21,1373500556,1373501477,13,4,921
8729032@N06,7217,17,1373510955,1373510994,3,4,39
8729032@N06,7217,25,1373500167,1373500220,2,4,53
8729032@N06,7217,27,1373499760,1373499971,4,4,211
8729032@N06,7218,7,1387320962,1387321026,3,16,64
8729032@N06,7218,9,1387319817,1387324260,14,16,4443
8729032@N06,7218,8,1387320932,1387325005,25,16,4073
8729032@N06,7218,10,1387321378,1387326431,25,16,5053
8729032@N06,7218,11,1387321988,1387322093,7,16,105
8729032@N06,7218,26,1387344120,1387344120,1,16,0
8729032@N06,7218,5,1387319831,1387319831,1,16,0
8729032@N06,7218,13,1387325407,1387329068,26,16,3661
8729032@N06,7218,16,1387349445,1387349445,1,16,0
8729032@N06,7218,1,1387321081,1387321081,1,16,0
8729032@N06,7218,12,1387327827,1387327855,2,16,28
8729032@N06,7218,18,1387329896,1387333829,90,16,3933
8729032@N06,7218,6,1387321059,1387321061,2,16,2
8729032@N06,7218,21,1387334429,1387335939,4,16,1510
8729032@N06,7218,17,1387344118,1387351253,3,16,7135
8729032@N06,7218,27,1387318759,1387355241,20,16,36482
8729032@N06,7219,12,1418084407,1418085737,56,15,1330
8729032@N06,7219,18,1418083064,1418084298,36,15,1234
8729032@N06,7219,9,1418083813,1418086980,7,15,3167
8729032@N06,7219,11,1418103698,1418104064,6,15,366
8729032@N06,7219,20,1418102937,1418103519,2,15,582
8729032@N06,7219,19,1418103532,1418103572,5,15,40
8729032@N06,7219,1,1418090759,1418093265,22,15,2506
8729032@N06,7219,13,1418079338,1418099407,12,15,20069
8729032@N06,7219,14,1418085936,1418085971,2,15,35
8729032@N06,7219,10,1418087217,1418089526,13,15,2309
8729032@N06,7219,27,1418077763,1418104326,3,15,26563
8729032@N06,7219,6,1418089656,1418089656,1,15,0
8729032@N06,7219,17,1418079129,1418079131,2,15,2
8729032@N06,7219,2,1418093272,1418095735,11,15,2463
8729032@N06,7219,26,1418080667,1418082381,29,15,1714
8729032@N06,7220,3,1428813953,1428813953,1,2,0
8729032@N06,7220,9,1428813932,1428814560,4,2,628
8729032@N06,7221,15,1456630211,1456630211,1,1,0
8729032@N06,7222,21,1458284294,1458284294,1,1,0
8730186@N03,7223,17,1427678946,1427680905,2,1,1959
8732544@N07,7224,26,1252286626,1252326045,24,1,39419
8738175@N08,7225,22,1274599856,1274600809,4,1,953
87415005@N02,7226,7,1417406570,1417408404,7,4,1834
87415005@N02,7226,14,1417392724,1417392828,4,4,104
87415005@N02,7226,9,1417404192,1417404192,1,4,0
87415005@N02,7226,27,1417390092,1417398468,22,4,8376
87447493@N00,7227,27,1383173719,1383193784,2,2,20065
87447493@N00,7227,13,1383194080,1383194080,1,2,0
87507703@N04,7228,19,1356482497,1356493315,3,12,10818
87507703@N04,7228,20,1356488596,1356492903,4,12,4307
87507703@N04,7228,4,1356495165,1356510545,3,12,15380
87507703@N04,7228,3,1356510394,1356510394,1,12,0
87507703@N04,7228,21,1356489702,1356489801,2,12,99
87507703@N04,7228,15,1356507700,1356507700,1,12,0
87507703@N04,7228,18,1356483357,1356484013,6,12,656
87507703@N04,7228,17,1356481979,1356481979,1,12,0
87507703@N04,7228,27,1356493970,1356494408,6,12,438
87507703@N04,7228,16,1356506937,1356507638,6,12,701
87507703@N04,7228,22,1356481992,1356489060,5,12,7068
87507703@N04,7228,14,1356507105,1356507105,1,12,0
87549191@N00,7229,16,1338812612,1338812612,1,1,0
87598282@N03,7230,14,1355118615,1355118615,1,1,0
8760137@N08,7231,27,1189656097,1189656097,1,1,0
8760137@N08,7232,18,1281579825,1281579825,1,2,0
8760137@N08,7232,20,1281579825,1281579825,1,2,0
87621759@N05,7233,2,1289712219,1289712219,1,1,0
87635169@N02,7234,16,1197791960,1197791960,1,1,0
87723016@N00,7235,13,1379466144,1379466144,1,2,0
87723016@N00,7235,27,1379455342,1379455342,1,2,0
87723016@N00,7236,21,1379632276,1379632276,1,1,0
87723016@N00,7237,27,1379755594,1379755594,1,2,0
87723016@N00,7237,22,1379751799,1379751799,1,2,0
87744557@N00,7238,6,1201824595,1201824596,2,6,1
87744557@N00,7238,7,1201824594,1201824594,1,6,0
87744557@N00,7238,27,1201828411,1201828411,2,6,0
87744557@N00,7238,23,1201824593,1201824593,1,6,0
87744557@N00,7238,1,1201824559,1201824559,1,6,0
87744557@N00,7238,21,1201824594,1201824594,1,6,0
8783683@N08,7239,18,1313304520,1313304520,1,1,0
87847222@N03,7240,7,1363232883,1363232891,2,1,8
87847222@N03,7241,12,1401249084,1401249084,1,2,0
87847222@N03,7241,26,1401254291,1401254734,4,2,443
87847222@N03,7242,27,1401449450,1401449450,1,2,0
87847222@N03,7242,9,1401446229,1401446229,1,2,0
87854506@N04,7243,10,1352332112,1352332112,1,1,0
87854506@N04,7244,4,1355551975,1355551975,1,1,0
87854506@N04,7245,25,1363417353,1363417396,4,3,43
87854506@N04,7245,6,1363423739,1363423739,1,3,0
87854506@N04,7245,1,1363406345,1363406345,1,3,0
87854506@N04,7246,27,1376641079,1376641525,4,1,446
8789515@N06,7247,17,1310319917,1310319920,2,1,3
87895332@N08,7248,16,1387342260,1387342260,1,2,0
87895332@N08,7248,27,1387342384,1387342384,1,2,0
87903999@N03,7249,27,1441375211,1441375212,2,1,1
87903999@N03,7250,24,1450443604,1450443606,3,4,2
87903999@N03,7250,17,1450443603,1450443624,3,4,21
87903999@N03,7250,16,1450443600,1450443646,4,4,46
87903999@N03,7250,14,1450443601,1450443642,3,4,41
87907279@N06,7251,27,1367018872,1367018872,1,1,0
87953089@N04,7252,24,1389828987,1389829510,15,13,523
87953089@N04,7252,25,1389829374,1389829495,5,13,121
87953089@N04,7252,26,1389827960,1389827982,3,13,22
87953089@N04,7252,14,1389850577,1389851954,10,13,1377
87953089@N04,7252,27,1389825263,1389825977,9,13,714
87953089@N04,7252,9,1389837276,1389841023,4,13,3747
87953089@N04,7252,12,1389834799,1389834965,5,13,166
87953089@N04,7252,13,1389832300,1389835123,7,13,2823
87953089@N04,7252,15,1389834170,1389851313,5,13,17143
87953089@N04,7252,17,1389832173,1389832250,5,13,77
87953089@N04,7252,2,1389840642,1389853530,4,13,12888
87953089@N04,7252,21,1389829827,1389829864,2,13,37
87953089@N04,7252,20,1389831667,1389831736,4,13,69
87983801@N08,7253,6,1382264976,1382277619,12,1,12643
87983801@N08,7254,6,1382756332,1382786020,34,1,29688
88007935@N02,7255,15,1418690056,1418690056,1,3,0
88007935@N02,7255,14,1418706096,1418706146,2,3,50
88007935@N02,7255,17,1418701917,1418701917,1,3,0
8803306@N02,7256,27,1224265516,1224265516,1,1,0
8803306@N02,7257,27,1224325500,1224330025,5,1,4525
8803306@N02,7258,27,1224553259,1224553259,1,1,0
8803306@N02,7259,27,1224666044,1224666044,1,1,0
8803306@N02,7260,27,1225878324,1225878324,1,1,0
8803306@N02,7261,27,1227348249,1227359291,4,1,11042
8803306@N02,7262,27,1227522168,1227522168,1,1,0
8803306@N02,7263,27,1235706892,1235706892,1,1,0
8803306@N02,7264,26,1235779853,1235779853,1,9,0
8803306@N02,7264,14,1235784135,1235784135,1,9,0
8803306@N02,7264,15,1235784039,1235784086,3,9,47
8803306@N02,7264,8,1235787172,1235787172,1,9,0
8803306@N02,7264,19,1235775372,1235776946,4,9,1574
8803306@N02,7264,27,1235771068,1235820402,13,9,49334
8803306@N02,7264,1,1235809009,1235809009,1,9,0
8803306@N02,7264,23,1235774577,1235774577,1,9,0
8803306@N02,7264,16,1235786231,1235786231,1,9,0
8803306@N02,7265,27,1235894247,1235894247,1,1,0
8803306@N02,7266,27,1251503555,1251503555,1,1,0
8803306@N02,7267,16,1251546445,1251546445,1,1,0
8803306@N02,7268,14,1265419428,1265419428,1,1,0
8803306@N02,7269,17,1274578258,1274578258,1,4,0
8803306@N02,7269,27,1274567343,1274567343,1,4,0
8803306@N02,7269,20,1274579108,1274579108,1,4,0
8803306@N02,7269,13,1274572557,1274572579,2,4,22
8803306@N02,7270,13,1296972715,1296972715,1,4,0
8803306@N02,7270,27,1296978878,1296978878,1,4,0
8803306@N02,7270,15,1296970874,1296970874,1,4,0
8803306@N02,7270,7,1296980791,1296980791,1,4,0
8803306@N02,7271,13,1305968651,1305968651,1,2,0
8803306@N02,7271,14,1305972896,1305972896,1,2,0
8803306@N02,7272,14,1327377759,1327377759,1,1,0
8803306@N02,7273,11,1331967383,1331967383,1,1,0
88078923@N04,7274,8,1415580366,1415580372,2,1,6
88078923@N04,7275,16,1415664110,1415664110,1,2,0
88078923@N04,7275,14,1415659289,1415664658,8,2,5369
88078923@N04,7276,17,1415750697,1415750728,2,3,31
88078923@N04,7276,19,1415749575,1415749579,4,3,4
88078923@N04,7276,10,1415769289,1415769289,1,3,0
88078923@N04,7277,16,1415872765,1415872765,1,2,0
88078923@N04,7277,27,1415864620,1415864662,2,2,42
88087621@N00,7278,27,1345191982,1345194527,2,1,2545
88095899@N05,7279,14,1300663111,1300663111,1,1,0
88095899@N05,7280,17,1369889694,1369889694,1,1,0
88095899@N05,7281,21,1377656984,1377656984,1,2,0
88095899@N05,7281,6,1377666610,1377666610,1,2,0
88095899@N05,7282,14,1425091021,1425091021,1,1,0
88158593@N00,7283,6,1305795810,1305795857,3,1,47
88158593@N00,7284,1,1334379200,1334379200,1,1,0
88168516@N02,7285,26,1344559353,1344562536,2,7,3183
88168516@N02,7285,17,1344557462,1344557462,1,7,0
88168516@N02,7285,19,1344557139,1344557139,1,7,0
88168516@N02,7285,21,1344555336,1344555359,3,7,23
88168516@N02,7285,20,1344556108,1344557133,3,7,1025
88168516@N02,7285,18,1344557635,1344558007,2,7,372
88168516@N02,7285,13,1344559073,1344559100,2,7,27
88201963@N00,7286,18,1444799558,1444802628,4,2,3070
88201963@N00,7286,17,1444796304,1444796315,3,2,11
88201963@N00,7287,18,1444898503,1444898514,2,5,11
88201963@N00,7287,22,1444898596,1444898596,1,5,0
88201963@N00,7287,9,1444877220,1444877230,3,5,10
88201963@N00,7287,14,1444896537,1444897068,4,5,531
88201963@N00,7287,4,1444906849,1444906853,2,5,4
88201963@N00,7288,5,1445083042,1445083042,1,4,0
88201963@N00,7288,27,1445046703,1445067125,11,4,20422
88201963@N00,7288,3,1445083024,1445083024,1,4,0
88201963@N00,7288,4,1445083090,1445083298,7,4,208
88249284@N00,7289,14,1217419741,1217419782,2,1,41
8831977@N05,7290,14,1200455641,1200455641,1,1,0
88322185@N00,7291,16,1195814902,1195815706,3,1,804
8838492@N05,7292,11,1198201907,1198202096,2,7,189
8838492@N05,7292,8,1198202025,1198202025,1,7,0
8838492@N05,7292,9,1198200523,1198200776,2,7,253
8838492@N05,7292,27,1198196969,1198197343,6,7,374
8838492@N05,7292,22,1198212350,1198213422,2,7,1072
8838492@N05,7292,18,1198206237,1198206237,1,7,0
8838492@N05,7292,17,1198210114,1198210759,30,7,645
88479439@N03,7293,8,1350909292,1350909292,1,5,0
88479439@N03,7293,6,1350891279,1350910099,4,5,18820
88479439@N03,7293,4,1350910719,1350910719,1,5,0
88479439@N03,7293,7,1350891285,1350891285,1,5,0
88479439@N03,7293,14,1350910975,1350911201,2,5,226
88487062@N00,7294,23,1319366430,1319366911,13,3,481
88487062@N00,7294,9,1319358887,1319359878,18,3,991
88487062@N00,7294,27,1319351753,1319364660,9,3,12907
88487062@N00,7295,16,1319419498,1319422629,5,6,3131
88487062@N00,7295,17,1319424106,1319424168,4,6,62
88487062@N00,7295,14,1319428377,1319429092,8,6,715
88487062@N00,7295,4,1319418431,1319418433,2,6,2
88487062@N00,7295,27,1319427961,1319434548,2,6,6587
88487062@N00,7295,1,1319419218,1319419218,1,6,0
88504071@N00,7296,2,1211507115,1211507158,3,2,43
88504071@N00,7296,25,1211498986,1211498986,1,2,0
88504071@N00,7297,25,1211582452,1211582452,1,1,0
88518643@N06,7298,9,1375665066,1375665082,2,1,16
8854930@N07,7299,18,1351673773,1351673773,1,1,0
8854930@N07,7300,9,1383535264,1383535277,2,1,13
88653431@N00,7301,17,1338599442,1338599442,1,1,0
88653431@N00,7302,2,1338681873,1338681873,1,3,0
88653431@N00,7302,24,1338693186,1338693186,1,3,0
88653431@N00,7302,3,1338682981,1338682981,1,3,0
88689129@N07,7303,27,1322601546,1322601546,1,1,0
88711965@N00,7304,27,1380461323,1380461323,1,1,0
88711965@N00,7305,24,1380593456,1380593456,1,3,0
88711965@N00,7305,27,1380582092,1380582092,1,3,0
88711965@N00,7305,16,1380589656,1380589656,1,3,0
88711965@N00,7306,27,1380629378,1380629378,1,1,0
88785574@N00,7307,17,1340001077,1340018304,2,4,17227
88785574@N00,7307,9,1339979097,1339979097,1,4,0
88785574@N00,7307,20,1339992663,1339992672,2,4,9
88785574@N00,7307,13,1339983921,1339983921,1,4,0
88785574@N00,7308,27,1340240234,1340240234,1,1,0
88785574@N00,7309,22,1340422546,1340422546,1,1,0
88859710@N03,7310,17,1350700687,1350700687,1,1,0
88859710@N03,7311,27,1378346443,1378346443,1,2,0
88859710@N03,7311,17,1378350083,1378350083,1,2,0
88859710@N03,7312,27,1379302322,1379302472,2,1,150
88859710@N03,7313,5,1381538837,1381538837,1,1,0
88859710@N03,7314,27,1384735366,1384736712,3,1,1346
88859710@N03,7315,22,1384842021,1384842111,2,2,90
88859710@N03,7315,27,1384826329,1384835102,2,2,8773
8886608@N06,7316,16,1413246003,1413246003,1,1,0
88915883@N00,7317,27,1395698969,1395732521,55,1,33552
88949796@N00,7318,25,1374660371,1374660481,2,5,110
88949796@N00,7318,6,1374659982,1374659982,1,5,0
88949796@N00,7318,23,1374660603,1374660603,1,5,0
88949796@N00,7318,16,1374669178,1374669178,1,5,0
88949796@N00,7318,4,1374668137,1374668137,1,5,0
88959316@N00,7319,1,1193470895,1193471176,3,2,281
88959316@N00,7319,27,1193456018,1193479444,2,2,23426
88984016@N00,7320,16,1348830115,1348830115,1,1,0
88984016@N00,7321,27,1349037474,1349059208,2,1,21734
88984016@N00,7322,20,1349194007,1349194007,1,2,0
88984016@N00,7322,11,1349196979,1349196979,1,2,0
88984016@N00,7323,21,1349288740,1349288740,1,2,0
88984016@N00,7323,11,1349287073,1349287108,2,2,35
88994581@N00,7324,13,1351220009,1351220009,1,3,0
88994581@N00,7324,20,1351212559,1351212559,1,3,0
88994581@N00,7324,1,1351219992,1351219992,1,3,0
88994581@N00,7325,10,1367050545,1367050545,1,1,0
89072528@N00,7326,18,1402101779,1402102754,2,1,975
89076265@N02,7327,14,1357779842,1357779842,1,5,0
89076265@N02,7327,4,1357809703,1357809721,2,5,18
89076265@N02,7327,19,1357778194,1357778194,1,5,0
89076265@N02,7327,17,1357781961,1357781961,1,5,0
89076265@N02,7327,11,1357799295,1357800449,2,5,1154
89138020@N00,7328,15,1241143835,1241159722,30,9,15887
89138020@N00,7328,5,1241171138,1241171948,9,9,810
89138020@N00,7328,23,1241135620,1241136994,11,9,1374
89138020@N00,7328,6,1241164648,1241169494,13,9,4846
89138020@N00,7328,20,1241137763,1241139302,5,9,1539
89138020@N00,7328,11,1241159931,1241164336,20,9,4405
89138020@N00,7328,27,1241134978,1241135527,5,9,549
89138020@N00,7328,13,1241142312,1241143492,2,9,1180
89138020@N00,7328,19,1241138180,1241138180,1,9,0
89138020@N00,7329,11,1241857233,1241857652,8,5,419
89138020@N00,7329,27,1241847096,1241847628,4,5,532
89138020@N00,7329,15,1241858235,1241858235,1,5,0
89138020@N00,7329,25,1241850344,1241850359,2,5,15
89138020@N00,7329,16,1241858282,1241858554,9,5,272
89286166@N02,7330,16,1345756224,1345756224,1,1,0
89286166@N02,7331,16,1357302440,1357302440,1,1,0
89388234@N00,7332,10,1371694495,1371694495,1,3,0
89388234@N00,7332,6,1371692810,1371692810,1,3,0
89388234@N00,7332,25,1371687669,1371687669,1,3,0
89451823@N08,7333,19,1357079602,1357079602,2,1,0
89451823@N08,7334,4,1357110720,1357110720,1,2,0
89451823@N08,7334,5,1357110690,1357110690,1,2,0
89451823@N08,7335,10,1378979488,1378979488,1,3,0
89451823@N08,7335,4,1378980560,1378980560,1,3,0
89451823@N08,7335,9,1378978796,1378978796,1,3,0
89451823@N08,7336,23,1379029565,1379029565,1,2,0
89451823@N08,7336,27,1379042559,1379042559,1,2,0
89451823@N08,7337,2,1388716140,1388716140,1,5,0
89451823@N08,7337,19,1388724419,1388725047,3,5,628
89451823@N08,7337,17,1388713904,1388714288,3,5,384
89451823@N08,7337,8,1388701053,1388701053,1,5,0
89451823@N08,7337,6,1388718700,1388718700,1,5,0
89451823@N08,7338,4,1398330353,1398330353,2,4,0
89451823@N08,7338,7,1398338525,1398338525,1,4,0
89451823@N08,7338,9,1398338984,1398339128,2,4,144
89451823@N08,7338,8,1398338784,1398338784,1,4,0
89451823@N08,7339,20,1398467252,1398467252,1,4,0
89451823@N08,7339,3,1398471978,1398472146,3,4,168
89451823@N08,7339,14,1398463866,1398463866,1,4,0
89451823@N08,7339,26,1398464389,1398464389,2,4,0
89451823@N08,7340,3,1398552094,1398552094,1,2,0
89451823@N08,7340,6,1398551529,1398551529,2,2,0
89455189@N05,7341,27,1396852285,1396852352,2,4,67
89455189@N05,7341,25,1396853182,1396853182,2,4,0
89455189@N05,7341,17,1396864670,1396864676,2,4,6
89455189@N05,7341,13,1396866802,1396866802,1,4,0
89455201@N00,7342,19,1230694798,1230694798,1,1,0
8949620@N08,7343,27,1199106000,1199106000,2,1,0
8949620@N08,7344,16,1209999909,1210000095,6,5,186
8949620@N08,7344,17,1209999731,1209999731,1,5,0
8949620@N08,7344,19,1210000173,1210000173,1,5,0
8949620@N08,7344,26,1209999832,1209999869,2,5,37
8949620@N08,7344,13,1209999770,1209999770,1,5,0
8949620@N08,7345,18,1244200763,1244200910,2,4,147
8949620@N08,7345,12,1244190232,1244190416,6,4,184
8949620@N08,7345,27,1244164608,1244201482,9,4,36874
8949620@N08,7345,22,1244164575,1244200313,3,4,35738
8951720@N04,7346,27,1304298279,1304299115,9,1,836
89522530@N00,7347,23,1332319755,1332319760,2,15,5
89522530@N00,7347,5,1332298449,1332317912,5,15,19463
89522530@N00,7347,15,1332287018,1332287018,1,15,0
89522530@N00,7347,4,1332299600,1332311395,2,15,11795
89522530@N00,7347,14,1332277324,1332316396,6,15,39072
89522530@N00,7347,8,1332293415,1332293534,5,15,119
89522530@N00,7347,1,1332317728,1332317728,1,15,0
89522530@N00,7347,25,1332299819,1332304533,2,15,4714
89522530@N00,7347,13,1332283811,1332283811,1,15,0
89522530@N00,7347,27,1332276343,1332329056,4,15,52713
89522530@N00,7347,24,1332304734,1332304734,1,15,0
89522530@N00,7347,16,1332277145,1332280937,13,15,3792
89522530@N00,7347,9,1332281720,1332292051,10,15,10331
89522530@N00,7347,6,1332317975,1332317975,1,15,0
89522530@N00,7347,7,1332292461,1332292814,3,15,353
89582403@N08,7348,27,1354404223,1354404223,1,1,0
89634087@N00,7349,2,1298880923,1298880923,1,2,0
89634087@N00,7349,17,1298880929,1298880929,1,2,0
89760541@N02,7350,27,1349494041,1349494477,2,1,436
8980678@N03,7351,18,1190706195,1190707054,2,3,859
8980678@N03,7351,27,1190703882,1190703882,1,3,0
8980678@N03,7351,21,1190708423,1190708423,1,3,0
8980678@N03,7352,11,1194414697,1194414697,1,3,0
8980678@N03,7352,13,1194411745,1194411745,1,3,0
8980678@N03,7352,18,1194410954,1194410954,1,3,0
8980678@N03,7353,18,1197356625,1197356625,1,1,0
8980678@N03,7354,27,1204088160,1204088221,2,1,61
8980678@N03,7355,17,1205627842,1205627842,1,1,0
8980678@N03,7356,8,1211340269,1211340269,1,1,0
8980678@N03,7357,21,1226472365,1226472805,3,1,440
8980678@N03,7358,9,1236747239,1236747239,1,2,0
8980678@N03,7358,14,1236746868,1236746868,1,2,0
8980678@N03,7359,27,1257116300,1257116300,1,1,0
8980678@N03,7360,27,1258080780,1258080780,1,1,0
8980678@N03,7361,22,1264751648,1264751648,1,1,0
8980678@N03,7362,21,1272182552,1272182552,1,1,0
8980678@N03,7363,17,1279110385,1279110385,1,1,0
8980678@N03,7364,16,1282870144,1282870144,1,2,0
8980678@N03,7364,14,1282868881,1282868881,1,2,0
8980678@N03,7365,16,1290126099,1290126099,1,1,0
8980678@N03,7366,16,1290155342,1290155342,1,1,0
8980678@N03,7367,22,1297407569,1297407673,2,1,104
8980678@N03,7368,18,1302837195,1302837264,3,1,69
8980678@N03,7369,14,1307067152,1307067940,3,5,788
8980678@N03,7369,26,1307063383,1307063383,1,5,0
8980678@N03,7369,21,1307062359,1307062359,1,5,0
8980678@N03,7369,9,1307058692,1307058692,1,5,0
8980678@N03,7369,27,1307075948,1307075948,1,5,0
8980678@N03,7370,13,1308440101,1308444052,2,2,3951
8980678@N03,7370,18,1308439261,1308439261,1,2,0
8980678@N03,7371,14,1315108919,1315108919,1,4,0
8980678@N03,7371,23,1315099769,1315099769,1,4,0
8980678@N03,7371,21,1315101101,1315101464,2,4,363
8980678@N03,7371,4,1315117306,1315117306,1,4,0
8980678@N03,7372,27,1326434853,1326434853,1,2,0
8980678@N03,7372,16,1326429570,1326429570,1,2,0
8980678@N03,7373,10,1350099465,1350102812,12,1,3347
8980678@N03,7374,16,1350717542,1350717542,1,2,0
8980678@N03,7374,8,1350721525,1350721525,1,2,0
8980678@N03,7375,10,1352677031,1352678038,4,1,1007
8980678@N03,7376,27,1358817373,1358829672,19,1,12299
8980678@N03,7377,15,1369631061,1369631061,1,1,0
8980678@N03,7378,21,1379163163,1379163163,1,2,0
8980678@N03,7378,10,1379158950,1379158950,1,2,0
8980678@N03,7379,20,1400858263,1400858263,1,1,0
8980678@N03,7380,27,1411278147,1411278147,1,1,0
8980678@N03,7381,24,1418448022,1418448022,1,1,0
89823107@N00,7382,27,1233182744,1233182744,1,1,0
89823107@N00,7383,27,1233255465,1233284463,5,1,28998
89862145@N00,7384,16,1353914838,1353914838,1,1,0
89938050@N07,7385,8,1350298831,1350298831,1,5,0
89938050@N07,7385,6,1350288312,1350288312,1,5,0
89938050@N07,7385,7,1350285588,1350285588,1,5,0
89938050@N07,7385,27,1350283362,1350283364,2,5,2
89938050@N07,7385,4,1350296187,1350296187,1,5,0
89939063@N03,7386,17,1369104298,1369104324,2,1,26
8996989@N02,7387,20,1238020624,1238020624,1,1,0
90008840@N00,7388,15,1370944905,1370944905,1,1,0
90008840@N00,7389,1,1439031983,1439031983,1,1,0
90008840@N00,7390,4,1461990316,1461990316,1,1,0
90028379@N00,7391,26,1232273375,1232280588,6,1,7213
90028379@N00,7392,27,1269662854,1269666331,3,1,3477
90067442@N03,7393,14,1376701534,1376701534,1,1,0
90099586@N00,7394,27,1314239800,1314239800,1,1,0
90112536@N00,7395,20,1224737891,1224737891,1,3,0
90112536@N00,7395,24,1224749095,1224749095,1,3,0
90112536@N00,7395,18,1224728959,1224729108,2,3,149
90115276@N00,7396,26,1204278041,1204278041,1,1,0
90123960@N00,7397,16,1270254476,1270261458,2,1,6982
9026784@N08,7398,14,1356565610,1356565909,2,1,299
9026784@N08,7399,17,1385435258,1385457166,2,2,21908
9026784@N08,7399,14,1385436945,1385436945,1,2,0
90315279@N00,7400,14,1369192513,1369192513,1,5,0
90315279@N00,7400,5,1369197648,1369197648,2,5,0
90315279@N00,7400,4,1369196118,1369196175,2,5,57
90315279@N00,7400,18,1369182351,1369182351,1,5,0
90315279@N00,7400,10,1369194740,1369194740,1,5,0
90315279@N00,7401,14,1443146448,1443148819,2,1,2371
90347114@N05,7402,27,1397090891,1397092311,21,8,1420
90347114@N05,7402,6,1397094307,1397094349,7,8,42
90347114@N05,7402,2,1397096968,1397096971,4,8,3
90347114@N05,7402,3,1397098564,1397098583,4,8,19
90347114@N05,7402,17,1397128431,1397128431,1,8,0
90347114@N05,7402,18,1397117139,1397117235,3,8,96
90347114@N05,7402,1,1397098160,1397098160,1,8,0
90347114@N05,7402,9,1397107097,1397107097,1,8,0
90347114@N05,7403,27,1397698992,1397700407,3,1,1415
90351516@N00,7404,9,1451519598,1451521368,3,2,1770
90351516@N00,7404,27,1451536471,1451536471,1,2,0
9036688@N06,7405,27,1285853401,1285853499,4,8,98
9036688@N06,7405,5,1285857480,1285857984,4,8,504
9036688@N06,7405,18,1285861795,1285863060,4,8,1265
9036688@N06,7405,26,1285860418,1285862155,6,8,1737
9036688@N06,7405,1,1285856261,1285856261,1,8,0
9036688@N06,7405,6,1285858411,1285859248,4,8,837
9036688@N06,7405,14,1285859520,1285859823,7,8,303
9036688@N06,7405,15,1285859935,1285859935,1,8,0
9036688@N06,7406,16,1316996655,1317013905,9,2,17250
9036688@N06,7406,3,1317004508,1317013693,21,2,9185
9036688@N06,7407,2,1317127592,1317127592,1,3,0
9036688@N06,7407,16,1317121937,1317121937,1,3,0
9036688@N06,7407,26,1317121944,1317121997,2,3,53
9036688@N06,7408,14,1317345253,1317345253,1,3,0
9036688@N06,7408,9,1317351374,1317351374,1,3,0
9036688@N06,7408,25,1317351384,1317351384,1,3,0
9036688@N06,7409,27,1317463587,1317465649,12,2,2062
9036688@N06,7409,16,1317454174,1317464460,2,2,10286
90367727@N00,7410,9,1366094261,1366094261,1,1,0
9036889@N06,7411,16,1352442670,1352442670,1,3,0
9036889@N06,7411,7,1352441361,1352441361,1,3,0
9036889@N06,7411,8,1352441258,1352441258,1,3,0
9036889@N06,7412,14,1384682815,1384682836,2,4,21
9036889@N06,7412,10,1384688233,1384689023,5,4,790
9036889@N06,7412,12,1384683908,1384684056,28,4,148
9036889@N06,7412,2,1384692758,1384693673,27,4,915
9036889@N06,7413,6,1417768667,1417768667,1,2,0
9036889@N06,7413,9,1417771180,1417771180,1,2,0
90370508@N02,7414,22,1436157122,1436157127,2,2,5
90370508@N02,7414,20,1436175300,1436175300,1,2,0
90468007@N00,7415,9,1202730999,1202730999,1,1,0
90475653@N00,7416,16,1324984308,1324984308,1,1,0
90496636@N05,7417,17,1423386492,1423386492,1,1,0
90496636@N05,7418,14,1432701657,1432701873,2,1,216
9051885@N06,7419,11,1275460107,1275475105,10,10,14998
9051885@N06,7419,25,1275467842,1275468038,4,10,196
9051885@N06,7419,8,1275461815,1275461951,8,10,136
9051885@N06,7419,27,1275436093,1275436093,1,10,0
9051885@N06,7419,7,1275461274,1275461278,2,10,4
9051885@N06,7419,24,1275466171,1275466317,2,10,146
9051885@N06,7419,23,1275467526,1275467526,1,10,0
9051885@N06,7419,9,1275446757,1275446757,1,10,0
9051885@N06,7419,21,1275464193,1275464193,1,10,0
9051885@N06,7419,14,1275441200,1275441651,6,10,451
9053157@N02,7420,14,1340502346,1340502346,1,2,0
9053157@N02,7420,17,1340502333,1340502333,1,2,0
9053157@N02,7421,27,1342433721,1342433721,1,1,0
90533800@N00,7422,6,1329777546,1329777562,4,2,16
90533800@N00,7422,27,1329795163,1329795163,1,2,0
90533800@N00,7423,6,1330057276,1330057276,1,3,0
90533800@N00,7423,7,1330057293,1330057315,2,3,22
90533800@N00,7423,2,1330057253,1330057259,2,3,6
90562571@N00,7424,27,1406766681,1406766722,4,2,41
90562571@N00,7424,19,1406775370,1406778752,11,2,3382
90584232@N07,7425,27,1353464221,1353464221,1,1,0
90603065@N06,7426,14,1451373665,1451398303,2,2,24638
90603065@N06,7426,10,1451354087,1451354087,1,2,0
90603065@N06,7427,27,1469257679,1469257679,1,1,0
90603065@N06,7428,15,1470479181,1470479181,1,1,0
90642923@N00,7429,9,1193541239,1193541239,1,2,0
90642923@N00,7429,13,1193538100,1193538100,1,2,0
90642923@N00,7430,6,1199614794,1199614794,1,2,0
90642923@N00,7430,19,1199603364,1199603364,1,2,0
90642923@N00,7431,19,1199692212,1199692841,2,2,629
90642923@N00,7431,20,1199691993,1199691993,1,2,0
90642923@N00,7432,4,1205460426,1205460426,1,2,0
90642923@N00,7432,17,1205457984,1205457984,1,2,0
90642923@N00,7433,27,1222784326,1222784326,1,5,0
90642923@N00,7433,9,1222783775,1222783775,1,5,0
90642923@N00,7433,22,1222778977,1222780155,33,5,1178
90642923@N00,7433,6,1222770899,1222770920,2,5,21
90642923@N00,7433,17,1222780376,1222780376,1,5,0
90642923@N00,7434,24,1249356944,1249356993,3,1,49
90642923@N00,7435,20,1270096087,1270096087,1,6,0
90642923@N00,7435,26,1270094996,1270094996,1,6,0
90642923@N00,7435,1,1270098888,1270098888,1,6,0
90642923@N00,7435,7,1270096698,1270096698,1,6,0
90642923@N00,7435,6,1270097275,1270097684,2,6,409
90642923@N00,7435,17,1270094106,1270094106,1,6,0
9070451@N03,7436,20,1400445129,1400449235,11,8,4106
9070451@N03,7436,19,1400450172,1400450285,3,8,113
9070451@N03,7436,18,1400450869,1400451617,2,8,748
9070451@N03,7436,22,1400452378,1400453052,2,8,674
9070451@N03,7436,27,1400444482,1400444578,3,8,96
9070451@N03,7436,6,1400457484,1400457484,1,8,0
9070451@N03,7436,2,1400458288,1400461582,4,8,3294
9070451@N03,7436,9,1400454732,1400454846,2,8,114
9070451@N03,7437,18,1400576502,1400576502,1,2,0
9070451@N03,7437,25,1400572334,1400573887,3,2,1553
9070451@N03,7438,22,1400740730,1400741586,2,1,856
9070451@N03,7439,13,1400845672,1400845672,1,6,0
9070451@N03,7439,22,1400848650,1400848650,1,6,0
9070451@N03,7439,10,1400827810,1400839450,5,6,11640
9070451@N03,7439,7,1400827689,1400827689,1,6,0
9070451@N03,7439,8,1400827589,1400827589,1,6,0
9070451@N03,7439,9,1400842277,1400842277,1,6,0
9070451@N03,7440,13,1400897681,1400899469,28,6,1788
9070451@N03,7440,20,1400906444,1400906484,4,6,40
9070451@N03,7440,9,1400892176,1400892566,7,6,390
9070451@N03,7440,14,1400893360,1400893360,1,6,0
9070451@N03,7440,27,1400889087,1400889160,4,6,73
9070451@N03,7440,22,1400900775,1400900824,2,6,49
90728477@N00,7441,25,1369410829,1369410829,1,2,0
90728477@N00,7441,21,1369408721,1369408721,1,2,0
90728477@N00,7442,4,1369564854,1369564854,1,2,0
90728477@N00,7442,21,1369557399,1369557399,1,2,0
90728477@N00,7443,4,1371896925,1371896925,1,12,0
90728477@N00,7443,27,1371851403,1371859690,2,12,8287
90728477@N00,7443,8,1371861807,1371861807,1,12,0
90728477@N00,7443,10,1371860276,1371860276,1,12,0
90728477@N00,7443,17,1371882865,1371907813,3,12,24948
90728477@N00,7443,18,1371885431,1371885431,1,12,0
90728477@N00,7443,1,1371873724,1371896506,3,12,22782
90728477@N00,7443,7,1371861567,1371861567,1,12,0
90728477@N00,7443,21,1371869071,1371889488,3,12,20417
90728477@N00,7443,9,1371877763,1371877763,1,12,0
90728477@N00,7443,23,1371888564,1371888564,1,12,0
90728477@N00,7443,14,1371862520,1371879984,4,12,17464
90745831@N00,7444,24,1348844467,1348844467,1,2,0
90745831@N00,7444,27,1348844514,1348844514,1,2,0
90755543@N00,7445,11,1396425324,1396425324,1,4,0
90755543@N00,7445,16,1396409877,1396409877,1,4,0
90755543@N00,7445,10,1396408696,1396409330,2,4,634
90755543@N00,7445,4,1396417495,1396417495,1,4,0
90791262@N00,7446,16,1267587582,1267587582,1,1,0
90844305@N00,7447,19,1215321799,1215321799,1,2,0
90844305@N00,7447,20,1215318661,1215318661,1,2,0
90850703@N04,7448,27,1364998899,1364998899,1,2,0
90850703@N04,7448,9,1364999158,1364999158,1,2,0
90863949@N00,7449,16,1259486859,1259486859,1,2,0
90863949@N00,7449,12,1259486866,1259486867,2,2,1
90906438@N03,7450,27,1364858818,1364898740,9,1,39922
91013187@N00,7451,26,1191207369,1191207369,1,1,0
91045059@N02,7452,18,1358476583,1358476583,1,8,0
91045059@N02,7452,7,1358462487,1358463087,6,8,600
91045059@N02,7452,6,1358485023,1358500681,43,8,15658
91045059@N02,7452,21,1358471289,1358471360,2,8,71
91045059@N02,7452,20,1358469516,1358471013,4,8,1497
91045059@N02,7452,15,1358465080,1358467009,20,8,1929
91045059@N02,7452,27,1358482387,1358482445,3,8,58
91045059@N02,7452,17,1358467084,1358467084,1,8,0
91065735@N08,7453,17,1394075540,1394085262,2,2,9722
91065735@N08,7453,16,1394085824,1394091337,4,2,5513
91080660@N08,7454,14,1407398634,1407398634,1,1,0
91087719@N08,7455,14,1355880288,1355880288,1,1,0
91087719@N08,7456,14,1356207066,1356207066,1,2,0
91087719@N08,7456,10,1356207324,1356207324,1,2,0
91087719@N08,7457,27,1369255526,1369255526,1,1,0
91087719@N08,7458,27,1369336171,1369336171,1,1,0
91087719@N08,7459,13,1416475642,1416475642,1,2,0
91087719@N08,7459,10,1416487775,1416487775,1,2,0
91110029@N02,7460,1,1363490398,1363490398,1,1,0
91110029@N02,7461,15,1414619226,1414619226,1,3,0
91110029@N02,7461,14,1414619196,1414619196,1,3,0
91110029@N02,7461,27,1414619189,1414619189,1,3,0
91129684@N00,7462,14,1256428894,1256428894,1,1,0
91132397@N08,7463,8,1417391856,1417391856,1,2,0
91132397@N08,7463,11,1417392727,1417392727,1,2,0
91132397@N08,7464,27,1417780672,1417780672,1,1,0
91138989@N00,7465,9,1403678483,1403678483,1,1,0
91144647@N06,7466,14,1333927978,1333928106,10,4,128
91144647@N06,7466,18,1333933677,1333933677,1,4,0
91144647@N06,7466,27,1333920168,1333920390,4,4,222
91144647@N06,7466,20,1333937989,1333937989,1,4,0
91144647@N06,7467,25,1334038854,1334038854,1,1,0
91194707@N06,7468,13,1389061598,1389061598,1,1,0
91207697@N08,7469,27,1413235548,1413271707,8,2,36159
91207697@N08,7469,14,1413251428,1413259589,2,2,8161
91207697@N08,7470,16,1413326021,1413326021,1,5,0
91207697@N08,7470,15,1413329924,1413329924,1,5,0
91207697@N08,7470,9,1413336393,1413336393,1,5,0
91207697@N08,7470,10,1413326793,1413326793,1,5,0
91207697@N08,7470,23,1413332932,1413332932,1,5,0
91207697@N08,7471,27,1413797192,1413797291,4,1,99
91207697@N08,7472,25,1413926870,1413929281,2,2,2411
91207697@N08,7472,14,1413935213,1413935213,1,2,0
91207697@N08,7473,27,1414052139,1414052139,1,1,0
91207697@N08,7474,17,1414300175,1414300960,2,2,785
91207697@N08,7474,10,1414306308,1414306308,1,2,0
91207697@N08,7475,23,1445354341,1445354341,1,1,0
91219782@N07,7476,4,1370179570,1370179570,1,2,0
91219782@N07,7476,27,1370179291,1370179291,1,2,0
91220827@N02,7477,27,1376946610,1376946610,1,1,0
91220827@N02,7478,19,1376978047,1376978047,1,1,0
91227166@N06,7479,20,1353213714,1353213714,1,1,0
91227166@N06,7480,16,1354361561,1354361561,1,1,0
91227166@N06,7481,9,1393149555,1393150421,2,1,866
91227690@N08,7482,18,1459666805,1459666832,2,3,27
91227690@N08,7482,16,1459665238,1459665238,1,3,0
91227690@N08,7482,20,1459666719,1459666719,1,3,0
91227690@N08,7483,18,1460006878,1460007087,7,4,209
91227690@N08,7483,19,1460006265,1460007022,4,4,757
91227690@N08,7483,27,1460003456,1460003957,4,4,501
91227690@N08,7483,9,1460004680,1460004694,3,4,14
91227690@N08,7484,19,1460524584,1460524858,7,3,274
91227690@N08,7484,24,1460527760,1460528062,5,3,302
91227690@N08,7484,27,1460521986,1460522455,3,3,469
91227690@N08,7485,3,1461214646,1461215447,3,2,801
91227690@N08,7485,9,1461217551,1461217551,1,2,0
91227690@N08,7486,10,1461474461,1461475201,6,2,740
91227690@N08,7486,14,1461474293,1461474299,2,2,6
91255056@N07,7487,9,1353751213,1353751213,1,2,0
91255056@N07,7487,16,1353751960,1353752295,2,2,335
91288922@N03,7488,14,1387608264,1387608264,1,1,0
91315857@N02,7489,19,1377548204,1377548204,1,2,0
91315857@N02,7489,21,1377558920,1377558920,1,2,0
91315857@N02,7490,4,1444079988,1444079988,1,1,0
91363409@N07,7491,20,1416359079,1416359079,1,2,0
91363409@N07,7491,14,1416355465,1416355465,1,2,0
91363409@N07,7492,14,1416449852,1416449852,1,1,0
91372718@N04,7493,15,1374721571,1374732463,4,7,10892
91372718@N04,7493,27,1374706681,1374706726,3,7,45
91372718@N04,7493,13,1374721547,1374721592,2,7,45
91372718@N04,7493,22,1374724070,1374724070,1,7,0
91372718@N04,7493,20,1374726618,1374735463,3,7,8845
91372718@N04,7493,21,1374725970,1374726031,4,7,61
91372718@N04,7493,12,1374734158,1374734158,1,7,0
91372846@N04,7494,14,1384330275,1384330373,3,2,98
91372846@N04,7494,6,1384332668,1384332668,1,2,0
91401980@N02,7495,27,1461741502,1461741502,1,5,0
91401980@N02,7495,6,1461720475,1461724392,2,5,3917
91401980@N02,7495,20,1461735108,1461735108,1,5,0
91401980@N02,7495,9,1461730215,1461730215,1,5,0
91401980@N02,7495,2,1461722887,1461722887,1,5,0
91407288@N07,7496,14,1352200726,1352200726,1,5,0
91407288@N07,7496,20,1352151845,1352151845,1,5,0
91407288@N07,7496,6,1352198299,1352198299,1,5,0
91407288@N07,7496,4,1352162943,1352191334,10,5,28391
91407288@N07,7496,3,1352189537,1352189562,3,5,25
91407458@N00,7497,27,1305331053,1305331053,1,1,0
91409399@N07,7498,22,1379483899,1379484607,4,9,708
91409399@N07,7498,18,1379469785,1379469858,2,9,73
91409399@N07,7498,12,1379500491,1379500491,1,9,0
91409399@N07,7498,10,1379476499,1379480351,7,9,3852
91409399@N07,7498,4,1379461777,1379461777,1,9,0
91409399@N07,7498,11,1379480429,1379480451,2,9,22
91409399@N07,7498,17,1379487401,1379487401,1,9,0
91409399@N07,7498,14,1379474139,1379474139,1,9,0
91409399@N07,7498,13,1379491866,1379493164,3,9,1298
91409399@N07,7499,26,1379845412,1379845448,4,2,36
91409399@N07,7499,14,1379859036,1379859601,2,2,565
91409399@N07,7500,27,1380015147,1380017040,2,3,1893
91409399@N07,7500,13,1380029001,1380029001,1,3,0
91409399@N07,7500,17,1380032292,1380032292,1,3,0
91435349@N03,7501,1,1381533573,1381533573,1,1,0
91456744@N00,7502,17,1322296534,1322296534,1,2,0
91456744@N00,7502,9,1322297225,1322297225,1,2,0
91456744@N00,7503,24,1322724090,1322724090,1,2,0
91456744@N00,7503,14,1322722769,1322722769,1,2,0
91501015@N07,7504,27,1357597010,1357613145,54,1,16135
91511594@N02,7505,13,1370959280,1370959280,1,1,0
91511594@N02,7506,27,1385291634,1385291634,1,2,0
91511594@N02,7506,14,1385304130,1385304130,1,2,0
91511594@N02,7507,27,1388823296,1388823296,1,1,0
91513146@N00,7508,20,1451185656,1451185656,1,1,0
91569514@N05,7509,9,1432944223,1432948120,20,2,3897
91569514@N05,7509,16,1432976293,1432997232,31,2,20939
91569514@N05,7510,9,1433508807,1433508807,1,1,0
91603829@N00,7511,15,1425944538,1425944538,1,3,0
91603829@N00,7511,3,1425937026,1425937026,1,3,0
91603829@N00,7511,20,1425960887,1425976108,2,3,15221
91605234@N05,7512,21,1357955542,1357955542,1,3,0
91605234@N05,7512,24,1357944268,1357944268,1,3,0
91605234@N05,7512,13,1357958550,1357958550,1,3,0
9161595@N03,7513,25,1329274730,1329297450,3,15,22720
9161595@N03,7513,26,1329295348,1329295348,1,15,0
9161595@N03,7513,17,1329297209,1329297371,2,15,162
9161595@N03,7513,16,1329259678,1329271423,11,15,11745
9161595@N03,7513,4,1329265426,1329267992,13,15,2566
9161595@N03,7513,9,1329260481,1329261898,3,15,1417
9161595@N03,7513,27,1329274943,1329297872,5,15,22929
9161595@N03,7513,2,1329261473,1329261473,1,15,0
9161595@N03,7513,18,1329272382,1329294868,2,15,22486
9161595@N03,7513,22,1329273307,1329273901,12,15,594
9161595@N03,7513,14,1329260296,1329260296,1,15,0
9161595@N03,7513,1,1329260926,1329261301,2,15,375
9161595@N03,7513,23,1329295403,1329297031,19,15,1628
9161595@N03,7513,13,1329292219,1329292388,3,15,169
9161595@N03,7513,15,1329291361,1329294532,22,15,3171
91619162@N06,7514,3,1391638995,1391638995,1,1,0
91621746@N00,7515,2,1330295128,1330295131,2,5,3
91621746@N00,7515,27,1330291508,1330293489,2,5,1981
91621746@N00,7515,1,1330295135,1330295160,3,5,25
91621746@N00,7515,6,1330295341,1330295341,1,5,0
91621746@N00,7515,17,1330302130,1330303474,10,5,1344
91621746@N00,7516,27,1330401851,1330402130,2,3,279
91621746@N00,7516,14,1330412952,1330412952,1,3,0
91621746@N00,7516,17,1330411034,1330411081,2,3,47
91646799@N06,7517,9,1439791619,1439791619,1,1,0
91678850@N02,7518,16,1355403296,1355403296,1,1,0
91694685@N00,7519,27,1221045155,1221045155,1,1,0
91742441@N04,7520,17,1325666335,1325666335,1,1,0
91759611@N06,7521,19,1337326476,1337327445,2,1,969
91761857@N00,7522,14,1396143059,1396143064,2,2,5
91761857@N00,7522,12,1396143043,1396143051,2,2,8
91761857@N00,7523,16,1396439491,1396440539,8,1,1048
91761857@N00,7524,27,1400760339,1400760737,2,1,398
9176927@N08,7525,17,1212811779,1212812349,8,2,570
9176927@N08,7525,22,1212803903,1212821809,2,2,17906
9176927@N08,7526,27,1230270435,1230270435,1,1,0
9176927@N08,7527,4,1239253636,1239253636,1,4,0
9176927@N08,7527,27,1239253428,1239253428,1,4,0
9176927@N08,7527,9,1239257446,1239257446,1,4,0
9176927@N08,7527,17,1239279369,1239279369,1,4,0
91779914@N00,7528,27,1241675709,1241675709,1,1,0
91792400@N00,7529,14,1436332835,1436332835,1,1,0
91831221@N00,7530,4,1325509234,1325509234,1,1,0
91835518@N00,7531,18,1236240889,1236240889,1,1,0
91855896@N00,7532,27,1319844261,1319865082,6,4,20821
91855896@N00,7532,14,1319846654,1319856611,3,4,9957
91855896@N00,7532,9,1319849330,1319849399,2,4,69
91855896@N00,7532,16,1319856625,1319856625,2,4,0
91855896@N00,7533,27,1319972871,1319975496,3,3,2625
91855896@N00,7533,14,1319964971,1319964971,3,3,0
91855896@N00,7533,16,1319962338,1319965191,6,3,2853
91869814@N05,7534,27,1327574662,1327574662,1,1,0
91930279@N04,7535,27,1373518121,1373520996,4,1,2875
91966035@N00,7536,7,1401864340,1401864458,2,1,118
9197147@N03,7537,22,1400419717,1400419717,1,1,0
92008781@N05,7538,17,1344248474,1344248474,1,1,0
92026547@N05,7539,27,1409731795,1409731795,1,1,0
92026547@N05,7540,22,1410853523,1410853523,1,2,0
92026547@N05,7540,27,1410857956,1410857987,2,2,31
92026547@N05,7541,13,1411539345,1411539345,1,5,0
92026547@N05,7541,18,1411538600,1411544501,6,5,5901
92026547@N05,7541,19,1411538863,1411538863,1,5,0
92026547@N05,7541,20,1411540369,1411540369,1,5,0
92026547@N05,7541,27,1411547641,1411547706,2,5,65
92026547@N05,7542,20,1412076160,1412076160,1,3,0
92026547@N05,7542,2,1412073455,1412073485,2,3,30
92026547@N05,7542,16,1412077360,1412077360,1,3,0
92026547@N05,7543,9,1412647678,1412647678,1,3,0
92026547@N05,7543,15,1412646183,1412646183,1,3,0
92026547@N05,7543,3,1412648213,1412648213,1,3,0
92096485@N04,7544,14,1353477379,1353477379,1,1,0
9211132@N07,7545,25,1335067836,1335068546,2,1,710
92243116@N08,7546,25,1375334273,1375334273,1,1,0
9228491@N06,7547,27,1267264245,1267267193,3,8,2948
9228491@N06,7547,4,1267262459,1267263155,2,8,696
9228491@N06,7547,9,1267262834,1267273526,3,8,10692
9228491@N06,7547,1,1267263026,1267263026,1,8,0
9228491@N06,7547,2,1267263106,1267263106,1,8,0
9228491@N06,7547,17,1267263420,1267263420,1,8,0
9228491@N06,7547,16,1267262581,1267263556,4,8,975
9228491@N06,7547,14,1267262714,1267262724,2,8,10
9228491@N06,7548,1,1267397306,1267399643,6,14,2337
9228491@N06,7548,8,1267398371,1267398371,1,14,0
9228491@N06,7548,6,1267397317,1267397621,4,14,304
9228491@N06,7548,9,1267398117,1267398117,1,14,0
9228491@N06,7548,5,1267397350,1267397766,2,14,416
9228491@N06,7548,26,1267409456,1267409468,2,14,12
9228491@N06,7548,4,1267397110,1267397110,1,14,0
9228491@N06,7548,24,1267395653,1267395653,1,14,0
9228491@N06,7548,19,1267399131,1267405819,3,14,6688
9228491@N06,7548,21,1267394881,1267394881,1,14,0
9228491@N06,7548,16,1267400366,1267401405,12,14,1039
9228491@N06,7548,2,1267397164,1267402238,3,14,5074
9228491@N06,7548,27,1267392984,1267411364,12,14,18380
9228491@N06,7548,18,1267405066,1267406334,5,14,1268
9228491@N06,7549,12,1267501686,1267502204,5,3,518
9228491@N06,7549,26,1267503021,1267504283,27,3,1262
9228491@N06,7549,16,1267513430,1267521943,4,3,8513
9228491@N06,7550,12,1267745417,1267746265,2,4,848
9228491@N06,7550,19,1267752403,1267752403,1,4,0
9228491@N06,7550,2,1267744357,1267744357,1,4,0
9228491@N06,7550,27,1267739849,1267761811,10,4,21962
9228491@N06,7551,22,1267863832,1267864949,17,1,1117
9228491@N06,7552,17,1268010058,1268010058,1,1,0
9228491@N06,7553,27,1268367744,1268367925,10,3,181
9228491@N06,7553,1,1268369415,1268369458,2,3,43
9228491@N06,7553,2,1268365199,1268365199,1,3,0
9228491@N06,7554,27,1269852665,1269852665,1,1,0
9228491@N06,7555,27,1322945356,1322945356,1,1,0
9228491@N06,7556,27,1323134836,1323134836,1,1,0
9228491@N06,7557,16,1323471691,1323471691,1,1,0
9228491@N06,7558,1,1323739185,1323739185,1,1,0
9228491@N06,7559,22,1323854670,1323855645,5,1,975
92320528@N07,7560,27,1387132054,1387132105,2,1,51
92320528@N07,7561,27,1431925579,1431925579,1,1,0
9233146@N03,7562,23,1208864277,1208864277,1,2,0
9233146@N03,7562,25,1208864277,1208864277,1,2,0
9233146@N03,7563,17,1208950737,1208950737,1,1,0
92391434@N05,7564,13,1420604047,1420604047,1,1,0
92398584@N02,7565,2,1353559635,1353559635,1,1,0
9243200@N04,7566,14,1361283189,1361283189,1,1,0
92504072@N06,7567,25,1291264847,1291265462,4,1,615
92504072@N06,7568,17,1291459310,1291459310,1,1,0
92504072@N06,7569,21,1305959364,1305968840,4,3,9476
92504072@N06,7569,17,1305959034,1305959120,3,3,86
92504072@N06,7569,9,1305964253,1305964443,4,3,190
92533979@N00,7570,14,1359702948,1359702948,1,10,0
92533979@N00,7570,10,1359702036,1359702816,2,10,780
92533979@N00,7570,24,1359687628,1359687628,1,10,0
92533979@N00,7570,22,1359681098,1359681098,1,10,0
92533979@N00,7570,2,1359711195,1359711195,1,10,0
92533979@N00,7570,5,1359674738,1359674738,1,10,0
92533979@N00,7570,6,1359675650,1359675650,1,10,0
92533979@N00,7570,1,1359674005,1359674005,1,10,0
92533979@N00,7570,23,1359691202,1359691202,1,10,0
92533979@N00,7570,17,1359703485,1359703485,1,10,0
9261503@N08,7571,17,1434338659,1434338659,1,5,0
9261503@N08,7571,16,1434338681,1434356749,3,5,18068
9261503@N08,7571,9,1434338989,1434338989,1,5,0
9261503@N08,7571,4,1434357079,1434357079,1,5,0
9261503@N08,7571,5,1434341832,1434341832,1,5,0
92622262@N08,7572,15,1369488672,1369488672,1,4,0
92622262@N08,7572,19,1369485375,1369485375,1,4,0
92622262@N08,7572,13,1369486689,1369486694,2,4,5
92622262@N08,7572,27,1369480456,1369480456,1,4,0
92622262@N08,7573,3,1375531952,1375531952,2,3,0
92622262@N08,7573,9,1375528792,1375528966,3,3,174
92622262@N08,7573,10,1375524770,1375524770,1,3,0
92622262@N08,7574,15,1378526335,1378526335,2,5,0
92622262@N08,7574,14,1378526327,1378526394,5,5,67
92622262@N08,7574,9,1378525780,1378525780,2,5,0
92622262@N08,7574,20,1378517960,1378518731,8,5,771
92622262@N08,7574,16,1378527186,1378527195,4,5,9
92622262@N08,7575,19,1392430108,1392430109,2,1,1
92622262@N08,7576,10,1400928156,1400928159,2,4,3
92622262@N08,7576,20,1400937113,1400937113,1,4,0
92622262@N08,7576,27,1400939597,1400939597,1,4,0
92622262@N08,7576,7,1400926973,1400927075,3,4,102
92678857@N02,7577,16,1388658996,1388661005,6,1,2009
92682932@N08,7578,12,1381146319,1381146319,1,1,0
9274852@N08,7579,4,1349349715,1349349715,1,1,0
9275923@N03,7580,27,1231109066,1231109955,2,7,889
9275923@N03,7580,12,1231110580,1231112387,3,7,1807
9275923@N03,7580,26,1231112941,1231112941,1,7,0
9275923@N03,7580,4,1231117463,1231117463,1,7,0
9275923@N03,7580,15,1231116093,1231116093,1,7,0
9275923@N03,7580,25,1231117127,1231117127,1,7,0
9275923@N03,7580,16,1231115284,1231124264,3,7,8980
92824695@N03,7581,27,1366176479,1366176479,1,2,0
92824695@N03,7581,16,1366171373,1366171373,1,2,0
92854641@N00,7582,8,1192868204,1192868222,2,1,18
92859253@N04,7583,8,1403867937,1403868196,2,10,259
92859253@N04,7583,12,1403863854,1403864554,10,10,700
92859253@N04,7583,13,1403864058,1403864095,2,10,37
92859253@N04,7583,10,1403857341,1403857520,4,10,179
92859253@N04,7583,27,1403854617,1403854617,1,10,0
92859253@N04,7583,15,1403864946,1403864946,1,10,0
92859253@N04,7583,7,1403864292,1403867986,3,10,3694
92859253@N04,7583,6,1403863752,1403863752,1,10,0
92859253@N04,7583,16,1403856108,1403856108,1,10,0
92859253@N04,7583,1,1403867558,1403868153,5,10,595
9290765@N06,7584,2,1222149939,1222149939,1,2,0
9290765@N06,7584,20,1222135883,1222135908,3,2,25
93003498@N05,7585,27,1360966495,1360966495,1,1,0
93003498@N05,7586,27,1363313411,1363313411,1,2,0
93003498@N05,7586,10,1363321379,1363321379,1,2,0
93003498@N05,7587,14,1366079721,1366079876,2,1,155
93004366@N08,7588,14,1456728696,1456728696,1,1,0
93081598@N05,7589,27,1360808724,1360808724,1,1,0
93081598@N05,7590,3,1361442751,1361442751,1,1,0
93081598@N05,7591,10,1361520639,1361520683,8,2,44
93081598@N05,7591,27,1361517589,1361518974,21,2,1385
93081598@N05,7592,9,1364796169,1364796169,1,1,0
93081598@N05,7593,27,1366192199,1366192199,1,1,0
93081598@N05,7594,26,1366335424,1366335544,10,4,120
93081598@N05,7594,6,1366328495,1366331246,27,4,2751
93081598@N05,7594,9,1366330781,1366331230,4,4,449
93081598@N05,7594,27,1366327468,1366327480,4,4,12
93081598@N05,7595,27,1366690362,1366705527,9,1,15165
93081598@N05,7596,25,1367151500,1367151501,2,1,1
93081598@N05,7597,26,1367727746,1367727746,1,3,0
93081598@N05,7597,14,1367714832,1367714832,1,3,0
93081598@N05,7597,25,1367727560,1367727560,1,3,0
93081598@N05,7598,27,1367822051,1367829084,9,1,7033
93086051@N00,7599,8,1333877529,1333877529,1,1,0
93117900@N03,7600,9,1383199762,1383199762,1,3,0
93117900@N03,7600,13,1383189805,1383189805,1,3,0
93117900@N03,7600,14,1383199593,1383199593,1,3,0
93123267@N00,7601,23,1209783099,1209783099,1,1,0
93126204@N00,7602,12,1368320995,1368321121,3,9,126
93126204@N00,7602,23,1368330641,1368330641,1,9,0
93126204@N00,7602,2,1368343156,1368343518,5,9,362
93126204@N00,7602,7,1368350300,1368350300,1,9,0
93126204@N00,7602,22,1368354458,1368354612,2,9,154
93126204@N00,7602,4,1368340833,1368342129,4,9,1296
93126204@N00,7602,11,1368351538,1368351679,3,9,141
93126204@N00,7602,1,1368342443,1368344221,4,9,1778
93126204@N00,7602,9,1368319543,1368319543,1,9,0
93132003@N00,7603,14,1225179990,1225186867,12,1,6877
93150071@N06,7604,16,1364005380,1364005380,1,1,0
93175351@N02,7605,14,1361673787,1361673787,1,1,0
93192429@N00,7606,14,1273434573,1273434573,1,5,0
93192429@N00,7606,16,1273433419,1273433419,1,5,0
93192429@N00,7606,9,1273437752,1273437752,1,5,0
93192429@N00,7606,27,1273432824,1273432824,1,5,0
93192429@N00,7606,12,1273434800,1273434809,2,5,9
93194990@N08,7607,10,1358834245,1358834245,1,1,0
93218256@N03,7608,8,1410940431,1410940431,1,1,0
93260943@N08,7609,14,1360919213,1360919213,1,1,0
93260943@N08,7610,16,1380374802,1380374802,1,1,0
93273458@N00,7611,25,1297729925,1297730428,3,3,503
93273458@N00,7611,13,1297719898,1297719898,1,3,0
93273458@N00,7611,20,1297724445,1297724445,1,3,0
93273458@N00,7612,20,1410594452,1410594452,1,1,0
93283041@N00,7613,20,1217925246,1217925251,2,1,5
93283041@N00,7614,27,1229374452,1229398516,12,15,24064
93283041@N00,7614,9,1229382281,1229382453,3,15,172
93283041@N00,7614,2,1229382924,1229388273,2,15,5349
93283041@N00,7614,5,1229386464,1229386464,1,15,0
93283041@N00,7614,20,1229375552,1229393318,10,15,17766
93283041@N00,7614,12,1229379178,1229380452,15,15,1274
93283041@N00,7614,15,1229379738,1229379738,1,15,0
93283041@N00,7614,14,1229381422,1229381422,1,15,0
93283041@N00,7614,16,1229374812,1229388174,6,15,13362
93283041@N00,7614,1,1229382935,1229391033,2,15,8098
93283041@N00,7614,13,1229378891,1229393882,2,15,14991
93283041@N00,7614,17,1229374949,1229393725,2,15,18776
93283041@N00,7614,21,1229391276,1229392028,3,15,752
93283041@N00,7614,19,1229376935,1229376935,1,15,0
93283041@N00,7614,4,1229386556,1229386556,1,15,0
93283041@N00,7615,27,1229582384,1229593887,8,7,11503
93283041@N00,7615,9,1229583630,1229584280,6,7,650
93283041@N00,7615,13,1229589951,1229589966,2,7,15
93283041@N00,7615,16,1229582909,1229601566,20,7,18657
93283041@N00,7615,26,1229596719,1229597846,15,7,1127
93283041@N00,7615,20,1229599807,1229599807,1,7,0
93283041@N00,7615,3,1229588046,1229588561,4,7,515
93283041@N00,7616,12,1229769803,1229770018,2,4,215
93283041@N00,7616,27,1229759337,1229759569,2,4,232
93283041@N00,7616,22,1229763535,1229763535,1,4,0
93283041@N00,7616,26,1229761410,1229762547,20,4,1137
93283041@N00,7617,2,1264652075,1264658149,4,9,6074
93283041@N00,7617,27,1264628553,1264628553,1,9,0
93283041@N00,7617,24,1264661680,1264662153,5,9,473
93283041@N00,7617,9,1264638776,1264638776,1,9,0
93283041@N00,7617,20,1264630193,1264630193,1,9,0
93283041@N00,7617,17,1264648403,1264649635,17,9,1232
93283041@N00,7617,1,1264654174,1264654518,2,9,344
93283041@N00,7617,19,1264633614,1264633705,2,9,91
93283041@N00,7617,6,1264640310,1264640310,1,9,0
93283041@N00,7618,22,1276680204,1276681214,21,1,1010
93283041@N00,7619,27,1286151922,1286170934,16,7,19012
93283041@N00,7619,9,1286160347,1286160347,1,7,0
93283041@N00,7619,7,1286161031,1286161031,1,7,0
93283041@N00,7619,18,1286157506,1286157945,6,7,439
93283041@N00,7619,19,1286158014,1286158347,2,7,333
93283041@N00,7619,11,1286161154,1286161917,14,7,763
93283041@N00,7619,17,1286159156,1286159156,1,7,0
93283041@N00,7620,27,1291794457,1291794457,1,1,0
93283041@N00,7621,9,1318757708,1318757720,2,3,12
93283041@N00,7621,12,1318740494,1318740494,1,3,0
93283041@N00,7621,16,1318755592,1318755592,1,3,0
93283041@N00,7622,27,1323404755,1323425296,6,3,20541
93283041@N00,7622,13,1323409518,1323409647,2,3,129
93283041@N00,7622,24,1323405808,1323405940,2,3,132
93283041@N00,7623,18,1334478501,1334478735,2,1,234
93294943@N08,7624,14,1357008698,1357008698,1,1,0
93294943@N08,7625,24,1362051142,1362051142,1,1,0
93294943@N08,7626,16,1403620162,1403620162,1,1,0
9329633@N04,7627,19,1353993623,1353993623,1,1,0
9329633@N04,7628,14,1354072118,1354072118,1,1,0
93334382@N02,7629,8,1375436149,1375436149,1,1,0
93334382@N02,7630,27,1376347369,1376348290,2,2,921
93334382@N02,7630,16,1376346465,1376346772,2,2,307
93334382@N02,7631,8,1380248721,1380248721,1,4,0
93334382@N02,7631,23,1380246764,1380248040,2,4,1276
93334382@N02,7631,18,1380247481,1380247918,3,4,437
93334382@N02,7631,13,1380248192,1380248192,1,4,0
93334382@N02,7632,10,1391375745,1391375930,2,2,185
93334382@N02,7632,15,1391375624,1391375624,1,2,0
93334382@N02,7633,9,1425815788,1425815788,1,1,0
93334382@N02,7634,16,1431465607,1431465607,1,1,0
93387506@N02,7635,16,1381216790,1381216790,1,1,0
93393982@N00,7636,21,1426561289,1426561289,1,1,0
9349788@N07,7637,13,1364320697,1364320697,1,1,0
93503884@N03,7638,20,1351521102,1351521235,2,1,133
93538524@N06,7639,6,1374196185,1374197533,6,6,1348
93538524@N06,7639,8,1374203593,1374205327,2,6,1734
93538524@N06,7639,1,1374198415,1374198415,1,6,0
93538524@N06,7639,19,1374201949,1374201949,1,6,0
93538524@N06,7639,4,1374194650,1374194650,1,6,0
93538524@N06,7639,2,1374196703,1374196727,2,6,24
93575563@N08,7640,27,1331489630,1331533246,19,1,43616
93628549@N00,7641,26,1302775502,1302779740,2,6,4238
93628549@N00,7641,16,1302759910,1302791399,5,6,31489
93628549@N00,7641,19,1302767785,1302775394,2,6,7609
93628549@N00,7641,24,1302761809,1302766568,2,6,4759
93628549@N00,7641,27,1302759355,1302759553,2,6,198
93628549@N00,7641,14,1302783127,1302794112,7,6,10985
93629101@N05,7642,13,1430271339,1430293088,7,13,21749
93629101@N05,7642,4,1430285456,1430286878,5,13,1422
93629101@N05,7642,10,1430274662,1430292074,25,13,17412
93629101@N05,7642,21,1430293741,1430294857,4,13,1116
93629101@N05,7642,3,1430285599,1430286484,8,13,885
93629101@N05,7642,9,1430301015,1430303585,10,13,2570
93629101@N05,7642,6,1430301963,1430301963,1,13,0
93629101@N05,7642,12,1430292087,1430292999,3,13,912
93629101@N05,7642,15,1430292116,1430292649,4,13,533
93629101@N05,7642,14,1430272698,1430276412,15,13,3714
93629101@N05,7642,22,1430295192,1430296723,10,13,1531
93629101@N05,7642,27,1430269193,1430309869,3,13,40676
93629101@N05,7642,17,1430297231,1430299733,14,13,2502
9365143@N07,7643,27,1364087748,1364087748,1,1,0
93743574@N08,7644,14,1416777492,1416777496,3,1,4
93762817@N08,7645,21,1388196275,1388196275,1,2,0
93762817@N08,7645,16,1388200692,1388200692,1,2,0
9381285@N07,7646,27,1300995989,1300995989,1,1,0
93890245@N05,7647,27,1376952127,1376952127,1,1,0
93890245@N05,7648,25,1377300786,1377300786,1,1,0
93928120@N03,7649,27,1444856061,1444856061,1,1,0
9395016@N08,7650,3,1210411069,1210422775,9,13,11706
9395016@N08,7650,22,1210391303,1210391303,1,13,0
9395016@N08,7650,15,1210401125,1210401125,1,13,0
9395016@N08,7650,20,1210387229,1210425422,6,13,38193
9395016@N08,7650,16,1210401480,1210401500,2,13,20
9395016@N08,7650,27,1210383560,1210427148,10,13,43588
9395016@N08,7650,2,1210409845,1210410274,5,13,429
9395016@N08,7650,4,1210408278,1210421063,11,13,12785
9395016@N08,7650,21,1210386520,1210386685,4,13,165
9395016@N08,7650,19,1210397369,1210398081,3,13,712
9395016@N08,7650,26,1210392440,1210396448,2,13,4008
9395016@N08,7650,17,1210399482,1210408055,7,13,8573
9395016@N08,7650,13,1210400201,1210400316,2,13,115
94011132@N06,7651,5,1407461518,1407461666,2,4,148
94011132@N06,7651,2,1407461588,1407461588,1,4,0
94011132@N06,7651,3,1407461558,1407461577,2,4,19
94011132@N06,7651,4,1407461375,1407472021,7,4,10646
94024282@N00,7652,27,1324206667,1324206667,1,1,0
94078193@N03,7653,16,1330223739,1330223925,3,1,186
94078193@N03,7654,16,1362266445,1362266445,1,1,0
94078193@N03,7655,27,1362305345,1362305345,1,1,0
94078193@N03,7656,27,1362618297,1362618297,1,3,0
94078193@N03,7656,14,1362640607,1362640607,1,3,0
94078193@N03,7656,24,1362619545,1362619545,1,3,0
94100125@N07,7657,22,1452761842,1452761842,1,1,0
94126498@N00,7658,27,1445903926,1445935249,2,4,31323
94126498@N00,7658,3,1445908033,1445908630,2,4,597
94126498@N00,7658,2,1445922811,1445922811,1,4,0
94126498@N00,7658,24,1445912098,1445912098,1,4,0
94155755@N00,7659,15,1356036095,1356036095,1,2,0
94155755@N00,7659,27,1356055043,1356055043,1,2,0
94155755@N00,7660,27,1370390429,1370390662,4,1,233
9426006@N04,7661,27,1207563361,1207577097,2,1,13736
9426006@N04,7662,27,1207706208,1207711266,13,2,5058
9426006@N04,7662,12,1207705593,1207705593,1,2,0
94272898@N05,7663,14,1394393786,1394393787,2,1,1
9432653@N05,7664,27,1362947871,1362947871,1,1,0
94358021@N08,7665,27,1376865685,1376865685,1,1,0
94378868@N00,7666,10,1361081160,1361081160,1,1,0
9442309@N03,7667,27,1339549116,1339561498,3,1,12382
9442309@N03,7668,16,1366850636,1366860785,12,1,10149
94436430@N00,7669,2,1360384735,1360384735,1,4,0
94436430@N00,7669,3,1360388960,1360388960,1,4,0
94436430@N00,7669,27,1360376674,1360376674,1,4,0
94436430@N00,7669,5,1360403847,1360403847,1,4,0
94450464@N02,7670,16,1278072284,1278072284,1,2,0
94450464@N02,7670,17,1278072284,1278072284,1,2,0
94472595@N03,7671,16,1366293047,1366293047,1,1,0
94472595@N03,7672,9,1370875596,1370875596,1,2,0
94472595@N03,7672,18,1370877158,1370877158,1,2,0
94473284@N04,7673,1,1455330912,1455330914,2,5,2
94473284@N04,7673,13,1455332131,1455332131,1,5,0
94473284@N04,7673,6,1455330918,1455330918,1,5,0
94473284@N04,7673,26,1455334027,1455334027,2,5,0
94473284@N04,7673,2,1455323532,1455323553,4,5,21
94511303@N04,7674,27,1414227229,1414227229,1,1,0
94512378@N00,7675,16,1336437716,1336437716,1,1,0
94512378@N00,7676,17,1460101419,1460101419,1,1,0
94529757@N00,7677,9,1255861492,1255861492,1,1,0
9456601@N03,7678,26,1308188270,1308201983,3,7,13713
9456601@N03,7678,17,1308194052,1308194052,1,7,0
9456601@N03,7678,3,1308199812,1308199812,1,7,0
9456601@N03,7678,4,1308201523,1308201523,1,7,0
9456601@N03,7678,16,1308218104,1308218171,2,7,67
9456601@N03,7678,25,1308188101,1308188616,3,7,515
9456601@N03,7678,9,1308197100,1308197100,1,7,0
9461342@N03,7679,27,1397442901,1397442901,1,1,0
9461342@N03,7680,17,1459839596,1459839596,1,1,0
94622063@N07,7681,22,1365476744,1365476744,1,1,0
94687753@N00,7682,4,1372463677,1372463677,1,1,0
94697173@N00,7683,10,1443319176,1443320649,3,8,1473
94697173@N00,7683,27,1443334186,1443360498,44,8,26312
94697173@N00,7683,16,1443345998,1443347338,5,8,1340
94697173@N00,7683,11,1443321948,1443321948,1,8,0
94697173@N00,7683,2,1443344107,1443344107,2,8,0
94697173@N00,7683,12,1443318352,1443318352,1,8,0
94697173@N00,7683,9,1443345741,1443345741,1,8,0
94697173@N00,7683,23,1443309473,1443309473,1,8,0
94697173@N00,7684,14,1443493242,1443493242,1,3,0
94697173@N00,7684,27,1443484121,1443484127,4,3,6
94697173@N00,7684,26,1443489833,1443489848,4,3,15
94697173@N00,7685,27,1443822605,1443829702,2,1,7097
94697173@N00,7686,27,1454625958,1454625958,1,3,0
94697173@N00,7686,9,1454633713,1454633725,4,3,12
94697173@N00,7686,17,1454626907,1454627665,4,3,758
94738051@N05,7687,17,1375340170,1375340170,1,1,0
94817984@N02,7688,4,1382050903,1382050903,1,1,0
94817984@N02,7689,4,1384501587,1384501587,1,1,0
94817984@N02,7690,15,1384844702,1384844702,1,1,0
94817984@N02,7691,9,1390464748,1390464748,1,1,0
94817984@N02,7692,16,1390886411,1390886411,1,3,0
94817984@N02,7692,13,1390885607,1390885607,1,3,0
94817984@N02,7692,15,1390885485,1390885587,3,3,102
94817984@N02,7693,15,1391941401,1391941401,3,1,0
94867877@N02,7694,27,1353742593,1353742593,1,1,0
94921086@N08,7695,16,1384146532,1384146532,1,2,0
94921086@N08,7695,27,1384120724,1384120724,1,2,0
94921086@N08,7696,14,1384495757,1384500847,3,1,5090
94987380@N08,7697,17,1398321881,1398323687,2,4,1806
94987380@N08,7697,27,1398278029,1398278029,1,4,0
94987380@N08,7697,1,1398283096,1398283096,1,4,0
94987380@N08,7697,22,1398301372,1398301372,1,4,0
94988491@N02,7698,3,1347002957,1347019861,2,1,16904
95095552@N02,7699,19,1401504404,1401504404,1,1,0
95095552@N02,7700,14,1401788716,1401788716,1,1,0
95198134@N00,7701,18,1191302256,1191303806,5,18,1550
95198134@N00,7701,1,1191291600,1191291600,1,18,0
95198134@N00,7701,22,1191304441,1191304441,1,18,0
95198134@N00,7701,20,1191304649,1191304699,3,18,50
95198134@N00,7701,24,1191310304,1191311204,5,18,900
95198134@N00,7701,14,1191296216,1191296241,2,18,25
95198134@N00,7701,27,1191286435,1191321775,16,18,35340
95198134@N00,7701,19,1191287206,1191303246,4,18,16040
95198134@N00,7701,26,1191304199,1191304199,1,18,0
95198134@N00,7701,17,1191299142,1191299142,1,18,0
95198134@N00,7701,4,1191288964,1191312980,4,18,24016
95198134@N00,7701,16,1191298983,1191298983,1,18,0
95198134@N00,7701,13,1191300714,1191300843,4,18,129
95198134@N00,7701,21,1191307948,1191308037,2,18,89
95198134@N00,7701,6,1191291028,1191315850,4,18,24822
95198134@N00,7701,15,1191296841,1191298192,3,18,1351
95198134@N00,7701,25,1191311522,1191311795,3,18,273
95198134@N00,7701,9,1191298847,1191298847,1,18,0
95208154@N03,7702,14,1380327528,1380327528,1,2,0
95208154@N03,7702,12,1380325295,1380325295,1,2,0
95225007@N00,7703,27,1383737362,1383737362,1,1,0
95230267@N07,7704,9,1409350910,1409350910,1,1,0
95258067@N00,7705,14,1386578202,1386578202,1,1,0
95341382@N05,7706,14,1443569261,1443569261,1,1,0
95356654@N00,7707,27,1223295253,1223295253,2,1,0
95356654@N00,7708,5,1223551777,1223551924,3,4,147
95356654@N00,7708,27,1223551309,1223551309,1,4,0
95356654@N00,7708,16,1223558436,1223558508,2,4,72
95356654@N00,7708,20,1223555586,1223556050,2,4,464
95356654@N00,7709,27,1223593200,1223593200,1,1,0
95356654@N00,7710,27,1328527135,1328527135,1,1,0
95356654@N00,7711,27,1431253721,1431253721,1,2,0
95356654@N00,7711,1,1431250307,1431250307,1,2,0
95356654@N00,7712,2,1431433622,1431433634,2,3,12
95356654@N00,7712,1,1431434795,1431434796,2,3,1
95356654@N00,7712,4,1431435179,1431435482,3,3,303
95356654@N00,7713,2,1431603316,1431603329,2,4,13
95356654@N00,7713,4,1431601790,1431601798,2,4,8
95356654@N00,7713,5,1431601592,1431601592,1,4,0
95356654@N00,7713,1,1431602344,1431602471,4,4,127
95356654@N00,7714,27,1431695647,1431695845,6,1,198
95386011@N06,7715,27,1397608340,1397608567,5,1,227
95400328@N03,7716,25,1371619125,1371619125,1,3,0
95400328@N03,7716,12,1371620119,1371620119,1,3,0
95400328@N03,7716,27,1371638494,1371638494,1,3,0
95415513@N07,7717,14,1365405992,1365405992,1,2,0
95415513@N07,7717,27,1365379105,1365379105,1,2,0
95432764@N04,7718,8,1375491273,1375491273,1,2,0
95432764@N04,7718,23,1375495261,1375495261,1,2,0
95462179@N04,7719,18,1429201202,1429201202,1,2,0
95462179@N04,7719,16,1429193341,1429193341,1,2,0
95462179@N04,7720,18,1432316072,1432316072,1,1,0
9549670@N05,7721,4,1467764215,1467764215,1,3,0
9549670@N05,7721,9,1467773279,1467773342,2,3,63
9549670@N05,7721,27,1467759120,1467779410,71,3,20290
95536755@N00,7722,16,1215569030,1215569030,1,2,0
95536755@N00,7722,27,1215569004,1215569004,1,2,0
95551576@N00,7723,17,1280048073,1280048073,1,8,0
95551576@N00,7723,2,1280031198,1280031198,1,8,0
95551576@N00,7723,11,1280022513,1280024355,2,8,1842
95551576@N00,7723,6,1280021432,1280021432,1,8,0
95551576@N00,7723,8,1280020151,1280024286,3,8,4135
95551576@N00,7723,9,1280026448,1280026448,1,8,0
95551576@N00,7723,14,1280045304,1280045346,2,8,42
95551576@N00,7723,27,1280012074,1280012074,1,8,0
95555783@N05,7724,27,1365906325,1365906325,1,1,0
95559818@N00,7725,14,1190447203,1190447203,1,2,0
95559818@N00,7725,16,1190444780,1190444780,1,2,0
95559818@N00,7726,16,1190780005,1190785082,3,1,5077
95559818@N00,7727,18,1207165591,1207165591,1,1,0
95559818@N00,7728,19,1207269922,1207269922,1,1,0
95559818@N00,7729,27,1333271969,1333272477,2,2,508
95559818@N00,7729,17,1333274796,1333274796,1,2,0
95559818@N00,7730,9,1333592133,1333592190,2,4,57
95559818@N00,7730,6,1333592325,1333592334,2,4,9
95559818@N00,7730,20,1333595926,1333596006,2,4,80
95559818@N00,7730,22,1333620004,1333620004,1,4,0
95598685@N00,7731,26,1275314400,1275314400,1,1,0
95611282@N05,7732,27,1368582484,1368582484,1,1,0
95611282@N05,7733,27,1368612342,1368612342,1,1,0
95611282@N05,7734,27,1370565828,1370565828,1,1,0
95611282@N05,7735,27,1402543435,1402543435,1,1,0
95611282@N05,7736,27,1432263244,1432263322,9,1,78
95611282@N05,7737,21,1434601587,1434601587,1,6,0
95611282@N05,7737,17,1434591723,1434602661,3,6,10938
95611282@N05,7737,24,1434601500,1434601744,4,6,244
95611282@N05,7737,25,1434601483,1434601483,1,6,0
95611282@N05,7737,27,1434590465,1434626441,9,6,35976
95611282@N05,7737,15,1434603022,1434603022,1,6,0
95611942@N00,7738,27,1381967844,1381967854,2,4,10
95611942@N00,7738,14,1381972084,1381972084,1,4,0
95611942@N00,7738,12,1381972486,1381973098,8,4,612
95611942@N00,7738,4,1381968197,1381968292,2,4,95
95611942@N00,7739,8,1468360063,1468360063,1,10,0
95611942@N00,7739,12,1468367736,1468368331,5,10,595
95611942@N00,7739,24,1468393390,1468393390,1,10,0
95611942@N00,7739,14,1468365175,1468399384,6,10,34209
95611942@N00,7739,10,1468363181,1468363992,6,10,811
95611942@N00,7739,6,1468361056,1468361056,1,10,0
95611942@N00,7739,21,1468391541,1468391541,1,10,0
95611942@N00,7739,9,1468394448,1468394448,1,10,0
95611942@N00,7739,26,1468383667,1468383667,1,10,0
95611942@N00,7739,16,1468369930,1468381212,5,10,11282
95646877@N00,7740,13,1273912186,1273912186,1,5,0
95646877@N00,7740,17,1273913350,1273913350,1,5,0
95646877@N00,7740,5,1273920146,1273920146,1,5,0
95646877@N00,7740,4,1273925339,1273925339,1,5,0
95646877@N00,7740,14,1273920815,1273922786,2,5,1971
95653839@N03,7741,4,1416381921,1416381921,1,2,0
95653839@N03,7741,18,1416375834,1416375834,1,2,0
95691495@N08,7742,17,1422051270,1422051270,1,3,0
95691495@N08,7742,6,1422061593,1422061593,1,3,0
95691495@N08,7742,23,1422053351,1422053929,14,3,578
95692999@N05,7743,3,1381614437,1381614437,1,5,0
95692999@N05,7743,22,1381634498,1381634498,1,5,0
95692999@N05,7743,14,1381645375,1381645375,1,5,0
95692999@N05,7743,11,1381616854,1381616854,1,5,0
95692999@N05,7743,19,1381637614,1381637614,1,5,0
95692999@N05,7744,6,1408170310,1408170310,1,1,0
95694198@N00,7745,13,1362964293,1362964306,2,2,13
95694198@N00,7745,10,1362964688,1362964688,1,2,0
95694198@N00,7746,13,1363163047,1363163126,2,2,79
95694198@N00,7746,17,1363163292,1363163300,2,2,8
95736828@N07,7747,8,1369895667,1369895667,1,2,0
95736828@N07,7747,11,1369895165,1369895397,4,2,232
95736828@N07,7748,9,1370403438,1370403567,2,1,129
95743859@N00,7749,14,1215331192,1215331192,1,1,0
95748568@N02,7750,16,1421140022,1421140022,1,1,0
95760272@N03,7751,17,1354147548,1354147548,1,1,0
95769700@N00,7752,10,1380865084,1380867911,3,7,2827
95769700@N00,7752,21,1380859289,1380859289,1,7,0
95769700@N00,7752,12,1380872786,1380872786,1,7,0
95769700@N00,7752,14,1380851991,1380854979,6,7,2988
95769700@N00,7752,9,1380854357,1380854746,5,7,389
95769700@N00,7752,16,1380848269,1380848416,2,7,147
95769700@N00,7752,27,1380846363,1380846491,2,7,128
95778894@N00,7753,13,1380756016,1380756016,1,2,0
95778894@N00,7753,22,1380776766,1380776766,1,2,0
95778894@N00,7754,13,1381055897,1381055897,1,3,0
95778894@N00,7754,19,1381055888,1381055888,1,3,0
95778894@N00,7754,14,1381027498,1381027498,1,3,0
95778894@N00,7755,20,1457064302,1457064353,3,5,51
95778894@N00,7755,23,1457087245,1457087245,1,5,0
95778894@N00,7755,22,1457067027,1457067027,1,5,0
95778894@N00,7755,15,1457081073,1457081073,1,5,0
95778894@N00,7755,17,1457074439,1457074439,1,5,0
95778894@N00,7756,26,1457339710,1457339710,1,4,0
95778894@N00,7756,22,1457330929,1457331281,3,4,352
95778894@N00,7756,23,1457346703,1457346703,1,4,0
95778894@N00,7756,18,1457350557,1457350557,1,4,0
9578142@N02,7757,3,1365067635,1365067635,1,5,0
9578142@N02,7757,6,1365064964,1365064964,1,5,0
9578142@N02,7757,17,1365062338,1365062338,1,5,0
9578142@N02,7757,13,1365063450,1365063450,1,5,0
9578142@N02,7757,14,1365073437,1365073940,4,5,503
95782054@N05,7758,11,1382767167,1382767167,1,11,0
95782054@N05,7758,12,1382764555,1382764555,1,11,0
95782054@N05,7758,8,1382767417,1382767430,2,11,13
95782054@N05,7758,14,1382763240,1382763926,16,11,686
95782054@N05,7758,19,1382766955,1382766977,5,11,22
95782054@N05,7758,20,1382766212,1382766926,7,11,714
95782054@N05,7758,26,1382765031,1382765159,9,11,128
95782054@N05,7758,1,1382767489,1382767489,1,11,0
95782054@N05,7758,23,1382765697,1382765697,1,11,0
95782054@N05,7758,27,1382760165,1382767584,23,11,7419
95782054@N05,7758,15,1382764159,1382764607,8,11,448
95839603@N02,7759,24,1395726061,1395726061,1,11,0
95839603@N02,7759,9,1395731299,1395731299,1,11,0
95839603@N02,7759,14,1395703662,1395703782,3,11,120
95839603@N02,7759,2,1395714458,1395728855,4,11,14397
95839603@N02,7759,4,1395733818,1395734194,3,11,376
95839603@N02,7759,10,1395706814,1395706814,1,11,0
95839603@N02,7759,27,1395697216,1395698882,5,11,1666
95839603@N02,7759,18,1395737698,1395737698,1,11,0
95839603@N02,7759,7,1395710267,1395710267,1,11,0
95839603@N02,7759,15,1395700817,1395700817,1,11,0
95839603@N02,7759,12,1395712087,1395712380,3,11,293
95911107@N02,7760,8,1442736958,1442736958,1,2,0
95911107@N02,7760,27,1442737758,1442737758,2,2,0
95916581@N03,7761,26,1378467644,1378467644,1,1,0
95928051@N04,7762,14,1277953158,1277953162,2,2,4
95928051@N04,7762,6,1277953095,1277953095,1,2,0
95979850@N00,7763,27,1237006258,1237044524,6,1,38266
95992643@N08,7764,14,1370609164,1370609164,1,2,0
95992643@N08,7764,2,1370601264,1370605053,2,2,3789
96062950@N02,7765,15,1385891033,1385891121,3,10,88
96062950@N02,7765,20,1385859128,1385859128,1,10,0
96062950@N02,7765,27,1385853148,1385881348,3,10,28200
96062950@N02,7765,17,1385853934,1385878887,5,10,24953
96062950@N02,7765,14,1385866879,1385883662,6,10,16783
96062950@N02,7765,22,1385862092,1385862092,1,10,0
96062950@N02,7765,21,1385866327,1385866327,1,10,0
96062950@N02,7765,16,1385855625,1385855625,1,10,0
96062950@N02,7765,24,1385866357,1385866357,1,10,0
96062950@N02,7765,9,1385859987,1385860239,3,10,252
96062950@N02,7766,15,1386391665,1386391665,1,3,0
96062950@N02,7766,22,1386388967,1386388967,1,3,0
96062950@N02,7766,18,1386406478,1386406478,1,3,0
96074685@N04,7767,7,1373770925,1373771985,5,3,1060
96074685@N04,7767,14,1373771990,1373772029,3,3,39
96074685@N04,7767,16,1373772031,1373772031,1,3,0
96074685@N04,7768,25,1374054299,1374054299,1,2,0
96074685@N04,7768,14,1374048383,1374048392,4,2,9
96077153@N00,7769,27,1228718295,1228718295,1,1,0
96077153@N00,7770,3,1287265306,1287265799,2,9,493
96077153@N00,7770,21,1287290035,1287290035,1,9,0
96077153@N00,7770,1,1287265230,1287265230,1,9,0
96077153@N00,7770,15,1287273993,1287273993,1,9,0
96077153@N00,7770,27,1287245773,1287298327,3,9,52554
96077153@N00,7770,16,1287267463,1287267463,1,9,0
96077153@N00,7770,23,1287288642,1287288642,1,9,0
96077153@N00,7770,22,1287290915,1287290915,1,9,0
96077153@N00,7770,13,1287269753,1287269753,1,9,0
96077153@N00,7771,27,1291793109,1291793109,1,1,0
96077153@N00,7772,25,1295066985,1295066985,1,3,0
96077153@N00,7772,12,1295055158,1295055299,2,3,141
96077153@N00,7772,23,1295062716,1295062716,1,3,0
96077153@N00,7773,27,1303380282,1303380282,1,1,0
96077153@N00,7774,14,1303508760,1303508791,6,9,31
96077153@N00,7774,13,1303506964,1303506964,1,9,0
96077153@N00,7774,26,1303517225,1303517225,1,9,0
96077153@N00,7774,25,1303515675,1303517224,2,9,1549
96077153@N00,7774,2,1303511039,1303511039,1,9,0
96077153@N00,7774,24,1303517225,1303517225,1,9,0
96077153@N00,7774,27,1303503588,1303503588,1,9,0
96077153@N00,7774,19,1303504380,1303504380,1,9,0
96077153@N00,7774,23,1303517233,1303517233,1,9,0
96077153@N00,7775,13,1305245425,1305246117,2,1,692
96077153@N00,7776,14,1338025401,1338025401,1,2,0
96077153@N00,7776,17,1338021192,1338021192,1,2,0
96077153@N00,7777,18,1338193604,1338193604,1,1,0
96084178@N00,7778,8,1258001306,1258001306,1,6,0
96084178@N00,7778,17,1257996650,1257996650,1,6,0
96084178@N00,7778,11,1257999994,1257999994,1,6,0
96084178@N00,7778,14,1257980663,1257984304,4,6,3641
96084178@N00,7778,26,1257996429,1257996440,3,6,11
96084178@N00,7778,27,1257977460,1257977758,3,6,298
96084178@N00,7779,27,1368170168,1368176655,8,3,6487
96084178@N00,7779,7,1368172507,1368172507,1,3,0
96084178@N00,7779,8,1368172457,1368174142,5,3,1685
96084178@N00,7780,17,1368232678,1368233036,6,3,358
96084178@N00,7780,27,1368226627,1368226627,1,3,0
96084178@N00,7780,9,1368241355,1368241670,6,3,315
96084178@N00,7781,14,1395460221,1395462707,3,2,2486
96084178@N00,7781,8,1395467652,1395467652,1,2,0
96084178@N00,7782,16,1395575380,1395575380,1,2,0
96084178@N00,7782,14,1395571541,1395571541,1,2,0
96088830@N07,7783,24,1298612296,1298612998,10,3,702
96088830@N07,7783,13,1298609786,1298610167,4,3,381
96088830@N07,7783,21,1298612413,1298612413,1,3,0
96088830@N07,7784,12,1310377966,1310377974,2,1,8
9611843@N04,7785,19,1193742309,1193742309,1,1,0
9611843@N04,7786,4,1193939798,1193939798,1,1,0
9611843@N04,7787,21,1265599600,1265599600,1,1,0
9611843@N04,7788,13,1317290652,1317290652,1,1,0
9611843@N04,7789,19,1317439346,1317439346,1,2,0
9611843@N04,7789,6,1317460120,1317460120,1,2,0
9611843@N04,7790,9,1317548391,1317548391,1,2,0
9611843@N04,7790,14,1317548449,1317548449,1,2,0
9611843@N04,7791,19,1328400132,1328400132,1,2,0
9611843@N04,7791,26,1328421894,1328421894,1,2,0
9611843@N04,7792,19,1350176313,1350176313,1,3,0
9611843@N04,7792,14,1350186049,1350186049,1,3,0
9611843@N04,7792,27,1350202293,1350204699,4,3,2406
9611843@N04,7793,12,1350295863,1350295863,1,1,0
9611843@N04,7794,1,1360016787,1360016787,1,1,0
96119805@N03,7795,27,1269664872,1269664878,2,1,6
96128002@N00,7796,11,1225170605,1225171030,5,1,425
96139953@N06,7797,17,1448506835,1448506835,1,1,0
96196973@N02,7798,25,1363910750,1363910750,1,4,0
96196973@N02,7798,19,1363904906,1363905501,5,4,595
96196973@N02,7798,20,1363907522,1363907549,2,4,27
96196973@N02,7798,26,1363909679,1363909679,1,4,0
9621505@N08,7799,17,1411040206,1411040308,4,3,102
9621505@N08,7799,16,1411040100,1411040114,3,3,14
9621505@N08,7799,15,1411040581,1411040596,2,3,15
96225726@N08,7800,27,1302149475,1302149475,1,1,0
9623061@N06,7801,27,1365116591,1365116591,1,2,0
9623061@N06,7801,6,1365129547,1365129547,1,2,0
96244139@N03,7802,25,1280018801,1280063196,105,1,44395
96244139@N03,7803,25,1333410817,1333410817,1,1,0
96244139@N03,7804,25,1333786107,1333786107,1,1,0
96244139@N03,7805,25,1364005078,1364005078,1,1,0
9624826@N05,7806,1,1310339639,1310339639,1,1,0
96249470@N03,7807,10,1378197955,1378197984,2,2,29
96249470@N03,7807,3,1378200383,1378200383,1,2,0
96249470@N03,7808,21,1378342657,1378343947,2,7,1290
96249470@N03,7808,14,1378333493,1378333499,2,7,6
96249470@N03,7808,9,1378351538,1378351538,1,7,0
96249470@N03,7808,18,1378336052,1378336052,1,7,0
96249470@N03,7808,22,1378340987,1378340987,1,7,0
96249470@N03,7808,19,1378337660,1378337747,2,7,87
96249470@N03,7808,26,1378345365,1378345386,3,7,21
96269557@N00,7809,1,1245639541,1245639549,3,3,8
96269557@N00,7809,14,1245643731,1245646171,7,3,2440
96269557@N00,7809,7,1245637740,1245637746,2,3,6
96274088@N05,7810,9,1356048911,1356048911,1,2,0
96274088@N05,7810,4,1356045920,1356045920,1,2,0
96274088@N05,7811,4,1356505017,1356505017,2,3,0
96274088@N05,7811,3,1356504782,1356504827,4,3,45
96274088@N05,7811,27,1356505404,1356505496,6,3,92
96312503@N08,7812,26,1369343486,1369343486,1,2,0
96312503@N08,7812,17,1369340240,1369340240,1,2,0
96312503@N08,7813,6,1369576088,1369576088,1,1,0
96312503@N08,7814,4,1372562848,1372562848,1,1,0
96312503@N08,7815,21,1372814264,1372814264,1,2,0
96312503@N08,7815,27,1372798705,1372798705,1,2,0
96312503@N08,7816,27,1372958582,1372958582,1,1,0
96312503@N08,7817,14,1372991866,1372991866,1,1,0
96312503@N08,7818,21,1373049691,1373049691,1,3,0
96312503@N08,7818,22,1373075085,1373075085,1,3,0
96312503@N08,7818,13,1373073188,1373073188,1,3,0
96312503@N08,7819,13,1373166511,1373166511,1,2,0
96312503@N08,7819,14,1373163730,1373163730,1,2,0
96312503@N08,7820,19,1382364771,1382364771,1,1,0
96312503@N08,7821,13,1382617758,1382620273,2,1,2515
96312503@N08,7822,13,1382936380,1382936380,1,1,0
96312503@N08,7823,27,1386151911,1386151911,1,1,0
96312503@N08,7824,27,1386237053,1386237053,1,1,0
96312503@N08,7825,27,1389527933,1389527933,1,1,0
96312503@N08,7826,13,1399103595,1399103595,1,1,0
96312503@N08,7827,22,1399290636,1399290636,1,2,0
96312503@N08,7827,14,1399283127,1399283127,1,2,0
96312503@N08,7828,15,1400786402,1400786402,1,6,0
96312503@N08,7828,17,1400785762,1400790608,2,6,4846
96312503@N08,7828,16,1400789412,1400789412,1,6,0
96312503@N08,7828,18,1400786830,1400786830,1,6,0
96312503@N08,7828,7,1400788399,1400788642,2,6,243
96312503@N08,7828,14,1400787974,1400787974,1,6,0
96312503@N08,7829,16,1404660856,1404660856,1,1,0
96331620@N03,7830,27,1328231968,1328259010,4,1,27042
96333180@N05,7831,14,1323605088,1323605091,3,1,3
9639902@N04,7832,27,1223156105,1223156105,1,2,0
9639902@N04,7832,19,1223167315,1223167315,1,2,0
96430093@N05,7833,23,1370129927,1370129999,2,1,72
96430093@N05,7834,3,1372857941,1372857941,1,2,0
96430093@N05,7834,10,1372858093,1372858093,1,2,0
96430093@N05,7835,10,1372919032,1372919032,1,3,0
96430093@N05,7835,27,1372893127,1372893127,1,3,0
96430093@N05,7835,21,1372923241,1372923241,1,3,0
96430093@N05,7836,10,1373088458,1373088578,2,1,120
96430093@N05,7837,10,1382353935,1382353935,1,2,0
96430093@N05,7837,13,1382353089,1382353089,1,2,0
96430093@N05,7838,10,1382673375,1382673510,2,3,135
96430093@N05,7838,17,1382657312,1382664517,3,3,7205
96430093@N05,7838,1,1382653641,1382653641,1,3,0
96430093@N05,7839,11,1383190895,1383190895,1,1,0
96430093@N05,7840,27,1391561841,1391561841,1,4,0
96430093@N05,7840,17,1391560626,1391571696,2,4,11070
96430093@N05,7840,23,1391581732,1391581732,1,4,0
96430093@N05,7840,9,1391577307,1391577307,1,4,0
96430093@N05,7841,14,1391823936,1391823936,1,2,0
96430093@N05,7841,23,1391822058,1391822058,1,2,0
96430093@N05,7842,27,1394934237,1394934237,1,1,0
96430093@N05,7843,4,1395035397,1395035397,1,2,0
96430093@N05,7843,27,1395035561,1395035561,1,2,0
96430093@N05,7844,19,1425121391,1425121391,1,5,0
96430093@N05,7844,14,1425109305,1425109305,1,5,0
96430093@N05,7844,25,1425120214,1425120214,1,5,0
96430093@N05,7844,18,1425122733,1425122733,1,5,0
96430093@N05,7844,13,1425108042,1425108042,1,5,0
96430093@N05,7845,13,1429305631,1429306599,4,1,968
96430093@N05,7846,6,1430195413,1430195413,1,2,0
96430093@N05,7846,18,1430193499,1430193499,1,2,0
96430093@N05,7847,18,1446784812,1446784812,1,1,0
96430093@N05,7848,26,1454125700,1454129729,4,3,4029
96430093@N05,7848,25,1454118557,1454118557,1,3,0
96430093@N05,7848,21,1454120823,1454120823,1,3,0
96430093@N05,7849,22,1454366602,1454366602,1,1,0
96430093@N05,7850,27,1454622041,1454622826,6,1,785
96430093@N05,7851,17,1460517476,1460517476,1,1,0
96430093@N05,7852,27,1463817571,1463817571,1,1,0
96430093@N05,7853,27,1464235939,1464235939,1,1,0
96466494@N00,7854,10,1470559439,1470559439,1,1,0
96466494@N00,7855,6,1471788110,1471788110,1,1,0
96467992@N05,7856,7,1362621299,1362621299,1,2,0
96467992@N05,7856,10,1362618847,1362624578,4,2,5731
96472796@N00,7857,27,1386219422,1386219422,1,3,0
96472796@N00,7857,20,1386231387,1386231387,1,3,0
96472796@N00,7857,16,1386240061,1386249775,2,3,9714
96525092@N00,7858,27,1254485495,1254485978,2,2,483
96525092@N00,7858,1,1254488989,1254488989,1,2,0
96525092@N00,7859,16,1257322463,1257322463,1,2,0
96525092@N00,7859,14,1257323410,1257323410,1,2,0
96525092@N00,7860,1,1267654411,1267654411,1,1,0
96525092@N00,7861,8,1288680139,1288680139,1,1,0
96525092@N00,7862,27,1289024622,1289024622,1,1,0
96525092@N00,7863,9,1317551949,1317551949,1,1,0
96525092@N00,7864,24,1320503260,1320503260,1,1,0
96525092@N00,7865,14,1352083221,1352083221,1,1,0
9653109@N04,7866,27,1252533816,1252533816,1,1,0
9653109@N04,7867,17,1252796780,1252796780,1,1,0
9653109@N04,7868,25,1285200811,1285200816,2,1,5
9653109@N04,7869,26,1285670108,1285670108,1,1,0
96581496@N06,7870,27,1401096796,1401096796,1,2,0
96581496@N06,7870,9,1401076687,1401078725,2,2,2038
96581740@N03,7871,10,1442120786,1442120856,5,16,70
96581740@N03,7871,19,1442130264,1442130285,4,16,21
96581740@N03,7871,22,1442124444,1442126930,7,16,2486
96581740@N03,7871,8,1442130578,1442130816,2,16,238
96581740@N03,7871,26,1442124326,1442124326,1,16,0
96581740@N03,7871,21,1442125332,1442126451,2,16,1119
96581740@N03,7871,27,1442107195,1442144959,37,16,37764
96581740@N03,7871,24,1442125355,1442125381,2,16,26
96581740@N03,7871,15,1442121176,1442121500,6,16,324
96581740@N03,7871,17,1442110728,1442110758,2,16,30
96581740@N03,7871,9,1442120758,1442120758,1,16,0
96581740@N03,7871,12,1442122058,1442122058,1,16,0
96581740@N03,7871,14,1442111359,1442123066,60,16,11707
96581740@N03,7871,16,1442110861,1442110889,2,16,28
96581740@N03,7871,20,1442124446,1442130123,3,16,5677
96581740@N03,7871,23,1442125395,1442126052,9,16,657
96581740@N03,7872,26,1442465052,1442465052,1,8,0
96581740@N03,7872,8,1442456190,1442456190,1,8,0
96581740@N03,7872,2,1442461097,1442461249,4,8,152
96581740@N03,7872,7,1442456609,1442456615,3,8,6
96581740@N03,7872,21,1442473673,1442473673,1,8,0
96581740@N03,7872,24,1442473498,1442473714,2,8,216
96581740@N03,7872,6,1442458009,1442458009,1,8,0
96581740@N03,7872,25,1442465075,1442473911,11,8,8836
96586459@N00,7873,8,1422861337,1422861337,1,2,0
96586459@N00,7873,16,1422851294,1422851294,1,2,0
96603081@N02,7874,14,1310906129,1310906133,2,1,4
96603081@N02,7875,12,1369459460,1369459460,1,1,0
9663436@N03,7876,27,1396168982,1396169184,8,3,202
9663436@N03,7876,13,1396161367,1396161406,3,3,39
9663436@N03,7876,18,1396161341,1396161341,1,3,0
96634395@N05,7877,22,1389338826,1389338826,1,1,0
96634395@N05,7878,10,1392981970,1392981970,1,1,0
96634395@N05,7879,22,1393500442,1393500442,1,1,0
96634395@N05,7880,17,1394345203,1394345203,1,1,0
96639807@N00,7881,22,1418207119,1418208100,9,5,981
96639807@N00,7881,4,1418212878,1418212878,1,5,0
96639807@N00,7881,16,1418204210,1418204210,1,5,0
96639807@N00,7881,14,1418192485,1418204125,3,5,11640
96639807@N00,7881,27,1418213458,1418213458,1,5,0
9664341@N05,7882,14,1215071994,1215085357,4,4,13363
9664341@N05,7882,27,1215090288,1215090288,1,4,0
9664341@N05,7882,17,1215089039,1215089039,1,4,0
9664341@N05,7882,13,1215084436,1215084436,1,4,0
96678288@N02,7883,21,1367736735,1367736735,1,1,0
96678288@N02,7884,27,1369660465,1369660718,8,2,253
96678288@N02,7884,24,1369656737,1369656737,1,2,0
96678288@N02,7885,10,1370438905,1370438905,3,2,0
96678288@N02,7885,3,1370439022,1370439026,6,2,4
96678288@N02,7886,1,1378287806,1378287967,4,7,161
96678288@N02,7886,5,1378287184,1378287184,1,7,0
96678288@N02,7886,10,1378292377,1378292749,4,7,372
96678288@N02,7886,14,1378284771,1378291852,24,7,7081
96678288@N02,7886,27,1378282870,1378282945,15,7,75
96678288@N02,7886,2,1378287343,1378287343,1,7,0
96678288@N02,7886,9,1378286925,1378286925,1,7,0
96678288@N02,7887,26,1380376547,1380376547,1,3,0
96678288@N02,7887,1,1380367664,1380367664,1,3,0
96678288@N02,7887,21,1380375456,1380375519,2,3,63
96678288@N02,7888,10,1381571880,1381572912,31,14,1032
96678288@N02,7888,22,1381567465,1381567465,1,14,0
96678288@N02,7888,23,1381567350,1381567350,1,14,0
96678288@N02,7888,2,1381570887,1381570887,1,14,0
96678288@N02,7888,4,1381571156,1381571156,1,14,0
96678288@N02,7888,14,1381571600,1381571600,1,14,0
96678288@N02,7888,20,1381574152,1381574274,4,14,122
96678288@N02,7888,6,1381569105,1381569374,4,14,269
96678288@N02,7888,15,1381568067,1381574140,3,14,6073
96678288@N02,7888,21,1381576319,1381577450,10,14,1131
96678288@N02,7888,27,1381566205,1381578643,13,14,12438
96678288@N02,7888,1,1381570898,1381570898,1,14,0
96678288@N02,7888,25,1381567128,1381577909,4,14,10781
96678288@N02,7888,3,1381570951,1381570951,1,14,0
96678288@N02,7889,26,1383123215,1383123507,10,9,292
96678288@N02,7889,11,1383126588,1383127937,48,9,1349
96678288@N02,7889,8,1383128717,1383129300,8,9,583
96678288@N02,7889,10,1383129338,1383129491,5,9,153
96678288@N02,7889,27,1383118288,1383130566,13,9,12278
96678288@N02,7889,13,1383124498,1383124616,2,9,118
96678288@N02,7889,15,1383124122,1383126360,14,9,2238
96678288@N02,7889,23,1383123664,1383123664,1,9,0
96678288@N02,7889,7,1383129843,1383129849,2,9,6
96678288@N02,7890,27,1383978661,1383978661,1,1,0
96678288@N02,7891,10,1386412661,1386412711,2,6,50
96678288@N02,7891,7,1386412213,1386412304,2,6,91
96678288@N02,7891,1,1386416742,1386416742,1,6,0
96678288@N02,7891,6,1386411514,1386411514,1,6,0
96678288@N02,7891,5,1386419070,1386419070,1,6,0
96678288@N02,7891,27,1386419464,1386419464,1,6,0
96678288@N02,7892,27,1387946635,1387958898,15,1,12263
96678288@N02,7893,10,1388491673,1388491673,1,5,0
96678288@N02,7893,27,1388502690,1388502727,3,5,37
96678288@N02,7893,17,1388499516,1388499642,2,5,126
96678288@N02,7893,3,1388490061,1388490061,1,5,0
96678288@N02,7893,14,1388495865,1388495865,1,5,0
96678288@N02,7894,10,1391253618,1391255549,8,4,1931
96678288@N02,7894,5,1391250542,1391250542,2,4,0
96678288@N02,7894,9,1391252902,1391253018,2,4,116
96678288@N02,7894,14,1391253493,1391253493,1,4,0
96678288@N02,7895,13,1393667935,1393667935,1,8,0
96678288@N02,7895,14,1393671889,1393672221,4,8,332
96678288@N02,7895,3,1393675517,1393675613,3,8,96
96678288@N02,7895,18,1393669011,1393669011,1,8,0
96678288@N02,7895,6,1393674386,1393674471,3,8,85
96678288@N02,7895,22,1393665153,1393665970,2,8,817
96678288@N02,7895,9,1393673719,1393673719,1,8,0
96678288@N02,7895,19,1393666625,1393666625,1,8,0
96678288@N02,7896,10,1395816061,1395816061,1,8,0
96678288@N02,7896,22,1395821047,1395821047,1,8,0
96678288@N02,7896,17,1395821389,1395821869,2,8,480
96678288@N02,7896,1,1395810057,1395810119,2,8,62
96678288@N02,7896,9,1395815639,1395815867,3,8,228
96678288@N02,7896,14,1395815430,1395815430,1,8,0
96678288@N02,7896,2,1395810020,1395814548,5,8,4528
96678288@N02,7896,27,1395807403,1395822815,99,8,15412
96678288@N02,7897,7,1398507113,1398507113,1,5,0
96678288@N02,7897,3,1398513855,1398513855,1,5,0
96678288@N02,7897,6,1398510743,1398511111,2,5,368
96678288@N02,7897,9,1398506275,1398507038,16,5,763
96678288@N02,7897,14,1398507466,1398509302,2,5,1836
96678288@N02,7898,14,1403099751,1403100808,15,1,1057
96678288@N02,7899,16,1403186263,1403186322,2,2,59
96678288@N02,7899,14,1403179456,1403186057,13,2,6601
96678288@N02,7900,14,1405512561,1405512561,1,2,0
96678288@N02,7900,16,1405522643,1405522643,1,2,0
96678288@N02,7901,17,1407338527,1407338527,1,1,0
96678288@N02,7902,27,1412152345,1412161200,7,1,8855
96678288@N02,7903,15,1412767660,1412767660,1,1,0
96678288@N02,7904,27,1414566371,1414566371,1,1,0
96678288@N02,7905,27,1419481947,1419481947,1,1,0
96678288@N02,7906,14,1419513057,1419513057,1,1,0
96678288@N02,7907,14,1435307593,1435307593,1,1,0
96678288@N02,7908,23,1440235541,1440235663,2,2,122
96678288@N02,7908,24,1440235019,1440235824,2,2,805
96678288@N02,7909,1,1451103609,1451103609,1,2,0
96678288@N02,7909,27,1451095093,1451096702,2,2,1609
96678288@N02,7910,10,1451554511,1451563837,3,1,9326
96678288@N02,7911,21,1451629047,1451629047,1,3,0
96678288@N02,7911,27,1451647504,1451647504,1,3,0
96678288@N02,7911,26,1451632430,1451632430,1,3,0
96678288@N02,7912,27,1452849944,1452853549,2,5,3605
96678288@N02,7912,6,1452846042,1452846042,1,5,0
96678288@N02,7912,2,1452836784,1452838486,2,5,1702
96678288@N02,7912,18,1452859094,1452860168,3,5,1074
96678288@N02,7912,1,1452844300,1452844300,1,5,0
96678288@N02,7913,2,1454910374,1454910374,1,1,0
96678288@N02,7914,21,1456725816,1456726717,2,5,901
96678288@N02,7914,9,1456736292,1456736292,1,5,0
96678288@N02,7914,27,1456739871,1456745842,2,5,5971
96678288@N02,7914,13,1456730693,1456734009,2,5,3316
96678288@N02,7914,8,1456732607,1456734760,2,5,2153
96678288@N02,7915,22,1456802784,1456802784,1,1,0
96678288@N02,7916,20,1457421164,1457421164,1,1,0
96678288@N02,7917,21,1457617582,1457617582,1,1,0
96678288@N02,7918,13,1458635832,1458635832,1,1,0
96678288@N02,7919,20,1459238799,1459242405,3,1,3606
96678288@N02,7920,20,1459825002,1459825002,1,1,0
96678288@N02,7921,15,1460371947,1460371947,1,2,0
96678288@N02,7921,20,1460365292,1460365292,1,2,0
96678288@N02,7922,15,1460416091,1460416562,2,1,471
96678288@N02,7923,9,1461578309,1461586764,2,3,8455
96678288@N02,7923,4,1461565690,1461565690,1,3,0
96678288@N02,7923,2,1461564579,1461564579,1,3,0
96678288@N02,7924,22,1461679276,1461679276,1,1,0
96678288@N02,7925,20,1462258362,1462258362,1,4,0
96678288@N02,7925,4,1462266037,1462266037,1,4,0
96678288@N02,7925,3,1462254480,1462254480,1,4,0
96678288@N02,7925,27,1462279700,1462279700,1,4,0
96678288@N02,7926,3,1462401665,1462401665,1,1,0
96678288@N02,7927,4,1462488131,1462488131,1,1,0
96678288@N02,7928,4,1462749007,1462749007,1,1,0
96678288@N02,7929,2,1463390833,1463395189,2,3,4356
96678288@N02,7929,1,1463401800,1463401800,1,3,0
96678288@N02,7929,19,1463382980,1463382980,1,3,0
96678288@N02,7930,10,1467616506,1467621951,4,1,5445
96678288@N02,7931,10,1467659104,1467659104,1,1,0
96678288@N02,7932,27,1468307047,1468331759,3,1,24712
96678288@N02,7933,27,1468410637,1468410894,2,2,257
96678288@N02,7933,14,1468411292,1468411292,1,2,0
96678288@N02,7934,27,1468588050,1468588464,3,1,414
96678288@N02,7935,24,1470125905,1470125905,1,4,0
96678288@N02,7935,2,1470108812,1470148589,8,4,39777
96678288@N02,7935,10,1470115011,1470117063,4,4,2052
96678288@N02,7935,7,1470121751,1470121751,1,4,0
96678288@N02,7936,15,1470309454,1470309454,1,3,0
96678288@N02,7936,27,1470313128,1470313128,1,3,0
96678288@N02,7936,3,1470310107,1470310107,1,3,0
96678288@N02,7937,22,1471257411,1471257411,1,3,0
96678288@N02,7937,26,1471257212,1471257212,1,3,0
96678288@N02,7937,27,1471245018,1471245018,1,3,0
96678288@N02,7938,27,1471311374,1471319837,2,1,8463
96678288@N02,7939,15,1471440129,1471440129,1,1,0
96739093@N00,7940,18,1279275004,1279275004,1,2,0
96739093@N00,7940,8,1279275382,1279275382,1,2,0
96739093@N00,7941,18,1279337194,1279359843,2,1,22649
96740336@N06,7942,12,1438744815,1438744815,1,1,0
96846534@N05,7943,27,1363387110,1363388864,7,1,1754
96846534@N05,7944,26,1363587539,1363587744,8,4,205
96846534@N05,7944,10,1363590809,1363590809,1,4,0
96846534@N05,7944,7,1363575272,1363575482,11,4,210
96846534@N05,7944,14,1363577591,1363580292,12,4,2701
96882800@N08,7945,27,1370076575,1370076575,1,2,0
96882800@N08,7945,14,1370076574,1370076574,1,2,0
96899238@N00,7946,5,1451453357,1451453357,1,7,0
96899238@N00,7946,16,1451441126,1451441126,1,7,0
96899238@N00,7946,2,1451451838,1451452143,2,7,305
96899238@N00,7946,4,1451453340,1451453340,1,7,0
96899238@N00,7946,15,1451438025,1451444250,12,7,6225
96899238@N00,7946,6,1451461433,1451461455,3,7,22
96899238@N00,7946,27,1451428931,1451469254,6,7,40323
96905971@N05,7947,17,1370598027,1370598027,1,1,0
96913191@N00,7948,27,1330058962,1330058962,1,1,0
96926231@N00,7949,27,1341095105,1341095105,1,2,0
96926231@N00,7949,9,1341102353,1341102353,1,2,0
96934975@N05,7950,23,1371003868,1371003874,2,1,6
96934975@N05,7951,17,1371381121,1371382043,9,1,922
96954838@N03,7952,4,1397110626,1397110626,1,12,0
96954838@N03,7952,2,1397112289,1397117470,16,12,5181
96954838@N03,7952,14,1397118582,1397118917,5,12,335
96954838@N03,7952,7,1397117817,1397117817,1,12,0
96954838@N03,7952,1,1397112589,1397116385,8,12,3796
96954838@N03,7952,6,1397117567,1397117567,1,12,0
96954838@N03,7952,21,1397122450,1397122450,1,12,0
96954838@N03,7952,27,1397106778,1397120555,5,12,13777
96954838@N03,7952,3,1397112928,1397112928,1,12,0
96954838@N03,7952,17,1397119061,1397119301,6,12,240
96954838@N03,7952,10,1397118023,1397118499,10,12,476
96954838@N03,7952,5,1397116687,1397116699,2,12,12
9698992@N06,7953,14,1297580200,1297580200,1,2,0
9698992@N06,7953,16,1297586946,1297597251,2,2,10305
96991828@N07,7954,10,1324727180,1324729941,11,4,2761
96991828@N07,7954,4,1324707466,1324707466,1,4,0
96991828@N07,7954,14,1324707261,1324730073,17,4,22812
96991828@N07,7954,9,1324729704,1324729732,4,4,28
97023479@N08,7955,4,1444043043,1444043064,4,8,21
97023479@N08,7955,17,1444023419,1444040393,2,8,16974
97023479@N08,7955,26,1444016719,1444018610,14,8,1891
97023479@N08,7955,27,1444036857,1444036857,1,8,0
97023479@N08,7955,20,1444006898,1444006898,1,8,0
97023479@N08,7955,19,1444008768,1444009974,2,8,1206
97023479@N08,7955,13,1444010825,1444010825,1,8,0
97023479@N08,7955,22,1444010329,1444010329,1,8,0
9708101@N02,7956,1,1218958585,1218958585,1,3,0
9708101@N02,7956,22,1218968261,1218968375,2,3,114
9708101@N02,7956,19,1218966706,1218966706,1,3,0
97137858@N00,7957,14,1261472052,1261472553,3,10,501
97137858@N00,7957,7,1261491061,1261491061,1,10,0
97137858@N00,7957,18,1261488260,1261488260,1,10,0
97137858@N00,7957,27,1261465023,1261465023,1,10,0
97137858@N00,7957,9,1261490254,1261490254,1,10,0
97137858@N00,7957,12,1261468857,1261470106,4,10,1249
97137858@N00,7957,24,1261482138,1261483217,3,10,1079
97137858@N00,7957,21,1261477832,1261480977,7,10,3145
97137858@N00,7957,15,1261467916,1261471647,4,10,3731
97137858@N00,7957,17,1261484580,1261484580,1,10,0
97156490@N00,7958,1,1324014858,1324014858,1,1,0
97225209@N00,7959,27,1382060066,1382088241,3,2,28175
97225209@N00,7959,12,1382052839,1382052839,1,2,0
97225209@N00,7960,3,1419547923,1419547923,1,2,0
97225209@N00,7960,6,1419552979,1419552979,1,2,0
97267319@N00,7961,7,1365583383,1365583383,1,4,0
97267319@N00,7961,6,1365584561,1365584561,1,4,0
97267319@N00,7961,14,1365568522,1365568644,6,4,122
97267319@N00,7961,27,1365577484,1365577584,3,4,100
97267319@N00,7962,3,1365733549,1365733553,2,3,4
97267319@N00,7962,2,1365744803,1365744803,1,3,0
97267319@N00,7962,4,1365745811,1365745811,1,3,0
97316061@N05,7963,7,1426557337,1426557337,1,4,0
97316061@N05,7963,25,1426550868,1426550868,1,4,0
97316061@N05,7963,16,1426541525,1426541525,1,4,0
97316061@N05,7963,27,1426540733,1426540733,1,4,0
97316886@N04,7964,17,1452341320,1452341332,3,6,12
97316886@N04,7964,27,1452330858,1452330923,3,6,65
97316886@N04,7964,7,1452337417,1452337942,30,6,525
97316886@N04,7964,4,1452331312,1452331312,1,6,0
97316886@N04,7964,8,1452337398,1452337754,2,6,356
97316886@N04,7964,14,1452338462,1452338462,1,6,0
97316886@N04,7965,13,1452577026,1452577026,1,1,0
97321472@N00,7966,27,1308352026,1308352026,1,1,0
97408089@N00,7967,14,1363124027,1363124027,2,6,0
97408089@N00,7967,5,1363142629,1363142629,2,6,0
97408089@N00,7967,3,1363154434,1363154434,2,6,0
97408089@N00,7967,27,1363155659,1363155659,2,6,0
97408089@N00,7967,7,1363136926,1363136926,2,6,0
97408089@N00,7967,12,1363124059,1363124431,4,6,372
97413516@N00,7968,8,1287056445,1287056445,1,1,0
97428135@N07,7969,27,1415860714,1415860714,1,1,0
97435799@N07,7970,17,1433554537,1433554541,2,3,4
97435799@N07,7970,10,1433552329,1433552332,2,3,3
97435799@N07,7970,22,1433555952,1433556992,10,3,1040
97477255@N00,7971,18,1359608057,1359608057,1,2,0
97477255@N00,7971,27,1359605282,1359605727,2,2,445
97477255@N00,7972,25,1359686831,1359687247,6,4,416
97477255@N00,7972,4,1359706390,1359706390,1,4,0
97477255@N00,7972,21,1359689090,1359689555,2,4,465
97477255@N00,7972,17,1359686659,1359686659,1,4,0
97477255@N00,7973,19,1423192818,1423206216,5,9,13398
97477255@N00,7973,23,1423188783,1423188783,1,9,0
97477255@N00,7973,10,1423207815,1423208976,4,9,1161
97477255@N00,7973,13,1423200189,1423200189,1,9,0
97477255@N00,7973,27,1423184958,1423184958,1,9,0
97477255@N00,7973,22,1423194522,1423203086,3,9,8564
97477255@N00,7973,20,1423191562,1423203442,7,9,11880
97477255@N00,7973,17,1423186019,1423198296,4,9,12277
97477255@N00,7973,14,1423186344,1423186344,1,9,0
97477255@N00,7974,6,1423548174,1423548174,1,8,0
97477255@N00,7974,22,1423560961,1423561045,3,8,84
97477255@N00,7974,15,1423533927,1423533927,1,8,0
97477255@N00,7974,10,1423534741,1423537222,9,8,2481
97477255@N00,7974,7,1423540121,1423540121,1,8,0
97477255@N00,7974,9,1423532590,1423544489,3,8,11899
97477255@N00,7974,26,1423561577,1423561577,1,8,0
97477255@N00,7974,14,1423533404,1423534501,2,8,1097
97480752@N07,7975,13,1371895116,1371896435,3,1,1319
97489023@N00,7976,13,1323138118,1323138118,1,3,0
97489023@N00,7976,14,1323151526,1323151526,1,3,0
97489023@N00,7976,23,1323147679,1323147679,1,3,0
97489023@N00,7977,25,1323667923,1323667923,1,2,0
97489023@N00,7977,27,1323652370,1323652370,1,2,0
97522763@N07,7978,27,1381017622,1381040369,37,1,22747
97522763@N07,7979,15,1445051430,1445051430,1,4,0
97522763@N07,7979,27,1445040222,1445040255,2,4,33
97522763@N07,7979,14,1445051513,1445051513,1,4,0
97522763@N07,7979,13,1445048550,1445051329,2,4,2779
97550352@N08,7980,27,1381549018,1381549018,1,1,0
97550352@N08,7981,27,1381642239,1381642239,1,1,0
97550352@N08,7982,27,1387613832,1387614580,2,1,748
97586961@N05,7983,17,1395629754,1395629754,1,1,0
97586961@N05,7984,18,1395710345,1395710345,1,1,0
97586961@N05,7985,19,1395803530,1395803530,1,1,0
97586978@N07,7986,10,1350053985,1350053985,1,1,0
97599663@N05,7987,26,1434413750,1434413777,4,4,27
97599663@N05,7987,25,1434454273,1434455412,13,4,1139
97599663@N05,7987,6,1434430551,1434430551,1,4,0
97599663@N05,7987,10,1434436494,1434436494,1,4,0
97599663@N05,7988,14,1434766158,1434766171,2,2,13
97599663@N05,7988,16,1434766107,1434766158,4,2,51
97621779@N03,7989,14,1339503658,1339503670,2,1,12
97621779@N03,7990,27,1378252343,1378252343,1,2,0
97621779@N03,7990,10,1378253885,1378256097,3,2,2212
97639305@N00,7991,27,1300103120,1300103143,2,1,23
97662785@N07,7992,14,1313628553,1313628553,1,1,0
97675277@N00,7993,12,1350824137,1350824137,1,5,0
97675277@N00,7993,14,1350825340,1350825340,1,5,0
97675277@N00,7993,23,1350825229,1350825229,1,5,0
97675277@N00,7993,15,1350824150,1350824150,1,5,0
97675277@N00,7993,4,1350825312,1350825312,1,5,0
97721343@N08,7994,27,1420030830,1420030830,1,1,0
97721343@N08,7995,8,1420242905,1420244435,4,1,1530
97721343@N08,7996,27,1438994807,1438994807,1,1,0
97721343@N08,7997,17,1439100169,1439100169,1,3,0
97721343@N08,7997,8,1439094942,1439098862,4,3,3920
97721343@N08,7997,27,1439099863,1439100775,2,3,912
97721343@N08,7998,8,1463627916,1463627923,2,1,7
97797214@N02,7999,27,1450313924,1450343267,3,1,29343
97818848@N05,8000,22,1402126343,1402126343,1,1,0
97818848@N05,8001,14,1438001502,1438001508,2,1,6
97818848@N05,8002,9,1453444950,1453444980,3,2,30
97818848@N05,8002,27,1453422308,1453422308,1,2,0
97831130@N00,8003,27,1333463439,1333463439,1,1,0
97831130@N00,8004,16,1333509359,1333509359,1,3,0
97831130@N00,8004,6,1333533820,1333533820,1,3,0
97831130@N00,8004,14,1333535097,1333535097,1,3,0
97831130@N00,8005,6,1333955747,1333955747,1,1,0
97831130@N00,8006,14,1334058873,1334058873,1,1,0
97838235@N00,8007,9,1381356368,1381368542,3,4,12174
97838235@N00,8007,14,1381352422,1381354294,6,4,1872
97838235@N00,8007,2,1381357659,1381357659,1,4,0
97838235@N00,8007,16,1381352142,1381352142,1,4,0
97838235@N00,8008,25,1381460660,1381460661,2,7,1
97838235@N00,8008,21,1381463555,1381463815,2,7,260
97838235@N00,8008,23,1381462825,1381462825,1,7,0
97838235@N00,8008,14,1381443732,1381444270,13,7,538
97838235@N00,8008,12,1381446938,1381447499,17,7,561
97838235@N00,8008,10,1381449053,1381449053,1,7,0
97838235@N00,8008,19,1381458805,1381458805,1,7,0
97845599@N04,8009,10,1423523645,1423523645,1,1,0
9790304@N07,8010,10,1364036885,1364037077,5,3,192
9790304@N07,8010,27,1364031491,1364039511,28,3,8020
9790304@N07,8010,16,1364029799,1364029799,1,3,0
9790304@N07,8011,27,1364088250,1364088250,1,3,0
9790304@N07,8011,8,1364089177,1364089275,3,3,98
9790304@N07,8011,2,1364089923,1364089923,1,3,0
97927316@N02,8012,16,1388815712,1388815712,1,2,0
97927316@N02,8012,27,1388799739,1388799739,1,2,0
97964364@N00,8013,14,1191645519,1191645519,1,1,0
97964364@N00,8014,14,1191880270,1191883731,5,1,3461
97994710@N03,8015,27,1403101458,1403101458,1,1,0
98051750@N04,8016,14,1369477787,1369477787,1,1,0
98066314@N07,8017,18,1362011847,1362011847,1,2,0
98066314@N07,8017,17,1362037157,1362037724,2,2,567
9806845@N03,8018,4,1308096017,1308105553,16,1,9536
9806845@N03,8019,4,1308222721,1308226549,9,1,3828
9806845@N03,8020,4,1308545486,1308546877,11,1,1391
9806845@N03,8021,4,1308786981,1308793711,23,1,6730
98109106@N00,8022,27,1246163185,1246182409,2,6,19224
98109106@N00,8022,14,1246175250,1246175250,1,6,0
98109106@N00,8022,2,1246167612,1246168819,5,6,1207
98109106@N00,8022,6,1246171606,1246171606,1,6,0
98109106@N00,8022,11,1246173505,1246181391,3,6,7886
98109106@N00,8022,8,1246180096,1246180096,1,6,0
98109106@N00,8023,27,1246638552,1246639354,5,2,802
98109106@N00,8023,14,1246639825,1246645055,9,2,5230
98109106@N00,8024,27,1246952379,1246952785,2,9,406
98109106@N00,8024,12,1246960803,1246960803,1,9,0
98109106@N00,8024,21,1246972427,1246972427,1,9,0
98109106@N00,8024,16,1246954159,1246954159,1,9,0
98109106@N00,8024,14,1246953268,1246968865,7,9,15597
98109106@N00,8024,23,1246973202,1246973202,1,9,0
98109106@N00,8024,17,1246964422,1246964422,1,9,0
98109106@N00,8024,20,1246974879,1246975290,4,9,411
98109106@N00,8024,15,1246967654,1246967654,1,9,0
98111413@N05,8025,3,1445418697,1445418697,1,1,0
9813050@N08,8026,16,1257156506,1257162351,39,8,5845
9813050@N08,8026,22,1257165948,1257166111,7,8,163
9813050@N08,8026,13,1257164680,1257165542,4,8,862
9813050@N08,8026,9,1257162400,1257162400,1,8,0
9813050@N08,8026,18,1257165673,1257165752,3,8,79
9813050@N08,8026,6,1257163692,1257163692,1,8,0
9813050@N08,8026,27,1257156177,1257156427,8,8,250
9813050@N08,8026,5,1257163969,1257164160,5,8,191
9813050@N08,8027,9,1257309410,1257309645,6,10,235
9813050@N08,8027,26,1257310150,1257310358,7,10,208
9813050@N08,8027,15,1257309681,1257310038,10,10,357
9813050@N08,8027,16,1257315294,1257316293,34,10,999
9813050@N08,8027,2,1257316311,1257317009,20,10,698
9813050@N08,8027,22,1257312923,1257313044,9,10,121
9813050@N08,8027,11,1257309244,1257309388,8,10,144
9813050@N08,8027,17,1257310365,1257310392,2,10,27
9813050@N08,8027,4,1257316328,1257318182,17,10,1854
9813050@N08,8027,27,1257308167,1257320254,27,10,12087
9813050@N08,8028,9,1257485836,1257485871,3,3,35
9813050@N08,8028,20,1257482119,1257483184,16,3,1065
9813050@N08,8028,27,1257471137,1257471826,18,3,689
98223232@N00,8029,27,1255327275,1255327379,4,1,104
98223232@N00,8030,27,1255646704,1255647004,7,1,300
98234674@N06,8031,27,1332022648,1332022648,1,1,0
98283794@N05,8032,24,1369185868,1369185868,1,2,0
98283794@N05,8032,14,1369193479,1369193479,1,2,0
98297562@N04,8033,18,1395042396,1395042410,2,1,14
98297562@N04,8034,1,1395320611,1395320611,1,1,0
98323063@N07,8035,27,1375955440,1375955440,1,1,0
98327728@N00,8036,10,1418539182,1418539182,1,1,0
98327728@N00,8037,17,1418956060,1418956060,1,2,0
98327728@N00,8037,9,1418963625,1418963625,1,2,0
98387918@N07,8038,16,1417164882,1417164882,1,1,0
98474523@N00,8039,19,1322828927,1322829315,3,3,388
98474523@N00,8039,16,1322818304,1322821449,14,3,3145
98474523@N00,8039,17,1322825994,1322826177,2,3,183
98474523@N00,8040,14,1322979299,1322979299,1,5,0
98474523@N00,8040,17,1322961253,1322962536,11,5,1283
98474523@N00,8040,16,1322959628,1322959878,2,5,250
98474523@N00,8040,19,1322953938,1322955680,4,5,1742
98474523@N00,8040,21,1322976785,1322978039,7,5,1254
98474523@N00,8041,14,1323149376,1323150931,3,1,1555
98497282@N00,8042,7,1369960600,1369960600,1,8,0
98497282@N00,8042,9,1369966909,1369987132,4,8,20223
98497282@N00,8042,17,1369972876,1369972876,1,8,0
98497282@N00,8042,11,1369958802,1369958802,1,8,0
98497282@N00,8042,16,1369962383,1369962383,1,8,0
98497282@N00,8042,14,1369962558,1369962560,2,8,2
98497282@N00,8042,27,1369954409,1369954409,1,8,0
98497282@N00,8042,13,1369985653,1369985667,2,8,14
98497282@N00,8043,24,1370314165,1370314165,1,1,0
98537131@N08,8044,6,1398215170,1398215170,1,1,0
9858951@N03,8045,27,1230200290,1230200329,26,2,39
9858951@N03,8045,16,1230199892,1230200083,10,2,191
9858951@N03,8046,16,1230354957,1230357105,224,2,2148
9858951@N03,8046,27,1230354679,1230357168,52,2,2489
9858951@N03,8047,19,1241317197,1241317197,1,1,0
98593368@N02,8048,15,1408526595,1408527105,3,2,510
98593368@N02,8048,12,1408527049,1408527049,1,2,0
9860213@N08,8049,27,1343025047,1343025047,1,1,0
9860213@N08,8050,27,1343181716,1343185972,2,2,4256
9860213@N08,8050,14,1343185868,1343185868,1,2,0
9860213@N08,8051,5,1343218165,1343218165,1,1,0
9860213@N08,8052,27,1441520849,1441520849,1,1,0
9860213@N08,8053,21,1447905067,1447905067,1,1,0
98645300@N00,8054,27,1308739999,1308739999,1,1,0
98672908@N07,8055,9,1451362222,1451362222,1,4,0
98672908@N07,8055,27,1451347747,1451347747,1,4,0
98672908@N07,8055,1,1451349924,1451349924,1,4,0
98672908@N07,8055,22,1451371091,1451371091,1,4,0
9868739@N04,8056,19,1467978476,1467978476,1,1,0
98713175@N04,8057,4,1372892614,1372892614,1,1,0
98713175@N04,8058,26,1372927124,1372927147,3,3,23
98713175@N04,8058,24,1372926826,1372926866,2,3,40
98713175@N04,8058,21,1372926207,1372926354,3,3,147
98767429@N00,8059,5,1197283866,1197283944,3,7,78
98767429@N00,8059,27,1197230596,1197230674,2,7,78
98767429@N00,8059,16,1197253894,1197284689,3,7,30795
98767429@N00,8059,22,1197248194,1197251682,6,7,3488
98767429@N00,8059,25,1197235623,1197243703,10,7,8080
98767429@N00,8059,14,1197285308,1197285724,4,7,416
98767429@N00,8059,17,1197244018,1197245639,6,7,1621
98876406@N00,8060,2,1356736137,1356736137,1,1,0
98889314@N02,8061,23,1403490990,1403490990,1,1,0
98889314@N02,8062,10,1403675163,1403675163,1,1,0
98889314@N02,8063,27,1403771161,1403772428,2,2,1267
98889314@N02,8063,17,1403771344,1403771350,2,2,6
98889314@N02,8064,9,1403906341,1403906487,11,12,146
98889314@N02,8064,10,1403921547,1403921636,7,12,89
98889314@N02,8064,4,1403920029,1403926247,3,12,6218
98889314@N02,8064,14,1403906144,1403922943,11,12,16799
98889314@N02,8064,7,1403921483,1403921543,2,12,60
98889314@N02,8064,17,1403908271,1403908329,8,12,58
98889314@N02,8064,6,1403921368,1403921430,2,12,62
98889314@N02,8064,2,1403924943,1403926115,3,12,1172
98889314@N02,8064,5,1403921358,1403926162,7,12,4804
98889314@N02,8064,16,1403906088,1403923509,9,12,17421
98889314@N02,8064,27,1403905776,1403926736,43,12,20960
98889314@N02,8064,1,1403924984,1403925995,10,12,1011
98889314@N02,8065,15,1404035946,1404035946,1,1,0
98889314@N02,8066,15,1405591815,1405591815,1,1,0
98889314@N02,8067,17,1417212251,1417212251,1,1,0
98889314@N02,8068,17,1430872728,1430872728,1,1,0
98889314@N02,8069,10,1432467476,1432467481,2,1,5
98926431@N07,8070,6,1381412946,1381412952,2,1,6
98926431@N07,8071,6,1383632807,1383632811,2,1,4
9907136@N02,8072,13,1252018655,1252019472,2,2,817
9907136@N02,8072,27,1252010963,1252012276,2,2,1313
9907136@N02,8073,27,1252378021,1252378021,1,1,0
9907136@N02,8074,13,1252453599,1252453599,1,5,0
9907136@N02,8074,19,1252461121,1252461121,1,5,0
9907136@N02,8074,17,1252477810,1252483674,3,5,5864
9907136@N02,8074,9,1252448787,1252448787,1,5,0
9907136@N02,8074,20,1252459570,1252459570,1,5,0
9907136@N02,8075,13,1333500775,1333501081,2,6,306
9907136@N02,8075,6,1333491574,1333491574,1,6,0
9907136@N02,8075,14,1333494870,1333494870,1,6,0
9907136@N02,8075,8,1333492467,1333492467,1,6,0
9907136@N02,8075,12,1333499562,1333499562,1,6,0
9907136@N02,8075,9,1333492838,1333492838,1,6,0
9907136@N02,8076,27,1333708328,1333708328,1,2,0
9907136@N02,8076,17,1333719010,1333719010,1,2,0
9907136@N02,8077,9,1333762405,1333762501,2,1,96
99078571@N02,8078,21,1426144367,1426144514,5,3,147
99078571@N02,8078,20,1426132895,1426132930,2,3,35
99078571@N02,8078,19,1426151770,1426151926,4,3,156
99119735@N06,8079,9,1382567761,1382567761,1,8,0
99119735@N06,8079,3,1382587208,1382587497,3,8,289
99119735@N06,8079,14,1382567606,1382567637,2,8,31
99119735@N06,8079,10,1382567702,1382568047,4,8,345
99119735@N06,8079,8,1382569173,1382569173,1,8,0
99119735@N06,8079,27,1382566767,1382566871,2,8,104
99119735@N06,8079,1,1382583832,1382583854,3,8,22
99119735@N06,8079,15,1382573940,1382573945,2,8,5
99119735@N06,8080,9,1382672537,1382672537,1,7,0
99119735@N06,8080,7,1382657502,1382657502,1,7,0
99119735@N06,8080,23,1382678381,1382678381,1,7,0
99119735@N06,8080,26,1382675005,1382675355,12,7,350
99119735@N06,8080,27,1382655020,1382669750,6,7,14730
99119735@N06,8080,15,1382661923,1382661923,1,7,0
99119735@N06,8080,4,1382680385,1382680625,2,7,240
99119735@N06,8081,13,1383041788,1383041788,1,2,0
99119735@N06,8081,17,1383042663,1383042663,1,2,0
99146615@N07,8082,16,1382773914,1382773914,1,1,0
9919720@N04,8083,14,1380185801,1380185801,1,1,0
9919720@N04,8084,9,1380252471,1380252478,3,1,7
99219204@N00,8085,8,1358937188,1358937188,1,8,0
99219204@N00,8085,15,1358929846,1358929846,1,8,0
99219204@N00,8085,10,1358930814,1358930814,1,8,0
99219204@N00,8085,13,1358929516,1358929602,3,8,86
99219204@N00,8085,16,1358925411,1358925411,1,8,0
99219204@N00,8085,12,1358929187,1358929368,3,8,181
99219204@N00,8085,7,1358931984,1358931984,1,8,0
99219204@N00,8085,2,1358933868,1358933868,1,8,0
99219204@N00,8086,27,1358970625,1358970625,1,1,0
99219204@N00,8087,25,1359248865,1359248919,2,7,54
99219204@N00,8087,11,1359266916,1359266916,1,7,0
99219204@N00,8087,13,1359258211,1359258211,1,7,0
99219204@N00,8087,18,1359253916,1359253916,1,7,0
99219204@N00,8087,14,1359268916,1359273711,3,7,4795
99219204@N00,8087,10,1359238989,1359275441,2,7,36452
99219204@N00,8087,17,1359256227,1359257963,3,7,1736
99250440@N05,8088,14,1386405995,1386405995,1,1,0
99250440@N05,8089,25,1386474239,1386474239,1,1,0
99259935@N03,8090,17,1374134020,1374134020,1,4,0
99259935@N03,8090,7,1374125897,1374125913,2,4,16
99259935@N03,8090,16,1374131301,1374131301,2,4,0
99259935@N03,8090,22,1374133013,1374133912,3,4,899
9926279@N03,8091,10,1460861395,1460865171,2,1,3776
99290939@N03,8092,19,1418200650,1418200723,3,7,73
99290939@N03,8092,12,1418176281,1418176281,1,7,0
99290939@N03,8092,15,1418176760,1418176772,3,7,12
99290939@N03,8092,9,1418196416,1418196417,2,7,1
99290939@N03,8092,20,1418201873,1418201873,1,7,0
99290939@N03,8092,17,1418206695,1418207636,21,7,941
99290939@N03,8092,13,1418176508,1418176508,1,7,0
99331736@N00,8093,9,1376038122,1376038122,1,4,0
99331736@N00,8093,12,1376034331,1376034331,1,4,0
99331736@N00,8093,24,1376035726,1376035726,1,4,0
99331736@N00,8093,8,1376041093,1376041093,1,4,0
99331736@N00,8094,16,1376094978,1376094978,1,1,0
99357496@N07,8095,3,1466808932,1466808932,2,1,0
99383273@N03,8096,16,1394349482,1394349521,4,1,39
99385068@N00,8097,26,1258862755,1258862822,2,2,67
99385068@N00,8097,18,1258862534,1258862761,2,2,227
99385068@N00,8098,16,1259188143,1259188143,1,2,0
99385068@N00,8098,14,1259185913,1259185913,1,2,0
99385068@N00,8099,14,1383308417,1383308426,4,2,9
99385068@N00,8099,2,1383309136,1383309749,16,2,613
99385068@N00,8100,12,1383436907,1383436952,8,1,45
99385068@N00,8101,9,1383694922,1383695080,11,2,158
99385068@N00,8101,14,1383715639,1383716576,3,2,937
99385068@N00,8102,20,1383900891,1383900896,2,1,5
99413924@N08,8103,27,1372932280,1372932280,1,1,0
99422834@N05,8104,14,1331641781,1331641781,1,4,0
99422834@N05,8104,2,1331636473,1331636473,1,4,0
99422834@N05,8104,12,1331641168,1331641392,12,4,224
99422834@N05,8104,9,1331639739,1331639949,4,4,210
99422834@N05,8105,18,1331895287,1331895287,1,1,0
9943459@N04,8106,16,1331672449,1331672449,1,1,0
99467063@N06,8107,27,1376220156,1376220160,3,1,4
99467063@N06,8108,8,1376371822,1376371822,1,1,0
99471343@N00,8109,2,1366071173,1366075686,4,7,4513
99471343@N00,8109,15,1366093819,1366093819,1,7,0
99471343@N00,8109,17,1366089715,1366090467,10,7,752
99471343@N00,8109,4,1366073176,1366073189,2,7,13
99471343@N00,8109,7,1366077582,1366077608,2,7,26
99471343@N00,8109,1,1366070014,1366070027,2,7,13
99471343@N00,8109,5,1366075801,1366075801,1,7,0
99471343@N00,8110,9,1366240081,1366250633,2,6,10552
99471343@N00,8110,25,1366257388,1366257408,2,6,20
99471343@N00,8110,14,1366240587,1366240957,3,6,370
99471343@N00,8110,10,1366249820,1366250522,3,6,702
99471343@N00,8110,8,1366251457,1366251640,2,6,183
99471343@N00,8110,24,1366258505,1366258505,1,6,0
99471343@N00,8111,23,1366356068,1366356068,1,2,0
99471343@N00,8111,27,1366351152,1366351152,1,2,0
99476430@N00,8112,5,1434510469,1434510469,1,2,0
99476430@N00,8112,14,1434509812,1434509812,1,2,0
99502551@N08,8113,20,1406943715,1406944488,5,3,773
99502551@N08,8113,19,1406950626,1406950626,1,3,0
99502551@N08,8113,10,1406948096,1406948096,1,3,0
99503665@N00,8114,19,1324867749,1324867749,1,1,0
99655398@N04,8115,16,1371730076,1371730076,1,1,0
9969286@N04,8116,4,1373169174,1373169174,1,1,0
99770522@N07,8117,14,1374277970,1374277970,1,1,0
9979792@N04,8118,2,1318378033,1318378045,2,1,12
99813844@N00,8119,16,1340532589,1340532589,1,4,0
99813844@N00,8119,27,1340532642,1340532642,1,4,0
99813844@N00,8119,1,1340532027,1340532027,1,4,0
99813844@N00,8119,13,1340531976,1340531976,1,4,0
99842259@N06,8120,2,1359330989,1359330989,1,1,0
99948019@N00,8121,13,1385860935,1385860935,1,2,0
99948019@N00,8121,14,1385877676,1385877676,1,2,0
99948019@N00,8122,16,1386489505,1386489505,1,4,0
99948019@N00,8122,6,1386487292,1386487292,1,4,0
99948019@N00,8122,19,1386498190,1386498190,1,4,0
99948019@N00,8122,9,1386488081,1386488081,1,4,0
99948019@N00,8123,10,1386759970,1386759970,1,3,0
99948019@N00,8123,14,1386754687,1386756287,2,3,1600
99948019@N00,8123,16,1386727916,1386727916,1,3,0
99948019@N00,8124,27,1386889912,1386889912,1,3,0
99948019@N00,8124,19,1386910531,1386910531,1,3,0
99948019@N00,8124,16,1386915318,1386915318,1,3,0
99977334@N00,8125,4,1317128191,1317128191,1,1,0
99983775@N00,8126,9,1335487318,1335487318,1,3,0
99983775@N00,8126,6,1335490718,1335490718,1,3,0
99983775@N00,8126,27,1335484143,1335484709,4,3,566
